trial	sttime	entime	sttime_rel	entime_rel	duration	eye	fname	ID	session
1	4213036	4213197	1228	1389	161	RIGHT	A12a.EDF	A12	1
2	4242793	4245262	58	2527	2469	RIGHT	A12a.EDF	A12	1
2	4245303	4245303	2568	2568	0	RIGHT	A12a.EDF	A12	1
2	4246160	4246178	3425	3443	18	RIGHT	A12a.EDF	A12	1
4	4254149	4254320	58	229	171	RIGHT	A12a.EDF	A12	1
5	4260390	4260605	159	374	215	RIGHT	A12a.EDF	A12	1
5	4260628	4260661	397	430	33	RIGHT	A12a.EDF	A12	1
6	4267843	4267843	887	887	0	RIGHT	A12a.EDF	A12	1
6	4268736	4268736	1780	1780	0	RIGHT	A12a.EDF	A12	1
6	4268780	4268780	1824	1824	0	RIGHT	A12a.EDF	A12	1
8	4279333	4279383	58	108	50	RIGHT	A12a.EDF	A12	1
9	4285259	4285460	58	259	201	RIGHT	A12a.EDF	A12	1
10	4291095	4291140	66	111	45	RIGHT	A12a.EDF	A12	1
11	4296902	4297081	58	237	179	RIGHT	A12a.EDF	A12	1
12	4303059	4303123	59	123	64	RIGHT	A12a.EDF	A12	1
12	4303308	4303647	308	647	339	RIGHT	A12a.EDF	A12	1
14	4316102	4316239	58	195	137	RIGHT	A12a.EDF	A12	1
14	4316324	4316520	280	476	196	RIGHT	A12a.EDF	A12	1
14	4317418	4317418	1374	1374	0	RIGHT	A12a.EDF	A12	1
14	4317442	4317583	1398	1539	141	RIGHT	A12a.EDF	A12	1
14	4317608	4317614	1564	1570	6	RIGHT	A12a.EDF	A12	1
14	4317641	4317641	1597	1597	0	RIGHT	A12a.EDF	A12	1
14	4317720	4317721	1676	1677	1	RIGHT	A12a.EDF	A12	1
14	4317861	4317873	1817	1829	12	RIGHT	A12a.EDF	A12	1
14	4317929	4317929	1885	1885	0	RIGHT	A12a.EDF	A12	1
17	4334238	4334469	240	471	231	RIGHT	A12a.EDF	A12	1
18	4339812	4340076	288	552	264	RIGHT	A12a.EDF	A12	1
19	4344960	4344979	73	92	19	RIGHT	A12a.EDF	A12	1
20	4350390	4350632	498	740	242	RIGHT	A12a.EDF	A12	1
21	4356119	4356394	365	640	275	RIGHT	A12a.EDF	A12	1
22	4361939	4362172	304	537	233	RIGHT	A12a.EDF	A12	1
25	4379872	4380013	658	799	141	RIGHT	A12a.EDF	A12	1
25	4380079	4380087	865	873	8	RIGHT	A12a.EDF	A12	1
26	4384678	4384685	91	98	7	RIGHT	A12a.EDF	A12	1
27	4391296	4391554	304	562	258	RIGHT	A12a.EDF	A12	1
29	4401843	4402028	58	243	185	RIGHT	A12a.EDF	A12	1
29	4402084	4402093	299	308	9	RIGHT	A12a.EDF	A12	1
31	4412243	4412351	58	166	108	RIGHT	A12a.EDF	A12	1
31	4412417	4412425	232	240	8	RIGHT	A12a.EDF	A12	1
32	4418198	4418203	78	83	5	RIGHT	A12a.EDF	A12	1
33	4423883	4424125	253	495	242	RIGHT	A12a.EDF	A12	1
35	4439680	4439884	4194	4398	204	RIGHT	A12a.EDF	A12	1
36	4441707	4442734	58	1085	1027	RIGHT	A12a.EDF	A12	1
37	4447111	4447309	58	256	198	RIGHT	A12a.EDF	A12	1
42	4474673	4474795	58	180	122	RIGHT	A12a.EDF	A12	1
43	4480494	4480734	336	576	240	RIGHT	A12a.EDF	A12	1
45	4490105	4490270	236	401	165	RIGHT	A12a.EDF	A12	1
45	4490324	4490327	455	458	3	RIGHT	A12a.EDF	A12	1
46	4495073	4495245	217	389	172	RIGHT	A12a.EDF	A12	1
46	4495293	4495303	437	447	10	RIGHT	A12a.EDF	A12	1
49	4512730	4512870	541	681	140	RIGHT	A12a.EDF	A12	1
49	4512915	4512923	726	734	8	RIGHT	A12a.EDF	A12	1
51	4523860	4523860	2238	2238	0	RIGHT	A12a.EDF	A12	1
52	4526886	4527150	71	335	264	RIGHT	A12a.EDF	A12	1
53	4532467	4532520	57	110	53	RIGHT	A12a.EDF	A12	1
53	4532603	4532604	193	194	1	RIGHT	A12a.EDF	A12	1
54	4537540	4537548	71	79	8	RIGHT	A12a.EDF	A12	1
54	4538250	4538398	781	929	148	RIGHT	A12a.EDF	A12	1
55	4543561	4543612	57	108	51	RIGHT	A12a.EDF	A12	1
55	4543676	4543680	172	176	4	RIGHT	A12a.EDF	A12	1
57	4557798	4557885	3593	3680	87	RIGHT	A12a.EDF	A12	1
58	4559583	4559594	72	83	11	RIGHT	A12a.EDF	A12	1
61	4576069	4576155	58	144	86	RIGHT	A12a.EDF	A12	1
61	4576214	4576214	203	203	0	RIGHT	A12a.EDF	A12	1
62	4580979	4581115	59	195	136	RIGHT	A12a.EDF	A12	1
62	4582078	4582182	1158	1262	104	RIGHT	A12a.EDF	A12	1
63	4586262	4586322	58	118	60	RIGHT	A12a.EDF	A12	1
63	4586391	4586392	187	188	1	RIGHT	A12a.EDF	A12	1
65	4597492	4597529	57	94	37	RIGHT	A12a.EDF	A12	1
65	4597622	4597628	187	193	6	RIGHT	A12a.EDF	A12	1
66	4602883	4603033	100	250	150	RIGHT	A12a.EDF	A12	1
66	4603112	4603120	329	337	8	RIGHT	A12a.EDF	A12	1
67	4608032	4608041	83	92	9	RIGHT	A12a.EDF	A12	1
67	4608586	4608757	637	808	171	RIGHT	A12a.EDF	A12	1
67	4608819	4608827	870	878	8	RIGHT	A12a.EDF	A12	1
68	4613493	4613494	118	119	1	RIGHT	A12a.EDF	A12	1
68	4613523	4613683	148	308	160	RIGHT	A12a.EDF	A12	1
68	4613751	4613764	376	389	13	RIGHT	A12a.EDF	A12	1
69	4619163	4619298	59	194	135	RIGHT	A12a.EDF	A12	1
71	4630634	4630646	1004	1016	12	RIGHT	A12a.EDF	A12	1
71	4630673	4633051	1043	3421	2378	RIGHT	A12a.EDF	A12	1
72	4634481	4634627	59	205	146	RIGHT	A12a.EDF	A12	1
72	4634688	4634708	266	286	20	RIGHT	A12a.EDF	A12	1
72	4634729	4634767	307	345	38	RIGHT	A12a.EDF	A12	1
72	4634813	4634975	391	553	162	RIGHT	A12a.EDF	A12	1
72	4635017	4638650	595	4228	3633	RIGHT	A12a.EDF	A12	1
73	4640763	4640997	456	690	234	RIGHT	A12a.EDF	A12	1
73	4641133	4641133	826	826	0	RIGHT	A12a.EDF	A12	1
73	4641487	4641487	1180	1180	0	RIGHT	A12a.EDF	A12	1
74	4647973	4647974	1441	1442	1	RIGHT	A12a.EDF	A12	1
74	4648066	4648110	1534	1578	44	RIGHT	A12a.EDF	A12	1
74	4648132	4648166	1600	1634	34	RIGHT	A12a.EDF	A12	1
74	4648192	4648213	1660	1681	21	RIGHT	A12a.EDF	A12	1
74	4648268	4648269	1736	1737	1	RIGHT	A12a.EDF	A12	1
74	4648297	4648297	1765	1765	0	RIGHT	A12a.EDF	A12	1
74	4648319	4648319	1787	1787	0	RIGHT	A12a.EDF	A12	1
74	4648376	4648376	1844	1844	0	RIGHT	A12a.EDF	A12	1
74	4648405	4648405	1873	1873	0	RIGHT	A12a.EDF	A12	1
74	4648445	4648446	1913	1914	1	RIGHT	A12a.EDF	A12	1
74	4648486	4648486	1954	1954	0	RIGHT	A12a.EDF	A12	1
74	4648515	4648761	1983	2229	246	RIGHT	A12a.EDF	A12	1
74	4648791	4648892	2259	2360	101	RIGHT	A12a.EDF	A12	1
75	4651595	4651742	59	206	147	RIGHT	A12a.EDF	A12	1
76	4657519	4657569	58	108	50	RIGHT	A12a.EDF	A12	1
76	4658352	4658352	891	891	0	RIGHT	A12a.EDF	A12	1
76	4658534	4658534	1073	1073	0	RIGHT	A12a.EDF	A12	1
78	4668504	4668763	359	618	259	RIGHT	A12a.EDF	A12	1
78	4670553	4670695	2408	2550	142	RIGHT	A12a.EDF	A12	1
78	4670735	4670735	2590	2590	0	RIGHT	A12a.EDF	A12	1
78	4670756	4670772	2611	2627	16	RIGHT	A12a.EDF	A12	1
78	4670793	4670995	2648	2850	202	RIGHT	A12a.EDF	A12	1
79	4673973	4674171	58	256	198	RIGHT	A12a.EDF	A12	1
80	4678950	4679005	57	112	55	RIGHT	A12a.EDF	A12	1
81	4683569	4683627	59	117	58	RIGHT	A12a.EDF	A12	1
82	4689359	4689439	58	138	80	RIGHT	A12a.EDF	A12	1
82	4690020	4690223	719	922	203	RIGHT	A12a.EDF	A12	1
82	4690244	4690274	943	973	30	RIGHT	A12a.EDF	A12	1
85	4705239	4705429	58	248	190	RIGHT	A12a.EDF	A12	1
86	4710898	4710981	58	141	83	RIGHT	A12a.EDF	A12	1
87	4715818	4715959	58	199	141	RIGHT	A12a.EDF	A12	1
88	4720707	4720871	58	222	164	RIGHT	A12a.EDF	A12	1
89	4726271	4726396	58	183	125	RIGHT	A12a.EDF	A12	1
89	4726419	4726429	206	216	10	RIGHT	A12a.EDF	A12	1
89	4729091	4729223	2878	3010	132	RIGHT	A12a.EDF	A12	1
90	4731670	4731852	58	240	182	RIGHT	A12a.EDF	A12	1
92	4743534	4743909	58	433	375	RIGHT	A12a.EDF	A12	1
94	4754742	4755040	729	1027	298	RIGHT	A12a.EDF	A12	1
95	4759521	4759575	58	112	54	RIGHT	A12a.EDF	A12	1
2	229311	229377	59	125	66	RIGHT	A12b.EDF	A12	2
3	235184	235242	57	115	58	RIGHT	A12b.EDF	A12	2
4	240410	240603	58	251	193	RIGHT	A12b.EDF	A12	2
7	256857	257062	60	265	205	RIGHT	A12b.EDF	A12	2
8	262037	262129	57	149	92	RIGHT	A12b.EDF	A12	2
9	268903	269127	1255	1479	224	RIGHT	A12b.EDF	A12	2
10	273546	274009	529	992	463	RIGHT	A12b.EDF	A12	2
11	278607	278695	58	146	88	RIGHT	A12b.EDF	A12	2
12	283584	283863	58	337	279	RIGHT	A12b.EDF	A12	2
13	288885	288954	58	127	69	RIGHT	A12b.EDF	A12	2
14	293730	293804	58	132	74	RIGHT	A12b.EDF	A12	2
15	299866	300084	59	277	218	RIGHT	A12b.EDF	A12	2
16	305099	305235	59	195	136	RIGHT	A12b.EDF	A12	2
16	306202	306429	1162	1389	227	RIGHT	A12b.EDF	A12	2
16	306535	306745	1495	1705	210	RIGHT	A12b.EDF	A12	2
17	309722	309774	58	110	52	RIGHT	A12b.EDF	A12	2
17	309900	310082	236	418	182	RIGHT	A12b.EDF	A12	2
18	315855	316061	876	1082	206	RIGHT	A12b.EDF	A12	2
18	316532	316532	1553	1553	0	RIGHT	A12b.EDF	A12	2
19	320123	320330	86	293	207	RIGHT	A12b.EDF	A12	2
19	321463	321769	1426	1732	306	RIGHT	A12b.EDF	A12	2
20	325550	325899	59	408	349	RIGHT	A12b.EDF	A12	2
21	331492	331705	58	271	213	RIGHT	A12b.EDF	A12	2
21	332232	332460	798	1026	228	RIGHT	A12b.EDF	A12	2
22	336993	337190	75	272	197	RIGHT	A12b.EDF	A12	2
24	346671	346841	57	227	170	RIGHT	A12b.EDF	A12	2
24	346895	347153	281	539	258	RIGHT	A12b.EDF	A12	2
25	352846	353016	477	647	170	RIGHT	A12b.EDF	A12	2
26	358637	358643	106	112	6	RIGHT	A12b.EDF	A12	2
26	358672	358871	141	340	199	RIGHT	A12b.EDF	A12	2
26	359130	359130	599	599	0	RIGHT	A12b.EDF	A12	2
26	359183	359183	652	652	0	RIGHT	A12b.EDF	A12	2
27	363919	363944	58	83	25	RIGHT	A12b.EDF	A12	2
28	369789	369951	58	220	162	RIGHT	A12b.EDF	A12	2
28	370098	370294	367	563	196	RIGHT	A12b.EDF	A12	2
30	380178	380216	59	97	38	RIGHT	A12b.EDF	A12	2
30	380368	380568	249	449	200	RIGHT	A12b.EDF	A12	2
31	384969	385052	57	140	83	RIGHT	A12b.EDF	A12	2
31	385199	385473	287	561	274	RIGHT	A12b.EDF	A12	2
32	390798	391027	90	319	229	RIGHT	A12b.EDF	A12	2
32	393817	393817	3109	3109	0	RIGHT	A12b.EDF	A12	2
32	393875	393897	3167	3189	22	RIGHT	A12b.EDF	A12	2
32	393919	393919	3211	3211	0	RIGHT	A12b.EDF	A12	2
32	393941	394023	3233	3315	82	RIGHT	A12b.EDF	A12	2
33	396097	396311	104	318	214	RIGHT	A12b.EDF	A12	2
33	396786	397017	793	1024	231	RIGHT	A12b.EDF	A12	2
33	399240	399476	3247	3483	236	RIGHT	A12b.EDF	A12	2
34	401855	402082	505	732	227	RIGHT	A12b.EDF	A12	2
35	406955	407179	386	610	224	RIGHT	A12b.EDF	A12	2
36	412116	412332	76	292	216	RIGHT	A12b.EDF	A12	2
38	422626	422883	128	385	257	RIGHT	A12b.EDF	A12	2
39	428412	428527	58	173	115	RIGHT	A12b.EDF	A12	2
39	428655	428903	301	549	248	RIGHT	A12b.EDF	A12	2
40	434053	434292	119	358	239	RIGHT	A12b.EDF	A12	2
41	439544	439823	296	575	279	RIGHT	A12b.EDF	A12	2
42	447030	447287	2533	2790	257	RIGHT	A12b.EDF	A12	2
42	447667	447919	3170	3422	252	RIGHT	A12b.EDF	A12	2
43	449515	449655	59	199	140	RIGHT	A12b.EDF	A12	2
43	449770	449815	314	359	45	RIGHT	A12b.EDF	A12	2
43	449838	449839	382	383	1	RIGHT	A12b.EDF	A12	2
43	450062	450946	606	1490	884	RIGHT	A12b.EDF	A12	2
43	450975	450998	1519	1542	23	RIGHT	A12b.EDF	A12	2
43	451105	453332	1649	3876	2227	RIGHT	A12b.EDF	A12	2
44	454661	454807	59	205	146	RIGHT	A12b.EDF	A12	2
44	455102	455102	500	500	0	RIGHT	A12b.EDF	A12	2
44	455140	455913	538	1311	773	RIGHT	A12b.EDF	A12	2
44	455941	455941	1339	1339	0	RIGHT	A12b.EDF	A12	2
44	455970	459055	1368	4453	3085	RIGHT	A12b.EDF	A12	2
45	460727	464527	58	3858	3800	RIGHT	A12b.EDF	A12	2
46	465953	465955	110	112	2	RIGHT	A12b.EDF	A12	2
46	465990	466960	147	1117	970	RIGHT	A12b.EDF	A12	2
46	467134	469526	1291	3683	2392	RIGHT	A12b.EDF	A12	2
47	471569	471644	58	133	75	RIGHT	A12b.EDF	A12	2
47	471705	471962	194	451	257	RIGHT	A12b.EDF	A12	2
47	471985	472017	474	506	32	RIGHT	A12b.EDF	A12	2
47	472116	472116	605	605	0	RIGHT	A12b.EDF	A12	2
47	472143	472225	632	714	82	RIGHT	A12b.EDF	A12	2
47	472269	472277	758	766	8	RIGHT	A12b.EDF	A12	2
47	472308	472329	797	818	21	RIGHT	A12b.EDF	A12	2
47	472353	472353	842	842	0	RIGHT	A12b.EDF	A12	2
47	472374	475394	863	3883	3020	RIGHT	A12b.EDF	A12	2
48	476959	477133	58	232	174	RIGHT	A12b.EDF	A12	2
48	477290	477290	389	389	0	RIGHT	A12b.EDF	A12	2
48	477377	477377	476	476	0	RIGHT	A12b.EDF	A12	2
48	477420	477712	519	811	292	RIGHT	A12b.EDF	A12	2
48	477740	477787	839	886	47	RIGHT	A12b.EDF	A12	2
48	477833	477867	932	966	34	RIGHT	A12b.EDF	A12	2
48	477900	477907	999	1006	7	RIGHT	A12b.EDF	A12	2
48	477928	477929	1027	1028	1	RIGHT	A12b.EDF	A12	2
48	477955	481282	1054	4381	3327	RIGHT	A12b.EDF	A12	2
49	482635	483167	58	590	532	RIGHT	A12b.EDF	A12	2
49	483233	483233	656	656	0	RIGHT	A12b.EDF	A12	2
49	483304	483306	727	729	2	RIGHT	A12b.EDF	A12	2
49	483338	486385	761	3808	3047	RIGHT	A12b.EDF	A12	2
50	487819	489886	159	2226	2067	RIGHT	A12b.EDF	A12	2
50	489909	489974	2249	2314	65	RIGHT	A12b.EDF	A12	2
50	490014	490015	2354	2355	1	RIGHT	A12b.EDF	A12	2
50	490044	490562	2384	2902	518	RIGHT	A12b.EDF	A12	2
50	490590	490591	2930	2931	1	RIGHT	A12b.EDF	A12	2
50	490619	490619	2959	2959	0	RIGHT	A12b.EDF	A12	2
50	490654	490664	2994	3004	10	RIGHT	A12b.EDF	A12	2
50	490711	491240	3051	3580	529	RIGHT	A12b.EDF	A12	2
51	492394	496210	58	3874	3816	RIGHT	A12b.EDF	A12	2
52	497598	501360	59	3821	3762	RIGHT	A12b.EDF	A12	2
53	502698	505974	58	3334	3276	RIGHT	A12b.EDF	A12	2
54	507609	507687	73	151	78	RIGHT	A12b.EDF	A12	2
54	507709	508145	173	609	436	RIGHT	A12b.EDF	A12	2
54	508202	508290	666	754	88	RIGHT	A12b.EDF	A12	2
54	508322	508414	786	878	92	RIGHT	A12b.EDF	A12	2
54	508435	508698	899	1162	263	RIGHT	A12b.EDF	A12	2
54	508761	508899	1225	1363	138	RIGHT	A12b.EDF	A12	2
54	508956	508968	1420	1432	12	RIGHT	A12b.EDF	A12	2
54	509002	509010	1466	1474	8	RIGHT	A12b.EDF	A12	2
54	509081	509094	1545	1558	13	RIGHT	A12b.EDF	A12	2
54	509119	509131	1583	1595	12	RIGHT	A12b.EDF	A12	2
54	509178	509178	1642	1642	0	RIGHT	A12b.EDF	A12	2
54	509288	509289	1752	1753	1	RIGHT	A12b.EDF	A12	2
54	509336	509336	1800	1800	0	RIGHT	A12b.EDF	A12	2
54	509571	509571	2035	2035	0	RIGHT	A12b.EDF	A12	2
54	509624	510166	2088	2630	542	RIGHT	A12b.EDF	A12	2
54	510187	510883	2651	3347	696	RIGHT	A12b.EDF	A12	2
54	510907	510984	3371	3448	77	RIGHT	A12b.EDF	A12	2
54	511020	511037	3484	3501	17	RIGHT	A12b.EDF	A12	2
54	511062	511476	3526	3940	414	RIGHT	A12b.EDF	A12	2
54	511504	511522	3968	3986	18	RIGHT	A12b.EDF	A12	2
54	511549	511549	4013	4013	0	RIGHT	A12b.EDF	A12	2
54	511571	511571	4035	4035	0	RIGHT	A12b.EDF	A12	2
54	511594	511628	4058	4092	34	RIGHT	A12b.EDF	A12	2
54	511660	511662	4124	4126	2	RIGHT	A12b.EDF	A12	2
55	513045	513089	59	103	44	RIGHT	A12b.EDF	A12	2
55	513117	513218	131	232	101	RIGHT	A12b.EDF	A12	2
55	513260	513283	274	297	23	RIGHT	A12b.EDF	A12	2
55	513602	513602	616	616	0	RIGHT	A12b.EDF	A12	2
55	513724	513989	738	1003	265	RIGHT	A12b.EDF	A12	2
55	514287	514288	1301	1302	1	RIGHT	A12b.EDF	A12	2
55	514356	514382	1370	1396	26	RIGHT	A12b.EDF	A12	2
55	514428	514428	1442	1442	0	RIGHT	A12b.EDF	A12	2
55	514468	514469	1482	1483	1	RIGHT	A12b.EDF	A12	2
55	514516	514560	1530	1574	44	RIGHT	A12b.EDF	A12	2
55	514596	514619	1610	1633	23	RIGHT	A12b.EDF	A12	2
55	514659	514659	1673	1673	0	RIGHT	A12b.EDF	A12	2
55	514791	514791	1805	1805	0	RIGHT	A12b.EDF	A12	2
55	514822	514822	1836	1836	0	RIGHT	A12b.EDF	A12	2
56	518579	518899	59	379	320	RIGHT	A12b.EDF	A12	2
56	519237	519237	717	717	0	RIGHT	A12b.EDF	A12	2
56	519281	519281	761	761	0	RIGHT	A12b.EDF	A12	2
56	519327	519328	807	808	1	RIGHT	A12b.EDF	A12	2
56	519410	519661	890	1141	251	RIGHT	A12b.EDF	A12	2
56	520056	520056	1536	1536	0	RIGHT	A12b.EDF	A12	2
56	520115	520124	1595	1604	9	RIGHT	A12b.EDF	A12	2
56	520177	520186	1657	1666	9	RIGHT	A12b.EDF	A12	2
56	520224	520224	1704	1704	0	RIGHT	A12b.EDF	A12	2
56	520261	520261	1741	1741	0	RIGHT	A12b.EDF	A12	2
56	520344	520344	1824	1824	0	RIGHT	A12b.EDF	A12	2
56	520404	520418	1884	1898	14	RIGHT	A12b.EDF	A12	2
56	520463	520475	1943	1955	12	RIGHT	A12b.EDF	A12	2
56	520533	520537	2013	2017	4	RIGHT	A12b.EDF	A12	2
56	520568	520568	2048	2048	0	RIGHT	A12b.EDF	A12	2
56	520594	520594	2074	2074	0	RIGHT	A12b.EDF	A12	2
56	520669	520670	2149	2150	1	RIGHT	A12b.EDF	A12	2
56	520926	520927	2406	2407	1	RIGHT	A12b.EDF	A12	2
58	529356	529356	1542	1542	0	RIGHT	A12b.EDF	A12	2
58	529378	529393	1564	1579	15	RIGHT	A12b.EDF	A12	2
58	529488	529488	1674	1674	0	RIGHT	A12b.EDF	A12	2
58	529520	529520	1706	1706	0	RIGHT	A12b.EDF	A12	2
58	529586	529594	1772	1780	8	RIGHT	A12b.EDF	A12	2
58	530037	530037	2223	2223	0	RIGHT	A12b.EDF	A12	2
58	530096	530096	2282	2282	0	RIGHT	A12b.EDF	A12	2
58	530196	530205	2382	2391	9	RIGHT	A12b.EDF	A12	2
58	530334	530334	2520	2520	0	RIGHT	A12b.EDF	A12	2
58	530811	530811	2997	2997	0	RIGHT	A12b.EDF	A12	2
58	531129	531129	3315	3315	0	RIGHT	A12b.EDF	A12	2
58	531162	531164	3348	3350	2	RIGHT	A12b.EDF	A12	2
59	532603	532682	58	137	79	RIGHT	A12b.EDF	A12	2
59	532829	533086	284	541	257	RIGHT	A12b.EDF	A12	2
59	533344	533344	799	799	0	RIGHT	A12b.EDF	A12	2
59	533373	533393	828	848	20	RIGHT	A12b.EDF	A12	2
59	533415	533428	870	883	13	RIGHT	A12b.EDF	A12	2
59	533474	533474	929	929	0	RIGHT	A12b.EDF	A12	2
59	533589	533590	1044	1045	1	RIGHT	A12b.EDF	A12	2
59	533620	533740	1075	1195	120	RIGHT	A12b.EDF	A12	2
59	533778	533779	1233	1234	1	RIGHT	A12b.EDF	A12	2
59	533846	534524	1301	1979	678	RIGHT	A12b.EDF	A12	2
59	534550	534566	2005	2021	16	RIGHT	A12b.EDF	A12	2
59	534593	534719	2048	2174	126	RIGHT	A12b.EDF	A12	2
59	534740	535003	2195	2458	263	RIGHT	A12b.EDF	A12	2
59	535036	535487	2491	2942	451	RIGHT	A12b.EDF	A12	2
59	535509	535612	2964	3067	103	RIGHT	A12b.EDF	A12	2
59	535636	535644	3091	3099	8	RIGHT	A12b.EDF	A12	2
59	535684	535950	3139	3405	266	RIGHT	A12b.EDF	A12	2
59	535983	535998	3438	3453	15	RIGHT	A12b.EDF	A12	2
59	536029	536030	3484	3485	1	RIGHT	A12b.EDF	A12	2
59	536059	536061	3514	3516	2	RIGHT	A12b.EDF	A12	2
60	538145	538204	57	116	59	RIGHT	A12b.EDF	A12	2
60	538349	538378	261	290	29	RIGHT	A12b.EDF	A12	2
60	538448	538449	360	361	1	RIGHT	A12b.EDF	A12	2
60	538494	538494	406	406	0	RIGHT	A12b.EDF	A12	2
60	538524	538581	436	493	57	RIGHT	A12b.EDF	A12	2
60	538852	538881	764	793	29	RIGHT	A12b.EDF	A12	2
60	538917	539025	829	937	108	RIGHT	A12b.EDF	A12	2
60	539689	539689	1601	1601	0	RIGHT	A12b.EDF	A12	2
60	539780	540079	1692	1991	299	RIGHT	A12b.EDF	A12	2
60	540105	540105	2017	2017	0	RIGHT	A12b.EDF	A12	2
60	540137	540137	2049	2049	0	RIGHT	A12b.EDF	A12	2
60	540194	540331	2106	2243	137	RIGHT	A12b.EDF	A12	2
60	540359	540359	2271	2271	0	RIGHT	A12b.EDF	A12	2
60	540383	540433	2295	2345	50	RIGHT	A12b.EDF	A12	2
60	540485	540494	2397	2406	9	RIGHT	A12b.EDF	A12	2
60	540535	540539	2447	2451	4	RIGHT	A12b.EDF	A12	2
60	540567	540588	2479	2500	21	RIGHT	A12b.EDF	A12	2
60	540610	540610	2522	2522	0	RIGHT	A12b.EDF	A12	2
60	540652	540652	2564	2564	0	RIGHT	A12b.EDF	A12	2
60	540898	540898	2810	2810	0	RIGHT	A12b.EDF	A12	2
60	541762	541762	3674	3674	0	RIGHT	A12b.EDF	A12	2
60	541808	541808	3720	3720	0	RIGHT	A12b.EDF	A12	2
60	542166	542166	4078	4078	0	RIGHT	A12b.EDF	A12	2
60	542260	542260	4172	4172	0	RIGHT	A12b.EDF	A12	2
61	544466	544706	842	1082	240	RIGHT	A12b.EDF	A12	2
61	545143	545161	1519	1537	18	RIGHT	A12b.EDF	A12	2
61	545188	545188	1564	1564	0	RIGHT	A12b.EDF	A12	2
61	545247	545249	1623	1625	2	RIGHT	A12b.EDF	A12	2
61	545271	545290	1647	1666	19	RIGHT	A12b.EDF	A12	2
61	545316	545316	1692	1692	0	RIGHT	A12b.EDF	A12	2
61	545348	547968	1724	4344	2620	RIGHT	A12b.EDF	A12	2
62	549427	553078	57	3708	3651	RIGHT	A12b.EDF	A12	2
63	554832	554836	199	203	4	RIGHT	A12b.EDF	A12	2
63	554907	554907	274	274	0	RIGHT	A12b.EDF	A12	2
63	554957	554970	324	337	13	RIGHT	A12b.EDF	A12	2
63	555016	555050	383	417	34	RIGHT	A12b.EDF	A12	2
63	555076	555422	443	789	346	RIGHT	A12b.EDF	A12	2
63	555458	555459	825	826	1	RIGHT	A12b.EDF	A12	2
63	555485	555838	852	1205	353	RIGHT	A12b.EDF	A12	2
63	555870	555870	1237	1237	0	RIGHT	A12b.EDF	A12	2
63	555892	555894	1259	1261	2	RIGHT	A12b.EDF	A12	2
63	555944	555969	1311	1336	25	RIGHT	A12b.EDF	A12	2
63	555993	558896	1360	4263	2903	RIGHT	A12b.EDF	A12	2
64	560253	561051	57	855	798	RIGHT	A12b.EDF	A12	2
64	561100	561100	904	904	0	RIGHT	A12b.EDF	A12	2
64	561126	561135	930	939	9	RIGHT	A12b.EDF	A12	2
64	561156	564372	960	4176	3216	RIGHT	A12b.EDF	A12	2
65	566029	566332	58	361	303	RIGHT	A12b.EDF	A12	2
65	566435	567491	464	1520	1056	RIGHT	A12b.EDF	A12	2
65	567532	567532	1561	1561	0	RIGHT	A12b.EDF	A12	2
65	567619	567621	1648	1650	2	RIGHT	A12b.EDF	A12	2
65	567757	569726	1786	3755	1969	RIGHT	A12b.EDF	A12	2
66	571356	571792	171	607	436	RIGHT	A12b.EDF	A12	2
66	571815	571894	630	709	79	RIGHT	A12b.EDF	A12	2
66	571921	571989	736	804	68	RIGHT	A12b.EDF	A12	2
66	572012	572015	827	830	3	RIGHT	A12b.EDF	A12	2
66	572047	572063	862	878	16	RIGHT	A12b.EDF	A12	2
66	572101	572101	916	916	0	RIGHT	A12b.EDF	A12	2
66	572122	572122	937	937	0	RIGHT	A12b.EDF	A12	2
66	572163	572181	978	996	18	RIGHT	A12b.EDF	A12	2
66	572211	572245	1026	1060	34	RIGHT	A12b.EDF	A12	2
66	572271	572285	1086	1100	14	RIGHT	A12b.EDF	A12	2
66	572311	572376	1126	1191	65	RIGHT	A12b.EDF	A12	2
66	572410	572424	1225	1239	14	RIGHT	A12b.EDF	A12	2
66	572452	575290	1267	4105	2838	RIGHT	A12b.EDF	A12	2
67	577139	577416	337	614	277	RIGHT	A12b.EDF	A12	2
67	577613	577614	811	812	1	RIGHT	A12b.EDF	A12	2
67	577639	577640	837	838	1	RIGHT	A12b.EDF	A12	2
67	577671	578292	869	1490	621	RIGHT	A12b.EDF	A12	2
67	578362	578362	1560	1560	0	RIGHT	A12b.EDF	A12	2
67	578449	578449	1647	1647	0	RIGHT	A12b.EDF	A12	2
67	578489	578524	1687	1722	35	RIGHT	A12b.EDF	A12	2
67	578597	578598	1795	1796	1	RIGHT	A12b.EDF	A12	2
67	578630	578647	1828	1845	17	RIGHT	A12b.EDF	A12	2
67	578677	579101	1875	2299	424	RIGHT	A12b.EDF	A12	2
67	579122	580124	2320	3322	1002	RIGHT	A12b.EDF	A12	2
68	581509	581567	58	116	58	RIGHT	A12b.EDF	A12	2
68	581764	581779	313	328	15	RIGHT	A12b.EDF	A12	2
68	581807	581831	356	380	24	RIGHT	A12b.EDF	A12	2
68	581861	585386	410	3935	3525	RIGHT	A12b.EDF	A12	2
69	587031	587058	91	118	27	RIGHT	A12b.EDF	A12	2
69	587083	590766	143	3826	3683	RIGHT	A12b.EDF	A12	2
70	592391	596719	57	4385	4328	RIGHT	A12b.EDF	A12	2
71	598254	599339	57	1142	1085	RIGHT	A12b.EDF	A12	2
71	599409	599409	1212	1212	0	RIGHT	A12b.EDF	A12	2
71	599450	599459	1253	1262	9	RIGHT	A12b.EDF	A12	2
71	599539	599557	1342	1360	18	RIGHT	A12b.EDF	A12	2
71	599594	599595	1397	1398	1	RIGHT	A12b.EDF	A12	2
71	599720	599721	1523	1524	1	RIGHT	A12b.EDF	A12	2
71	599747	599759	1550	1562	12	RIGHT	A12b.EDF	A12	2
71	599803	599808	1606	1611	5	RIGHT	A12b.EDF	A12	2
71	599829	599829	1632	1632	0	RIGHT	A12b.EDF	A12	2
71	599859	599859	1662	1662	0	RIGHT	A12b.EDF	A12	2
71	599927	599941	1730	1744	14	RIGHT	A12b.EDF	A12	2
71	599962	600016	1765	1819	54	RIGHT	A12b.EDF	A12	2
71	600158	600158	1961	1961	0	RIGHT	A12b.EDF	A12	2
71	600182	600296	1985	2099	114	RIGHT	A12b.EDF	A12	2
71	600325	600335	2128	2138	10	RIGHT	A12b.EDF	A12	2
71	600358	601842	2161	3645	1484	RIGHT	A12b.EDF	A12	2
71	601936	602034	3739	3837	98	RIGHT	A12b.EDF	A12	2
72	603527	603732	61	266	205	RIGHT	A12b.EDF	A12	2
72	604181	604181	715	715	0	RIGHT	A12b.EDF	A12	2
72	604383	604486	917	1020	103	RIGHT	A12b.EDF	A12	2
72	604510	604520	1044	1054	10	RIGHT	A12b.EDF	A12	2
72	604653	604710	1187	1244	57	RIGHT	A12b.EDF	A12	2
72	604741	604743	1275	1277	2	RIGHT	A12b.EDF	A12	2
72	604925	604934	1459	1468	9	RIGHT	A12b.EDF	A12	2
72	605091	605091	1625	1625	0	RIGHT	A12b.EDF	A12	2
72	605121	605121	1655	1655	0	RIGHT	A12b.EDF	A12	2
72	605235	605276	1769	1810	41	RIGHT	A12b.EDF	A12	2
72	605315	605375	1849	1909	60	RIGHT	A12b.EDF	A12	2
72	605400	605410	1934	1944	10	RIGHT	A12b.EDF	A12	2
72	605437	605456	1971	1990	19	RIGHT	A12b.EDF	A12	2
72	605477	605513	2011	2047	36	RIGHT	A12b.EDF	A12	2
72	605549	605566	2083	2100	17	RIGHT	A12b.EDF	A12	2
72	605594	605663	2128	2197	69	RIGHT	A12b.EDF	A12	2
72	605693	605693	2227	2227	0	RIGHT	A12b.EDF	A12	2
72	605735	605752	2269	2286	17	RIGHT	A12b.EDF	A12	2
73	609745	610022	801	1078	277	RIGHT	A12b.EDF	A12	2
73	610241	610241	1297	1297	0	RIGHT	A12b.EDF	A12	2
73	610313	610315	1369	1371	2	RIGHT	A12b.EDF	A12	2
73	610489	610489	1545	1545	0	RIGHT	A12b.EDF	A12	2
73	610759	610769	1815	1825	10	RIGHT	A12b.EDF	A12	2
73	610799	610800	1855	1856	1	RIGHT	A12b.EDF	A12	2
73	610868	610868	1924	1924	0	RIGHT	A12b.EDF	A12	2
73	610894	610895	1950	1951	1	RIGHT	A12b.EDF	A12	2
73	610924	610929	1980	1985	5	RIGHT	A12b.EDF	A12	2
73	610971	610971	2027	2027	0	RIGHT	A12b.EDF	A12	2
73	611034	611036	2090	2092	2	RIGHT	A12b.EDF	A12	2
73	611157	611157	2213	2213	0	RIGHT	A12b.EDF	A12	2
74	615038	615042	227	231	4	RIGHT	A12b.EDF	A12	2
74	615068	615650	257	839	582	RIGHT	A12b.EDF	A12	2
74	615701	615701	890	890	0	RIGHT	A12b.EDF	A12	2
74	615777	615818	966	1007	41	RIGHT	A12b.EDF	A12	2
74	615840	615843	1029	1032	3	RIGHT	A12b.EDF	A12	2
74	615891	615891	1080	1080	0	RIGHT	A12b.EDF	A12	2
74	615920	615952	1109	1141	32	RIGHT	A12b.EDF	A12	2
74	616164	616185	1353	1374	21	RIGHT	A12b.EDF	A12	2
74	616215	616216	1404	1405	1	RIGHT	A12b.EDF	A12	2
74	616273	616694	1462	1883	421	RIGHT	A12b.EDF	A12	2
74	616719	616790	1908	1979	71	RIGHT	A12b.EDF	A12	2
74	616811	617589	2000	2778	778	RIGHT	A12b.EDF	A12	2
74	617611	617731	2800	2920	120	RIGHT	A12b.EDF	A12	2
75	620966	621256	291	581	290	RIGHT	A12b.EDF	A12	2
75	621689	622043	1014	1368	354	RIGHT	A12b.EDF	A12	2
75	622071	622079	1396	1404	8	RIGHT	A12b.EDF	A12	2
75	622295	622295	1620	1620	0	RIGHT	A12b.EDF	A12	2
75	622521	622521	1846	1846	0	RIGHT	A12b.EDF	A12	2
75	623321	623321	2646	2646	0	RIGHT	A12b.EDF	A12	2
75	623385	623385	2710	2710	0	RIGHT	A12b.EDF	A12	2
75	623410	623673	2735	2998	263	RIGHT	A12b.EDF	A12	2
75	624379	624379	3704	3704	0	RIGHT	A12b.EDF	A12	2
76	626039	626135	58	154	96	RIGHT	A12b.EDF	A12	2
76	626465	626731	484	750	266	RIGHT	A12b.EDF	A12	2
76	626764	626764	783	783	0	RIGHT	A12b.EDF	A12	2
76	626803	626818	822	837	15	RIGHT	A12b.EDF	A12	2
76	626858	626923	877	942	65	RIGHT	A12b.EDF	A12	2
76	627059	627059	1078	1078	0	RIGHT	A12b.EDF	A12	2
77	631721	632465	70	814	744	RIGHT	A12b.EDF	A12	2
77	632493	632506	842	855	13	RIGHT	A12b.EDF	A12	2
77	632546	633521	895	1870	975	RIGHT	A12b.EDF	A12	2
77	633543	633559	1892	1908	16	RIGHT	A12b.EDF	A12	2
77	633580	633597	1929	1946	17	RIGHT	A12b.EDF	A12	2
77	633618	633633	1967	1982	15	RIGHT	A12b.EDF	A12	2
77	633668	633699	2017	2048	31	RIGHT	A12b.EDF	A12	2
77	633724	633800	2073	2149	76	RIGHT	A12b.EDF	A12	2
77	633822	633822	2171	2171	0	RIGHT	A12b.EDF	A12	2
77	633860	633865	2209	2214	5	RIGHT	A12b.EDF	A12	2
77	633899	633919	2248	2268	20	RIGHT	A12b.EDF	A12	2
77	633990	633993	2339	2342	3	RIGHT	A12b.EDF	A12	2
77	634017	634033	2366	2382	16	RIGHT	A12b.EDF	A12	2
77	634072	634120	2421	2469	48	RIGHT	A12b.EDF	A12	2
77	634225	634298	2574	2647	73	RIGHT	A12b.EDF	A12	2
78	638368	638369	787	788	1	RIGHT	A12b.EDF	A12	2
78	638396	638396	815	815	0	RIGHT	A12b.EDF	A12	2
78	638455	638455	874	874	0	RIGHT	A12b.EDF	A12	2
78	638497	638498	916	917	1	RIGHT	A12b.EDF	A12	2
78	638596	638596	1015	1015	0	RIGHT	A12b.EDF	A12	2
78	638688	638716	1107	1135	28	RIGHT	A12b.EDF	A12	2
78	638774	638774	1193	1193	0	RIGHT	A12b.EDF	A12	2
78	639364	639392	1783	1811	28	RIGHT	A12b.EDF	A12	2
78	639418	639419	1837	1838	1	RIGHT	A12b.EDF	A12	2
78	639446	639461	1865	1880	15	RIGHT	A12b.EDF	A12	2
78	639508	639508	1927	1927	0	RIGHT	A12b.EDF	A12	2
78	639549	639550	1968	1969	1	RIGHT	A12b.EDF	A12	2
78	639702	639702	2121	2121	0	RIGHT	A12b.EDF	A12	2
78	639727	639727	2146	2146	0	RIGHT	A12b.EDF	A12	2
78	640079	640409	2498	2828	330	RIGHT	A12b.EDF	A12	2
78	640479	640484	2898	2903	5	RIGHT	A12b.EDF	A12	2
78	640546	640576	2965	2995	30	RIGHT	A12b.EDF	A12	2
78	640608	640619	3027	3038	11	RIGHT	A12b.EDF	A12	2
78	641010	641010	3429	3429	0	RIGHT	A12b.EDF	A12	2
78	641049	641049	3468	3468	0	RIGHT	A12b.EDF	A12	2
78	641095	641151	3514	3570	56	RIGHT	A12b.EDF	A12	2
79	642664	643447	57	840	783	RIGHT	A12b.EDF	A12	2
79	643471	643489	864	882	18	RIGHT	A12b.EDF	A12	2
79	643537	643575	930	968	38	RIGHT	A12b.EDF	A12	2
79	643598	643885	991	1278	287	RIGHT	A12b.EDF	A12	2
79	644010	645919	1403	3312	1909	RIGHT	A12b.EDF	A12	2
81	652763	652984	130	351	221	RIGHT	A12b.EDF	A12	2
81	653032	653050	399	417	18	RIGHT	A12b.EDF	A12	2
81	653090	654024	457	1391	934	RIGHT	A12b.EDF	A12	2
81	654065	654266	1432	1633	201	RIGHT	A12b.EDF	A12	2
81	654289	654338	1656	1705	49	RIGHT	A12b.EDF	A12	2
81	654360	654361	1727	1728	1	RIGHT	A12b.EDF	A12	2
81	654390	654390	1757	1757	0	RIGHT	A12b.EDF	A12	2
81	654459	654698	1826	2065	239	RIGHT	A12b.EDF	A12	2
81	654722	655476	2089	2843	754	RIGHT	A12b.EDF	A12	2
81	655500	655517	2867	2884	17	RIGHT	A12b.EDF	A12	2
81	655543	655730	2910	3097	187	RIGHT	A12b.EDF	A12	2
81	655775	655806	3142	3173	31	RIGHT	A12b.EDF	A12	2
81	655888	655924	3255	3291	36	RIGHT	A12b.EDF	A12	2
81	655963	656012	3330	3379	49	RIGHT	A12b.EDF	A12	2
81	656053	656058	3420	3425	5	RIGHT	A12b.EDF	A12	2
81	656080	656080	3447	3447	0	RIGHT	A12b.EDF	A12	2
81	656102	656313	3469	3680	211	RIGHT	A12b.EDF	A12	2
82	657859	659799	58	1998	1940	RIGHT	A12b.EDF	A12	2
82	659828	659856	2027	2055	28	RIGHT	A12b.EDF	A12	2
82	659885	659917	2084	2116	32	RIGHT	A12b.EDF	A12	2
82	660026	660035	2225	2234	9	RIGHT	A12b.EDF	A12	2
82	660060	660061	2259	2260	1	RIGHT	A12b.EDF	A12	2
82	660135	660747	2334	2946	612	RIGHT	A12b.EDF	A12	2
82	660794	660801	2993	3000	7	RIGHT	A12b.EDF	A12	2
82	660823	660865	3022	3064	42	RIGHT	A12b.EDF	A12	2
82	660886	661197	3085	3396	311	RIGHT	A12b.EDF	A12	2
82	661225	661226	3424	3425	1	RIGHT	A12b.EDF	A12	2
82	661248	661331	3447	3530	83	RIGHT	A12b.EDF	A12	2
82	661353	661410	3552	3609	57	RIGHT	A12b.EDF	A12	2
82	661439	661508	3638	3707	69	RIGHT	A12b.EDF	A12	2
82	661529	661584	3728	3783	55	RIGHT	A12b.EDF	A12	2
83	663383	663463	108	188	80	RIGHT	A12b.EDF	A12	2
83	663536	663536	261	261	0	RIGHT	A12b.EDF	A12	2
83	663571	663811	296	536	240	RIGHT	A12b.EDF	A12	2
83	663897	663897	622	622	0	RIGHT	A12b.EDF	A12	2
83	664225	664225	950	950	0	RIGHT	A12b.EDF	A12	2
83	664249	664319	974	1044	70	RIGHT	A12b.EDF	A12	2
83	664347	664367	1072	1092	20	RIGHT	A12b.EDF	A12	2
83	664395	664406	1120	1131	11	RIGHT	A12b.EDF	A12	2
83	664433	664493	1158	1218	60	RIGHT	A12b.EDF	A12	2
83	664523	664567	1248	1292	44	RIGHT	A12b.EDF	A12	2
83	664609	664610	1334	1335	1	RIGHT	A12b.EDF	A12	2
83	664631	664709	1356	1434	78	RIGHT	A12b.EDF	A12	2
83	664742	664753	1467	1478	11	RIGHT	A12b.EDF	A12	2
83	664785	664785	1510	1510	0	RIGHT	A12b.EDF	A12	2
83	664808	664808	1533	1533	0	RIGHT	A12b.EDF	A12	2
83	664845	664846	1570	1571	1	RIGHT	A12b.EDF	A12	2
83	664904	664906	1629	1631	2	RIGHT	A12b.EDF	A12	2
83	664933	664933	1658	1658	0	RIGHT	A12b.EDF	A12	2
83	664977	664977	1702	1702	0	RIGHT	A12b.EDF	A12	2
83	665025	665030	1750	1755	5	RIGHT	A12b.EDF	A12	2
83	665087	665087	1812	1812	0	RIGHT	A12b.EDF	A12	2
83	665111	665147	1836	1872	36	RIGHT	A12b.EDF	A12	2
83	665182	665183	1907	1908	1	RIGHT	A12b.EDF	A12	2
83	665212	665212	1937	1937	0	RIGHT	A12b.EDF	A12	2
83	665245	665245	1970	1970	0	RIGHT	A12b.EDF	A12	2
83	665289	665289	2014	2014	0	RIGHT	A12b.EDF	A12	2
83	666452	666452	3177	3177	0	RIGHT	A12b.EDF	A12	2
84	668946	669156	59	269	210	RIGHT	A12b.EDF	A12	2
84	669566	669568	679	681	2	RIGHT	A12b.EDF	A12	2
84	669764	669764	877	877	0	RIGHT	A12b.EDF	A12	2
84	669837	669837	950	950	0	RIGHT	A12b.EDF	A12	2
84	669929	669939	1042	1052	10	RIGHT	A12b.EDF	A12	2
84	670040	670043	1153	1156	3	RIGHT	A12b.EDF	A12	2
84	670094	670095	1207	1208	1	RIGHT	A12b.EDF	A12	2
84	670147	670147	1260	1260	0	RIGHT	A12b.EDF	A12	2
84	670175	670215	1288	1328	40	RIGHT	A12b.EDF	A12	2
84	670247	670256	1360	1369	9	RIGHT	A12b.EDF	A12	2
84	670280	670280	1393	1393	0	RIGHT	A12b.EDF	A12	2
84	670309	670327	1422	1440	18	RIGHT	A12b.EDF	A12	2
84	670363	670373	1476	1486	10	RIGHT	A12b.EDF	A12	2
84	670425	670425	1538	1538	0	RIGHT	A12b.EDF	A12	2
84	670485	670494	1598	1607	9	RIGHT	A12b.EDF	A12	2
84	670574	670575	1687	1688	1	RIGHT	A12b.EDF	A12	2
84	670647	670649	1760	1762	2	RIGHT	A12b.EDF	A12	2
84	670730	670731	1843	1844	1	RIGHT	A12b.EDF	A12	2
84	670783	670784	1896	1897	1	RIGHT	A12b.EDF	A12	2
84	670978	670978	2091	2091	0	RIGHT	A12b.EDF	A12	2
84	671031	671032	2144	2145	1	RIGHT	A12b.EDF	A12	2
84	671302	671302	2415	2415	0	RIGHT	A12b.EDF	A12	2
84	671338	671338	2451	2451	0	RIGHT	A12b.EDF	A12	2
84	671491	671492	2604	2605	1	RIGHT	A12b.EDF	A12	2
84	671555	671588	2668	2701	33	RIGHT	A12b.EDF	A12	2
84	671614	671615	2727	2728	1	RIGHT	A12b.EDF	A12	2
84	671643	671656	2756	2769	13	RIGHT	A12b.EDF	A12	2
84	671726	671726	2839	2839	0	RIGHT	A12b.EDF	A12	2
84	672091	672091	3204	3204	0	RIGHT	A12b.EDF	A12	2
84	672129	672131	3242	3244	2	RIGHT	A12b.EDF	A12	2
84	672304	672312	3417	3425	8	RIGHT	A12b.EDF	A12	2
84	672341	672379	3454	3492	38	RIGHT	A12b.EDF	A12	2
85	674219	674383	166	330	164	RIGHT	A12b.EDF	A12	2
85	674462	674463	409	410	1	RIGHT	A12b.EDF	A12	2
85	674510	674511	457	458	1	RIGHT	A12b.EDF	A12	2
85	674557	674557	504	504	0	RIGHT	A12b.EDF	A12	2
85	674578	674579	525	526	1	RIGHT	A12b.EDF	A12	2
85	674650	674650	597	597	0	RIGHT	A12b.EDF	A12	2
85	674832	675168	779	1115	336	RIGHT	A12b.EDF	A12	2
85	675840	675840	1787	1787	0	RIGHT	A12b.EDF	A12	2
85	675869	675869	1816	1816	0	RIGHT	A12b.EDF	A12	2
85	675903	675911	1850	1858	8	RIGHT	A12b.EDF	A12	2
85	676018	676018	1965	1965	0	RIGHT	A12b.EDF	A12	2
85	676114	676115	2061	2062	1	RIGHT	A12b.EDF	A12	2
85	676144	676146	2091	2093	2	RIGHT	A12b.EDF	A12	2
85	676178	676178	2125	2125	0	RIGHT	A12b.EDF	A12	2
85	676206	676207	2153	2154	1	RIGHT	A12b.EDF	A12	2
85	676239	676298	2186	2245	59	RIGHT	A12b.EDF	A12	2
85	676382	676402	2329	2349	20	RIGHT	A12b.EDF	A12	2
85	676452	676452	2399	2399	0	RIGHT	A12b.EDF	A12	2
85	676481	676525	2428	2472	44	RIGHT	A12b.EDF	A12	2
85	676685	676722	2632	2669	37	RIGHT	A12b.EDF	A12	2
85	676747	676750	2694	2697	3	RIGHT	A12b.EDF	A12	2
85	676778	676799	2725	2746	21	RIGHT	A12b.EDF	A12	2
85	676870	676871	2817	2818	1	RIGHT	A12b.EDF	A12	2
85	676894	676920	2841	2867	26	RIGHT	A12b.EDF	A12	2
85	676949	676962	2896	2909	13	RIGHT	A12b.EDF	A12	2
85	677009	677076	2956	3023	67	RIGHT	A12b.EDF	A12	2
85	677110	677215	3057	3162	105	RIGHT	A12b.EDF	A12	2
85	677236	677251	3183	3198	15	RIGHT	A12b.EDF	A12	2
85	677340	677340	3287	3287	0	RIGHT	A12b.EDF	A12	2
85	677369	677430	3316	3377	61	RIGHT	A12b.EDF	A12	2
85	677454	677455	3401	3402	1	RIGHT	A12b.EDF	A12	2
85	677502	677505	3449	3452	3	RIGHT	A12b.EDF	A12	2
86	679391	679442	57	108	51	RIGHT	A12b.EDF	A12	2
86	679467	680437	133	1103	970	RIGHT	A12b.EDF	A12	2
86	680465	680552	1131	1218	87	RIGHT	A12b.EDF	A12	2
86	680692	680697	1358	1363	5	RIGHT	A12b.EDF	A12	2
86	680723	680779	1389	1445	56	RIGHT	A12b.EDF	A12	2
86	680821	680873	1487	1539	52	RIGHT	A12b.EDF	A12	2
86	680897	680965	1563	1631	68	RIGHT	A12b.EDF	A12	2
86	681064	681065	1730	1731	1	RIGHT	A12b.EDF	A12	2
86	681103	681103	1769	1769	0	RIGHT	A12b.EDF	A12	2
86	681215	681216	1881	1882	1	RIGHT	A12b.EDF	A12	2
86	681376	681376	2042	2042	0	RIGHT	A12b.EDF	A12	2
86	681422	681449	2088	2115	27	RIGHT	A12b.EDF	A12	2
86	681505	681512	2171	2178	7	RIGHT	A12b.EDF	A12	2
86	681588	681934	2254	2600	346	RIGHT	A12b.EDF	A12	2
86	682269	682322	2935	2988	53	RIGHT	A12b.EDF	A12	2
86	682344	682345	3010	3011	1	RIGHT	A12b.EDF	A12	2
86	682376	682377	3042	3043	1	RIGHT	A12b.EDF	A12	2
86	682401	682493	3067	3159	92	RIGHT	A12b.EDF	A12	2
86	682526	682549	3192	3215	23	RIGHT	A12b.EDF	A12	2
86	682575	682645	3241	3311	70	RIGHT	A12b.EDF	A12	2
86	682672	682822	3338	3488	150	RIGHT	A12b.EDF	A12	2
87	684396	684429	59	92	33	RIGHT	A12b.EDF	A12	2
87	684494	684494	157	157	0	RIGHT	A12b.EDF	A12	2
87	684591	684602	254	265	11	RIGHT	A12b.EDF	A12	2
87	684635	684636	298	299	1	RIGHT	A12b.EDF	A12	2
87	684691	684692	354	355	1	RIGHT	A12b.EDF	A12	2
87	684764	684766	427	429	2	RIGHT	A12b.EDF	A12	2
87	686581	686581	2244	2244	0	RIGHT	A12b.EDF	A12	2
87	686658	686671	2321	2334	13	RIGHT	A12b.EDF	A12	2
87	686705	686705	2368	2368	0	RIGHT	A12b.EDF	A12	2
87	686793	686793	2456	2456	0	RIGHT	A12b.EDF	A12	2
87	686837	686848	2500	2511	11	RIGHT	A12b.EDF	A12	2
87	686920	686920	2583	2583	0	RIGHT	A12b.EDF	A12	2
87	686969	686969	2632	2632	0	RIGHT	A12b.EDF	A12	2
87	687283	687283	2946	2946	0	RIGHT	A12b.EDF	A12	2
87	687369	687394	3032	3057	25	RIGHT	A12b.EDF	A12	2
87	687450	687450	3113	3113	0	RIGHT	A12b.EDF	A12	2
87	687501	687501	3164	3164	0	RIGHT	A12b.EDF	A12	2
87	687563	687563	3226	3226	0	RIGHT	A12b.EDF	A12	2
88	689785	689802	138	155	17	RIGHT	A12b.EDF	A12	2
88	689853	689881	206	234	28	RIGHT	A12b.EDF	A12	2
88	689918	689918	271	271	0	RIGHT	A12b.EDF	A12	2
88	690047	690076	400	429	29	RIGHT	A12b.EDF	A12	2
88	690099	690108	452	461	9	RIGHT	A12b.EDF	A12	2
88	690129	690167	482	520	38	RIGHT	A12b.EDF	A12	2
88	690193	690204	546	557	11	RIGHT	A12b.EDF	A12	2
88	690255	690263	608	616	8	RIGHT	A12b.EDF	A12	2
88	690285	690292	638	645	7	RIGHT	A12b.EDF	A12	2
88	690330	690398	683	751	68	RIGHT	A12b.EDF	A12	2
88	690438	690482	791	835	44	RIGHT	A12b.EDF	A12	2
88	690511	690531	864	884	20	RIGHT	A12b.EDF	A12	2
88	690552	690628	905	981	76	RIGHT	A12b.EDF	A12	2
88	690652	690694	1005	1047	42	RIGHT	A12b.EDF	A12	2
88	690736	690760	1089	1113	24	RIGHT	A12b.EDF	A12	2
88	690782	690861	1135	1214	79	RIGHT	A12b.EDF	A12	2
88	690882	690891	1235	1244	9	RIGHT	A12b.EDF	A12	2
88	690913	691201	1266	1554	288	RIGHT	A12b.EDF	A12	2
88	691229	691232	1582	1585	3	RIGHT	A12b.EDF	A12	2
88	691264	691305	1617	1658	41	RIGHT	A12b.EDF	A12	2
88	691335	691337	1688	1690	2	RIGHT	A12b.EDF	A12	2
88	691362	691398	1715	1751	36	RIGHT	A12b.EDF	A12	2
88	691497	693942	1850	4295	2445	RIGHT	A12b.EDF	A12	2
89	695250	695787	59	596	537	RIGHT	A12b.EDF	A12	2
89	695809	695911	618	720	102	RIGHT	A12b.EDF	A12	2
89	695955	696288	764	1097	333	RIGHT	A12b.EDF	A12	2
89	696330	696379	1139	1188	49	RIGHT	A12b.EDF	A12	2
89	696421	699392	1230	4201	2971	RIGHT	A12b.EDF	A12	2
90	701065	704862	58	3855	3797	RIGHT	A12b.EDF	A12	2
91	706884	707055	58	229	171	RIGHT	A12b.EDF	A12	2
91	707338	710738	512	3912	3400	RIGHT	A12b.EDF	A12	2
92	712295	712867	59	631	572	RIGHT	A12b.EDF	A12	2
92	712891	712944	655	708	53	RIGHT	A12b.EDF	A12	2
92	714020	715545	1784	3309	1525	RIGHT	A12b.EDF	A12	2
93	717306	717575	58	327	269	RIGHT	A12b.EDF	A12	2
93	717611	717664	363	416	53	RIGHT	A12b.EDF	A12	2
93	717704	717805	456	557	101	RIGHT	A12b.EDF	A12	2
93	717832	717961	584	713	129	RIGHT	A12b.EDF	A12	2
93	717984	718066	736	818	82	RIGHT	A12b.EDF	A12	2
93	719734	719735	2486	2487	1	RIGHT	A12b.EDF	A12	2
93	719904	719910	2656	2662	6	RIGHT	A12b.EDF	A12	2
93	719931	719931	2683	2683	0	RIGHT	A12b.EDF	A12	2
94	723185	723405	57	277	220	RIGHT	A12b.EDF	A12	2
94	725433	725433	2305	2305	0	RIGHT	A12b.EDF	A12	2
95	729076	732827	58	3809	3751	RIGHT	A12b.EDF	A12	2
96	735155	735967	58	870	812	RIGHT	A12b.EDF	A12	2
96	736002	736671	905	1574	669	RIGHT	A12b.EDF	A12	2
96	736696	737742	1599	2645	1046	RIGHT	A12b.EDF	A12	2
96	737774	737797	2677	2700	23	RIGHT	A12b.EDF	A12	2
96	737821	737821	2724	2724	0	RIGHT	A12b.EDF	A12	2
96	737877	737923	2780	2826	46	RIGHT	A12b.EDF	A12	2
96	737966	738020	2869	2923	54	RIGHT	A12b.EDF	A12	2
96	738056	738098	2959	3001	42	RIGHT	A12b.EDF	A12	2
96	738119	738119	3022	3022	0	RIGHT	A12b.EDF	A12	2
96	738173	738182	3076	3085	9	RIGHT	A12b.EDF	A12	2
96	738239	738319	3142	3222	80	RIGHT	A12b.EDF	A12	2
96	738349	738561	3252	3464	212	RIGHT	A12b.EDF	A12	2
96	738629	738629	3532	3532	0	RIGHT	A12b.EDF	A12	2
96	738696	738702	3599	3605	6	RIGHT	A12b.EDF	A12	2
96	738765	738766	3668	3669	1	RIGHT	A12b.EDF	A12	2
96	738877	738878	3780	3781	1	RIGHT	A12b.EDF	A12	2
96	738931	738931	3834	3834	0	RIGHT	A12b.EDF	A12	2
96	738967	738973	3870	3876	6	RIGHT	A12b.EDF	A12	2
96	739057	739062	3960	3965	5	RIGHT	A12b.EDF	A12	2
1	1045322	1045436	290	404	114	RIGHT	A12c.EDF	A12	3
1	1045845	1045976	813	944	131	RIGHT	A12c.EDF	A12	3
1	1046093	1046301	1061	1269	208	RIGHT	A12c.EDF	A12	3
1	1047355	1047452	2323	2420	97	RIGHT	A12c.EDF	A12	3
1	1047670	1047844	2638	2812	174	RIGHT	A12c.EDF	A12	3
1	1047878	1048026	2846	2994	148	RIGHT	A12c.EDF	A12	3
2	1052386	1052418	58	90	32	RIGHT	A12c.EDF	A12	3
2	1053182	1053364	854	1036	182	RIGHT	A12c.EDF	A12	3
3	1057717	1057949	137	369	232	RIGHT	A12c.EDF	A12	3
6	1075115	1075165	58	108	50	RIGHT	A12c.EDF	A12	3
6	1075232	1075466	175	409	234	RIGHT	A12c.EDF	A12	3
7	1081617	1081843	57	283	226	RIGHT	A12c.EDF	A12	3
8	1087172	1087431	156	415	259	RIGHT	A12c.EDF	A12	3
10	1097577	1097616	58	97	39	RIGHT	A12c.EDF	A12	3
11	1103078	1103277	105	304	199	RIGHT	A12c.EDF	A12	3
12	1108745	1108980	58	293	235	RIGHT	A12c.EDF	A12	3
13	1115516	1115689	58	231	173	RIGHT	A12c.EDF	A12	3
14	1121803	1122177	58	432	374	RIGHT	A12c.EDF	A12	3
16	1132743	1132766	59	82	23	RIGHT	A12c.EDF	A12	3
17	1137776	1138146	58	428	370	RIGHT	A12c.EDF	A12	3
17	1138301	1138528	583	810	227	RIGHT	A12c.EDF	A12	3
19	1148822	1149044	377	599	222	RIGHT	A12c.EDF	A12	3
19	1151024	1151250	2579	2805	226	RIGHT	A12c.EDF	A12	3
21	1158663	1158879	59	275	216	RIGHT	A12c.EDF	A12	3
21	1159497	1159555	893	951	58	RIGHT	A12c.EDF	A12	3
21	1162264	1162546	3660	3942	282	RIGHT	A12c.EDF	A12	3
22	1163996	1164072	58	134	76	RIGHT	A12c.EDF	A12	3
22	1164170	1164393	232	455	223	RIGHT	A12c.EDF	A12	3
22	1164662	1164902	724	964	240	RIGHT	A12c.EDF	A12	3
22	1164995	1164995	1057	1057	0	RIGHT	A12c.EDF	A12	3
22	1165024	1165776	1086	1838	752	RIGHT	A12c.EDF	A12	3
23	1169904	1169929	58	83	25	RIGHT	A12c.EDF	A12	3
23	1172175	1172370	2329	2524	195	RIGHT	A12c.EDF	A12	3
24	1175677	1175903	223	449	226	RIGHT	A12c.EDF	A12	3
25	1180742	1182314	282	1854	1572	RIGHT	A12c.EDF	A12	3
25	1183788	1183924	3328	3464	136	RIGHT	A12c.EDF	A12	3
26	1185949	1186188	582	821	239	RIGHT	A12c.EDF	A12	3
27	1191570	1191812	1051	1293	242	RIGHT	A12c.EDF	A12	3
28	1196486	1196829	58	401	343	RIGHT	A12c.EDF	A12	3
28	1197612	1197804	1184	1376	192	RIGHT	A12c.EDF	A12	3
28	1197997	1198074	1569	1646	77	RIGHT	A12c.EDF	A12	3
28	1198658	1198675	2230	2247	17	RIGHT	A12c.EDF	A12	3
28	1198722	1198722	2294	2294	0	RIGHT	A12c.EDF	A12	3
28	1199153	1199235	2725	2807	82	RIGHT	A12c.EDF	A12	3
28	1200633	1200640	4205	4212	7	RIGHT	A12c.EDF	A12	3
29	1203036	1203303	807	1074	267	RIGHT	A12c.EDF	A12	3
29	1204588	1204588	2359	2359	0	RIGHT	A12c.EDF	A12	3
29	1204612	1204612	2383	2383	0	RIGHT	A12c.EDF	A12	3
29	1204643	1204643	2414	2414	0	RIGHT	A12c.EDF	A12	3
29	1204694	1204778	2465	2549	84	RIGHT	A12c.EDF	A12	3
29	1204799	1204806	2570	2577	7	RIGHT	A12c.EDF	A12	3
29	1204909	1204936	2680	2707	27	RIGHT	A12c.EDF	A12	3
29	1204959	1204961	2730	2732	2	RIGHT	A12c.EDF	A12	3
29	1204990	1204990	2761	2761	0	RIGHT	A12c.EDF	A12	3
29	1205018	1205363	2789	3134	345	RIGHT	A12c.EDF	A12	3
29	1205519	1205519	3290	3290	0	RIGHT	A12c.EDF	A12	3
29	1205551	1205551	3322	3322	0	RIGHT	A12c.EDF	A12	3
29	1205581	1205581	3352	3352	0	RIGHT	A12c.EDF	A12	3
29	1205606	1205626	3377	3397	20	RIGHT	A12c.EDF	A12	3
29	1205670	1205688	3441	3459	18	RIGHT	A12c.EDF	A12	3
29	1205868	1205884	3639	3655	16	RIGHT	A12c.EDF	A12	3
29	1205922	1205922	3693	3693	0	RIGHT	A12c.EDF	A12	3
29	1205960	1205961	3731	3732	1	RIGHT	A12c.EDF	A12	3
29	1206034	1206036	3805	3807	2	RIGHT	A12c.EDF	A12	3
30	1207700	1207712	76	88	12	RIGHT	A12c.EDF	A12	3
30	1209179	1209179	1555	1555	0	RIGHT	A12c.EDF	A12	3
30	1209345	1209345	1721	1721	0	RIGHT	A12c.EDF	A12	3
30	1209471	1209472	1847	1848	1	RIGHT	A12c.EDF	A12	3
30	1209495	1209505	1871	1881	10	RIGHT	A12c.EDF	A12	3
30	1209535	1209535	1911	1911	0	RIGHT	A12c.EDF	A12	3
30	1209577	1209577	1953	1953	0	RIGHT	A12c.EDF	A12	3
30	1209833	1209836	2209	2212	3	RIGHT	A12c.EDF	A12	3
30	1209867	1209899	2243	2275	32	RIGHT	A12c.EDF	A12	3
30	1209926	1209982	2302	2358	56	RIGHT	A12c.EDF	A12	3
30	1210004	1210046	2380	2422	42	RIGHT	A12c.EDF	A12	3
30	1210079	1210134	2455	2510	55	RIGHT	A12c.EDF	A12	3
30	1210165	1210179	2541	2555	14	RIGHT	A12c.EDF	A12	3
30	1210243	1210250	2619	2626	7	RIGHT	A12c.EDF	A12	3
30	1210300	1210300	2676	2676	0	RIGHT	A12c.EDF	A12	3
30	1210334	1210334	2710	2710	0	RIGHT	A12c.EDF	A12	3
30	1210374	1210374	2750	2750	0	RIGHT	A12c.EDF	A12	3
30	1210495	1210550	2871	2926	55	RIGHT	A12c.EDF	A12	3
30	1210574	1210628	2950	3004	54	RIGHT	A12c.EDF	A12	3
30	1210690	1210709	3066	3085	19	RIGHT	A12c.EDF	A12	3
30	1210739	1210740	3115	3116	1	RIGHT	A12c.EDF	A12	3
30	1210790	1210790	3166	3166	0	RIGHT	A12c.EDF	A12	3
30	1210812	1210828	3188	3204	16	RIGHT	A12c.EDF	A12	3
30	1210849	1210854	3225	3230	5	RIGHT	A12c.EDF	A12	3
30	1210875	1210880	3251	3256	5	RIGHT	A12c.EDF	A12	3
30	1210940	1210984	3316	3360	44	RIGHT	A12c.EDF	A12	3
30	1211023	1211023	3399	3399	0	RIGHT	A12c.EDF	A12	3
30	1211045	1211045	3421	3421	0	RIGHT	A12c.EDF	A12	3
30	1211162	1211206	3538	3582	44	RIGHT	A12c.EDF	A12	3
30	1211257	1211269	3633	3645	12	RIGHT	A12c.EDF	A12	3
31	1212965	1213211	58	304	246	RIGHT	A12c.EDF	A12	3
31	1214559	1214559	1652	1652	0	RIGHT	A12c.EDF	A12	3
31	1214599	1214603	1692	1696	4	RIGHT	A12c.EDF	A12	3
31	1214634	1214634	1727	1727	0	RIGHT	A12c.EDF	A12	3
31	1214655	1214671	1748	1764	16	RIGHT	A12c.EDF	A12	3
31	1214692	1214782	1785	1875	90	RIGHT	A12c.EDF	A12	3
31	1214808	1214808	1901	1901	0	RIGHT	A12c.EDF	A12	3
31	1215494	1215532	2587	2625	38	RIGHT	A12c.EDF	A12	3
31	1215576	1215596	2669	2689	20	RIGHT	A12c.EDF	A12	3
31	1215632	1215634	2725	2727	2	RIGHT	A12c.EDF	A12	3
31	1215660	1215671	2753	2764	11	RIGHT	A12c.EDF	A12	3
31	1215710	1215710	2803	2803	0	RIGHT	A12c.EDF	A12	3
31	1215958	1215983	3051	3076	25	RIGHT	A12c.EDF	A12	3
31	1216023	1216054	3116	3147	31	RIGHT	A12c.EDF	A12	3
31	1216077	1216077	3170	3170	0	RIGHT	A12c.EDF	A12	3
31	1216121	1216122	3214	3215	1	RIGHT	A12c.EDF	A12	3
31	1216147	1216159	3240	3252	12	RIGHT	A12c.EDF	A12	3
31	1216284	1216302	3377	3395	18	RIGHT	A12c.EDF	A12	3
31	1216325	1216325	3418	3418	0	RIGHT	A12c.EDF	A12	3
31	1216346	1216370	3439	3463	24	RIGHT	A12c.EDF	A12	3
31	1216391	1216881	3484	3974	490	RIGHT	A12c.EDF	A12	3
31	1216904	1216963	3997	4056	59	RIGHT	A12c.EDF	A12	3
31	1216998	1217107	4091	4200	109	RIGHT	A12c.EDF	A12	3
32	1218970	1218974	250	254	4	RIGHT	A12c.EDF	A12	3
32	1219072	1219072	352	352	0	RIGHT	A12c.EDF	A12	3
32	1219225	1219243	505	523	18	RIGHT	A12c.EDF	A12	3
32	1219283	1219283	563	563	0	RIGHT	A12c.EDF	A12	3
32	1219324	1219353	604	633	29	RIGHT	A12c.EDF	A12	3
32	1219378	1219379	658	659	1	RIGHT	A12c.EDF	A12	3
32	1219421	1219424	701	704	3	RIGHT	A12c.EDF	A12	3
32	1219538	1219555	818	835	17	RIGHT	A12c.EDF	A12	3
32	1219587	1219607	867	887	20	RIGHT	A12c.EDF	A12	3
32	1219638	1219644	918	924	6	RIGHT	A12c.EDF	A12	3
32	1219695	1219747	975	1027	52	RIGHT	A12c.EDF	A12	3
32	1219772	1219785	1052	1065	13	RIGHT	A12c.EDF	A12	3
32	1219813	1219831	1093	1111	18	RIGHT	A12c.EDF	A12	3
32	1219852	1219875	1132	1155	23	RIGHT	A12c.EDF	A12	3
32	1219896	1219950	1176	1230	54	RIGHT	A12c.EDF	A12	3
32	1219971	1220054	1251	1334	83	RIGHT	A12c.EDF	A12	3
32	1220075	1220175	1355	1455	100	RIGHT	A12c.EDF	A12	3
32	1220206	1222408	1486	3688	2202	RIGHT	A12c.EDF	A12	3
33	1224170	1228213	196	4239	4043	RIGHT	A12c.EDF	A12	3
34	1229739	1230000	107	368	261	RIGHT	A12c.EDF	A12	3
34	1230058	1233215	426	3583	3157	RIGHT	A12c.EDF	A12	3
35	1235466	1236414	58	1006	948	RIGHT	A12c.EDF	A12	3
35	1236576	1236647	1168	1239	71	RIGHT	A12c.EDF	A12	3
35	1236714	1236714	1306	1306	0	RIGHT	A12c.EDF	A12	3
35	1236871	1236871	1463	1463	0	RIGHT	A12c.EDF	A12	3
35	1237151	1237151	1743	1743	0	RIGHT	A12c.EDF	A12	3
35	1237202	1237816	1794	2408	614	RIGHT	A12c.EDF	A12	3
35	1237870	1238119	2462	2711	249	RIGHT	A12c.EDF	A12	3
35	1238150	1238401	2742	2993	251	RIGHT	A12c.EDF	A12	3
35	1238554	1238758	3146	3350	204	RIGHT	A12c.EDF	A12	3
35	1238789	1239068	3381	3660	279	RIGHT	A12c.EDF	A12	3
35	1239098	1239098	3690	3690	0	RIGHT	A12c.EDF	A12	3
35	1239140	1239623	3732	4215	483	RIGHT	A12c.EDF	A12	3
36	1242430	1242623	58	251	193	RIGHT	A12c.EDF	A12	3
36	1242706	1242918	334	546	212	RIGHT	A12c.EDF	A12	3
36	1243311	1243522	939	1150	211	RIGHT	A12c.EDF	A12	3
36	1244298	1246373	1926	4001	2075	RIGHT	A12c.EDF	A12	3
37	1248041	1248136	85	180	95	RIGHT	A12c.EDF	A12	3
37	1248157	1248169	201	213	12	RIGHT	A12c.EDF	A12	3
37	1248208	1248224	252	268	16	RIGHT	A12c.EDF	A12	3
37	1248261	1248261	305	305	0	RIGHT	A12c.EDF	A12	3
37	1248316	1249547	360	1591	1231	RIGHT	A12c.EDF	A12	3
37	1249593	1249639	1637	1683	46	RIGHT	A12c.EDF	A12	3
37	1249670	1249921	1714	1965	251	RIGHT	A12c.EDF	A12	3
37	1249959	1250168	2003	2212	209	RIGHT	A12c.EDF	A12	3
37	1250192	1250271	2236	2315	79	RIGHT	A12c.EDF	A12	3
37	1250293	1250388	2337	2432	95	RIGHT	A12c.EDF	A12	3
37	1250418	1250434	2462	2478	16	RIGHT	A12c.EDF	A12	3
37	1250491	1250492	2535	2536	1	RIGHT	A12c.EDF	A12	3
37	1250515	1250515	2559	2559	0	RIGHT	A12c.EDF	A12	3
37	1250651	1250651	2695	2695	0	RIGHT	A12c.EDF	A12	3
37	1250770	1251621	2814	3665	851	RIGHT	A12c.EDF	A12	3
38	1253694	1253931	420	657	237	RIGHT	A12c.EDF	A12	3
38	1254118	1254146	844	872	28	RIGHT	A12c.EDF	A12	3
38	1254280	1254293	1006	1019	13	RIGHT	A12c.EDF	A12	3
38	1254321	1257356	1047	4082	3035	RIGHT	A12c.EDF	A12	3
39	1258867	1258929	58	120	62	RIGHT	A12c.EDF	A12	3
39	1258966	1259294	157	485	328	RIGHT	A12c.EDF	A12	3
39	1259315	1259317	506	508	2	RIGHT	A12c.EDF	A12	3
39	1259344	1259465	535	656	121	RIGHT	A12c.EDF	A12	3
39	1259506	1260744	697	1935	1238	RIGHT	A12c.EDF	A12	3
39	1260805	1260806	1996	1997	1	RIGHT	A12c.EDF	A12	3
39	1260828	1260853	2019	2044	25	RIGHT	A12c.EDF	A12	3
39	1260877	1260942	2068	2133	65	RIGHT	A12c.EDF	A12	3
39	1260963	1261148	2154	2339	185	RIGHT	A12c.EDF	A12	3
39	1261289	1261289	2480	2480	0	RIGHT	A12c.EDF	A12	3
39	1261321	1261321	2512	2512	0	RIGHT	A12c.EDF	A12	3
39	1261550	1261562	2741	2753	12	RIGHT	A12c.EDF	A12	3
39	1261655	1261655	2846	2846	0	RIGHT	A12c.EDF	A12	3
39	1262108	1262108	3299	3299	0	RIGHT	A12c.EDF	A12	3
39	1262149	1262149	3340	3340	0	RIGHT	A12c.EDF	A12	3
39	1262331	1262332	3522	3523	1	RIGHT	A12c.EDF	A12	3
39	1262518	1262693	3709	3884	175	RIGHT	A12c.EDF	A12	3
39	1262722	1262734	3913	3925	12	RIGHT	A12c.EDF	A12	3
39	1262763	1262781	3954	3972	18	RIGHT	A12c.EDF	A12	3
39	1262802	1262906	3993	4097	104	RIGHT	A12c.EDF	A12	3
39	1262931	1262945	4122	4136	14	RIGHT	A12c.EDF	A12	3
39	1262977	1263003	4168	4194	26	RIGHT	A12c.EDF	A12	3
40	1265036	1265068	59	91	32	RIGHT	A12c.EDF	A12	3
40	1265764	1266117	787	1140	353	RIGHT	A12c.EDF	A12	3
41	1271061	1271330	667	936	269	RIGHT	A12c.EDF	A12	3
41	1271355	1271359	961	965	4	RIGHT	A12c.EDF	A12	3
41	1273350	1273356	2956	2962	6	RIGHT	A12c.EDF	A12	3
41	1273388	1273389	2994	2995	1	RIGHT	A12c.EDF	A12	3
41	1273411	1273423	3017	3029	12	RIGHT	A12c.EDF	A12	3
41	1273457	1273458	3063	3064	1	RIGHT	A12c.EDF	A12	3
41	1273484	1273484	3090	3090	0	RIGHT	A12c.EDF	A12	3
42	1275565	1275657	58	150	92	RIGHT	A12c.EDF	A12	3
44	1286784	1287102	628	946	318	RIGHT	A12c.EDF	A12	3
45	1294372	1294372	3159	3159	0	RIGHT	A12c.EDF	A12	3
45	1294463	1294488	3250	3275	25	RIGHT	A12c.EDF	A12	3
45	1294523	1294537	3310	3324	14	RIGHT	A12c.EDF	A12	3
45	1294602	1294616	3389	3403	14	RIGHT	A12c.EDF	A12	3
46	1296079	1296277	59	257	198	RIGHT	A12c.EDF	A12	3
47	1301454	1301709	310	565	255	RIGHT	A12c.EDF	A12	3
47	1302119	1302355	975	1211	236	RIGHT	A12c.EDF	A12	3
47	1302632	1302632	1488	1488	0	RIGHT	A12c.EDF	A12	3
47	1302871	1302871	1727	1727	0	RIGHT	A12c.EDF	A12	3
47	1302935	1302935	1791	1791	0	RIGHT	A12c.EDF	A12	3
47	1302968	1303155	1824	2011	187	RIGHT	A12c.EDF	A12	3
47	1303178	1303324	2034	2180	146	RIGHT	A12c.EDF	A12	3
47	1303351	1303400	2207	2256	49	RIGHT	A12c.EDF	A12	3
47	1303434	1303435	2290	2291	1	RIGHT	A12c.EDF	A12	3
47	1303574	1303574	2430	2430	0	RIGHT	A12c.EDF	A12	3
47	1303766	1303766	2622	2622	0	RIGHT	A12c.EDF	A12	3
47	1303991	1303999	2847	2855	8	RIGHT	A12c.EDF	A12	3
47	1304027	1304027	2883	2883	0	RIGHT	A12c.EDF	A12	3
47	1304071	1304071	2927	2927	0	RIGHT	A12c.EDF	A12	3
47	1304591	1304605	3447	3461	14	RIGHT	A12c.EDF	A12	3
48	1306793	1307388	59	654	595	RIGHT	A12c.EDF	A12	3
49	1312596	1312867	348	619	271	RIGHT	A12c.EDF	A12	3
49	1315286	1315465	3038	3217	179	RIGHT	A12c.EDF	A12	3
49	1315552	1315885	3304	3637	333	RIGHT	A12c.EDF	A12	3
50	1317735	1317835	59	159	100	RIGHT	A12c.EDF	A12	3
50	1317951	1317951	275	275	0	RIGHT	A12c.EDF	A12	3
50	1318067	1318124	391	448	57	RIGHT	A12c.EDF	A12	3
50	1318407	1318650	731	974	243	RIGHT	A12c.EDF	A12	3
52	1328735	1328957	327	549	222	RIGHT	A12c.EDF	A12	3
53	1334505	1334801	630	926	296	RIGHT	A12c.EDF	A12	3
54	1338681	1338887	58	264	206	RIGHT	A12c.EDF	A12	3
55	1343884	1344133	57	306	249	RIGHT	A12c.EDF	A12	3
56	1349712	1350029	259	576	317	RIGHT	A12c.EDF	A12	3
56	1350170	1350387	717	934	217	RIGHT	A12c.EDF	A12	3
57	1355599	1355841	340	582	242	RIGHT	A12c.EDF	A12	3
57	1355890	1356158	631	899	268	RIGHT	A12c.EDF	A12	3
58	1360879	1360945	71	137	66	RIGHT	A12c.EDF	A12	3
58	1361043	1361226	235	418	183	RIGHT	A12c.EDF	A12	3
58	1361577	1361733	769	925	156	RIGHT	A12c.EDF	A12	3
59	1367550	1367596	57	103	46	RIGHT	A12c.EDF	A12	3
59	1367781	1368000	288	507	219	RIGHT	A12c.EDF	A12	3
60	1373835	1373865	58	88	30	RIGHT	A12c.EDF	A12	3
60	1373929	1373949	152	172	20	RIGHT	A12c.EDF	A12	3
60	1374034	1374257	257	480	223	RIGHT	A12c.EDF	A12	3
61	1379795	1380090	58	353	295	RIGHT	A12c.EDF	A12	3
62	1385162	1385205	58	101	43	RIGHT	A12c.EDF	A12	3
62	1385346	1385623	242	519	277	RIGHT	A12c.EDF	A12	3
63	1390623	1390837	59	273	214	RIGHT	A12c.EDF	A12	3
63	1390909	1391128	345	564	219	RIGHT	A12c.EDF	A12	3
64	1396257	1396630	70	443	373	RIGHT	A12c.EDF	A12	3
64	1398009	1398009	1822	1822	0	RIGHT	A12c.EDF	A12	3
64	1398588	1398603	2401	2416	15	RIGHT	A12c.EDF	A12	3
64	1398644	1398644	2457	2457	0	RIGHT	A12c.EDF	A12	3
64	1398677	1398677	2490	2490	0	RIGHT	A12c.EDF	A12	3
66	1407130	1407434	197	501	304	RIGHT	A12c.EDF	A12	3
66	1408275	1408585	1342	1652	310	RIGHT	A12c.EDF	A12	3
67	1412610	1412899	149	438	289	RIGHT	A12c.EDF	A12	3
67	1413103	1413405	642	944	302	RIGHT	A12c.EDF	A12	3
68	1417273	1417611	114	452	338	RIGHT	A12c.EDF	A12	3
70	1428176	1428413	835	1072	237	RIGHT	A12c.EDF	A12	3
71	1434314	1434314	1852	1852	0	RIGHT	A12c.EDF	A12	3
71	1434413	1434428	1951	1966	15	RIGHT	A12c.EDF	A12	3
71	1434449	1434474	1987	2012	25	RIGHT	A12c.EDF	A12	3
71	1434499	1434501	2037	2039	2	RIGHT	A12c.EDF	A12	3
71	1434971	1434971	2509	2509	0	RIGHT	A12c.EDF	A12	3
71	1435166	1435166	2704	2704	0	RIGHT	A12c.EDF	A12	3
71	1435766	1435786	3304	3324	20	RIGHT	A12c.EDF	A12	3
71	1435834	1435930	3372	3468	96	RIGHT	A12c.EDF	A12	3
73	1442607	1442986	290	669	379	RIGHT	A12c.EDF	A12	3
74	1449647	1450827	2302	3482	1180	RIGHT	A12c.EDF	A12	3
75	1452600	1452641	58	99	41	RIGHT	A12c.EDF	A12	3
76	1457621	1457953	398	730	332	RIGHT	A12c.EDF	A12	3
76	1460444	1460444	3221	3221	0	RIGHT	A12c.EDF	A12	3
77	1462016	1462041	58	83	25	RIGHT	A12c.EDF	A12	3
77	1465425	1465428	3467	3470	3	RIGHT	A12c.EDF	A12	3
77	1465473	1465473	3515	3515	0	RIGHT	A12c.EDF	A12	3
77	1465494	1465586	3536	3628	92	RIGHT	A12c.EDF	A12	3
77	1465614	1465635	3656	3677	21	RIGHT	A12c.EDF	A12	3
77	1465659	1466052	3701	4094	393	RIGHT	A12c.EDF	A12	3
78	1467705	1467752	58	105	47	RIGHT	A12c.EDF	A12	3
78	1467782	1468154	135	507	372	RIGHT	A12c.EDF	A12	3
78	1470080	1470423	2433	2776	343	RIGHT	A12c.EDF	A12	3
79	1473584	1473917	57	390	333	RIGHT	A12c.EDF	A12	3
79	1475651	1477199	2124	3672	1548	RIGHT	A12c.EDF	A12	3
79	1477221	1477221	3694	3694	0	RIGHT	A12c.EDF	A12	3
80	1479549	1479777	58	286	228	RIGHT	A12c.EDF	A12	3
80	1479870	1480120	379	629	250	RIGHT	A12c.EDF	A12	3
80	1481385	1483002	1894	3511	1617	RIGHT	A12c.EDF	A12	3
81	1484508	1484692	57	241	184	RIGHT	A12c.EDF	A12	3
81	1485168	1485169	717	718	1	RIGHT	A12c.EDF	A12	3
81	1485401	1485404	950	953	3	RIGHT	A12c.EDF	A12	3
81	1485426	1485427	975	976	1	RIGHT	A12c.EDF	A12	3
81	1485454	1488334	1003	3883	2880	RIGHT	A12c.EDF	A12	3
81	1488408	1488519	3957	4068	111	RIGHT	A12c.EDF	A12	3
82	1489878	1490117	58	297	239	RIGHT	A12c.EDF	A12	3
82	1490235	1490459	415	639	224	RIGHT	A12c.EDF	A12	3
82	1490537	1490538	717	718	1	RIGHT	A12c.EDF	A12	3
82	1490573	1490573	753	753	0	RIGHT	A12c.EDF	A12	3
82	1490628	1490671	808	851	43	RIGHT	A12c.EDF	A12	3
82	1491050	1493165	1230	3345	2115	RIGHT	A12c.EDF	A12	3
82	1493193	1493232	3373	3412	39	RIGHT	A12c.EDF	A12	3
82	1493338	1493467	3518	3647	129	RIGHT	A12c.EDF	A12	3
82	1493488	1493493	3668	3673	5	RIGHT	A12c.EDF	A12	3
82	1493527	1493622	3707	3802	95	RIGHT	A12c.EDF	A12	3
83	1495165	1495352	73	260	187	RIGHT	A12c.EDF	A12	3
83	1497600	1497610	2508	2518	10	RIGHT	A12c.EDF	A12	3
84	1500429	1501045	58	674	616	RIGHT	A12c.EDF	A12	3
84	1501678	1501678	1307	1307	0	RIGHT	A12c.EDF	A12	3
84	1501708	1501821	1337	1450	113	RIGHT	A12c.EDF	A12	3
84	1501853	1501869	1482	1498	16	RIGHT	A12c.EDF	A12	3
84	1501895	1502005	1524	1634	110	RIGHT	A12c.EDF	A12	3
84	1502044	1502044	1673	1673	0	RIGHT	A12c.EDF	A12	3
84	1502072	1502092	1701	1721	20	RIGHT	A12c.EDF	A12	3
84	1502146	1502167	1775	1796	21	RIGHT	A12c.EDF	A12	3
84	1502201	1502201	1830	1830	0	RIGHT	A12c.EDF	A12	3
84	1502246	1502246	1875	1875	0	RIGHT	A12c.EDF	A12	3
84	1502269	1502269	1898	1898	0	RIGHT	A12c.EDF	A12	3
84	1502685	1502687	2314	2316	2	RIGHT	A12c.EDF	A12	3
84	1502785	1502787	2414	2416	2	RIGHT	A12c.EDF	A12	3
84	1503487	1503521	3116	3150	34	RIGHT	A12c.EDF	A12	3
84	1503555	1504931	3184	4560	1376	RIGHT	A12c.EDF	A12	3
85	1506680	1507292	59	671	612	RIGHT	A12c.EDF	A12	3
85	1507328	1507370	707	749	42	RIGHT	A12c.EDF	A12	3
85	1507395	1507422	774	801	27	RIGHT	A12c.EDF	A12	3
85	1507447	1507504	826	883	57	RIGHT	A12c.EDF	A12	3
85	1507532	1507544	911	923	12	RIGHT	A12c.EDF	A12	3
85	1507634	1507634	1013	1013	0	RIGHT	A12c.EDF	A12	3
85	1507661	1507670	1040	1049	9	RIGHT	A12c.EDF	A12	3
85	1507694	1507695	1073	1074	1	RIGHT	A12c.EDF	A12	3
85	1507916	1507916	1295	1295	0	RIGHT	A12c.EDF	A12	3
85	1507994	1507994	1373	1373	0	RIGHT	A12c.EDF	A12	3
85	1508032	1508056	1411	1435	24	RIGHT	A12c.EDF	A12	3
85	1508158	1508158	1537	1537	0	RIGHT	A12c.EDF	A12	3
85	1508239	1508240	1618	1619	1	RIGHT	A12c.EDF	A12	3
85	1508263	1508263	1642	1642	0	RIGHT	A12c.EDF	A12	3
85	1508293	1508469	1672	1848	176	RIGHT	A12c.EDF	A12	3
85	1508508	1508516	1887	1895	8	RIGHT	A12c.EDF	A12	3
85	1508547	1508568	1926	1947	21	RIGHT	A12c.EDF	A12	3
85	1508633	1508658	2012	2037	25	RIGHT	A12c.EDF	A12	3
85	1508774	1508774	2153	2153	0	RIGHT	A12c.EDF	A12	3
85	1508813	1509017	2192	2396	204	RIGHT	A12c.EDF	A12	3
85	1509055	1509301	2434	2680	246	RIGHT	A12c.EDF	A12	3
85	1509331	1509399	2710	2778	68	RIGHT	A12c.EDF	A12	3
85	1509434	1509436	2813	2815	2	RIGHT	A12c.EDF	A12	3
85	1509461	1509516	2840	2895	55	RIGHT	A12c.EDF	A12	3
85	1509689	1509689	3068	3068	0	RIGHT	A12c.EDF	A12	3
85	1509767	1509789	3146	3168	22	RIGHT	A12c.EDF	A12	3
85	1509826	1509858	3205	3237	32	RIGHT	A12c.EDF	A12	3
85	1509930	1509933	3309	3312	3	RIGHT	A12c.EDF	A12	3
85	1509954	1510002	3333	3381	48	RIGHT	A12c.EDF	A12	3
85	1510039	1510049	3418	3428	10	RIGHT	A12c.EDF	A12	3
85	1510089	1510089	3468	3468	0	RIGHT	A12c.EDF	A12	3
85	1510198	1510198	3577	3577	0	RIGHT	A12c.EDF	A12	3
86	1511552	1511707	181	336	155	RIGHT	A12c.EDF	A12	3
86	1511757	1512831	386	1460	1074	RIGHT	A12c.EDF	A12	3
86	1512855	1512870	1484	1499	15	RIGHT	A12c.EDF	A12	3
86	1512891	1512891	1520	1520	0	RIGHT	A12c.EDF	A12	3
86	1512917	1513220	1546	1849	303	RIGHT	A12c.EDF	A12	3
86	1513263	1513286	1892	1915	23	RIGHT	A12c.EDF	A12	3
86	1513309	1513309	1938	1938	0	RIGHT	A12c.EDF	A12	3
86	1513340	1513342	1969	1971	2	RIGHT	A12c.EDF	A12	3
86	1513379	1513411	2008	2040	32	RIGHT	A12c.EDF	A12	3
86	1513435	1513454	2064	2083	19	RIGHT	A12c.EDF	A12	3
86	1513488	1513488	2117	2117	0	RIGHT	A12c.EDF	A12	3
86	1513523	1513523	2152	2152	0	RIGHT	A12c.EDF	A12	3
86	1513545	1513545	2174	2174	0	RIGHT	A12c.EDF	A12	3
86	1513580	1513583	2209	2212	3	RIGHT	A12c.EDF	A12	3
86	1513617	1513617	2246	2246	0	RIGHT	A12c.EDF	A12	3
86	1513653	1513653	2282	2282	0	RIGHT	A12c.EDF	A12	3
86	1513708	1513709	2337	2338	1	RIGHT	A12c.EDF	A12	3
86	1513773	1513773	2402	2402	0	RIGHT	A12c.EDF	A12	3
86	1513850	1513850	2479	2479	0	RIGHT	A12c.EDF	A12	3
86	1513950	1513990	2579	2619	40	RIGHT	A12c.EDF	A12	3
86	1514012	1514023	2641	2652	11	RIGHT	A12c.EDF	A12	3
86	1514061	1514062	2690	2691	1	RIGHT	A12c.EDF	A12	3
86	1514174	1514203	2803	2832	29	RIGHT	A12c.EDF	A12	3
86	1514237	1514287	2866	2916	50	RIGHT	A12c.EDF	A12	3
86	1514309	1514375	2938	3004	66	RIGHT	A12c.EDF	A12	3
86	1514431	1514437	3060	3066	6	RIGHT	A12c.EDF	A12	3
86	1514481	1514496	3110	3125	15	RIGHT	A12c.EDF	A12	3
86	1514571	1514582	3200	3211	11	RIGHT	A12c.EDF	A12	3
86	1514746	1514750	3375	3379	4	RIGHT	A12c.EDF	A12	3
86	1514931	1514931	3560	3560	0	RIGHT	A12c.EDF	A12	3
86	1514973	1514973	3602	3602	0	RIGHT	A12c.EDF	A12	3
86	1515058	1515164	3687	3793	106	RIGHT	A12c.EDF	A12	3
86	1515227	1515260	3856	3889	33	RIGHT	A12c.EDF	A12	3
86	1515361	1515458	3990	4087	97	RIGHT	A12c.EDF	A12	3
86	1515489	1515489	4118	4118	0	RIGHT	A12c.EDF	A12	3
86	1515511	1515511	4140	4140	0	RIGHT	A12c.EDF	A12	3
86	1515544	1515623	4173	4252	79	RIGHT	A12c.EDF	A12	3
86	1515668	1515682	4297	4311	14	RIGHT	A12c.EDF	A12	3
87	1517417	1517698	288	569	281	RIGHT	A12c.EDF	A12	3
87	1517937	1517937	808	808	0	RIGHT	A12c.EDF	A12	3
87	1518092	1518092	963	963	0	RIGHT	A12c.EDF	A12	3
87	1518147	1518148	1018	1019	1	RIGHT	A12c.EDF	A12	3
87	1518379	1518379	1250	1250	0	RIGHT	A12c.EDF	A12	3
87	1518629	1518629	1500	1500	0	RIGHT	A12c.EDF	A12	3
87	1518690	1518690	1561	1561	0	RIGHT	A12c.EDF	A12	3
87	1518737	1518737	1608	1608	0	RIGHT	A12c.EDF	A12	3
87	1518867	1518868	1738	1739	1	RIGHT	A12c.EDF	A12	3
87	1518929	1518929	1800	1800	0	RIGHT	A12c.EDF	A12	3
87	1519270	1519272	2141	2143	2	RIGHT	A12c.EDF	A12	3
87	1519991	1519992	2862	2863	1	RIGHT	A12c.EDF	A12	3
87	1520020	1520020	2891	2891	0	RIGHT	A12c.EDF	A12	3
87	1520082	1520082	2953	2953	0	RIGHT	A12c.EDF	A12	3
88	1522221	1522358	58	195	137	RIGHT	A12c.EDF	A12	3
88	1522389	1522412	226	249	23	RIGHT	A12c.EDF	A12	3
88	1522447	1522452	284	289	5	RIGHT	A12c.EDF	A12	3
88	1522495	1522757	332	594	262	RIGHT	A12c.EDF	A12	3
88	1522841	1522842	678	679	1	RIGHT	A12c.EDF	A12	3
88	1522972	1522972	809	809	0	RIGHT	A12c.EDF	A12	3
88	1523283	1523334	1120	1171	51	RIGHT	A12c.EDF	A12	3
88	1523386	1523645	1223	1482	259	RIGHT	A12c.EDF	A12	3
88	1523669	1523745	1506	1582	76	RIGHT	A12c.EDF	A12	3
88	1523773	1524210	1610	2047	437	RIGHT	A12c.EDF	A12	3
88	1524564	1524564	2401	2401	0	RIGHT	A12c.EDF	A12	3
88	1525553	1525621	3390	3458	68	RIGHT	A12c.EDF	A12	3
89	1527813	1528085	190	462	272	RIGHT	A12c.EDF	A12	3
89	1528528	1528788	905	1165	260	RIGHT	A12c.EDF	A12	3
89	1529984	1529985	2361	2362	1	RIGHT	A12c.EDF	A12	3
89	1530029	1530029	2406	2406	0	RIGHT	A12c.EDF	A12	3
89	1530307	1530307	2684	2684	0	RIGHT	A12c.EDF	A12	3
89	1530339	1530340	2716	2717	1	RIGHT	A12c.EDF	A12	3
89	1530522	1530523	2899	2900	1	RIGHT	A12c.EDF	A12	3
90	1533212	1533463	58	309	251	RIGHT	A12c.EDF	A12	3
90	1533571	1533618	417	464	47	RIGHT	A12c.EDF	A12	3
90	1533648	1533668	494	514	20	RIGHT	A12c.EDF	A12	3
90	1533721	1533721	567	567	0	RIGHT	A12c.EDF	A12	3
90	1533766	1533766	612	612	0	RIGHT	A12c.EDF	A12	3
90	1533798	1533800	644	646	2	RIGHT	A12c.EDF	A12	3
90	1533894	1533894	740	740	0	RIGHT	A12c.EDF	A12	3
90	1533931	1533931	777	777	0	RIGHT	A12c.EDF	A12	3
90	1533974	1533994	820	840	20	RIGHT	A12c.EDF	A12	3
90	1534056	1534056	902	902	0	RIGHT	A12c.EDF	A12	3
90	1534096	1534104	942	950	8	RIGHT	A12c.EDF	A12	3
90	1534197	1534225	1043	1071	28	RIGHT	A12c.EDF	A12	3
90	1534249	1534280	1095	1126	31	RIGHT	A12c.EDF	A12	3
90	1534307	1534317	1153	1163	10	RIGHT	A12c.EDF	A12	3
90	1534382	1534384	1228	1230	2	RIGHT	A12c.EDF	A12	3
90	1534427	1534438	1273	1284	11	RIGHT	A12c.EDF	A12	3
90	1534462	1534462	1308	1308	0	RIGHT	A12c.EDF	A12	3
90	1534491	1534491	1337	1337	0	RIGHT	A12c.EDF	A12	3
90	1534527	1534545	1373	1391	18	RIGHT	A12c.EDF	A12	3
90	1534571	1534571	1417	1417	0	RIGHT	A12c.EDF	A12	3
90	1534595	1534595	1441	1441	0	RIGHT	A12c.EDF	A12	3
90	1534618	1534618	1464	1464	0	RIGHT	A12c.EDF	A12	3
90	1534938	1534938	1784	1784	0	RIGHT	A12c.EDF	A12	3
90	1535214	1535676	2060	2522	462	RIGHT	A12c.EDF	A12	3
90	1535708	1536067	2554	2913	359	RIGHT	A12c.EDF	A12	3
90	1536116	1536173	2962	3019	57	RIGHT	A12c.EDF	A12	3
90	1536199	1536295	3045	3141	96	RIGHT	A12c.EDF	A12	3
90	1536317	1536317	3163	3163	0	RIGHT	A12c.EDF	A12	3
90	1536373	1536508	3219	3354	135	RIGHT	A12c.EDF	A12	3
90	1536537	1537083	3383	3929	546	RIGHT	A12c.EDF	A12	3
91	1538655	1540568	66	1979	1913	RIGHT	A12c.EDF	A12	3
91	1540600	1540866	2011	2277	266	RIGHT	A12c.EDF	A12	3
91	1540888	1541852	2299	3263	964	RIGHT	A12c.EDF	A12	3
91	1541873	1542107	3284	3518	234	RIGHT	A12c.EDF	A12	3
91	1542141	1542509	3552	3920	368	RIGHT	A12c.EDF	A12	3
92	1544090	1545058	58	1026	968	RIGHT	A12c.EDF	A12	3
92	1545195	1546834	1163	2802	1639	RIGHT	A12c.EDF	A12	3
92	1546862	1546967	2830	2935	105	RIGHT	A12c.EDF	A12	3
92	1547349	1547350	3317	3318	1	RIGHT	A12c.EDF	A12	3
92	1547380	1547380	3348	3348	0	RIGHT	A12c.EDF	A12	3
93	1550245	1550513	698	966	268	RIGHT	A12c.EDF	A12	3
93	1550702	1550712	1155	1165	10	RIGHT	A12c.EDF	A12	3
93	1550753	1550753	1206	1206	0	RIGHT	A12c.EDF	A12	3
93	1551174	1551174	1627	1627	0	RIGHT	A12c.EDF	A12	3
93	1551242	1551290	1695	1743	48	RIGHT	A12c.EDF	A12	3
93	1551317	1551319	1770	1772	2	RIGHT	A12c.EDF	A12	3
93	1551348	1551348	1801	1801	0	RIGHT	A12c.EDF	A12	3
93	1551376	1551376	1829	1829	0	RIGHT	A12c.EDF	A12	3
93	1551399	1551399	1852	1852	0	RIGHT	A12c.EDF	A12	3
93	1551424	1551424	1877	1877	0	RIGHT	A12c.EDF	A12	3
93	1551453	1551453	1906	1906	0	RIGHT	A12c.EDF	A12	3
93	1551487	1551487	1940	1940	0	RIGHT	A12c.EDF	A12	3
93	1551723	1551723	2176	2176	0	RIGHT	A12c.EDF	A12	3
93	1551847	1551847	2300	2300	0	RIGHT	A12c.EDF	A12	3
93	1552402	1552476	2855	2929	74	RIGHT	A12c.EDF	A12	3
93	1552502	1552502	2955	2955	0	RIGHT	A12c.EDF	A12	3
93	1552525	1552528	2978	2981	3	RIGHT	A12c.EDF	A12	3
93	1552588	1552846	3041	3299	258	RIGHT	A12c.EDF	A12	3
94	1555305	1555549	70	314	244	RIGHT	A12c.EDF	A12	3
94	1557239	1557255	2004	2020	16	RIGHT	A12c.EDF	A12	3
94	1557521	1558119	2286	2884	598	RIGHT	A12c.EDF	A12	3
95	1560761	1561033	301	573	272	RIGHT	A12c.EDF	A12	3
95	1562921	1562958	2461	2498	37	RIGHT	A12c.EDF	A12	3
95	1563063	1563064	2603	2604	1	RIGHT	A12c.EDF	A12	3
96	1565399	1565472	90	163	73	RIGHT	A12c.EDF	A12	3
96	1565506	1565509	197	200	3	RIGHT	A12c.EDF	A12	3
96	1565735	1565993	426	684	258	RIGHT	A12c.EDF	A12	3
1	5185829	5185938	802	911	109	RIGHT	A14a.EDF	A14	1
2	5212342	5212460	58	176	118	RIGHT	A14a.EDF	A14	1
2	5213558	5213609	1274	1325	51	RIGHT	A14a.EDF	A14	1
2	5214501	5214541	2217	2257	40	RIGHT	A14a.EDF	A14	1
2	5215341	5215390	3057	3106	49	RIGHT	A14a.EDF	A14	1
2	5215986	5216000	3702	3716	14	RIGHT	A14a.EDF	A14	1
3	5220909	5220974	712	777	65	RIGHT	A14a.EDF	A14	1
3	5222364	5222424	2167	2227	60	RIGHT	A14a.EDF	A14	1
3	5222697	5222776	2500	2579	79	RIGHT	A14a.EDF	A14	1
3	5223217	5223283	3020	3086	66	RIGHT	A14a.EDF	A14	1
3	5223699	5223792	3502	3595	93	RIGHT	A14a.EDF	A14	1
3	5224398	5224480	4201	4283	82	RIGHT	A14a.EDF	A14	1
4	5226582	5226607	58	83	25	RIGHT	A14a.EDF	A14	1
4	5227798	5227823	1274	1299	25	RIGHT	A14a.EDF	A14	1
4	5228575	5228665	2051	2141	90	RIGHT	A14a.EDF	A14	1
4	5229238	5229314	2714	2790	76	RIGHT	A14a.EDF	A14	1
4	5230360	5230409	3836	3885	49	RIGHT	A14a.EDF	A14	1
5	5233055	5233118	630	693	63	RIGHT	A14a.EDF	A14	1
5	5234791	5234852	2366	2427	61	RIGHT	A14a.EDF	A14	1
6	5238652	5238726	425	499	74	RIGHT	A14a.EDF	A14	1
6	5240209	5240264	1982	2037	55	RIGHT	A14a.EDF	A14	1
7	5245314	5245410	834	930	96	RIGHT	A14a.EDF	A14	1
7	5246382	5246411	1902	1931	29	RIGHT	A14a.EDF	A14	1
7	5247231	5247252	2751	2772	21	RIGHT	A14a.EDF	A14	1
7	5248199	5248235	3719	3755	36	RIGHT	A14a.EDF	A14	1
8	5250927	5250978	846	897	51	RIGHT	A14a.EDF	A14	1
8	5251804	5251810	1723	1729	6	RIGHT	A14a.EDF	A14	1
9	5255600	5255666	410	476	66	RIGHT	A14a.EDF	A14	1
10	5262406	5262414	1700	1708	8	RIGHT	A14a.EDF	A14	1
10	5262962	5263003	2256	2297	41	RIGHT	A14a.EDF	A14	1
10	5263024	5263029	2318	2323	5	RIGHT	A14a.EDF	A14	1
11	5266463	5266497	606	640	34	RIGHT	A14a.EDF	A14	1
11	5267936	5267954	2079	2097	18	RIGHT	A14a.EDF	A14	1
12	5271967	5271968	502	503	1	RIGHT	A14a.EDF	A14	1
12	5271989	5272038	524	573	49	RIGHT	A14a.EDF	A14	1
12	5272060	5272065	595	600	5	RIGHT	A14a.EDF	A14	1
12	5273555	5273633	2090	2168	78	RIGHT	A14a.EDF	A14	1
13	5277039	5277089	58	108	50	RIGHT	A14a.EDF	A14	1
13	5277110	5277118	129	137	8	RIGHT	A14a.EDF	A14	1
13	5278639	5278664	1658	1683	25	RIGHT	A14a.EDF	A14	1
13	5279028	5279117	2047	2136	89	RIGHT	A14a.EDF	A14	1
13	5279482	5279534	2501	2553	52	RIGHT	A14a.EDF	A14	1
13	5280054	5280163	3073	3182	109	RIGHT	A14a.EDF	A14	1
14	5284683	5284685	1587	1589	2	RIGHT	A14a.EDF	A14	1
14	5284706	5284744	1610	1648	38	RIGHT	A14a.EDF	A14	1
14	5284773	5284773	1677	1677	0	RIGHT	A14a.EDF	A14	1
14	5286182	5286210	3086	3114	28	RIGHT	A14a.EDF	A14	1
15	5288741	5288745	88	92	4	RIGHT	A14a.EDF	A14	1
18	5307658	5307659	1431	1432	1	RIGHT	A14a.EDF	A14	1
18	5307681	5307702	1454	1475	21	RIGHT	A14a.EDF	A14	1
18	5307731	5307735	1504	1508	4	RIGHT	A14a.EDF	A14	1
19	5312867	5312868	984	985	1	RIGHT	A14a.EDF	A14	1
19	5312930	5312935	1047	1052	5	RIGHT	A14a.EDF	A14	1
21	5324442	5324497	647	702	55	RIGHT	A14a.EDF	A14	1
25	5347327	5347393	607	673	66	RIGHT	A14a.EDF	A14	1
25	5347669	5347802	949	1082	133	RIGHT	A14a.EDF	A14	1
27	5357823	5357914	268	359	91	RIGHT	A14a.EDF	A14	1
28	5363501	5363506	97	102	5	RIGHT	A14a.EDF	A14	1
28	5363562	5363574	158	170	12	RIGHT	A14a.EDF	A14	1
29	5370671	5370677	362	368	6	RIGHT	A14a.EDF	A14	1
29	5370750	5370756	441	447	6	RIGHT	A14a.EDF	A14	1
29	5372065	5372088	1756	1779	23	RIGHT	A14a.EDF	A14	1
29	5372863	5372914	2554	2605	51	RIGHT	A14a.EDF	A14	1
29	5372936	5372939	2627	2630	3	RIGHT	A14a.EDF	A14	1
30	5378583	5378590	2805	2812	7	RIGHT	A14a.EDF	A14	1
30	5378628	5378629	2850	2851	1	RIGHT	A14a.EDF	A14	1
31	5382467	5382558	789	880	91	RIGHT	A14a.EDF	A14	1
31	5383202	5383292	1524	1614	90	RIGHT	A14a.EDF	A14	1
33	5393569	5393611	110	152	42	RIGHT	A14a.EDF	A14	1
33	5393824	5393926	365	467	102	RIGHT	A14a.EDF	A14	1
34	5400943	5400944	1617	1618	1	RIGHT	A14a.EDF	A14	1
35	5404851	5404908	58	115	57	RIGHT	A14a.EDF	A14	1
35	5406893	5406923	2100	2130	30	RIGHT	A14a.EDF	A14	1
36	5411984	5412150	59	225	166	RIGHT	A14a.EDF	A14	1
36	5414402	5414487	2477	2562	85	RIGHT	A14a.EDF	A14	1
38	5423740	5423870	71	201	130	RIGHT	A14a.EDF	A14	1
39	5429085	5429089	205	209	4	RIGHT	A14a.EDF	A14	1
39	5429111	5429211	231	331	100	RIGHT	A14a.EDF	A14	1
40	5435748	5435903	604	759	155	RIGHT	A14a.EDF	A14	1
41	5441982	5441987	230	235	5	RIGHT	A14a.EDF	A14	1
41	5442010	5442045	258	293	35	RIGHT	A14a.EDF	A14	1
41	5442068	5442071	316	319	3	RIGHT	A14a.EDF	A14	1
41	5442395	5442499	643	747	104	RIGHT	A14a.EDF	A14	1
43	5453423	5453525	87	189	102	RIGHT	A14a.EDF	A14	1
44	5459516	5459614	330	428	98	RIGHT	A14a.EDF	A14	1
45	5466141	5466229	324	412	88	RIGHT	A14a.EDF	A14	1
47	5477735	5477807	84	156	72	RIGHT	A14a.EDF	A14	1
47	5477831	5477835	180	184	4	RIGHT	A14a.EDF	A14	1
47	5479448	5479451	1797	1800	3	RIGHT	A14a.EDF	A14	1
47	5479948	5479950	2297	2299	2	RIGHT	A14a.EDF	A14	1
47	5479978	5479978	2327	2327	0	RIGHT	A14a.EDF	A14	1
48	5486113	5486145	3164	3196	32	RIGHT	A14a.EDF	A14	1
49	5489139	5489235	143	239	96	RIGHT	A14a.EDF	A14	1
49	5489260	5489260	264	264	0	RIGHT	A14a.EDF	A14	1
49	5490849	5490871	1853	1875	22	RIGHT	A14a.EDF	A14	1
51	5500541	5500573	516	548	32	RIGHT	A14a.EDF	A14	1
51	5500597	5500598	572	573	1	RIGHT	A14a.EDF	A14	1
51	5501969	5502034	1944	2009	65	RIGHT	A14a.EDF	A14	1
51	5502276	5502276	2251	2251	0	RIGHT	A14a.EDF	A14	1
52	5506889	5507034	145	290	145	RIGHT	A14a.EDF	A14	1
53	5512239	5512346	164	271	107	RIGHT	A14a.EDF	A14	1
54	5517746	5517863	115	232	117	RIGHT	A14a.EDF	A14	1
54	5517891	5517902	260	271	11	RIGHT	A14a.EDF	A14	1
54	5519886	5519890	2255	2259	4	RIGHT	A14a.EDF	A14	1
54	5519914	5519922	2283	2291	8	RIGHT	A14a.EDF	A14	1
54	5520334	5520414	2703	2783	80	RIGHT	A14a.EDF	A14	1
55	5524060	5524061	110	111	1	RIGHT	A14a.EDF	A14	1
55	5524129	5524135	179	185	6	RIGHT	A14a.EDF	A14	1
55	5524239	5524322	289	372	83	RIGHT	A14a.EDF	A14	1
55	5524344	5524347	394	397	3	RIGHT	A14a.EDF	A14	1
55	5526591	5526624	2641	2674	33	RIGHT	A14a.EDF	A14	1
56	5531226	5531275	2140	2189	49	RIGHT	A14a.EDF	A14	1
57	5535198	5535321	59	182	123	RIGHT	A14a.EDF	A14	1
57	5535345	5535349	206	210	4	RIGHT	A14a.EDF	A14	1
58	5540775	5540951	92	268	176	RIGHT	A14a.EDF	A14	1
58	5540977	5540980	294	297	3	RIGHT	A14a.EDF	A14	1
59	5546899	5546957	57	115	58	RIGHT	A14a.EDF	A14	1
61	5558678	5558761	361	444	83	RIGHT	A14a.EDF	A14	1
61	5560117	5560117	1800	1800	0	RIGHT	A14a.EDF	A14	1
61	5560179	5560180	1862	1863	1	RIGHT	A14a.EDF	A14	1
62	5565118	5565189	58	129	71	RIGHT	A14a.EDF	A14	1
63	5570744	5570843	67	166	99	RIGHT	A14a.EDF	A14	1
63	5570866	5570880	189	203	14	RIGHT	A14a.EDF	A14	1
64	5576053	5576161	96	204	108	RIGHT	A14a.EDF	A14	1
64	5578110	5578110	2153	2153	0	RIGHT	A14a.EDF	A14	1
64	5578133	5578136	2176	2179	3	RIGHT	A14a.EDF	A14	1
65	5582037	5582180	59	202	143	RIGHT	A14a.EDF	A14	1
66	5589757	5589797	1841	1881	40	RIGHT	A14a.EDF	A14	1
66	5589827	5589827	1911	1911	0	RIGHT	A14a.EDF	A14	1
67	5595857	5595887	2226	2256	30	RIGHT	A14a.EDF	A14	1
67	5596705	5596706	3074	3075	1	RIGHT	A14a.EDF	A14	1
68	5599840	5599904	266	330	64	RIGHT	A14a.EDF	A14	1
69	5606293	5606324	59	90	31	RIGHT	A14a.EDF	A14	1
70	5612641	5612643	188	190	2	RIGHT	A14a.EDF	A14	1
70	5612695	5612703	242	250	8	RIGHT	A14a.EDF	A14	1
70	5612882	5612883	429	430	1	RIGHT	A14a.EDF	A14	1
70	5612906	5612931	453	478	25	RIGHT	A14a.EDF	A14	1
70	5612954	5612955	501	502	1	RIGHT	A14a.EDF	A14	1
72	5623752	5623795	57	100	43	RIGHT	A14a.EDF	A14	1
74	5635832	5635980	58	206	148	RIGHT	A14a.EDF	A14	1
75	5642291	5642305	172	186	14	RIGHT	A14a.EDF	A14	1
75	5642332	5642435	213	316	103	RIGHT	A14a.EDF	A14	1
75	5642459	5642467	340	348	8	RIGHT	A14a.EDF	A14	1
76	5648408	5648555	524	671	147	RIGHT	A14a.EDF	A14	1
76	5648582	5648587	698	703	5	RIGHT	A14a.EDF	A14	1
79	5665372	5665380	133	141	8	RIGHT	A14a.EDF	A14	1
79	5665416	5665458	177	219	42	RIGHT	A14a.EDF	A14	1
79	5665486	5665494	247	255	8	RIGHT	A14a.EDF	A14	1
80	5672049	5672056	90	97	7	RIGHT	A14a.EDF	A14	1
80	5672287	5672303	328	344	16	RIGHT	A14a.EDF	A14	1
80	5672350	5672434	391	475	84	RIGHT	A14a.EDF	A14	1
81	5678671	5678736	518	583	65	RIGHT	A14a.EDF	A14	1
81	5681059	5681119	2906	2966	60	RIGHT	A14a.EDF	A14	1
82	5684705	5684805	58	158	100	RIGHT	A14a.EDF	A14	1
82	5684826	5684837	179	190	11	RIGHT	A14a.EDF	A14	1
82	5686991	5687086	2344	2439	95	RIGHT	A14a.EDF	A14	1
82	5687766	5687799	3119	3152	33	RIGHT	A14a.EDF	A14	1
83	5690604	5690622	183	201	18	RIGHT	A14a.EDF	A14	1
83	5690662	5690671	241	250	9	RIGHT	A14a.EDF	A14	1
84	5697164	5697252	208	296	88	RIGHT	A14a.EDF	A14	1
84	5697612	5697655	656	699	43	RIGHT	A14a.EDF	A14	1
85	5702790	5702801	68	79	11	RIGHT	A14a.EDF	A14	1
85	5702846	5702989	124	267	143	RIGHT	A14a.EDF	A14	1
86	5708996	5709058	59	121	62	RIGHT	A14a.EDF	A14	1
86	5709091	5709093	154	156	2	RIGHT	A14a.EDF	A14	1
87	5715427	5715428	185	186	1	RIGHT	A14a.EDF	A14	1
87	5715494	5715498	252	256	4	RIGHT	A14a.EDF	A14	1
87	5715818	5715820	576	578	2	RIGHT	A14a.EDF	A14	1
87	5715848	5715913	606	671	65	RIGHT	A14a.EDF	A14	1
87	5715948	5715952	706	710	4	RIGHT	A14a.EDF	A14	1
88	5722078	5722148	641	711	70	RIGHT	A14a.EDF	A14	1
90	5733824	5733872	178	226	48	RIGHT	A14a.EDF	A14	1
90	5734157	5734290	511	644	133	RIGHT	A14a.EDF	A14	1
90	5734317	5734327	671	681	10	RIGHT	A14a.EDF	A14	1
91	5739428	5739428	382	382	0	RIGHT	A14a.EDF	A14	1
91	5739458	5739561	412	515	103	RIGHT	A14a.EDF	A14	1
91	5740973	5740978	1927	1932	5	RIGHT	A14a.EDF	A14	1
91	5741024	5741032	1978	1986	8	RIGHT	A14a.EDF	A14	1
92	5744899	5744909	157	167	10	RIGHT	A14a.EDF	A14	1
92	5744975	5744982	233	240	7	RIGHT	A14a.EDF	A14	1
92	5745303	5745305	561	563	2	RIGHT	A14a.EDF	A14	1
92	5745328	5745351	586	609	23	RIGHT	A14a.EDF	A14	1
92	5745386	5745397	644	655	11	RIGHT	A14a.EDF	A14	1
93	5750444	5750557	59	172	113	RIGHT	A14a.EDF	A14	1
95	5762180	5762186	93	99	6	RIGHT	A14a.EDF	A14	1
96	5769626	5769626	2072	2072	0	RIGHT	A14a.EDF	A14	1
96	5770215	5770215	2661	2661	0	RIGHT	A14a.EDF	A14	1
96	5770249	5770249	2695	2695	0	RIGHT	A14a.EDF	A14	1
97	5772909	5772941	59	91	32	RIGHT	A14a.EDF	A14	1
97	5772967	5772967	117	117	0	RIGHT	A14a.EDF	A14	1
98	5778840	5778880	59	99	40	RIGHT	A14a.EDF	A14	1
98	5779392	5779394	611	613	2	RIGHT	A14a.EDF	A14	1
98	5779419	5779504	638	723	85	RIGHT	A14a.EDF	A14	1
98	5779535	5779540	754	759	5	RIGHT	A14a.EDF	A14	1
99	5784508	5784637	310	439	129	RIGHT	A14a.EDF	A14	1
99	5786104	5786104	1906	1906	0	RIGHT	A14a.EDF	A14	1
100	5791033	5791036	473	476	3	RIGHT	A14a.EDF	A14	1
100	5791059	5791166	499	606	107	RIGHT	A14a.EDF	A14	1
100	5791194	5791196	634	636	2	RIGHT	A14a.EDF	A14	1
100	5792455	5792455	1895	1895	0	RIGHT	A14a.EDF	A14	1
100	5793709	5793729	3149	3169	20	RIGHT	A14a.EDF	A14	1
101	5799318	5799318	2713	2713	0	RIGHT	A14a.EDF	A14	1
102	5802830	5802951	122	243	121	RIGHT	A14a.EDF	A14	1
103	5808620	5808652	57	89	32	RIGHT	A14a.EDF	A14	1
103	5808676	5808678	113	115	2	RIGHT	A14a.EDF	A14	1
103	5809231	5809234	668	671	3	RIGHT	A14a.EDF	A14	1
103	5809435	5809472	872	909	37	RIGHT	A14a.EDF	A14	1
104	5814054	5814055	353	354	1	RIGHT	A14a.EDF	A14	1
104	5814093	5814104	392	403	11	RIGHT	A14a.EDF	A14	1
104	5814142	5814145	441	444	3	RIGHT	A14a.EDF	A14	1
105	5819036	5819074	59	97	38	RIGHT	A14a.EDF	A14	1
105	5819101	5819105	124	128	4	RIGHT	A14a.EDF	A14	1
106	5825079	5825117	198	236	38	RIGHT	A14a.EDF	A14	1
106	5825530	5825567	649	686	37	RIGHT	A14a.EDF	A14	1
107	5831809	5831897	126	214	88	RIGHT	A14a.EDF	A14	1
108	5837339	5837463	90	214	124	RIGHT	A14a.EDF	A14	1
109	5843056	5843070	97	111	14	RIGHT	A14a.EDF	A14	1
110	5849463	5849586	58	181	123	RIGHT	A14a.EDF	A14	1
111	5855074	5855074	145	145	0	RIGHT	A14a.EDF	A14	1
111	5855106	5855154	177	225	48	RIGHT	A14a.EDF	A14	1
111	5855179	5855180	250	251	1	RIGHT	A14a.EDF	A14	1
111	5855628	5855719	699	790	91	RIGHT	A14a.EDF	A14	1
112	5860410	5860514	60	164	104	RIGHT	A14a.EDF	A14	1
112	5860894	5861037	544	687	143	RIGHT	A14a.EDF	A14	1
113	5868018	5868032	2138	2152	14	RIGHT	A14a.EDF	A14	1
114	5871504	5871939	58	493	435	RIGHT	A14a.EDF	A14	1
114	5871960	5871961	514	515	1	RIGHT	A14a.EDF	A14	1
115	5876630	5876634	75	79	4	RIGHT	A14a.EDF	A14	1
117	5887046	5887046	77	77	0	RIGHT	A14a.EDF	A14	1
117	5887077	5887115	108	146	38	RIGHT	A14a.EDF	A14	1
117	5887140	5887146	171	177	6	RIGHT	A14a.EDF	A14	1
118	5892585	5892592	99	106	7	RIGHT	A14a.EDF	A14	1
118	5892785	5892808	299	322	23	RIGHT	A14a.EDF	A14	1
120	5904064	5904120	533	589	56	RIGHT	A14a.EDF	A14	1
120	5904148	5904152	617	621	4	RIGHT	A14a.EDF	A14	1
3	6126546	6126577	98	129	31	RIGHT	A14b.EDF	A14	2
3	6126762	6126764	314	316	2	RIGHT	A14b.EDF	A14	2
3	6126792	6126814	344	366	22	RIGHT	A14b.EDF	A14	2
3	6126840	6126843	392	395	3	RIGHT	A14b.EDF	A14	2
5	6137750	6137778	58	86	28	RIGHT	A14b.EDF	A14	2
6	6144118	6144187	632	701	69	RIGHT	A14b.EDF	A14	2
6	6144599	6144675	1113	1189	76	RIGHT	A14b.EDF	A14	2
6	6144698	6144699	1212	1213	1	RIGHT	A14b.EDF	A14	2
7	6150584	6150662	688	766	78	RIGHT	A14b.EDF	A14	2
8	6155388	6155423	86	121	35	RIGHT	A14b.EDF	A14	2
8	6155795	6155916	493	614	121	RIGHT	A14b.EDF	A14	2
9	6161704	6161770	113	179	66	RIGHT	A14b.EDF	A14	2
9	6162337	6162439	746	848	102	RIGHT	A14b.EDF	A14	2
10	6168293	6168325	193	225	32	RIGHT	A14b.EDF	A14	2
10	6168717	6168765	617	665	48	RIGHT	A14b.EDF	A14	2
12	6181564	6181612	565	613	48	RIGHT	A14b.EDF	A14	2
13	6187612	6187648	1138	1174	36	RIGHT	A14b.EDF	A14	2
18	6214812	6214934	330	452	122	RIGHT	A14b.EDF	A14	2
21	6233086	6233094	628	636	8	RIGHT	A14b.EDF	A14	2
21	6233140	6233179	682	721	39	RIGHT	A14b.EDF	A14	2
21	6233210	6233220	752	762	10	RIGHT	A14b.EDF	A14	2
26	6261256	6261276	97	117	20	RIGHT	A14b.EDF	A14	2
26	6261325	6261334	166	175	9	RIGHT	A14b.EDF	A14	2
26	6261358	6261407	199	248	49	RIGHT	A14b.EDF	A14	2
26	6261430	6261437	271	278	7	RIGHT	A14b.EDF	A14	2
29	6277345	6277449	101	205	104	RIGHT	A14b.EDF	A14	2
31	6289447	6289566	485	604	119	RIGHT	A14b.EDF	A14	2
32	6294931	6294942	87	98	11	RIGHT	A14b.EDF	A14	2
32	6295079	6295085	235	241	6	RIGHT	A14b.EDF	A14	2
32	6295110	6295147	266	303	37	RIGHT	A14b.EDF	A14	2
32	6295174	6295180	330	336	6	RIGHT	A14b.EDF	A14	2
40	6339862	6339872	688	698	10	RIGHT	A14b.EDF	A14	2
40	6340001	6340013	827	839	12	RIGHT	A14b.EDF	A14	2
42	6351977	6351982	2033	2038	5	RIGHT	A14b.EDF	A14	2
42	6352964	6352964	3020	3020	0	RIGHT	A14b.EDF	A14	2
44	6362192	6362242	572	622	50	RIGHT	A14b.EDF	A14	2
44	6362275	6362286	655	666	11	RIGHT	A14b.EDF	A14	2
45	6366914	6366930	131	147	16	RIGHT	A14b.EDF	A14	2
45	6367313	6367384	530	601	71	RIGHT	A14b.EDF	A14	2
46	6373424	6373426	599	601	2	RIGHT	A14b.EDF	A14	2
46	6373475	6373571	650	746	96	RIGHT	A14b.EDF	A14	2
46	6373593	6373601	768	776	8	RIGHT	A14b.EDF	A14	2
47	6378850	6378856	603	609	6	RIGHT	A14b.EDF	A14	2
47	6378884	6378998	637	751	114	RIGHT	A14b.EDF	A14	2
47	6379050	6379060	803	813	10	RIGHT	A14b.EDF	A14	2
51	6403650	6403671	2757	2778	21	RIGHT	A14b.EDF	A14	2
52	6409075	6409075	2619	2619	0	RIGHT	A14b.EDF	A14	2
52	6409124	6409128	2668	2672	4	RIGHT	A14b.EDF	A14	2
56	6430954	6430993	93	132	39	RIGHT	A14b.EDF	A14	2
56	6431019	6431030	158	169	11	RIGHT	A14b.EDF	A14	2
58	6445639	6445665	2667	2693	26	RIGHT	A14b.EDF	A14	2
58	6445702	6445708	2730	2736	6	RIGHT	A14b.EDF	A14	2
59	6448765	6448775	219	229	10	RIGHT	A14b.EDF	A14	2
63	6473062	6473146	402	486	84	RIGHT	A14b.EDF	A14	2
63	6473169	6473172	509	512	3	RIGHT	A14b.EDF	A14	2
64	6478521	6478579	81	139	58	RIGHT	A14b.EDF	A14	2
65	6485060	6485081	502	523	21	RIGHT	A14b.EDF	A14	2
65	6485132	6485224	574	666	92	RIGHT	A14b.EDF	A14	2
65	6485254	6485278	696	720	24	RIGHT	A14b.EDF	A14	2
66	6490802	6490885	126	209	83	RIGHT	A14b.EDF	A14	2
66	6491324	6491327	648	651	3	RIGHT	A14b.EDF	A14	2
66	6491434	6491442	758	766	8	RIGHT	A14b.EDF	A14	2
70	6514568	6514575	546	553	7	RIGHT	A14b.EDF	A14	2
70	6514620	6514641	598	619	21	RIGHT	A14b.EDF	A14	2
74	6537459	6537470	86	97	11	RIGHT	A14b.EDF	A14	2
74	6537549	6537562	176	189	13	RIGHT	A14b.EDF	A14	2
74	6539118	6539143	1745	1770	25	RIGHT	A14b.EDF	A14	2
74	6539313	6539313	1940	1940	0	RIGHT	A14b.EDF	A14	2
74	6539339	6539378	1966	2005	39	RIGHT	A14b.EDF	A14	2
74	6539405	6539411	2032	2038	6	RIGHT	A14b.EDF	A14	2
77	6554010	6554037	257	284	27	RIGHT	A14b.EDF	A14	2
77	6554095	6554123	342	370	28	RIGHT	A14b.EDF	A14	2
78	6559515	6559573	76	134	58	RIGHT	A14b.EDF	A14	2
78	6559730	6559795	291	356	65	RIGHT	A14b.EDF	A14	2
80	6572149	6572157	79	87	8	RIGHT	A14b.EDF	A14	2
80	6572706	6572706	636	636	0	RIGHT	A14b.EDF	A14	2
80	6572769	6572772	699	702	3	RIGHT	A14b.EDF	A14	2
80	6574315	6574378	2245	2308	63	RIGHT	A14b.EDF	A14	2
81	6578102	6578110	188	196	8	RIGHT	A14b.EDF	A14	2
81	6578166	6578185	252	271	19	RIGHT	A14b.EDF	A14	2
81	6578518	6578518	604	604	0	RIGHT	A14b.EDF	A14	2
81	6578562	6578592	648	678	30	RIGHT	A14b.EDF	A14	2
81	6578626	6578633	712	719	7	RIGHT	A14b.EDF	A14	2
82	6584011	6584092	200	281	81	RIGHT	A14b.EDF	A14	2
82	6584514	6584531	703	720	17	RIGHT	A14b.EDF	A14	2
82	6584637	6584656	826	845	19	RIGHT	A14b.EDF	A14	2
83	6590228	6590252	121	145	24	RIGHT	A14b.EDF	A14	2
83	6590330	6590350	223	243	20	RIGHT	A14b.EDF	A14	2
84	6596503	6596547	517	561	44	RIGHT	A14b.EDF	A14	2
84	6596584	6596595	598	609	11	RIGHT	A14b.EDF	A14	2
85	6602200	6602215	341	356	15	RIGHT	A14b.EDF	A14	2
85	6602243	6602265	384	406	22	RIGHT	A14b.EDF	A14	2
86	6608546	6608548	600	602	2	RIGHT	A14b.EDF	A14	2
86	6608639	6608674	693	728	35	RIGHT	A14b.EDF	A14	2
86	6608712	6608739	766	793	27	RIGHT	A14b.EDF	A14	2
88	6621677	6621684	458	465	7	RIGHT	A14b.EDF	A14	2
88	6621712	6621822	493	603	110	RIGHT	A14b.EDF	A14	2
90	6632181	6632213	58	90	32	RIGHT	A14b.EDF	A14	2
91	6637933	6637969	345	381	36	RIGHT	A14b.EDF	A14	2
91	6637991	6637996	403	408	5	RIGHT	A14b.EDF	A14	2
92	6642549	6642552	131	134	3	RIGHT	A14b.EDF	A14	2
92	6642609	6642647	191	229	38	RIGHT	A14b.EDF	A14	2
93	6649133	6649175	100	142	42	RIGHT	A14b.EDF	A14	2
93	6649202	6649214	169	181	12	RIGHT	A14b.EDF	A14	2
93	6649793	6649865	760	832	72	RIGHT	A14b.EDF	A14	2
95	6660789	6660866	122	199	77	RIGHT	A14b.EDF	A14	2
96	6666478	6666500	58	80	22	RIGHT	A14b.EDF	A14	2
96	6667058	6667069	638	649	11	RIGHT	A14b.EDF	A14	2
96	6667143	6667158	723	738	15	RIGHT	A14b.EDF	A14	2
98	6678571	6678591	272	292	20	RIGHT	A14b.EDF	A14	2
98	6678641	6678668	342	369	27	RIGHT	A14b.EDF	A14	2
102	6700671	6700705	73	107	34	RIGHT	A14b.EDF	A14	2
102	6701142	6701152	544	554	10	RIGHT	A14b.EDF	A14	2
102	6701177	6701244	579	646	67	RIGHT	A14b.EDF	A14	2
102	6701292	6701303	694	705	11	RIGHT	A14b.EDF	A14	2
104	6712682	6712700	560	578	18	RIGHT	A14b.EDF	A14	2
112	6759074	6759120	176	222	46	RIGHT	A14b.EDF	A14	2
112	6759554	6759640	656	742	86	RIGHT	A14b.EDF	A14	2
114	6771085	6771205	531	651	120	RIGHT	A14b.EDF	A14	2
1	7224367	7224373	2378	2384	6	RIGHT	A14c.EDF	A14	3
1	7224402	7224418	2413	2429	16	RIGHT	A14c.EDF	A14	3
2	7229998	7230033	58	93	35	RIGHT	A14c.EDF	A14	3
3	7236890	7236893	410	413	3	RIGHT	A14c.EDF	A14	3
3	7236916	7237008	436	528	92	RIGHT	A14c.EDF	A14	3
3	7237033	7237040	553	560	7	RIGHT	A14c.EDF	A14	3
3	7238869	7238906	2389	2426	37	RIGHT	A14c.EDF	A14	3
3	7238928	7238935	2448	2455	7	RIGHT	A14c.EDF	A14	3
6	7253679	7253695	68	84	16	RIGHT	A14c.EDF	A14	3
6	7253727	7253807	116	196	80	RIGHT	A14c.EDF	A14	3
6	7254132	7254148	521	537	16	RIGHT	A14c.EDF	A14	3
6	7254176	7254330	565	719	154	RIGHT	A14c.EDF	A14	3
6	7254356	7254377	745	766	21	RIGHT	A14c.EDF	A14	3
7	7262879	7262915	2641	2677	36	RIGHT	A14c.EDF	A14	3
7	7263346	7263411	3108	3173	65	RIGHT	A14c.EDF	A14	3
7	7263433	7263440	3195	3202	7	RIGHT	A14c.EDF	A14	3
8	7267701	7267743	1862	1904	42	RIGHT	A14c.EDF	A14	3
8	7267768	7267779	1929	1940	11	RIGHT	A14c.EDF	A14	3
10	7279300	7279318	2831	2849	18	RIGHT	A14c.EDF	A14	3
10	7279353	7279360	2884	2891	7	RIGHT	A14c.EDF	A14	3
11	7284353	7284371	2237	2255	18	RIGHT	A14c.EDF	A14	3
14	7298848	7298934	70	156	86	RIGHT	A14c.EDF	A14	3
14	7299280	7299287	502	509	7	RIGHT	A14c.EDF	A14	3
14	7299334	7299374	556	596	40	RIGHT	A14c.EDF	A14	3
14	7299411	7299427	633	649	16	RIGHT	A14c.EDF	A14	3
17	7316630	7316798	430	598	168	RIGHT	A14c.EDF	A14	3
18	7322712	7322714	545	547	2	RIGHT	A14c.EDF	A14	3
18	7322749	7322799	582	632	50	RIGHT	A14c.EDF	A14	3
19	7327859	7327992	67	200	133	RIGHT	A14c.EDF	A14	3
19	7328022	7328047	230	255	25	RIGHT	A14c.EDF	A14	3
21	7339001	7339194	362	555	193	RIGHT	A14c.EDF	A14	3
21	7339222	7339230	583	591	8	RIGHT	A14c.EDF	A14	3
22	7344470	7344490	597	617	20	RIGHT	A14c.EDF	A14	3
22	7344535	7344620	662	747	85	RIGHT	A14c.EDF	A14	3
22	7344643	7344670	770	797	27	RIGHT	A14c.EDF	A14	3
22	7345490	7345535	1617	1662	45	RIGHT	A14c.EDF	A14	3
22	7345563	7345576	1690	1703	13	RIGHT	A14c.EDF	A14	3
24	7355767	7355768	136	137	1	RIGHT	A14c.EDF	A14	3
25	7363603	7363611	2635	2643	8	RIGHT	A14c.EDF	A14	3
25	7363659	7363669	2691	2701	10	RIGHT	A14c.EDF	A14	3
29	7384168	7384199	57	88	31	RIGHT	A14c.EDF	A14	3
29	7384233	7384250	122	139	17	RIGHT	A14c.EDF	A14	3
30	7390160	7390168	650	658	8	RIGHT	A14c.EDF	A14	3
30	7390203	7390250	693	740	47	RIGHT	A14c.EDF	A14	3
30	7390277	7390291	767	781	14	RIGHT	A14c.EDF	A14	3
31	7396331	7396338	1374	1381	7	RIGHT	A14c.EDF	A14	3
31	7396362	7396406	1405	1449	44	RIGHT	A14c.EDF	A14	3
31	7396428	7396435	1471	1478	7	RIGHT	A14c.EDF	A14	3
32	7401236	7401254	691	709	18	RIGHT	A14c.EDF	A14	3
32	7401288	7401386	743	841	98	RIGHT	A14c.EDF	A14	3
32	7401413	7401423	868	878	10	RIGHT	A14c.EDF	A14	3
33	7406434	7406451	125	142	17	RIGHT	A14c.EDF	A14	3
33	7406479	7406619	170	310	140	RIGHT	A14c.EDF	A14	3
33	7406640	7406663	331	354	23	RIGHT	A14c.EDF	A14	3
37	7429638	7429649	494	505	11	RIGHT	A14c.EDF	A14	3
37	7429714	7429731	570	587	17	RIGHT	A14c.EDF	A14	3
37	7431732	7431739	2588	2595	7	RIGHT	A14c.EDF	A14	3
38	7435527	7435548	427	448	21	RIGHT	A14c.EDF	A14	3
38	7435652	7435670	552	570	18	RIGHT	A14c.EDF	A14	3
39	7441406	7441523	368	485	117	RIGHT	A14c.EDF	A14	3
39	7441549	7441558	511	520	9	RIGHT	A14c.EDF	A14	3
40	7446858	7446865	516	523	7	RIGHT	A14c.EDF	A14	3
40	7446958	7446972	616	630	14	RIGHT	A14c.EDF	A14	3
42	7459100	7459121	805	826	21	RIGHT	A14c.EDF	A14	3
42	7459184	7459193	889	898	9	RIGHT	A14c.EDF	A14	3
45	7475829	7476000	448	619	171	RIGHT	A14c.EDF	A14	3
46	7481910	7481926	666	682	16	RIGHT	A14c.EDF	A14	3
46	7481979	7482003	735	759	24	RIGHT	A14c.EDF	A14	3
47	7487188	7487201	74	87	13	RIGHT	A14c.EDF	A14	3
47	7487224	7487248	110	134	24	RIGHT	A14c.EDF	A14	3
48	7493183	7493184	239	240	1	RIGHT	A14c.EDF	A14	3
48	7493603	7493605	659	661	2	RIGHT	A14c.EDF	A14	3
48	7493696	7493708	752	764	12	RIGHT	A14c.EDF	A14	3
51	7510467	7510500	505	538	33	RIGHT	A14c.EDF	A14	3
51	7510562	7510615	600	653	53	RIGHT	A14c.EDF	A14	3
51	7510653	7510679	691	717	26	RIGHT	A14c.EDF	A14	3
55	7533937	7533947	460	470	10	RIGHT	A14c.EDF	A14	3
55	7534074	7534088	597	611	14	RIGHT	A14c.EDF	A14	3
56	7539779	7539929	59	209	150	RIGHT	A14c.EDF	A14	3
56	7539969	7540000	249	280	31	RIGHT	A14c.EDF	A14	3
56	7540095	7540100	375	380	5	RIGHT	A14c.EDF	A14	3
56	7540278	7540280	558	560	2	RIGHT	A14c.EDF	A14	3
56	7540312	7540398	592	678	86	RIGHT	A14c.EDF	A14	3
56	7540444	7540457	724	737	13	RIGHT	A14c.EDF	A14	3
57	7546310	7546346	339	375	36	RIGHT	A14c.EDF	A14	3
57	7546417	7546446	446	475	29	RIGHT	A14c.EDF	A14	3
58	7552364	7552382	275	293	18	RIGHT	A14c.EDF	A14	3
58	7552473	7552535	384	446	62	RIGHT	A14c.EDF	A14	3
58	7552560	7552575	471	486	15	RIGHT	A14c.EDF	A14	3
59	7558880	7558888	477	485	8	RIGHT	A14c.EDF	A14	3
59	7559017	7559027	614	624	10	RIGHT	A14c.EDF	A14	3
61	7569622	7569679	378	435	57	RIGHT	A14c.EDF	A14	3
62	7575058	7575073	445	460	15	RIGHT	A14c.EDF	A14	3
62	7575109	7575246	496	633	137	RIGHT	A14c.EDF	A14	3
62	7575284	7575309	671	696	25	RIGHT	A14c.EDF	A14	3
63	7580946	7580964	532	550	18	RIGHT	A14c.EDF	A14	3
63	7581007	7581088	593	674	81	RIGHT	A14c.EDF	A14	3
63	7581145	7581172	731	758	27	RIGHT	A14c.EDF	A14	3
64	7586605	7586637	506	538	32	RIGHT	A14c.EDF	A14	3
64	7586819	7586856	720	757	37	RIGHT	A14c.EDF	A14	3
66	7599361	7599402	868	909	41	RIGHT	A14c.EDF	A14	3
66	7599468	7599480	975	987	12	RIGHT	A14c.EDF	A14	3
67	7604112	7604174	202	264	62	RIGHT	A14c.EDF	A14	3
67	7604463	7604467	553	557	4	RIGHT	A14c.EDF	A14	3
67	7604560	7604576	650	666	16	RIGHT	A14c.EDF	A14	3
69	7615730	7615767	138	175	37	RIGHT	A14c.EDF	A14	3
69	7616273	7616294	681	702	21	RIGHT	A14c.EDF	A14	3
69	7616378	7616404	786	812	26	RIGHT	A14c.EDF	A14	3
70	7622961	7622965	832	836	4	RIGHT	A14c.EDF	A14	3
70	7623012	7623031	883	902	19	RIGHT	A14c.EDF	A14	3
71	7629093	7629095	381	383	2	RIGHT	A14c.EDF	A14	3
71	7629132	7629220	420	508	88	RIGHT	A14c.EDF	A14	3
71	7629269	7629290	557	578	21	RIGHT	A14c.EDF	A14	3
72	7634875	7634960	82	167	85	RIGHT	A14c.EDF	A14	3
72	7635310	7635323	517	530	13	RIGHT	A14c.EDF	A14	3
72	7635430	7635449	637	656	19	RIGHT	A14c.EDF	A14	3
73	7641045	7641188	424	567	143	RIGHT	A14c.EDF	A14	3
73	7641233	7641257	612	636	24	RIGHT	A14c.EDF	A14	3
82	7693099	7693142	58	101	43	RIGHT	A14c.EDF	A14	3
82	7693470	7693479	429	438	9	RIGHT	A14c.EDF	A14	3
82	7693509	7693638	468	597	129	RIGHT	A14c.EDF	A14	3
82	7693684	7693708	643	667	24	RIGHT	A14c.EDF	A14	3
83	7699082	7699106	68	92	24	RIGHT	A14c.EDF	A14	3
83	7699170	7699229	156	215	59	RIGHT	A14c.EDF	A14	3
84	7705463	7705570	711	818	107	RIGHT	A14c.EDF	A14	3
84	7705638	7705715	886	963	77	RIGHT	A14c.EDF	A14	3
84	7705760	7705768	1008	1016	8	RIGHT	A14c.EDF	A14	3
85	7710299	7710320	64	85	21	RIGHT	A14c.EDF	A14	3
86	7716890	7716913	1108	1131	23	RIGHT	A14c.EDF	A14	3
93	7755596	7755684	458	546	88	RIGHT	A14c.EDF	A14	3
94	7761479	7761543	569	633	64	RIGHT	A14c.EDF	A14	3
101	7800488	7800566	508	586	78	RIGHT	A14c.EDF	A14	3
102	7806803	7806829	399	425	26	RIGHT	A14c.EDF	A14	3
102	7806919	7806953	515	549	34	RIGHT	A14c.EDF	A14	3
102	7807075	7807083	671	679	8	RIGHT	A14c.EDF	A14	3
102	7807114	7807163	710	759	49	RIGHT	A14c.EDF	A14	3
102	7807194	7807206	790	802	12	RIGHT	A14c.EDF	A14	3
103	7812173	7812180	418	425	7	RIGHT	A14c.EDF	A14	3
103	7812275	7812293	520	538	18	RIGHT	A14c.EDF	A14	3
104	7818062	7818068	719	725	6	RIGHT	A14c.EDF	A14	3
104	7818101	7818176	758	833	75	RIGHT	A14c.EDF	A14	3
104	7818212	7818222	869	879	10	RIGHT	A14c.EDF	A14	3
105	7823589	7823600	414	425	11	RIGHT	A14c.EDF	A14	3
105	7823625	7823764	450	589	139	RIGHT	A14c.EDF	A14	3
105	7823791	7823802	616	627	11	RIGHT	A14c.EDF	A14	3
107	7834518	7834597	99	178	79	RIGHT	A14c.EDF	A14	3
107	7834637	7834665	218	246	28	RIGHT	A14c.EDF	A14	3
107	7835207	7835254	788	835	47	RIGHT	A14c.EDF	A14	3
107	7835301	7835318	882	899	17	RIGHT	A14c.EDF	A14	3
111	7857307	7857308	286	287	1	RIGHT	A14c.EDF	A14	3
111	7857350	7857359	329	338	9	RIGHT	A14c.EDF	A14	3
112	7862483	7862556	57	130	73	RIGHT	A14c.EDF	A14	3
112	7862590	7862620	164	194	30	RIGHT	A14c.EDF	A14	3
113	7867740	7867822	146	228	82	RIGHT	A14c.EDF	A14	3
113	7867871	7867906	277	312	35	RIGHT	A14c.EDF	A14	3
114	7873787	7873808	451	472	21	RIGHT	A14c.EDF	A14	3
114	7873875	7873889	539	553	14	RIGHT	A14c.EDF	A14	3
114	7874200	7874211	864	875	11	RIGHT	A14c.EDF	A14	3
114	7874235	7874330	899	994	95	RIGHT	A14c.EDF	A14	3
114	7874364	7874387	1028	1051	23	RIGHT	A14c.EDF	A14	3
116	7885013	7885028	93	108	15	RIGHT	A14c.EDF	A14	3
116	7885435	7885440	515	520	5	RIGHT	A14c.EDF	A14	3
116	7885485	7885561	565	641	76	RIGHT	A14c.EDF	A14	3
116	7885597	7885614	677	694	17	RIGHT	A14c.EDF	A14	3
118	7897056	7897058	137	139	2	RIGHT	A14c.EDF	A14	3
118	7897084	7897181	165	262	97	RIGHT	A14c.EDF	A14	3
1	6259425	6259726	4863	5164	301	RIGHT	A18.EDF	A18	.
1	6260572	6260811	6010	6249	239	RIGHT	A18.EDF	A18	.
2	6271353	6271634	57	338	281	RIGHT	A18.EDF	A18	.
2	6272123	6272498	827	1202	375	RIGHT	A18.EDF	A18	.
2	6272784	6273247	1488	1951	463	RIGHT	A18.EDF	A18	.
2	6276362	6276671	5066	5375	309	RIGHT	A18.EDF	A18	.
3	6279137	6279482	224	569	345	RIGHT	A18.EDF	A18	.
3	6279515	6279551	602	638	36	RIGHT	A18.EDF	A18	.
3	6279771	6280413	858	1500	642	RIGHT	A18.EDF	A18	.
3	6280456	6280529	1543	1616	73	RIGHT	A18.EDF	A18	.
3	6282804	6283391	3891	4478	587	RIGHT	A18.EDF	A18	.
3	6283421	6283469	4508	4556	48	RIGHT	A18.EDF	A18	.
4	6286734	6287073	57	396	339	RIGHT	A18.EDF	A18	.
4	6287119	6287210	442	533	91	RIGHT	A18.EDF	A18	.
4	6290066	6290335	3389	3658	269	RIGHT	A18.EDF	A18	.
4	6290360	6290378	3683	3701	18	RIGHT	A18.EDF	A18	.
4	6290834	6291251	4157	4574	417	RIGHT	A18.EDF	A18	.
5	6294905	6295122	58	275	217	RIGHT	A18.EDF	A18	.
5	6295144	6295184	297	337	40	RIGHT	A18.EDF	A18	.
5	6295207	6295295	360	448	88	RIGHT	A18.EDF	A18	.
5	6295422	6296142	575	1295	720	RIGHT	A18.EDF	A18	.
5	6296278	6296280	1431	1433	2	RIGHT	A18.EDF	A18	.
5	6296308	6296314	1461	1467	6	RIGHT	A18.EDF	A18	.
5	6296354	6296355	1507	1508	1	RIGHT	A18.EDF	A18	.
5	6296377	6296404	1530	1557	27	RIGHT	A18.EDF	A18	.
5	6296755	6296755	1908	1908	0	RIGHT	A18.EDF	A18	.
5	6296777	6297165	1930	2318	388	RIGHT	A18.EDF	A18	.
5	6297215	6297239	2368	2392	24	RIGHT	A18.EDF	A18	.
5	6297918	6298378	3071	3531	460	RIGHT	A18.EDF	A18	.
6	6303040	6303423	57	440	383	RIGHT	A18.EDF	A18	.
6	6306498	6306761	3515	3778	263	RIGHT	A18.EDF	A18	.
6	6306840	6307970	3857	4987	1130	RIGHT	A18.EDF	A18	.
7	6309637	6309930	58	351	293	RIGHT	A18.EDF	A18	.
7	6309961	6310128	382	549	167	RIGHT	A18.EDF	A18	.
7	6315186	6315607	5607	6028	421	RIGHT	A18.EDF	A18	.
7	6315977	6316290	6398	6711	313	RIGHT	A18.EDF	A18	.
7	6316358	6316596	6779	7017	238	RIGHT	A18.EDF	A18	.
8	6318639	6318693	58	112	54	RIGHT	A18.EDF	A18	.
8	6318747	6319716	166	1135	969	RIGHT	A18.EDF	A18	.
8	6319741	6320027	1160	1446	286	RIGHT	A18.EDF	A18	.
8	6321368	6321691	2787	3110	323	RIGHT	A18.EDF	A18	.
8	6321741	6321937	3160	3356	196	RIGHT	A18.EDF	A18	.
8	6323500	6323914	4919	5333	414	RIGHT	A18.EDF	A18	.
8	6323938	6324165	5357	5584	227	RIGHT	A18.EDF	A18	.
9	6326393	6326618	58	283	225	RIGHT	A18.EDF	A18	.
9	6326664	6326939	329	604	275	RIGHT	A18.EDF	A18	.
9	6327338	6327908	1003	1573	570	RIGHT	A18.EDF	A18	.
9	6328012	6328084	1677	1749	72	RIGHT	A18.EDF	A18	.
9	6329119	6329128	2784	2793	9	RIGHT	A18.EDF	A18	.
9	6329149	6329427	2814	3092	278	RIGHT	A18.EDF	A18	.
9	6329451	6329451	3116	3116	0	RIGHT	A18.EDF	A18	.
9	6329475	6329707	3140	3372	232	RIGHT	A18.EDF	A18	.
9	6330346	6331127	4011	4792	781	RIGHT	A18.EDF	A18	.
9	6331213	6331337	4878	5002	124	RIGHT	A18.EDF	A18	.
9	6331364	6331858	5029	5523	494	RIGHT	A18.EDF	A18	.
10	6335189	6335484	57	352	295	RIGHT	A18.EDF	A18	.
10	6335524	6335525	392	393	1	RIGHT	A18.EDF	A18	.
10	6335904	6335935	772	803	31	RIGHT	A18.EDF	A18	.
10	6338614	6338621	3482	3489	7	RIGHT	A18.EDF	A18	.
10	6338642	6338930	3510	3798	288	RIGHT	A18.EDF	A18	.
10	6338985	6339150	3853	4018	165	RIGHT	A18.EDF	A18	.
11	6342479	6342618	58	197	139	RIGHT	A18.EDF	A18	.
11	6342645	6342668	224	247	23	RIGHT	A18.EDF	A18	.
11	6342698	6343155	277	734	457	RIGHT	A18.EDF	A18	.
11	6343246	6343377	825	956	131	RIGHT	A18.EDF	A18	.
11	6343913	6343917	1492	1496	4	RIGHT	A18.EDF	A18	.
11	6343941	6344614	1520	2193	673	RIGHT	A18.EDF	A18	.
11	6344736	6344737	2315	2316	1	RIGHT	A18.EDF	A18	.
11	6344760	6344761	2339	2340	1	RIGHT	A18.EDF	A18	.
11	6344808	6345062	2387	2641	254	RIGHT	A18.EDF	A18	.
12	6349923	6350096	57	230	173	RIGHT	A18.EDF	A18	.
12	6350140	6350151	274	285	11	RIGHT	A18.EDF	A18	.
12	6350173	6350293	307	427	120	RIGHT	A18.EDF	A18	.
12	6351032	6351731	1166	1865	699	RIGHT	A18.EDF	A18	.
12	6351756	6352234	1890	2368	478	RIGHT	A18.EDF	A18	.
12	6352920	6353343	3054	3477	423	RIGHT	A18.EDF	A18	.
12	6354086	6354624	4220	4758	538	RIGHT	A18.EDF	A18	.
13	6357201	6357503	58	360	302	RIGHT	A18.EDF	A18	.
13	6359600	6360160	2457	3017	560	RIGHT	A18.EDF	A18	.
13	6360195	6360212	3052	3069	17	RIGHT	A18.EDF	A18	.
13	6361166	6361425	4023	4282	259	RIGHT	A18.EDF	A18	.
13	6361504	6361516	4361	4373	12	RIGHT	A18.EDF	A18	.
13	6361566	6361587	4423	4444	21	RIGHT	A18.EDF	A18	.
13	6362064	6362509	4921	5366	445	RIGHT	A18.EDF	A18	.
14	6364789	6365328	485	1024	539	RIGHT	A18.EDF	A18	.
14	6368569	6368731	4265	4427	162	RIGHT	A18.EDF	A18	.
14	6368765	6368883	4461	4579	118	RIGHT	A18.EDF	A18	.
14	6369360	6369728	5056	5424	368	RIGHT	A18.EDF	A18	.
14	6369755	6369908	5451	5604	153	RIGHT	A18.EDF	A18	.
15	6373116	6373515	58	457	399	RIGHT	A18.EDF	A18	.
15	6373559	6373691	501	633	132	RIGHT	A18.EDF	A18	.
15	6375454	6376053	2396	2995	599	RIGHT	A18.EDF	A18	.
15	6376098	6376449	3040	3391	351	RIGHT	A18.EDF	A18	.
16	6380887	6380945	60	118	58	RIGHT	A18.EDF	A18	.
16	6381115	6381781	288	954	666	RIGHT	A18.EDF	A18	.
16	6381935	6381935	1108	1108	0	RIGHT	A18.EDF	A18	.
16	6381971	6381988	1144	1161	17	RIGHT	A18.EDF	A18	.
16	6382009	6382179	1182	1352	170	RIGHT	A18.EDF	A18	.
16	6383219	6383532	2392	2705	313	RIGHT	A18.EDF	A18	.
16	6383933	6383935	3106	3108	2	RIGHT	A18.EDF	A18	.
16	6383959	6384212	3132	3385	253	RIGHT	A18.EDF	A18	.
16	6384248	6384265	3421	3438	17	RIGHT	A18.EDF	A18	.
16	6384372	6384406	3545	3579	34	RIGHT	A18.EDF	A18	.
16	6384809	6385354	3982	4527	545	RIGHT	A18.EDF	A18	.
16	6385386	6385484	4559	4657	98	RIGHT	A18.EDF	A18	.
16	6385508	6385863	4681	5036	355	RIGHT	A18.EDF	A18	.
17	6388656	6389130	57	531	474	RIGHT	A18.EDF	A18	.
17	6389389	6389529	790	930	140	RIGHT	A18.EDF	A18	.
17	6393496	6393504	4897	4905	8	RIGHT	A18.EDF	A18	.
17	6393525	6393626	4926	5027	101	RIGHT	A18.EDF	A18	.
17	6393658	6393695	5059	5096	37	RIGHT	A18.EDF	A18	.
17	6393716	6393768	5117	5169	52	RIGHT	A18.EDF	A18	.
18	6397281	6397988	58	765	707	RIGHT	A18.EDF	A18	.
18	6398041	6398042	818	819	1	RIGHT	A18.EDF	A18	.
18	6398095	6398121	872	898	26	RIGHT	A18.EDF	A18	.
18	6398144	6398279	921	1056	135	RIGHT	A18.EDF	A18	.
18	6399371	6399630	2148	2407	259	RIGHT	A18.EDF	A18	.
18	6399671	6399760	2448	2537	89	RIGHT	A18.EDF	A18	.
18	6399952	6400210	2729	2987	258	RIGHT	A18.EDF	A18	.
18	6400250	6400480	3027	3257	230	RIGHT	A18.EDF	A18	.
19	6405946	6406203	58	315	257	RIGHT	A18.EDF	A18	.
19	6406224	6406241	336	353	17	RIGHT	A18.EDF	A18	.
19	6406479	6406612	591	724	133	RIGHT	A18.EDF	A18	.
19	6407861	6408125	1973	2237	264	RIGHT	A18.EDF	A18	.
19	6408149	6408789	2261	2901	640	RIGHT	A18.EDF	A18	.
19	6408830	6408866	2942	2978	36	RIGHT	A18.EDF	A18	.
19	6408914	6408914	3026	3026	0	RIGHT	A18.EDF	A18	.
19	6409025	6409114	3137	3226	89	RIGHT	A18.EDF	A18	.
19	6409135	6409211	3247	3323	76	RIGHT	A18.EDF	A18	.
20	6413402	6413878	57	533	476	RIGHT	A18.EDF	A18	.
20	6413904	6413904	559	559	0	RIGHT	A18.EDF	A18	.
20	6414021	6414053	676	708	32	RIGHT	A18.EDF	A18	.
20	6415516	6416254	2171	2909	738	RIGHT	A18.EDF	A18	.
20	6416290	6416709	2945	3364	419	RIGHT	A18.EDF	A18	.
21	6421322	6421370	95	143	48	RIGHT	A18.EDF	A18	.
21	6422142	6422142	915	915	0	RIGHT	A18.EDF	A18	.
21	6422164	6422838	937	1611	674	RIGHT	A18.EDF	A18	.
21	6423099	6423203	1872	1976	104	RIGHT	A18.EDF	A18	.
21	6423248	6423253	2021	2026	5	RIGHT	A18.EDF	A18	.
21	6424384	6424740	3157	3513	356	RIGHT	A18.EDF	A18	.
21	6424772	6424970	3545	3743	198	RIGHT	A18.EDF	A18	.
21	6425425	6426053	4198	4826	628	RIGHT	A18.EDF	A18	.
21	6426100	6426150	4873	4923	50	RIGHT	A18.EDF	A18	.
21	6426198	6426518	4971	5291	320	RIGHT	A18.EDF	A18	.
22	6428200	6428638	58	496	438	RIGHT	A18.EDF	A18	.
22	6428687	6428729	545	587	42	RIGHT	A18.EDF	A18	.
22	6428764	6428766	622	624	2	RIGHT	A18.EDF	A18	.
22	6428847	6428848	705	706	1	RIGHT	A18.EDF	A18	.
22	6428870	6428870	728	728	0	RIGHT	A18.EDF	A18	.
22	6428919	6428919	777	777	0	RIGHT	A18.EDF	A18	.
22	6428947	6429121	805	979	174	RIGHT	A18.EDF	A18	.
22	6431270	6431273	3128	3131	3	RIGHT	A18.EDF	A18	.
22	6431295	6431818	3153	3676	523	RIGHT	A18.EDF	A18	.
22	6432322	6432634	4180	4492	312	RIGHT	A18.EDF	A18	.
23	6435897	6436286	58	447	389	RIGHT	A18.EDF	A18	.
23	6436840	6436900	1001	1061	60	RIGHT	A18.EDF	A18	.
23	6436923	6436992	1084	1153	69	RIGHT	A18.EDF	A18	.
23	6437033	6437043	1194	1204	10	RIGHT	A18.EDF	A18	.
23	6437071	6437078	1232	1239	7	RIGHT	A18.EDF	A18	.
23	6437099	6437100	1260	1261	1	RIGHT	A18.EDF	A18	.
23	6437136	6437310	1297	1471	174	RIGHT	A18.EDF	A18	.
23	6437596	6437606	1757	1767	10	RIGHT	A18.EDF	A18	.
23	6437843	6438001	2004	2162	158	RIGHT	A18.EDF	A18	.
23	6438024	6439096	2185	3257	1072	RIGHT	A18.EDF	A18	.
23	6439130	6439409	3291	3570	279	RIGHT	A18.EDF	A18	.
23	6439456	6440399	3617	4560	943	RIGHT	A18.EDF	A18	.
23	6440427	6440461	4588	4622	34	RIGHT	A18.EDF	A18	.
23	6440485	6440622	4646	4783	137	RIGHT	A18.EDF	A18	.
24	6442028	6442646	57	675	618	RIGHT	A18.EDF	A18	.
24	6443248	6443337	1277	1366	89	RIGHT	A18.EDF	A18	.
24	6443365	6443366	1394	1395	1	RIGHT	A18.EDF	A18	.
24	6443404	6443446	1433	1475	42	RIGHT	A18.EDF	A18	.
24	6443536	6443537	1565	1566	1	RIGHT	A18.EDF	A18	.
24	6443637	6444010	1666	2039	373	RIGHT	A18.EDF	A18	.
24	6446344	6446391	4373	4420	47	RIGHT	A18.EDF	A18	.
24	6446418	6446603	4447	4632	185	RIGHT	A18.EDF	A18	.
24	6446632	6446688	4661	4717	56	RIGHT	A18.EDF	A18	.
24	6446853	6447212	4882	5241	359	RIGHT	A18.EDF	A18	.
25	6451299	6451719	57	477	420	RIGHT	A18.EDF	A18	.
25	6451786	6451925	544	683	139	RIGHT	A18.EDF	A18	.
25	6451957	6452583	715	1341	626	RIGHT	A18.EDF	A18	.
25	6454069	6454832	2827	3590	763	RIGHT	A18.EDF	A18	.
25	6455516	6455819	4274	4577	303	RIGHT	A18.EDF	A18	.
25	6455933	6455934	4691	4692	1	RIGHT	A18.EDF	A18	.
25	6455963	6455982	4721	4740	19	RIGHT	A18.EDF	A18	.
25	6456069	6456144	4827	4902	75	RIGHT	A18.EDF	A18	.
25	6456167	6456167	4925	4925	0	RIGHT	A18.EDF	A18	.
25	6456207	6456215	4965	4973	8	RIGHT	A18.EDF	A18	.
26	6461679	6462365	658	1344	686	RIGHT	A18.EDF	A18	.
26	6463679	6463970	2658	2949	291	RIGHT	A18.EDF	A18	.
26	6464366	6464875	3345	3854	509	RIGHT	A18.EDF	A18	.
26	6464898	6464906	3877	3885	8	RIGHT	A18.EDF	A18	.
26	6464948	6465088	3927	4067	140	RIGHT	A18.EDF	A18	.
26	6465324	6465667	4303	4646	343	RIGHT	A18.EDF	A18	.
27	6467434	6467711	58	335	277	RIGHT	A18.EDF	A18	.
27	6467745	6468150	369	774	405	RIGHT	A18.EDF	A18	.
27	6468595	6468934	1219	1558	339	RIGHT	A18.EDF	A18	.
27	6468980	6469190	1604	1814	210	RIGHT	A18.EDF	A18	.
27	6469217	6469477	1841	2101	260	RIGHT	A18.EDF	A18	.
27	6470721	6471011	3345	3635	290	RIGHT	A18.EDF	A18	.
27	6471477	6471480	4101	4104	3	RIGHT	A18.EDF	A18	.
28	6474828	6475005	57	234	177	RIGHT	A18.EDF	A18	.
28	6475026	6475072	255	301	46	RIGHT	A18.EDF	A18	.
28	6475102	6475168	331	397	66	RIGHT	A18.EDF	A18	.
28	6476925	6477363	2154	2592	438	RIGHT	A18.EDF	A18	.
28	6477403	6477404	2632	2633	1	RIGHT	A18.EDF	A18	.
28	6477437	6477482	2666	2711	45	RIGHT	A18.EDF	A18	.
28	6477682	6477809	2911	3038	127	RIGHT	A18.EDF	A18	.
28	6477846	6477915	3075	3144	69	RIGHT	A18.EDF	A18	.
29	6481479	6481483	431	435	4	RIGHT	A18.EDF	A18	.
29	6481504	6481585	456	537	81	RIGHT	A18.EDF	A18	.
29	6481620	6481668	572	620	48	RIGHT	A18.EDF	A18	.
29	6481728	6482020	680	972	292	RIGHT	A18.EDF	A18	.
29	6484011	6484444	2963	3396	433	RIGHT	A18.EDF	A18	.
29	6484674	6484733	3626	3685	59	RIGHT	A18.EDF	A18	.
30	6489007	6489015	439	447	8	RIGHT	A18.EDF	A18	.
30	6489040	6489185	472	617	145	RIGHT	A18.EDF	A18	.
30	6489228	6489340	660	772	112	RIGHT	A18.EDF	A18	.
30	6490148	6490573	1580	2005	425	RIGHT	A18.EDF	A18	.
30	6490643	6490772	2075	2204	129	RIGHT	A18.EDF	A18	.
30	6491292	6491755	2724	3187	463	RIGHT	A18.EDF	A18	.
30	6491808	6492080	3240	3512	272	RIGHT	A18.EDF	A18	.
31	6494993	6495181	57	245	188	RIGHT	A18.EDF	A18	.
31	6495369	6495461	433	525	92	RIGHT	A18.EDF	A18	.
31	6495985	6496598	1049	1662	613	RIGHT	A18.EDF	A18	.
31	6497029	6497043	2093	2107	14	RIGHT	A18.EDF	A18	.
31	6501113	6501115	6177	6179	2	RIGHT	A18.EDF	A18	.
31	6501143	6501242	6207	6306	99	RIGHT	A18.EDF	A18	.
31	6501383	6501434	6447	6498	51	RIGHT	A18.EDF	A18	.
31	6501574	6501577	6638	6641	3	RIGHT	A18.EDF	A18	.
31	6501599	6501774	6663	6838	175	RIGHT	A18.EDF	A18	.
31	6501949	6502044	7013	7108	95	RIGHT	A18.EDF	A18	.
32	6503944	6503979	57	92	35	RIGHT	A18.EDF	A18	.
32	6504426	6504880	539	993	454	RIGHT	A18.EDF	A18	.
32	6505098	6505099	1211	1212	1	RIGHT	A18.EDF	A18	.
32	6505180	6505181	1293	1294	1	RIGHT	A18.EDF	A18	.
32	6505232	6505232	1345	1345	0	RIGHT	A18.EDF	A18	.
32	6506333	6506910	2446	3023	577	RIGHT	A18.EDF	A18	.
32	6507099	6507153	3212	3266	54	RIGHT	A18.EDF	A18	.
32	6507181	6507357	3294	3470	176	RIGHT	A18.EDF	A18	.
33	6511122	6511630	130	638	508	RIGHT	A18.EDF	A18	.
33	6512135	6512658	1143	1666	523	RIGHT	A18.EDF	A18	.
33	6513505	6513939	2513	2947	434	RIGHT	A18.EDF	A18	.
34	6517503	6517835	58	390	332	RIGHT	A18.EDF	A18	.
34	6519880	6520144	2435	2699	264	RIGHT	A18.EDF	A18	.
34	6520284	6520324	2839	2879	40	RIGHT	A18.EDF	A18	.
34	6521433	6521697	3988	4252	264	RIGHT	A18.EDF	A18	.
34	6521750	6521812	4305	4367	62	RIGHT	A18.EDF	A18	.
34	6521845	6521845	4400	4400	0	RIGHT	A18.EDF	A18	.
34	6521866	6521923	4421	4478	57	RIGHT	A18.EDF	A18	.
34	6523171	6523403	5726	5958	232	RIGHT	A18.EDF	A18	.
34	6523443	6523608	5998	6163	165	RIGHT	A18.EDF	A18	.
35	6525050	6525312	58	320	262	RIGHT	A18.EDF	A18	.
35	6525600	6525701	608	709	101	RIGHT	A18.EDF	A18	.
35	6526606	6526607	1614	1615	1	RIGHT	A18.EDF	A18	.
35	6526639	6526840	1647	1848	201	RIGHT	A18.EDF	A18	.
35	6526879	6527007	1887	2015	128	RIGHT	A18.EDF	A18	.
36	6533113	6533423	57	367	310	RIGHT	A18.EDF	A18	.
36	6533459	6533664	403	608	205	RIGHT	A18.EDF	A18	.
36	6535178	6535342	2122	2286	164	RIGHT	A18.EDF	A18	.
36	6535391	6535475	2335	2419	84	RIGHT	A18.EDF	A18	.
36	6535525	6536138	2469	3082	613	RIGHT	A18.EDF	A18	.
36	6538459	6538473	5403	5417	14	RIGHT	A18.EDF	A18	.
36	6538497	6538703	5441	5647	206	RIGHT	A18.EDF	A18	.
36	6538807	6538808	5751	5752	1	RIGHT	A18.EDF	A18	.
36	6538888	6538889	5832	5833	1	RIGHT	A18.EDF	A18	.
36	6538917	6538918	5861	5862	1	RIGHT	A18.EDF	A18	.
36	6538945	6538982	5889	5926	37	RIGHT	A18.EDF	A18	.
37	6540987	6541359	57	429	372	RIGHT	A18.EDF	A18	.
37	6541908	6542025	978	1095	117	RIGHT	A18.EDF	A18	.
37	6542764	6542767	1834	1837	3	RIGHT	A18.EDF	A18	.
37	6542804	6542948	1874	2018	144	RIGHT	A18.EDF	A18	.
37	6543192	6543259	2262	2329	67	RIGHT	A18.EDF	A18	.
38	6548259	6548419	58	218	160	RIGHT	A18.EDF	A18	.
38	6548559	6548559	358	358	0	RIGHT	A18.EDF	A18	.
38	6548889	6548890	688	689	1	RIGHT	A18.EDF	A18	.
38	6548916	6548939	715	738	23	RIGHT	A18.EDF	A18	.
38	6548967	6548975	766	774	8	RIGHT	A18.EDF	A18	.
38	6549000	6549271	799	1070	271	RIGHT	A18.EDF	A18	.
38	6549746	6549750	1545	1549	4	RIGHT	A18.EDF	A18	.
38	6549797	6549894	1596	1693	97	RIGHT	A18.EDF	A18	.
38	6551590	6551758	3389	3557	168	RIGHT	A18.EDF	A18	.
38	6551802	6551913	3601	3712	111	RIGHT	A18.EDF	A18	.
38	6553111	6553302	4910	5101	191	RIGHT	A18.EDF	A18	.
38	6553346	6553506	5145	5305	160	RIGHT	A18.EDF	A18	.
38	6553642	6553905	5441	5704	263	RIGHT	A18.EDF	A18	.
38	6553949	6553991	5748	5790	42	RIGHT	A18.EDF	A18	.
38	6554030	6554247	5829	6046	217	RIGHT	A18.EDF	A18	.
39	6556694	6556830	57	193	136	RIGHT	A18.EDF	A18	.
39	6556919	6557014	282	377	95	RIGHT	A18.EDF	A18	.
39	6557044	6557056	407	419	12	RIGHT	A18.EDF	A18	.
39	6557129	6557271	492	634	142	RIGHT	A18.EDF	A18	.
39	6557298	6557301	661	664	3	RIGHT	A18.EDF	A18	.
39	6557324	6557477	687	840	153	RIGHT	A18.EDF	A18	.
39	6560134	6560342	3497	3705	208	RIGHT	A18.EDF	A18	.
39	6560374	6560532	3737	3895	158	RIGHT	A18.EDF	A18	.
39	6560563	6560660	3926	4023	97	RIGHT	A18.EDF	A18	.
39	6560746	6561026	4109	4389	280	RIGHT	A18.EDF	A18	.
39	6561067	6561271	4430	4634	204	RIGHT	A18.EDF	A18	.
39	6561580	6561582	4943	4945	2	RIGHT	A18.EDF	A18	.
39	6561603	6561916	4966	5279	313	RIGHT	A18.EDF	A18	.
39	6561961	6562891	5324	6254	930	RIGHT	A18.EDF	A18	.
40	6565172	6565502	58	388	330	RIGHT	A18.EDF	A18	.
40	6565571	6565579	457	465	8	RIGHT	A18.EDF	A18	.
40	6565603	6565605	489	491	2	RIGHT	A18.EDF	A18	.
40	6565724	6565725	610	611	1	RIGHT	A18.EDF	A18	.
40	6565868	6566046	754	932	178	RIGHT	A18.EDF	A18	.
40	6567360	6567515	2246	2401	155	RIGHT	A18.EDF	A18	.
40	6567547	6568138	2433	3024	591	RIGHT	A18.EDF	A18	.
40	6568194	6568942	3080	3828	748	RIGHT	A18.EDF	A18	.
40	6570017	6570316	4903	5202	299	RIGHT	A18.EDF	A18	.
41	6573078	6573079	534	535	1	RIGHT	A18.EDF	A18	.
41	6573105	6573196	561	652	91	RIGHT	A18.EDF	A18	.
41	6573234	6573862	690	1318	628	RIGHT	A18.EDF	A18	.
41	6574724	6574837	2180	2293	113	RIGHT	A18.EDF	A18	.
41	6574925	6574931	2381	2387	6	RIGHT	A18.EDF	A18	.
42	6582588	6582594	171	177	6	RIGHT	A18.EDF	A18	.
42	6582618	6583111	201	694	493	RIGHT	A18.EDF	A18	.
42	6583173	6583174	756	757	1	RIGHT	A18.EDF	A18	.
42	6583380	6583843	963	1426	463	RIGHT	A18.EDF	A18	.
42	6584164	6584217	1747	1800	53	RIGHT	A18.EDF	A18	.
42	6587062	6587066	4645	4649	4	RIGHT	A18.EDF	A18	.
42	6587093	6587232	4676	4815	139	RIGHT	A18.EDF	A18	.
42	6587278	6587344	4861	4927	66	RIGHT	A18.EDF	A18	.
42	6587384	6587404	4967	4987	20	RIGHT	A18.EDF	A18	.
42	6587427	6587790	5010	5373	363	RIGHT	A18.EDF	A18	.
42	6587877	6587899	5460	5482	22	RIGHT	A18.EDF	A18	.
42	6587923	6587953	5506	5536	30	RIGHT	A18.EDF	A18	.
43	6590194	6590240	445	491	46	RIGHT	A18.EDF	A18	.
43	6591049	6591628	1300	1879	579	RIGHT	A18.EDF	A18	.
43	6591919	6591919	2170	2170	0	RIGHT	A18.EDF	A18	.
43	6591952	6592137	2203	2388	185	RIGHT	A18.EDF	A18	.
44	6598544	6598796	57	309	252	RIGHT	A18.EDF	A18	.
44	6598917	6598946	430	459	29	RIGHT	A18.EDF	A18	.
44	6599082	6599596	595	1109	514	RIGHT	A18.EDF	A18	.
44	6600246	6600715	1759	2228	469	RIGHT	A18.EDF	A18	.
44	6601051	6601051	2564	2564	0	RIGHT	A18.EDF	A18	.
45	6608614	6608969	111	466	355	RIGHT	A18.EDF	A18	.
45	6609073	6609073	570	570	0	RIGHT	A18.EDF	A18	.
45	6609106	6609127	603	624	21	RIGHT	A18.EDF	A18	.
45	6609592	6610112	1089	1609	520	RIGHT	A18.EDF	A18	.
45	6610134	6610504	1631	2001	370	RIGHT	A18.EDF	A18	.
45	6611938	6612055	3435	3552	117	RIGHT	A18.EDF	A18	.
45	6612092	6612093	3589	3590	1	RIGHT	A18.EDF	A18	.
46	6618110	6618280	58	228	170	RIGHT	A18.EDF	A18	.
46	6618350	6618369	298	317	19	RIGHT	A18.EDF	A18	.
46	6618401	6618820	349	768	419	RIGHT	A18.EDF	A18	.
46	6619478	6620144	1426	2092	666	RIGHT	A18.EDF	A18	.
46	6620170	6620186	2118	2134	16	RIGHT	A18.EDF	A18	.
46	6620455	6620615	2403	2563	160	RIGHT	A18.EDF	A18	.
46	6622045	6623211	3993	5159	1166	RIGHT	A18.EDF	A18	.
46	6623237	6623284	5185	5232	47	RIGHT	A18.EDF	A18	.
46	6623309	6623475	5257	5423	166	RIGHT	A18.EDF	A18	.
47	6625514	6626054	121	661	540	RIGHT	A18.EDF	A18	.
47	6626350	6626350	957	957	0	RIGHT	A18.EDF	A18	.
47	6626423	6626423	1030	1030	0	RIGHT	A18.EDF	A18	.
47	6628165	6628649	2772	3256	484	RIGHT	A18.EDF	A18	.
47	6629380	6629795	3987	4402	415	RIGHT	A18.EDF	A18	.
47	6629820	6629820	4427	4427	0	RIGHT	A18.EDF	A18	.
47	6629851	6629851	4458	4458	0	RIGHT	A18.EDF	A18	.
47	6629952	6629969	4559	4576	17	RIGHT	A18.EDF	A18	.
47	6629990	6630002	4597	4609	12	RIGHT	A18.EDF	A18	.
47	6630023	6630062	4630	4669	39	RIGHT	A18.EDF	A18	.
47	6630355	6630549	4962	5156	194	RIGHT	A18.EDF	A18	.
47	6630598	6630670	5205	5277	72	RIGHT	A18.EDF	A18	.
48	6632970	6633215	57	302	245	RIGHT	A18.EDF	A18	.
48	6633273	6633273	360	360	0	RIGHT	A18.EDF	A18	.
48	6633322	6633322	409	409	0	RIGHT	A18.EDF	A18	.
48	6633360	6633361	447	448	1	RIGHT	A18.EDF	A18	.
48	6633382	6633506	469	593	124	RIGHT	A18.EDF	A18	.
48	6634077	6634081	1164	1168	4	RIGHT	A18.EDF	A18	.
48	6634117	6634625	1204	1712	508	RIGHT	A18.EDF	A18	.
48	6634697	6634697	1784	1784	0	RIGHT	A18.EDF	A18	.
48	6635043	6635205	2130	2292	162	RIGHT	A18.EDF	A18	.
49	6640378	6640890	57	569	512	RIGHT	A18.EDF	A18	.
49	6641111	6641111	790	790	0	RIGHT	A18.EDF	A18	.
49	6641132	6641133	811	812	1	RIGHT	A18.EDF	A18	.
49	6643700	6643811	3379	3490	111	RIGHT	A18.EDF	A18	.
49	6644098	6644528	3777	4207	430	RIGHT	A18.EDF	A18	.
49	6645300	6645628	4979	5307	328	RIGHT	A18.EDF	A18	.
50	6648935	6649226	58	349	291	RIGHT	A18.EDF	A18	.
50	6649263	6652033	386	3156	2770	RIGHT	A18.EDF	A18	.
50	6652506	6653238	3629	4361	732	RIGHT	A18.EDF	A18	.
51	6655538	6655868	57	387	330	RIGHT	A18.EDF	A18	.
51	6657131	6657187	1650	1706	56	RIGHT	A18.EDF	A18	.
52	6663439	6663746	57	364	307	RIGHT	A18.EDF	A18	.
52	6663847	6663894	465	512	47	RIGHT	A18.EDF	A18	.
52	6669918	6670271	6536	6889	353	RIGHT	A18.EDF	A18	.
52	6670461	6670614	7079	7232	153	RIGHT	A18.EDF	A18	.
53	6673048	6673162	119	233	114	RIGHT	A18.EDF	A18	.
53	6673431	6674475	502	1546	1044	RIGHT	A18.EDF	A18	.
53	6676391	6678439	3462	5510	2048	RIGHT	A18.EDF	A18	.
54	6679977	6680436	58	517	459	RIGHT	A18.EDF	A18	.
54	6680495	6680500	576	581	5	RIGHT	A18.EDF	A18	.
54	6680528	6680549	609	630	21	RIGHT	A18.EDF	A18	.
54	6680626	6680706	707	787	80	RIGHT	A18.EDF	A18	.
55	6687481	6687585	57	161	104	RIGHT	A18.EDF	A18	.
55	6689089	6689097	1665	1673	8	RIGHT	A18.EDF	A18	.
55	6689129	6689134	1705	1710	5	RIGHT	A18.EDF	A18	.
55	6691737	6692041	4313	4617	304	RIGHT	A18.EDF	A18	.
55	6692164	6692510	4740	5086	346	RIGHT	A18.EDF	A18	.
55	6692760	6692766	5336	5342	6	RIGHT	A18.EDF	A18	.
56	6694814	6695034	57	277	220	RIGHT	A18.EDF	A18	.
56	6695509	6695511	752	754	2	RIGHT	A18.EDF	A18	.
56	6699363	6700160	4606	5403	797	RIGHT	A18.EDF	A18	.
57	6702818	6703525	58	765	707	RIGHT	A18.EDF	A18	.
57	6708331	6709127	5571	6367	796	RIGHT	A18.EDF	A18	.
58	6710553	6711094	58	599	541	RIGHT	A18.EDF	A18	.
58	6711118	6711125	623	630	7	RIGHT	A18.EDF	A18	.
58	6711150	6711152	655	657	2	RIGHT	A18.EDF	A18	.
58	6711367	6711648	872	1153	281	RIGHT	A18.EDF	A18	.
58	6712118	6712286	1623	1791	168	RIGHT	A18.EDF	A18	.
58	6714089	6714314	3594	3819	225	RIGHT	A18.EDF	A18	.
58	6714337	6715962	3842	5467	1625	RIGHT	A18.EDF	A18	.
59	6762805	6763358	1026	1579	553	RIGHT	A18.EDF	A18	.
59	6768669	6768824	6890	7045	155	RIGHT	A18.EDF	A18	.
59	6768962	6768962	7183	7183	0	RIGHT	A18.EDF	A18	.
60	6772093	6772526	737	1170	433	RIGHT	A18.EDF	A18	.
61	6778616	6780582	58	2024	1966	RIGHT	A18.EDF	A18	.
61	6780803	6780919	2245	2361	116	RIGHT	A18.EDF	A18	.
61	6781219	6782296	2661	3738	1077	RIGHT	A18.EDF	A18	.
61	6782714	6782749	4156	4191	35	RIGHT	A18.EDF	A18	.
61	6782801	6783191	4243	4633	390	RIGHT	A18.EDF	A18	.
61	6783270	6783361	4712	4803	91	RIGHT	A18.EDF	A18	.
61	6783441	6783452	4883	4894	11	RIGHT	A18.EDF	A18	.
61	6783480	6783728	4922	5170	248	RIGHT	A18.EDF	A18	.
61	6783777	6783840	5219	5282	63	RIGHT	A18.EDF	A18	.
61	6783861	6783947	5303	5389	86	RIGHT	A18.EDF	A18	.
62	6787954	6788194	832	1072	240	RIGHT	A18.EDF	A18	.
62	6788493	6789105	1371	1983	612	RIGHT	A18.EDF	A18	.
62	6789522	6789671	2400	2549	149	RIGHT	A18.EDF	A18	.
63	6795838	6795920	58	140	82	RIGHT	A18.EDF	A18	.
63	6796144	6796159	364	379	15	RIGHT	A18.EDF	A18	.
63	6796207	6796279	427	499	72	RIGHT	A18.EDF	A18	.
63	6796363	6796377	583	597	14	RIGHT	A18.EDF	A18	.
63	6796406	6796604	626	824	198	RIGHT	A18.EDF	A18	.
63	6796669	6796669	889	889	0	RIGHT	A18.EDF	A18	.
63	6796774	6796832	994	1052	58	RIGHT	A18.EDF	A18	.
63	6796854	6797010	1074	1230	156	RIGHT	A18.EDF	A18	.
63	6797784	6797792	2004	2012	8	RIGHT	A18.EDF	A18	.
63	6797865	6797954	2085	2174	89	RIGHT	A18.EDF	A18	.
63	6798944	6799415	3164	3635	471	RIGHT	A18.EDF	A18	.
63	6799495	6799933	3715	4153	438	RIGHT	A18.EDF	A18	.
63	6799973	6799979	4193	4199	6	RIGHT	A18.EDF	A18	.
63	6800016	6800322	4236	4542	306	RIGHT	A18.EDF	A18	.
63	6800387	6800387	4607	4607	0	RIGHT	A18.EDF	A18	.
63	6800443	6800466	4663	4686	23	RIGHT	A18.EDF	A18	.
63	6800494	6800503	4714	4723	9	RIGHT	A18.EDF	A18	.
63	6800704	6800725	4924	4945	21	RIGHT	A18.EDF	A18	.
63	6800927	6800930	5147	5150	3	RIGHT	A18.EDF	A18	.
63	6800955	6800998	5175	5218	43	RIGHT	A18.EDF	A18	.
63	6801083	6801140	5303	5360	57	RIGHT	A18.EDF	A18	.
63	6801176	6801451	5396	5671	275	RIGHT	A18.EDF	A18	.
63	6801895	6801895	6115	6115	0	RIGHT	A18.EDF	A18	.
63	6801919	6802440	6139	6660	521	RIGHT	A18.EDF	A18	.
64	6804831	6804951	57	177	120	RIGHT	A18.EDF	A18	.
64	6805981	6806682	1207	1908	701	RIGHT	A18.EDF	A18	.
64	6806806	6806806	2032	2032	0	RIGHT	A18.EDF	A18	.
64	6806937	6806949	2163	2175	12	RIGHT	A18.EDF	A18	.
64	6808387	6808524	3613	3750	137	RIGHT	A18.EDF	A18	.
64	6808907	6809246	4133	4472	339	RIGHT	A18.EDF	A18	.
65	6813176	6813435	58	317	259	RIGHT	A18.EDF	A18	.
65	6814654	6814659	1536	1541	5	RIGHT	A18.EDF	A18	.
65	6814714	6815075	1596	1957	361	RIGHT	A18.EDF	A18	.
65	6815371	6815371	2253	2253	0	RIGHT	A18.EDF	A18	.
65	6815405	6815457	2287	2339	52	RIGHT	A18.EDF	A18	.
65	6818090	6818101	4972	4983	11	RIGHT	A18.EDF	A18	.
65	6818123	6818268	5005	5150	145	RIGHT	A18.EDF	A18	.
65	6818293	6818317	5175	5199	24	RIGHT	A18.EDF	A18	.
65	6818344	6818628	5226	5510	284	RIGHT	A18.EDF	A18	.
65	6818650	6818651	5532	5533	1	RIGHT	A18.EDF	A18	.
65	6818698	6818868	5580	5750	170	RIGHT	A18.EDF	A18	.
66	6821353	6821771	57	475	418	RIGHT	A18.EDF	A18	.
66	6821814	6821854	518	558	40	RIGHT	A18.EDF	A18	.
66	6822391	6822434	1095	1138	43	RIGHT	A18.EDF	A18	.
66	6822475	6822475	1179	1179	0	RIGHT	A18.EDF	A18	.
66	6822497	6822511	1201	1215	14	RIGHT	A18.EDF	A18	.
66	6822559	6822560	1263	1264	1	RIGHT	A18.EDF	A18	.
66	6822612	6822612	1316	1316	0	RIGHT	A18.EDF	A18	.
66	6822659	6822987	1363	1691	328	RIGHT	A18.EDF	A18	.
66	6824557	6824573	3261	3277	16	RIGHT	A18.EDF	A18	.
66	6824595	6824717	3299	3421	122	RIGHT	A18.EDF	A18	.
66	6824769	6824782	3473	3486	13	RIGHT	A18.EDF	A18	.
66	6824865	6824911	3569	3615	46	RIGHT	A18.EDF	A18	.
66	6824934	6825222	3638	3926	288	RIGHT	A18.EDF	A18	.
66	6826971	6826972	5675	5676	1	RIGHT	A18.EDF	A18	.
66	6827002	6827244	5706	5948	242	RIGHT	A18.EDF	A18	.
66	6827797	6827797	6501	6501	0	RIGHT	A18.EDF	A18	.
66	6827897	6827968	6601	6672	71	RIGHT	A18.EDF	A18	.
66	6828011	6828011	6715	6715	0	RIGHT	A18.EDF	A18	.
66	6828041	6828041	6745	6745	0	RIGHT	A18.EDF	A18	.
66	6828114	6828133	6818	6837	19	RIGHT	A18.EDF	A18	.
66	6828175	6828175	6879	6879	0	RIGHT	A18.EDF	A18	.
66	6828199	6828199	6903	6903	0	RIGHT	A18.EDF	A18	.
66	6828239	6828421	6943	7125	182	RIGHT	A18.EDF	A18	.
67	6830768	6833026	57	2315	2258	RIGHT	A18.EDF	A18	.
67	6836463	6836463	5752	5752	0	RIGHT	A18.EDF	A18	.
67	6836500	6836646	5789	5935	146	RIGHT	A18.EDF	A18	.
68	6838812	6839195	58	441	383	RIGHT	A18.EDF	A18	.
68	6841055	6841262	2301	2508	207	RIGHT	A18.EDF	A18	.
68	6841299	6841679	2545	2925	380	RIGHT	A18.EDF	A18	.
68	6841722	6841860	2968	3106	138	RIGHT	A18.EDF	A18	.
69	6846323	6846494	141	312	171	RIGHT	A18.EDF	A18	.
69	6846516	6846523	334	341	7	RIGHT	A18.EDF	A18	.
69	6846549	6846549	367	367	0	RIGHT	A18.EDF	A18	.
69	6846578	6847200	396	1018	622	RIGHT	A18.EDF	A18	.
69	6847326	6847346	1144	1164	20	RIGHT	A18.EDF	A18	.
69	6847368	6847566	1186	1384	198	RIGHT	A18.EDF	A18	.
69	6847722	6847742	1540	1560	20	RIGHT	A18.EDF	A18	.
69	6847801	6847974	1619	1792	173	RIGHT	A18.EDF	A18	.
69	6848187	6848188	2005	2006	1	RIGHT	A18.EDF	A18	.
69	6848216	6848289	2034	2107	73	RIGHT	A18.EDF	A18	.
69	6849134	6849434	2952	3252	300	RIGHT	A18.EDF	A18	.
69	6849497	6850364	3315	4182	867	RIGHT	A18.EDF	A18	.
69	6851294	6851406	5112	5224	112	RIGHT	A18.EDF	A18	.
70	6853745	6854747	58	1060	1002	RIGHT	A18.EDF	A18	.
70	6854847	6855589	1160	1902	742	RIGHT	A18.EDF	A18	.
70	6859625	6859650	5938	5963	25	RIGHT	A18.EDF	A18	.
71	6861686	6862361	57	732	675	RIGHT	A18.EDF	A18	.
71	6862412	6862432	783	803	20	RIGHT	A18.EDF	A18	.
71	6862470	6862490	841	861	20	RIGHT	A18.EDF	A18	.
71	6862562	6862576	933	947	14	RIGHT	A18.EDF	A18	.
71	6862630	6863128	1001	1499	498	RIGHT	A18.EDF	A18	.
71	6865000	6865368	3371	3739	368	RIGHT	A18.EDF	A18	.
71	6865450	6867146	3821	5517	1696	RIGHT	A18.EDF	A18	.
72	6868890	6869001	57	168	111	RIGHT	A18.EDF	A18	.
72	6869062	6869813	229	980	751	RIGHT	A18.EDF	A18	.
72	6869971	6869980	1138	1147	9	RIGHT	A18.EDF	A18	.
72	6870009	6870551	1176	1718	542	RIGHT	A18.EDF	A18	.
72	6870582	6870632	1749	1799	50	RIGHT	A18.EDF	A18	.
72	6873548	6873615	4715	4782	67	RIGHT	A18.EDF	A18	.
72	6874571	6874635	5738	5802	64	RIGHT	A18.EDF	A18	.
72	6874971	6875218	6138	6385	247	RIGHT	A18.EDF	A18	.
73	6878055	6878402	58	405	347	RIGHT	A18.EDF	A18	.
73	6879091	6879384	1094	1387	293	RIGHT	A18.EDF	A18	.
73	6879444	6880044	1447	2047	600	RIGHT	A18.EDF	A18	.
73	6880356	6880368	2359	2371	12	RIGHT	A18.EDF	A18	.
74	6887950	6888630	207	887	680	RIGHT	A18.EDF	A18	.
74	6888701	6888702	958	959	1	RIGHT	A18.EDF	A18	.
74	6891474	6891665	3731	3922	191	RIGHT	A18.EDF	A18	.
74	6891709	6891876	3966	4133	167	RIGHT	A18.EDF	A18	.
74	6892145	6892158	4402	4415	13	RIGHT	A18.EDF	A18	.
74	6892181	6892261	4438	4518	80	RIGHT	A18.EDF	A18	.
74	6892283	6892531	4540	4788	248	RIGHT	A18.EDF	A18	.
74	6892982	6893310	5239	5567	328	RIGHT	A18.EDF	A18	.
74	6893347	6893771	5604	6028	424	RIGHT	A18.EDF	A18	.
75	6895641	6896404	138	901	763	RIGHT	A18.EDF	A18	.
75	6896465	6896645	962	1142	180	RIGHT	A18.EDF	A18	.
75	6896667	6897176	1164	1673	509	RIGHT	A18.EDF	A18	.
75	6899849	6899950	4346	4447	101	RIGHT	A18.EDF	A18	.
75	6899981	6900153	4478	4650	172	RIGHT	A18.EDF	A18	.
75	6900282	6900510	4779	5007	228	RIGHT	A18.EDF	A18	.
75	6900541	6900574	5038	5071	33	RIGHT	A18.EDF	A18	.
75	6900604	6900948	5101	5445	344	RIGHT	A18.EDF	A18	.
75	6901061	6901085	5558	5582	24	RIGHT	A18.EDF	A18	.
75	6901113	6901309	5610	5806	196	RIGHT	A18.EDF	A18	.
75	6901341	6902673	5838	7170	1332	RIGHT	A18.EDF	A18	.
75	6902697	6902757	7194	7254	60	RIGHT	A18.EDF	A18	.
76	6905112	6905852	58	798	740	RIGHT	A18.EDF	A18	.
76	6905904	6905929	850	875	25	RIGHT	A18.EDF	A18	.
77	6913115	6913773	702	1360	658	RIGHT	A18.EDF	A18	.
77	6913794	6914019	1381	1606	225	RIGHT	A18.EDF	A18	.
77	6916835	6916904	4422	4491	69	RIGHT	A18.EDF	A18	.
77	6916950	6917252	4537	4839	302	RIGHT	A18.EDF	A18	.
77	6917282	6917349	4869	4936	67	RIGHT	A18.EDF	A18	.
77	6917378	6917852	4965	5439	474	RIGHT	A18.EDF	A18	.
77	6917906	6917932	5493	5519	26	RIGHT	A18.EDF	A18	.
77	6918297	6918370	5884	5957	73	RIGHT	A18.EDF	A18	.
77	6918397	6918408	5984	5995	11	RIGHT	A18.EDF	A18	.
77	6918430	6919237	6017	6824	807	RIGHT	A18.EDF	A18	.
78	6921479	6921792	163	476	313	RIGHT	A18.EDF	A18	.
78	6921856	6922033	540	717	177	RIGHT	A18.EDF	A18	.
78	6922066	6922114	750	798	48	RIGHT	A18.EDF	A18	.
78	6922152	6922161	836	845	9	RIGHT	A18.EDF	A18	.
78	6922223	6922223	907	907	0	RIGHT	A18.EDF	A18	.
78	6922416	6922633	1100	1317	217	RIGHT	A18.EDF	A18	.
78	6926043	6926216	4727	4900	173	RIGHT	A18.EDF	A18	.
78	6926265	6926818	4949	5502	553	RIGHT	A18.EDF	A18	.
78	6926845	6927892	5529	6576	1047	RIGHT	A18.EDF	A18	.
79	6930600	6931434	930	1764	834	RIGHT	A18.EDF	A18	.
79	6931657	6931677	1987	2007	20	RIGHT	A18.EDF	A18	.
80	6936642	6936903	57	318	261	RIGHT	A18.EDF	A18	.
80	6936937	6937653	352	1068	716	RIGHT	A18.EDF	A18	.
80	6937792	6938817	1207	2232	1025	RIGHT	A18.EDF	A18	.
80	6940238	6940244	3653	3659	6	RIGHT	A18.EDF	A18	.
81	6943960	6944659	226	925	699	RIGHT	A18.EDF	A18	.
81	6944827	6945263	1093	1529	436	RIGHT	A18.EDF	A18	.
81	6948509	6948654	4775	4920	145	RIGHT	A18.EDF	A18	.
81	6948699	6949031	4965	5297	332	RIGHT	A18.EDF	A18	.
81	6949054	6949408	5320	5674	354	RIGHT	A18.EDF	A18	.
81	6949437	6949825	5703	6091	388	RIGHT	A18.EDF	A18	.
81	6949904	6950107	6170	6373	203	RIGHT	A18.EDF	A18	.
81	6950131	6950377	6397	6643	246	RIGHT	A18.EDF	A18	.
81	6950406	6950503	6672	6769	97	RIGHT	A18.EDF	A18	.
81	6950524	6950529	6790	6795	5	RIGHT	A18.EDF	A18	.
81	6950558	6950566	6824	6832	8	RIGHT	A18.EDF	A18	.
82	6952852	6953384	57	589	532	RIGHT	A18.EDF	A18	.
82	6953429	6953457	634	662	28	RIGHT	A18.EDF	A18	.
82	6953499	6953795	704	1000	296	RIGHT	A18.EDF	A18	.
83	6960325	6960674	58	407	349	RIGHT	A18.EDF	A18	.
83	6960836	6960838	569	571	2	RIGHT	A18.EDF	A18	.
83	6960870	6961429	603	1162	559	RIGHT	A18.EDF	A18	.
83	6961483	6964986	1216	4719	3503	RIGHT	A18.EDF	A18	.
84	6967285	6967333	58	106	48	RIGHT	A18.EDF	A18	.
84	6968586	6968974	1359	1747	388	RIGHT	A18.EDF	A18	.
84	6971680	6972100	4453	4873	420	RIGHT	A18.EDF	A18	.
85	6976626	6977091	485	950	465	RIGHT	A18.EDF	A18	.
86	6982769	6983106	57	394	337	RIGHT	A18.EDF	A18	.
86	6986505	6986727	3793	4015	222	RIGHT	A18.EDF	A18	.
86	6987451	6988060	4739	5348	609	RIGHT	A18.EDF	A18	.
87	6990962	6990992	629	659	30	RIGHT	A18.EDF	A18	.
87	6991707	6992149	1374	1816	442	RIGHT	A18.EDF	A18	.
88	6999502	6999712	58	268	210	RIGHT	A18.EDF	A18	.
88	7003994	7004078	4550	4634	84	RIGHT	A18.EDF	A18	.
88	7004108	7004133	4664	4689	25	RIGHT	A18.EDF	A18	.
88	7004248	7004387	4804	4943	139	RIGHT	A18.EDF	A18	.
88	7004433	7004436	4989	4992	3	RIGHT	A18.EDF	A18	.
89	7006781	7007544	57	820	763	RIGHT	A18.EDF	A18	.
89	7011532	7011679	4808	4955	147	RIGHT	A18.EDF	A18	.
89	7011708	7011747	4984	5023	39	RIGHT	A18.EDF	A18	.
89	7012533	7012691	5809	5967	158	RIGHT	A18.EDF	A18	.
89	7012726	7012757	6002	6033	31	RIGHT	A18.EDF	A18	.
90	7016090	7016922	488	1320	832	RIGHT	A18.EDF	A18	.
90	7017122	7017123	1520	1521	1	RIGHT	A18.EDF	A18	.
90	7019634	7019873	4032	4271	239	RIGHT	A18.EDF	A18	.
90	7020007	7020236	4405	4634	229	RIGHT	A18.EDF	A18	.
90	7020271	7020333	4669	4731	62	RIGHT	A18.EDF	A18	.
91	7022465	7022915	58	508	450	RIGHT	A18.EDF	A18	.
91	7023812	7024610	1405	2203	798	RIGHT	A18.EDF	A18	.
91	7025628	7026199	3221	3792	571	RIGHT	A18.EDF	A18	.
91	7028430	7028788	6023	6381	358	RIGHT	A18.EDF	A18	.
92	7031424	7031704	58	338	280	RIGHT	A18.EDF	A18	.
92	7036723	7036969	5357	5603	246	RIGHT	A18.EDF	A18	.
93	7039075	7039412	58	395	337	RIGHT	A18.EDF	A18	.
93	7039462	7039463	445	446	1	RIGHT	A18.EDF	A18	.
93	7040800	7041308	1783	2291	508	RIGHT	A18.EDF	A18	.
93	7041937	7042509	2920	3492	572	RIGHT	A18.EDF	A18	.
94	7047691	7047793	57	159	102	RIGHT	A18.EDF	A18	.
94	7047839	7047994	205	360	155	RIGHT	A18.EDF	A18	.
95	7054938	7055023	58	143	85	RIGHT	A18.EDF	A18	.
95	7055968	7056697	1088	1817	729	RIGHT	A18.EDF	A18	.
95	7059427	7059676	4547	4796	249	RIGHT	A18.EDF	A18	.
95	7060130	7060313	5250	5433	183	RIGHT	A18.EDF	A18	.
95	7060601	7060604	5721	5724	3	RIGHT	A18.EDF	A18	.
96	7062280	7062730	58	508	450	RIGHT	A18.EDF	A18	.
96	7062782	7062999	560	777	217	RIGHT	A18.EDF	A18	.
96	7068039	7068176	5817	5954	137	RIGHT	A18.EDF	A18	.
96	7068493	7068701	6271	6479	208	RIGHT	A18.EDF	A18	.
96	7068834	7069081	6612	6859	247	RIGHT	A18.EDF	A18	.
96	7069110	7069126	6888	6904	16	RIGHT	A18.EDF	A18	.
97	7070923	7071394	57	528	471	RIGHT	A18.EDF	A18	.
97	7071592	7073124	726	2258	1532	RIGHT	A18.EDF	A18	.
97	7073494	7073823	2628	2957	329	RIGHT	A18.EDF	A18	.
97	7074538	7074968	3672	4102	430	RIGHT	A18.EDF	A18	.
98	7079022	7081372	57	2407	2350	RIGHT	A18.EDF	A18	.
98	7081747	7082096	2782	3131	349	RIGHT	A18.EDF	A18	.
98	7082789	7083217	3824	4252	428	RIGHT	A18.EDF	A18	.
98	7083261	7083333	4296	4368	72	RIGHT	A18.EDF	A18	.
99	7087269	7087536	58	325	267	RIGHT	A18.EDF	A18	.
99	7090960	7091128	3749	3917	168	RIGHT	A18.EDF	A18	.
99	7091149	7091687	3938	4476	538	RIGHT	A18.EDF	A18	.
99	7091779	7092377	4568	5166	598	RIGHT	A18.EDF	A18	.
100	7095774	7097455	58	1739	1681	RIGHT	A18.EDF	A18	.
100	7098773	7099517	3057	3801	744	RIGHT	A18.EDF	A18	.
100	7099566	7099662	3850	3946	96	RIGHT	A18.EDF	A18	.
100	7099922	7100596	4206	4880	674	RIGHT	A18.EDF	A18	.
100	7100713	7100757	4997	5041	44	RIGHT	A18.EDF	A18	.
100	7100784	7100949	5068	5233	165	RIGHT	A18.EDF	A18	.
101	7103275	7103298	135	158	23	RIGHT	A18.EDF	A18	.
101	7103319	7103426	179	286	107	RIGHT	A18.EDF	A18	.
101	7106216	7106525	3076	3385	309	RIGHT	A18.EDF	A18	.
101	7106675	7107010	3535	3870	335	RIGHT	A18.EDF	A18	.
101	7107803	7108275	4663	5135	472	RIGHT	A18.EDF	A18	.
101	7108450	7108469	5310	5329	19	RIGHT	A18.EDF	A18	.
101	7108491	7108597	5351	5457	106	RIGHT	A18.EDF	A18	.
102	7113715	7114140	1077	1502	425	RIGHT	A18.EDF	A18	.
102	7114210	7114247	1572	1609	37	RIGHT	A18.EDF	A18	.
102	7116495	7116680	3857	4042	185	RIGHT	A18.EDF	A18	.
102	7116752	7116821	4114	4183	69	RIGHT	A18.EDF	A18	.
102	7117235	7117561	4597	4923	326	RIGHT	A18.EDF	A18	.
102	7117596	7117596	4958	4958	0	RIGHT	A18.EDF	A18	.
102	7117623	7117878	4985	5240	255	RIGHT	A18.EDF	A18	.
103	7122172	7122500	1529	1857	328	RIGHT	A18.EDF	A18	.
103	7122659	7122665	2016	2022	6	RIGHT	A18.EDF	A18	.
103	7124336	7124516	3693	3873	180	RIGHT	A18.EDF	A18	.
103	7124719	7124830	4076	4187	111	RIGHT	A18.EDF	A18	.
104	7127775	7128178	57	460	403	RIGHT	A18.EDF	A18	.
104	7128232	7128356	514	638	124	RIGHT	A18.EDF	A18	.
104	7130302	7130547	2584	2829	245	RIGHT	A18.EDF	A18	.
104	7130568	7130629	2850	2911	61	RIGHT	A18.EDF	A18	.
104	7131265	7131783	3547	4065	518	RIGHT	A18.EDF	A18	.
104	7133221	7133553	5503	5835	332	RIGHT	A18.EDF	A18	.
104	7133574	7133880	5856	6162	306	RIGHT	A18.EDF	A18	.
105	7137660	7138262	58	660	602	RIGHT	A18.EDF	A18	.
105	7138304	7138382	702	780	78	RIGHT	A18.EDF	A18	.
105	7138818	7138818	1216	1216	0	RIGHT	A18.EDF	A18	.
105	7144070	7144496	6468	6894	426	RIGHT	A18.EDF	A18	.
106	7146918	7146921	370	373	3	RIGHT	A18.EDF	A18	.
106	7147002	7148998	454	2450	1996	RIGHT	A18.EDF	A18	.
106	7151523	7151580	4975	5032	57	RIGHT	A18.EDF	A18	.
107	7156462	7157102	2638	3278	640	RIGHT	A18.EDF	A18	.
107	7159880	7160238	6056	6414	358	RIGHT	A18.EDF	A18	.
108	7163262	7164147	58	943	885	RIGHT	A18.EDF	A18	.
108	7164169	7164179	965	975	10	RIGHT	A18.EDF	A18	.
108	7164557	7164558	1353	1354	1	RIGHT	A18.EDF	A18	.
108	7164583	7164587	1379	1383	4	RIGHT	A18.EDF	A18	.
108	7164609	7165227	1405	2023	618	RIGHT	A18.EDF	A18	.
108	7166359	7166840	3155	3636	481	RIGHT	A18.EDF	A18	.
109	7171614	7171903	121	410	289	RIGHT	A18.EDF	A18	.
109	7171952	7172437	459	944	485	RIGHT	A18.EDF	A18	.
109	7173518	7173772	2025	2279	254	RIGHT	A18.EDF	A18	.
109	7173805	7174059	2312	2566	254	RIGHT	A18.EDF	A18	.
109	7175922	7176026	4429	4533	104	RIGHT	A18.EDF	A18	.
109	7176329	7176330	4836	4837	1	RIGHT	A18.EDF	A18	.
109	7176391	7176783	4898	5290	392	RIGHT	A18.EDF	A18	.
109	7176826	7177373	5333	5880	547	RIGHT	A18.EDF	A18	.
109	7177415	7177416	5922	5923	1	RIGHT	A18.EDF	A18	.
110	7179165	7179281	57	173	116	RIGHT	A18.EDF	A18	.
110	7180757	7181032	1649	1924	275	RIGHT	A18.EDF	A18	.
110	7181400	7181749	2292	2641	349	RIGHT	A18.EDF	A18	.
110	7182408	7183273	3300	4165	865	RIGHT	A18.EDF	A18	.
111	7187007	7187353	57	403	346	RIGHT	A18.EDF	A18	.
111	7187869	7187874	919	924	5	RIGHT	A18.EDF	A18	.
111	7187900	7188145	950	1195	245	RIGHT	A18.EDF	A18	.
111	7188394	7189158	1444	2208	764	RIGHT	A18.EDF	A18	.
111	7190965	7191401	4015	4451	436	RIGHT	A18.EDF	A18	.
112	7195754	7196255	57	558	501	RIGHT	A18.EDF	A18	.
112	7199152	7199486	3455	3789	334	RIGHT	A18.EDF	A18	.
112	7200941	7201377	5244	5680	436	RIGHT	A18.EDF	A18	.
113	7202997	7203508	58	569	511	RIGHT	A18.EDF	A18	.
113	7205654	7206485	2715	3546	831	RIGHT	A18.EDF	A18	.
113	7207827	7208906	4888	5967	1079	RIGHT	A18.EDF	A18	.
114	7212885	7213463	429	1007	578	RIGHT	A18.EDF	A18	.
114	7214957	7215704	2501	3248	747	RIGHT	A18.EDF	A18	.
114	7219164	7219403	6708	6947	239	RIGHT	A18.EDF	A18	.
115	7221384	7222018	58	692	634	RIGHT	A18.EDF	A18	.
115	7222431	7222628	1105	1302	197	RIGHT	A18.EDF	A18	.
115	7222897	7223916	1571	2590	1019	RIGHT	A18.EDF	A18	.
115	7224321	7224987	2995	3661	666	RIGHT	A18.EDF	A18	.
116	7229071	7232617	57	3603	3546	RIGHT	A18.EDF	A18	.
116	7232838	7233183	3824	4169	345	RIGHT	A18.EDF	A18	.
117	7236608	7236862	58	312	254	RIGHT	A18.EDF	A18	.
118	7245559	7245873	514	828	314	RIGHT	A18.EDF	A18	.
118	7245901	7245926	856	881	25	RIGHT	A18.EDF	A18	.
118	7246018	7246021	973	976	3	RIGHT	A18.EDF	A18	.
118	7247634	7247875	2589	2830	241	RIGHT	A18.EDF	A18	.
118	7247897	7248212	2852	3167	315	RIGHT	A18.EDF	A18	.
118	7249106	7249535	4061	4490	429	RIGHT	A18.EDF	A18	.
118	7249562	7250111	4517	5066	549	RIGHT	A18.EDF	A18	.
119	7253148	7253170	58	80	22	RIGHT	A18.EDF	A18	.
119	7253303	7253567	213	477	264	RIGHT	A18.EDF	A18	.
119	7253591	7253862	501	772	271	RIGHT	A18.EDF	A18	.
119	7256336	7256542	3246	3452	206	RIGHT	A18.EDF	A18	.
119	7256568	7256649	3478	3559	81	RIGHT	A18.EDF	A18	.
119	7257712	7257857	4622	4767	145	RIGHT	A18.EDF	A18	.
119	7257881	7258360	4791	5270	479	RIGHT	A18.EDF	A18	.
119	7258385	7258896	5295	5806	511	RIGHT	A18.EDF	A18	.
119	7258953	7259021	5863	5931	68	RIGHT	A18.EDF	A18	.
120	7260912	7264243	57	3388	3331	RIGHT	A18.EDF	A18	.
120	7264630	7265082	3775	4227	452	RIGHT	A18.EDF	A18	.
121	7267682	7267882	58	258	200	RIGHT	A18.EDF	A18	.
121	7271343	7272029	3719	4405	686	RIGHT	A18.EDF	A18	.
121	7272361	7273713	4737	6089	1352	RIGHT	A18.EDF	A18	.
122	7275811	7276575	57	821	764	RIGHT	A18.EDF	A18	.
122	7276597	7276628	843	874	31	RIGHT	A18.EDF	A18	.
122	7276667	7277001	913	1247	334	RIGHT	A18.EDF	A18	.
122	7278883	7278896	3129	3142	13	RIGHT	A18.EDF	A18	.
122	7278919	7279095	3165	3341	176	RIGHT	A18.EDF	A18	.
122	7279118	7279216	3364	3462	98	RIGHT	A18.EDF	A18	.
122	7282460	7282694	6706	6940	234	RIGHT	A18.EDF	A18	.
122	7282718	7282756	6964	7002	38	RIGHT	A18.EDF	A18	.
122	7282782	7282851	7028	7097	69	RIGHT	A18.EDF	A18	.
123	7285248	7291217	413	6382	5969	RIGHT	A18.EDF	A18	.
124	7292875	7294531	57	1713	1656	RIGHT	A18.EDF	A18	.
124	7295470	7295700	2652	2882	230	RIGHT	A18.EDF	A18	.
124	7296305	7296823	3487	4005	518	RIGHT	A18.EDF	A18	.
125	7299956	7300072	58	174	116	RIGHT	A18.EDF	A18	.
125	7300097	7300223	199	325	126	RIGHT	A18.EDF	A18	.
125	7301722	7302237	1824	2339	515	RIGHT	A18.EDF	A18	.
125	7303600	7303864	3702	3966	264	RIGHT	A18.EDF	A18	.
126	7307691	7308087	58	454	396	RIGHT	A18.EDF	A18	.
126	7308164	7308164	531	531	0	RIGHT	A18.EDF	A18	.
126	7308214	7308214	581	581	0	RIGHT	A18.EDF	A18	.
126	7308242	7308441	609	808	199	RIGHT	A18.EDF	A18	.
126	7309400	7309701	1767	2068	301	RIGHT	A18.EDF	A18	.
126	7309737	7309777	2104	2144	40	RIGHT	A18.EDF	A18	.
126	7309952	7310278	2319	2645	326	RIGHT	A18.EDF	A18	.
126	7312726	7313046	5093	5413	320	RIGHT	A18.EDF	A18	.
126	7313074	7313391	5441	5758	317	RIGHT	A18.EDF	A18	.
126	7313422	7313918	5789	6285	496	RIGHT	A18.EDF	A18	.
126	7313978	7314531	6345	6898	553	RIGHT	A18.EDF	A18	.
127	7319794	7319838	3242	3286	44	RIGHT	A18.EDF	A18	.
127	7319873	7319897	3321	3345	24	RIGHT	A18.EDF	A18	.
127	7319972	7320234	3420	3682	262	RIGHT	A18.EDF	A18	.
127	7320495	7320569	3943	4017	74	RIGHT	A18.EDF	A18	.
128	7327165	7327888	58	781	723	RIGHT	A18.EDF	A18	.
128	7328136	7328140	1029	1033	4	RIGHT	A18.EDF	A18	.
128	7328183	7328283	1076	1176	100	RIGHT	A18.EDF	A18	.
128	7328326	7328388	1219	1281	62	RIGHT	A18.EDF	A18	.
128	7328416	7328446	1309	1339	30	RIGHT	A18.EDF	A18	.
128	7328490	7328496	1383	1389	6	RIGHT	A18.EDF	A18	.
128	7329681	7330567	2574	3460	886	RIGHT	A18.EDF	A18	.
128	7330590	7330603	3483	3496	13	RIGHT	A18.EDF	A18	.
128	7330640	7331194	3533	4087	554	RIGHT	A18.EDF	A18	.
129	7335606	7336225	180	799	619	RIGHT	A18.EDF	A18	.
129	7339710	7340061	4284	4635	351	RIGHT	A18.EDF	A18	.
129	7340356	7340979	4930	5553	623	RIGHT	A18.EDF	A18	.
129	7341100	7341100	5674	5674	0	RIGHT	A18.EDF	A18	.
129	7341443	7342278	6017	6852	835	RIGHT	A18.EDF	A18	.
129	7342310	7342568	6884	7142	258	RIGHT	A18.EDF	A18	.
130	7344267	7344637	58	428	370	RIGHT	A18.EDF	A18	.
130	7348037	7348145	3828	3936	108	RIGHT	A18.EDF	A18	.
130	7348229	7348251	4020	4042	22	RIGHT	A18.EDF	A18	.
130	7348395	7351253	4186	7044	2858	RIGHT	A18.EDF	A18	.
131	7354149	7355069	57	977	920	RIGHT	A18.EDF	A18	.
131	7355280	7355360	1188	1268	80	RIGHT	A18.EDF	A18	.
131	7355415	7355419	1323	1327	4	RIGHT	A18.EDF	A18	.
131	7355469	7355469	1377	1377	0	RIGHT	A18.EDF	A18	.
131	7355531	7355544	1439	1452	13	RIGHT	A18.EDF	A18	.
131	7355568	7355746	1476	1654	178	RIGHT	A18.EDF	A18	.
131	7355770	7355812	1678	1720	42	RIGHT	A18.EDF	A18	.
131	7355864	7355893	1772	1801	29	RIGHT	A18.EDF	A18	.
131	7355945	7355945	1853	1853	0	RIGHT	A18.EDF	A18	.
131	7356027	7356030	1935	1938	3	RIGHT	A18.EDF	A18	.
131	7356055	7356082	1963	1990	27	RIGHT	A18.EDF	A18	.
131	7356122	7356312	2030	2220	190	RIGHT	A18.EDF	A18	.
131	7356333	7356371	2241	2279	38	RIGHT	A18.EDF	A18	.
131	7356392	7356447	2300	2355	55	RIGHT	A18.EDF	A18	.
131	7356470	7356475	2378	2383	5	RIGHT	A18.EDF	A18	.
131	7356526	7356526	2434	2434	0	RIGHT	A18.EDF	A18	.
131	7356570	7356570	2478	2478	0	RIGHT	A18.EDF	A18	.
131	7356602	7356602	2510	2510	0	RIGHT	A18.EDF	A18	.
131	7356685	7356686	2593	2594	1	RIGHT	A18.EDF	A18	.
131	7356826	7356854	2734	2762	28	RIGHT	A18.EDF	A18	.
131	7356889	7356922	2797	2830	33	RIGHT	A18.EDF	A18	.
131	7356963	7357063	2871	2971	100	RIGHT	A18.EDF	A18	.
131	7357085	7357121	2993	3029	36	RIGHT	A18.EDF	A18	.
131	7357157	7357336	3065	3244	179	RIGHT	A18.EDF	A18	.
131	7357508	7359729	3416	5637	2221	RIGHT	A18.EDF	A18	.
132	7362001	7362155	58	212	154	RIGHT	A18.EDF	A18	.
132	7362183	7362183	240	240	0	RIGHT	A18.EDF	A18	.
132	7362221	7362225	278	282	4	RIGHT	A18.EDF	A18	.
132	7362256	7362272	313	329	16	RIGHT	A18.EDF	A18	.
132	7362326	7362328	383	385	2	RIGHT	A18.EDF	A18	.
132	7362382	7362391	439	448	9	RIGHT	A18.EDF	A18	.
132	7362414	7366623	471	4680	4209	RIGHT	A18.EDF	A18	.
133	7368336	7369476	71	1211	1140	RIGHT	A18.EDF	A18	.
133	7369516	7369560	1251	1295	44	RIGHT	A18.EDF	A18	.
133	7369587	7369614	1322	1349	27	RIGHT	A18.EDF	A18	.
133	7369637	7369649	1372	1384	12	RIGHT	A18.EDF	A18	.
133	7369696	7369697	1431	1432	1	RIGHT	A18.EDF	A18	.
133	7369734	7369736	1469	1471	2	RIGHT	A18.EDF	A18	.
133	7369801	7369802	1536	1537	1	RIGHT	A18.EDF	A18	.
133	7369836	7369839	1571	1574	3	RIGHT	A18.EDF	A18	.
133	7369882	7369884	1617	1619	2	RIGHT	A18.EDF	A18	.
133	7369922	7369922	1657	1657	0	RIGHT	A18.EDF	A18	.
133	7369948	7370989	1683	2724	1041	RIGHT	A18.EDF	A18	.
133	7371157	7372381	2892	4116	1224	RIGHT	A18.EDF	A18	.
133	7372444	7372854	4179	4589	410	RIGHT	A18.EDF	A18	.
133	7372909	7375649	4644	7384	2740	RIGHT	A18.EDF	A18	.
134	7377988	7379206	75	1293	1218	RIGHT	A18.EDF	A18	.
134	7379428	7380716	1515	2803	1288	RIGHT	A18.EDF	A18	.
134	7381496	7382339	3583	4426	843	RIGHT	A18.EDF	A18	.
134	7384109	7384244	6196	6331	135	RIGHT	A18.EDF	A18	.
135	7386069	7388379	57	2367	2310	RIGHT	A18.EDF	A18	.
135	7388620	7389039	2608	3027	419	RIGHT	A18.EDF	A18	.
135	7390986	7390989	4974	4977	3	RIGHT	A18.EDF	A18	.
135	7391011	7391549	4999	5537	538	RIGHT	A18.EDF	A18	.
135	7391576	7391579	5564	5567	3	RIGHT	A18.EDF	A18	.
136	7393784	7394482	58	756	698	RIGHT	A18.EDF	A18	.
136	7394984	7398503	1258	4777	3519	RIGHT	A18.EDF	A18	.
137	7400479	7407368	58	6947	6889	RIGHT	A18.EDF	A18	.
138	7409477	7411068	57	1648	1591	RIGHT	A18.EDF	A18	.
138	7411412	7416704	1992	7284	5292	RIGHT	A18.EDF	A18	.
139	7418758	7425719	57	7018	6961	RIGHT	A18.EDF	A18	.
140	7427648	7432277	58	4687	4629	RIGHT	A18.EDF	A18	.
140	7432323	7433344	4733	5754	1021	RIGHT	A18.EDF	A18	.
141	7436280	7443230	57	7007	6950	RIGHT	A18.EDF	A18	.
142	7445289	7447707	57	2475	2418	RIGHT	A18.EDF	A18	.
142	7450292	7450467	5060	5235	175	RIGHT	A18.EDF	A18	.
142	7450493	7450753	5261	5521	260	RIGHT	A18.EDF	A18	.
143	7455068	7456167	58	1157	1099	RIGHT	A18.EDF	A18	.
143	7458032	7458441	3022	3431	409	RIGHT	A18.EDF	A18	.
143	7459827	7459912	4817	4902	85	RIGHT	A18.EDF	A18	.
143	7459933	7460200	4923	5190	267	RIGHT	A18.EDF	A18	.
143	7460234	7460243	5224	5233	9	RIGHT	A18.EDF	A18	.
143	7460286	7460310	5276	5300	24	RIGHT	A18.EDF	A18	.
143	7460468	7460781	5458	5771	313	RIGHT	A18.EDF	A18	.
144	7464633	7465002	57	426	369	RIGHT	A18.EDF	A18	.
144	7465266	7466406	690	1830	1140	RIGHT	A18.EDF	A18	.
144	7466458	7467041	1882	2465	583	RIGHT	A18.EDF	A18	.
144	7467924	7467924	3348	3348	0	RIGHT	A18.EDF	A18	.
144	7468012	7468041	3436	3465	29	RIGHT	A18.EDF	A18	.
144	7468068	7468073	3492	3497	5	RIGHT	A18.EDF	A18	.
144	7468107	7468114	3531	3538	7	RIGHT	A18.EDF	A18	.
144	7468138	7468138	3562	3562	0	RIGHT	A18.EDF	A18	.
144	7468160	7468175	3584	3599	15	RIGHT	A18.EDF	A18	.
144	7468227	7468236	3651	3660	9	RIGHT	A18.EDF	A18	.
144	7468906	7469498	4330	4922	592	RIGHT	A18.EDF	A18	.
144	7470223	7470246	5647	5670	23	RIGHT	A18.EDF	A18	.
144	7470278	7470516	5702	5940	238	RIGHT	A18.EDF	A18	.
144	7470553	7470572	5977	5996	19	RIGHT	A18.EDF	A18	.
144	7470633	7470664	6057	6088	31	RIGHT	A18.EDF	A18	.
144	7470693	7470727	6117	6151	34	RIGHT	A18.EDF	A18	.
145	7473146	7473399	60	313	253	RIGHT	A18.EDF	A18	.
145	7475160	7475761	2074	2675	601	RIGHT	A18.EDF	A18	.
145	7476264	7476803	3178	3717	539	RIGHT	A18.EDF	A18	.
145	7476841	7476889	3755	3803	48	RIGHT	A18.EDF	A18	.
145	7480117	7480336	7031	7250	219	RIGHT	A18.EDF	A18	.
145	7480364	7480428	7278	7342	64	RIGHT	A18.EDF	A18	.
146	7482434	7482719	57	342	285	RIGHT	A18.EDF	A18	.
146	7484292	7484954	1915	2577	662	RIGHT	A18.EDF	A18	.
146	7484985	7485470	2608	3093	485	RIGHT	A18.EDF	A18	.
146	7487212	7487251	4835	4874	39	RIGHT	A18.EDF	A18	.
146	7487402	7487776	5025	5399	374	RIGHT	A18.EDF	A18	.
146	7487803	7487911	5426	5534	108	RIGHT	A18.EDF	A18	.
146	7488222	7488422	5845	6045	200	RIGHT	A18.EDF	A18	.
146	7488445	7488445	6068	6068	0	RIGHT	A18.EDF	A18	.
146	7488468	7488712	6091	6335	244	RIGHT	A18.EDF	A18	.
147	7492790	7493106	430	746	316	RIGHT	A18.EDF	A18	.
147	7493256	7493256	896	896	0	RIGHT	A18.EDF	A18	.
147	7493284	7493304	924	944	20	RIGHT	A18.EDF	A18	.
147	7493693	7494164	1333	1804	471	RIGHT	A18.EDF	A18	.
147	7494584	7494615	2224	2255	31	RIGHT	A18.EDF	A18	.
147	7495478	7495814	3118	3454	336	RIGHT	A18.EDF	A18	.
147	7495886	7496239	3526	3879	353	RIGHT	A18.EDF	A18	.
147	7496261	7496284	3901	3924	23	RIGHT	A18.EDF	A18	.
147	7496396	7496396	4036	4036	0	RIGHT	A18.EDF	A18	.
147	7496424	7496425	4064	4065	1	RIGHT	A18.EDF	A18	.
147	7496446	7496735	4086	4375	289	RIGHT	A18.EDF	A18	.
147	7496903	7498101	4543	5741	1198	RIGHT	A18.EDF	A18	.
147	7499133	7499133	6773	6773	0	RIGHT	A18.EDF	A18	.
147	7499167	7499217	6807	6857	50	RIGHT	A18.EDF	A18	.
148	7501841	7502483	246	888	642	RIGHT	A18.EDF	A18	.
148	7503333	7503365	1738	1770	32	RIGHT	A18.EDF	A18	.
148	7503422	7503474	1827	1879	52	RIGHT	A18.EDF	A18	.
148	7505245	7505437	3650	3842	192	RIGHT	A18.EDF	A18	.
148	7505461	7506308	3866	4713	847	RIGHT	A18.EDF	A18	.
148	7507131	7507988	5536	6393	857	RIGHT	A18.EDF	A18	.
149	7511614	7511625	1526	1537	11	RIGHT	A18.EDF	A18	.
149	7511665	7512044	1577	1956	379	RIGHT	A18.EDF	A18	.
149	7514211	7514744	4123	4656	533	RIGHT	A18.EDF	A18	.
149	7515129	7515203	5041	5115	74	RIGHT	A18.EDF	A18	.
149	7515224	7515328	5136	5240	104	RIGHT	A18.EDF	A18	.
150	7518802	7519082	57	337	280	RIGHT	A18.EDF	A18	.
150	7519154	7519376	409	631	222	RIGHT	A18.EDF	A18	.
150	7523086	7523320	4341	4575	234	RIGHT	A18.EDF	A18	.
150	7523365	7523456	4620	4711	91	RIGHT	A18.EDF	A18	.
150	7523501	7523538	4756	4793	37	RIGHT	A18.EDF	A18	.
150	7523587	7523735	4842	4990	148	RIGHT	A18.EDF	A18	.
150	7523766	7524243	5021	5498	477	RIGHT	A18.EDF	A18	.
150	7524280	7524492	5535	5747	212	RIGHT	A18.EDF	A18	.
150	7524534	7524781	5789	6036	247	RIGHT	A18.EDF	A18	.
151	7526790	7527010	57	277	220	RIGHT	A18.EDF	A18	.
151	7527039	7527093	306	360	54	RIGHT	A18.EDF	A18	.
151	7527135	7527137	402	404	2	RIGHT	A18.EDF	A18	.
151	7527195	7527209	462	476	14	RIGHT	A18.EDF	A18	.
151	7527418	7527419	685	686	1	RIGHT	A18.EDF	A18	.
151	7527862	7527863	1129	1130	1	RIGHT	A18.EDF	A18	.
151	7529873	7530140	3140	3407	267	RIGHT	A18.EDF	A18	.
151	7530174	7530398	3441	3665	224	RIGHT	A18.EDF	A18	.
151	7531408	7531705	4675	4972	297	RIGHT	A18.EDF	A18	.
151	7531799	7531836	5066	5103	37	RIGHT	A18.EDF	A18	.
152	7534125	7534424	57	356	299	RIGHT	A18.EDF	A18	.
152	7534475	7534588	407	520	113	RIGHT	A18.EDF	A18	.
152	7535072	7535194	1004	1126	122	RIGHT	A18.EDF	A18	.
152	7536181	7537200	2113	3132	1019	RIGHT	A18.EDF	A18	.
152	7537271	7539109	3203	5041	1838	RIGHT	A18.EDF	A18	.
153	7542205	7542280	58	133	75	RIGHT	A18.EDF	A18	.
153	7542311	7542471	164	324	160	RIGHT	A18.EDF	A18	.
153	7547477	7547505	5330	5358	28	RIGHT	A18.EDF	A18	.
153	7547546	7547911	5399	5764	365	RIGHT	A18.EDF	A18	.
154	7551493	7552308	585	1400	815	RIGHT	A18.EDF	A18	.
154	7552440	7552903	1532	1995	463	RIGHT	A18.EDF	A18	.
154	7553206	7553398	2298	2490	192	RIGHT	A18.EDF	A18	.
154	7553943	7554217	3035	3309	274	RIGHT	A18.EDF	A18	.
154	7554241	7554463	3333	3555	222	RIGHT	A18.EDF	A18	.
154	7554515	7555532	3607	4624	1017	RIGHT	A18.EDF	A18	.
154	7555582	7555583	4674	4675	1	RIGHT	A18.EDF	A18	.
154	7555610	7555636	4702	4728	26	RIGHT	A18.EDF	A18	.
154	7555723	7555752	4815	4844	29	RIGHT	A18.EDF	A18	.
154	7555804	7555805	4896	4897	1	RIGHT	A18.EDF	A18	.
154	7555840	7555851	4932	4943	11	RIGHT	A18.EDF	A18	.
154	7555877	7555878	4969	4970	1	RIGHT	A18.EDF	A18	.
154	7555908	7555941	5000	5033	33	RIGHT	A18.EDF	A18	.
154	7555997	7556020	5089	5112	23	RIGHT	A18.EDF	A18	.
155	7559933	7560122	58	247	189	RIGHT	A18.EDF	A18	.
155	7560775	7561830	900	1955	1055	RIGHT	A18.EDF	A18	.
155	7562241	7562561	2366	2686	320	RIGHT	A18.EDF	A18	.
155	7562613	7563317	2738	3442	704	RIGHT	A18.EDF	A18	.
155	7564475	7564475	4600	4600	0	RIGHT	A18.EDF	A18	.
155	7564499	7564788	4624	4913	289	RIGHT	A18.EDF	A18	.
155	7564811	7564811	4936	4936	0	RIGHT	A18.EDF	A18	.
156	7569194	7569272	57	135	78	RIGHT	A18.EDF	A18	.
156	7569336	7569587	199	450	251	RIGHT	A18.EDF	A18	.
156	7569638	7569666	501	529	28	RIGHT	A18.EDF	A18	.
156	7569726	7569728	589	591	2	RIGHT	A18.EDF	A18	.
156	7569824	7569824	687	687	0	RIGHT	A18.EDF	A18	.
156	7569847	7569941	710	804	94	RIGHT	A18.EDF	A18	.
156	7570007	7570068	870	931	61	RIGHT	A18.EDF	A18	.
156	7570098	7570419	961	1282	321	RIGHT	A18.EDF	A18	.
156	7570478	7570739	1341	1602	261	RIGHT	A18.EDF	A18	.
156	7570764	7571337	1627	2200	573	RIGHT	A18.EDF	A18	.
156	7571431	7571433	2294	2296	2	RIGHT	A18.EDF	A18	.
156	7572023	7572174	2886	3037	151	RIGHT	A18.EDF	A18	.
156	7573417	7573423	4280	4286	6	RIGHT	A18.EDF	A18	.
156	7573444	7573449	4307	4312	5	RIGHT	A18.EDF	A18	.
156	7573503	7573522	4366	4385	19	RIGHT	A18.EDF	A18	.
156	7573675	7573682	4538	4545	7	RIGHT	A18.EDF	A18	.
156	7573703	7573730	4566	4593	27	RIGHT	A18.EDF	A18	.
156	7573751	7573752	4614	4615	1	RIGHT	A18.EDF	A18	.
156	7573781	7573782	4644	4645	1	RIGHT	A18.EDF	A18	.
156	7573819	7573829	4682	4692	10	RIGHT	A18.EDF	A18	.
156	7573853	7573879	4716	4742	26	RIGHT	A18.EDF	A18	.
156	7573936	7573963	4799	4826	27	RIGHT	A18.EDF	A18	.
156	7573987	7573988	4850	4851	1	RIGHT	A18.EDF	A18	.
156	7574033	7574058	4896	4921	25	RIGHT	A18.EDF	A18	.
156	7574079	7574091	4942	4954	12	RIGHT	A18.EDF	A18	.
156	7574116	7574480	4979	5343	364	RIGHT	A18.EDF	A18	.
156	7574508	7574575	5371	5438	67	RIGHT	A18.EDF	A18	.
156	7574599	7574624	5462	5487	25	RIGHT	A18.EDF	A18	.
156	7574645	7574691	5508	5554	46	RIGHT	A18.EDF	A18	.
156	7574713	7574713	5576	5576	0	RIGHT	A18.EDF	A18	.
156	7575028	7575097	5891	5960	69	RIGHT	A18.EDF	A18	.
156	7575120	7576012	5983	6875	892	RIGHT	A18.EDF	A18	.
157	7577827	7579198	57	1428	1371	RIGHT	A18.EDF	A18	.
157	7580514	7581154	2744	3384	640	RIGHT	A18.EDF	A18	.
157	7581219	7583306	3449	5536	2087	RIGHT	A18.EDF	A18	.
158	7584984	7588543	58	3617	3559	RIGHT	A18.EDF	A18	.
158	7588566	7588820	3640	3894	254	RIGHT	A18.EDF	A18	.
158	7588843	7592232	3917	7306	3389	RIGHT	A18.EDF	A18	.
159	7594201	7594443	58	300	242	RIGHT	A18.EDF	A18	.
159	7595002	7595013	859	870	11	RIGHT	A18.EDF	A18	.
159	7595148	7595512	1005	1369	364	RIGHT	A18.EDF	A18	.
159	7595547	7595915	1404	1772	368	RIGHT	A18.EDF	A18	.
159	7595955	7595956	1812	1813	1	RIGHT	A18.EDF	A18	.
159	7596307	7596901	2164	2758	594	RIGHT	A18.EDF	A18	.
159	7598242	7598256	4099	4113	14	RIGHT	A18.EDF	A18	.
159	7598280	7598437	4137	4294	157	RIGHT	A18.EDF	A18	.
159	7598518	7598787	4375	4644	269	RIGHT	A18.EDF	A18	.
159	7598844	7598911	4701	4768	67	RIGHT	A18.EDF	A18	.
159	7598942	7598942	4799	4799	0	RIGHT	A18.EDF	A18	.
159	7598968	7598968	4825	4825	0	RIGHT	A18.EDF	A18	.
159	7599006	7599011	4863	4868	5	RIGHT	A18.EDF	A18	.
159	7599039	7599052	4896	4909	13	RIGHT	A18.EDF	A18	.
159	7599166	7599167	5023	5024	1	RIGHT	A18.EDF	A18	.
159	7599292	7599292	5149	5149	0	RIGHT	A18.EDF	A18	.
159	7599388	7599389	5245	5246	1	RIGHT	A18.EDF	A18	.
159	7599421	7600468	5278	6325	1047	RIGHT	A18.EDF	A18	.
160	7602627	7603385	58	816	758	RIGHT	A18.EDF	A18	.
160	7604381	7604397	1812	1828	16	RIGHT	A18.EDF	A18	.
160	7604436	7606411	1867	3842	1975	RIGHT	A18.EDF	A18	.
160	7606449	7607401	3880	4832	952	RIGHT	A18.EDF	A18	.
161	7610078	7612401	515	2838	2323	RIGHT	A18.EDF	A18	.
161	7612778	7615236	3215	5673	2458	RIGHT	A18.EDF	A18	.
162	7617037	7617101	57	121	64	RIGHT	A18.EDF	A18	.
162	7617128	7617132	148	152	4	RIGHT	A18.EDF	A18	.
162	7617158	7617162	178	182	4	RIGHT	A18.EDF	A18	.
162	7617190	7617236	210	256	46	RIGHT	A18.EDF	A18	.
162	7617588	7617602	608	622	14	RIGHT	A18.EDF	A18	.
162	7617647	7617675	667	695	28	RIGHT	A18.EDF	A18	.
162	7617816	7618609	836	1629	793	RIGHT	A18.EDF	A18	.
162	7618781	7618781	1801	1801	0	RIGHT	A18.EDF	A18	.
162	7618835	7619096	1855	2116	261	RIGHT	A18.EDF	A18	.
162	7619328	7619476	2348	2496	148	RIGHT	A18.EDF	A18	.
162	7619670	7619982	2690	3002	312	RIGHT	A18.EDF	A18	.
162	7620015	7620751	3035	3771	736	RIGHT	A18.EDF	A18	.
162	7620821	7622128	3841	5148	1307	RIGHT	A18.EDF	A18	.
162	7622162	7622266	5182	5286	104	RIGHT	A18.EDF	A18	.
162	7622738	7622738	5758	5758	0	RIGHT	A18.EDF	A18	.
162	7622986	7623005	6006	6025	19	RIGHT	A18.EDF	A18	.
162	7623068	7623068	6088	6088	0	RIGHT	A18.EDF	A18	.
162	7623200	7623200	6220	6220	0	RIGHT	A18.EDF	A18	.
163	7627949	7627973	57	81	24	RIGHT	A18.EDF	A18	.
163	7628373	7628373	481	481	0	RIGHT	A18.EDF	A18	.
163	7628475	7628790	583	898	315	RIGHT	A18.EDF	A18	.
163	7629207	7629380	1315	1488	173	RIGHT	A18.EDF	A18	.
163	7629401	7629500	1509	1608	99	RIGHT	A18.EDF	A18	.
163	7629524	7629539	1632	1647	15	RIGHT	A18.EDF	A18	.
163	7629833	7629841	1941	1949	8	RIGHT	A18.EDF	A18	.
163	7629868	7630241	1976	2349	373	RIGHT	A18.EDF	A18	.
163	7630273	7630841	2381	2949	568	RIGHT	A18.EDF	A18	.
163	7630873	7632041	2981	4149	1168	RIGHT	A18.EDF	A18	.
163	7632508	7633277	4616	5385	769	RIGHT	A18.EDF	A18	.
163	7633770	7634046	5878	6154	276	RIGHT	A18.EDF	A18	.
163	7634308	7634318	6416	6426	10	RIGHT	A18.EDF	A18	.
164	7636745	7636869	57	181	124	RIGHT	A18.EDF	A18	.
164	7636906	7636940	218	252	34	RIGHT	A18.EDF	A18	.
164	7636979	7637011	291	323	32	RIGHT	A18.EDF	A18	.
164	7637558	7638225	870	1537	667	RIGHT	A18.EDF	A18	.
164	7638263	7639071	1575	2383	808	RIGHT	A18.EDF	A18	.
164	7639107	7639108	2419	2420	1	RIGHT	A18.EDF	A18	.
164	7639140	7639153	2452	2465	13	RIGHT	A18.EDF	A18	.
164	7639177	7639209	2489	2521	32	RIGHT	A18.EDF	A18	.
164	7639303	7639303	2615	2615	0	RIGHT	A18.EDF	A18	.
164	7639327	7639348	2639	2660	21	RIGHT	A18.EDF	A18	.
164	7639388	7639419	2700	2731	31	RIGHT	A18.EDF	A18	.
164	7639816	7640455	3128	3767	639	RIGHT	A18.EDF	A18	.
164	7640483	7640496	3795	3808	13	RIGHT	A18.EDF	A18	.
164	7640861	7642012	4173	5324	1151	RIGHT	A18.EDF	A18	.
164	7642035	7642163	5347	5475	128	RIGHT	A18.EDF	A18	.
165	7643797	7644083	57	343	286	RIGHT	A18.EDF	A18	.
165	7644184	7644186	444	446	2	RIGHT	A18.EDF	A18	.
165	7644211	7644827	471	1087	616	RIGHT	A18.EDF	A18	.
165	7644889	7645538	1149	1798	649	RIGHT	A18.EDF	A18	.
165	7645634	7646450	1894	2710	816	RIGHT	A18.EDF	A18	.
165	7646609	7646652	2869	2912	43	RIGHT	A18.EDF	A18	.
165	7646712	7646789	2972	3049	77	RIGHT	A18.EDF	A18	.
165	7647291	7647679	3551	3939	388	RIGHT	A18.EDF	A18	.
165	7647881	7647886	4141	4146	5	RIGHT	A18.EDF	A18	.
165	7649047	7650688	5307	6948	1641	RIGHT	A18.EDF	A18	.
166	7652534	7653136	57	659	602	RIGHT	A18.EDF	A18	.
166	7653524	7653524	1047	1047	0	RIGHT	A18.EDF	A18	.
166	7653546	7653552	1069	1075	6	RIGHT	A18.EDF	A18	.
166	7653601	7653602	1124	1125	1	RIGHT	A18.EDF	A18	.
166	7653624	7653774	1147	1297	150	RIGHT	A18.EDF	A18	.
166	7653881	7653972	1404	1495	91	RIGHT	A18.EDF	A18	.
166	7654068	7654096	1591	1619	28	RIGHT	A18.EDF	A18	.
166	7654139	7654213	1662	1736	74	RIGHT	A18.EDF	A18	.
166	7654239	7656074	1762	3597	1835	RIGHT	A18.EDF	A18	.
166	7656209	7656342	3732	3865	133	RIGHT	A18.EDF	A18	.
166	7656386	7657494	3909	5017	1108	RIGHT	A18.EDF	A18	.
166	7657575	7657753	5098	5276	178	RIGHT	A18.EDF	A18	.
167	7661964	7662031	1702	1769	67	RIGHT	A18.EDF	A18	.
167	7662718	7663504	2456	3242	786	RIGHT	A18.EDF	A18	.
167	7663560	7664870	3298	4608	1310	RIGHT	A18.EDF	A18	.
167	7664960	7664977	4698	4715	17	RIGHT	A18.EDF	A18	.
167	7665388	7665547	5126	5285	159	RIGHT	A18.EDF	A18	.
167	7665569	7666508	5307	6246	939	RIGHT	A18.EDF	A18	.
168	7669848	7672985	58	3195	3137	RIGHT	A18.EDF	A18	.
168	7674395	7674822	4605	5032	427	RIGHT	A18.EDF	A18	.
169	7678280	7678916	57	693	636	RIGHT	A18.EDF	A18	.
169	7679029	7679030	806	807	1	RIGHT	A18.EDF	A18	.
169	7679099	7679134	876	911	35	RIGHT	A18.EDF	A18	.
169	7679157	7679657	934	1434	500	RIGHT	A18.EDF	A18	.
169	7679890	7679934	1667	1711	44	RIGHT	A18.EDF	A18	.
169	7681737	7682998	3514	4775	1261	RIGHT	A18.EDF	A18	.
169	7683035	7685069	4812	6846	2034	RIGHT	A18.EDF	A18	.
170	7687037	7687839	57	859	802	RIGHT	A18.EDF	A18	.
170	7688028	7688029	1048	1049	1	RIGHT	A18.EDF	A18	.
170	7688150	7688177	1170	1197	27	RIGHT	A18.EDF	A18	.
170	7688208	7690982	1228	4002	2774	RIGHT	A18.EDF	A18	.
170	7691136	7691910	4156	4930	774	RIGHT	A18.EDF	A18	.
170	7692124	7692604	5144	5624	480	RIGHT	A18.EDF	A18	.
171	7696161	7696697	58	594	536	RIGHT	A18.EDF	A18	.
171	7696843	7696858	740	755	15	RIGHT	A18.EDF	A18	.
171	7697162	7697183	1059	1080	21	RIGHT	A18.EDF	A18	.
171	7697204	7697205	1101	1102	1	RIGHT	A18.EDF	A18	.
171	7697263	7697264	1160	1161	1	RIGHT	A18.EDF	A18	.
171	7697291	7697292	1188	1189	1	RIGHT	A18.EDF	A18	.
171	7697332	7697349	1229	1246	17	RIGHT	A18.EDF	A18	.
171	7697494	7697495	1391	1392	1	RIGHT	A18.EDF	A18	.
171	7697519	7698036	1416	1933	517	RIGHT	A18.EDF	A18	.
171	7698390	7700544	2287	4441	2154	RIGHT	A18.EDF	A18	.
171	7700571	7700847	4468	4744	276	RIGHT	A18.EDF	A18	.
171	7700898	7700900	4795	4797	2	RIGHT	A18.EDF	A18	.
171	7700938	7700938	4835	4835	0	RIGHT	A18.EDF	A18	.
171	7700966	7701299	4863	5196	333	RIGHT	A18.EDF	A18	.
172	7703436	7704287	76	927	851	RIGHT	A18.EDF	A18	.
172	7704323	7705119	963	1759	796	RIGHT	A18.EDF	A18	.
172	7705499	7705766	2139	2406	267	RIGHT	A18.EDF	A18	.
172	7705810	7705820	2450	2460	10	RIGHT	A18.EDF	A18	.
172	7705982	7706333	2622	2973	351	RIGHT	A18.EDF	A18	.
172	7706538	7706563	3178	3203	25	RIGHT	A18.EDF	A18	.
172	7706587	7706614	3227	3254	27	RIGHT	A18.EDF	A18	.
172	7706638	7706648	3278	3288	10	RIGHT	A18.EDF	A18	.
172	7706686	7707185	3326	3825	499	RIGHT	A18.EDF	A18	.
172	7707206	7707575	3846	4215	369	RIGHT	A18.EDF	A18	.
172	7707600	7708644	4240	5284	1044	RIGHT	A18.EDF	A18	.
173	7710968	7711578	57	667	610	RIGHT	A18.EDF	A18	.
173	7711633	7711707	722	796	74	RIGHT	A18.EDF	A18	.
173	7711806	7711806	895	895	0	RIGHT	A18.EDF	A18	.
173	7715211	7715653	4300	4742	442	RIGHT	A18.EDF	A18	.
173	7715689	7715700	4778	4789	11	RIGHT	A18.EDF	A18	.
173	7715726	7715812	4815	4901	86	RIGHT	A18.EDF	A18	.
173	7715901	7717030	4990	6119	1129	RIGHT	A18.EDF	A18	.
174	7834127	7834188	57	118	61	RIGHT	A18.EDF	A18	.
174	7835111	7835679	1041	1609	568	RIGHT	A18.EDF	A18	.
175	7841233	7841431	57	255	198	RIGHT	A18.EDF	A18	.
175	7844884	7844897	3708	3721	13	RIGHT	A18.EDF	A18	.
175	7844923	7844956	3747	3780	33	RIGHT	A18.EDF	A18	.
175	7845019	7845213	3843	4037	194	RIGHT	A18.EDF	A18	.
175	7845247	7845265	4071	4089	18	RIGHT	A18.EDF	A18	.
175	7845410	7845517	4234	4341	107	RIGHT	A18.EDF	A18	.
176	7849177	7849319	58	200	142	RIGHT	A18.EDF	A18	.
176	7849350	7849399	231	280	49	RIGHT	A18.EDF	A18	.
176	7849448	7849486	329	367	38	RIGHT	A18.EDF	A18	.
176	7849509	7849510	390	391	1	RIGHT	A18.EDF	A18	.
176	7849531	7849662	412	543	131	RIGHT	A18.EDF	A18	.
177	7857423	7857483	58	118	60	RIGHT	A18.EDF	A18	.
177	7858788	7859127	1423	1762	339	RIGHT	A18.EDF	A18	.
177	7861081	7861356	3716	3991	275	RIGHT	A18.EDF	A18	.
178	7866380	7866523	57	200	143	RIGHT	A18.EDF	A18	.
178	7866703	7866707	380	384	4	RIGHT	A18.EDF	A18	.
178	7870412	7870538	4089	4215	126	RIGHT	A18.EDF	A18	.
178	7870577	7870580	4254	4257	3	RIGHT	A18.EDF	A18	.
178	7870712	7870745	4389	4422	33	RIGHT	A18.EDF	A18	.
179	7873201	7873809	99	707	608	RIGHT	A18.EDF	A18	.
179	7874499	7874512	1397	1410	13	RIGHT	A18.EDF	A18	.
179	7874551	7874567	1449	1465	16	RIGHT	A18.EDF	A18	.
179	7874598	7874697	1496	1595	99	RIGHT	A18.EDF	A18	.
180	7881155	7881615	58	518	460	RIGHT	A18.EDF	A18	.
181	7894877	7895131	4913	5167	254	RIGHT	A18.EDF	A18	.
181	7895254	7895299	5290	5335	45	RIGHT	A18.EDF	A18	.
182	7901840	7902421	2624	3205	581	RIGHT	A18.EDF	A18	.
182	7902715	7903078	3499	3862	363	RIGHT	A18.EDF	A18	.
182	7903230	7903249	4014	4033	19	RIGHT	A18.EDF	A18	.
182	7903501	7903800	4285	4584	299	RIGHT	A18.EDF	A18	.
182	7905040	7905416	5824	6200	376	RIGHT	A18.EDF	A18	.
183	7907294	7907508	57	271	214	RIGHT	A18.EDF	A18	.
183	7907741	7907743	504	506	2	RIGHT	A18.EDF	A18	.
183	7907781	7907851	544	614	70	RIGHT	A18.EDF	A18	.
184	7915731	7916177	58	504	446	RIGHT	A18.EDF	A18	.
184	7916218	7916726	545	1053	508	RIGHT	A18.EDF	A18	.
184	7918722	7919053	3049	3380	331	RIGHT	A18.EDF	A18	.
184	7919087	7919311	3414	3638	224	RIGHT	A18.EDF	A18	.
184	7920492	7920731	4819	5058	239	RIGHT	A18.EDF	A18	.
184	7920769	7920815	5096	5142	46	RIGHT	A18.EDF	A18	.
184	7920858	7920865	5185	5192	7	RIGHT	A18.EDF	A18	.
184	7920896	7921183	5223	5510	287	RIGHT	A18.EDF	A18	.
185	7925740	7926814	236	1310	1074	RIGHT	A18.EDF	A18	.
185	7926843	7927678	1339	2174	835	RIGHT	A18.EDF	A18	.
186	7936634	7937020	1980	2366	386	RIGHT	A18.EDF	A18	.
186	7937689	7937894	3035	3240	205	RIGHT	A18.EDF	A18	.
186	7937929	7938096	3275	3442	167	RIGHT	A18.EDF	A18	.
186	7938360	7939227	3706	4573	867	RIGHT	A18.EDF	A18	.
187	7944169	7944864	454	1149	695	RIGHT	A18.EDF	A18	.
187	7945111	7945245	1396	1530	134	RIGHT	A18.EDF	A18	.
187	7948012	7948013	4297	4298	1	RIGHT	A18.EDF	A18	.
187	7948035	7948215	4320	4500	180	RIGHT	A18.EDF	A18	.
187	7948304	7948563	4589	4848	259	RIGHT	A18.EDF	A18	.
187	7948626	7948626	4911	4911	0	RIGHT	A18.EDF	A18	.
187	7948663	7948672	4948	4957	9	RIGHT	A18.EDF	A18	.
188	7954437	7954811	2778	3152	374	RIGHT	A18.EDF	A18	.
188	7955179	7955316	3520	3657	137	RIGHT	A18.EDF	A18	.
188	7955349	7955500	3690	3841	151	RIGHT	A18.EDF	A18	.
188	7956789	7956903	5130	5244	114	RIGHT	A18.EDF	A18	.
188	7956928	7957051	5269	5392	123	RIGHT	A18.EDF	A18	.
188	7957588	7957755	5929	6096	167	RIGHT	A18.EDF	A18	.
188	7957786	7957975	6127	6316	189	RIGHT	A18.EDF	A18	.
189	7960988	7960989	77	78	1	RIGHT	A18.EDF	A18	.
189	7962265	7962269	1354	1358	4	RIGHT	A18.EDF	A18	.
189	7962302	7962434	1391	1523	132	RIGHT	A18.EDF	A18	.
189	7962464	7962549	1553	1638	85	RIGHT	A18.EDF	A18	.
189	7962580	7962896	1669	1985	316	RIGHT	A18.EDF	A18	.
189	7962929	7963356	2018	2445	427	RIGHT	A18.EDF	A18	.
189	7963382	7963390	2471	2479	8	RIGHT	A18.EDF	A18	.
189	7964083	7964365	3172	3454	282	RIGHT	A18.EDF	A18	.
189	7964395	7964958	3484	4047	563	RIGHT	A18.EDF	A18	.
189	7964993	7965057	4082	4146	64	RIGHT	A18.EDF	A18	.
189	7965080	7965870	4169	4959	790	RIGHT	A18.EDF	A18	.
189	7965977	7967774	5066	6863	1797	RIGHT	A18.EDF	A18	.
190	7969599	7969759	58	218	160	RIGHT	A18.EDF	A18	.
190	7969806	7969807	265	266	1	RIGHT	A18.EDF	A18	.
190	7969914	7969914	373	373	0	RIGHT	A18.EDF	A18	.
190	7969969	7969969	428	428	0	RIGHT	A18.EDF	A18	.
190	7970150	7970151	609	610	1	RIGHT	A18.EDF	A18	.
190	7970191	7970191	650	650	0	RIGHT	A18.EDF	A18	.
190	7970245	7970510	704	969	265	RIGHT	A18.EDF	A18	.
190	7972535	7972548	2994	3007	13	RIGHT	A18.EDF	A18	.
190	7972569	7972699	3028	3158	130	RIGHT	A18.EDF	A18	.
190	7972721	7972872	3180	3331	151	RIGHT	A18.EDF	A18	.
190	7973977	7975153	4436	5612	1176	RIGHT	A18.EDF	A18	.
190	7975589	7975589	6048	6048	0	RIGHT	A18.EDF	A18	.
190	7975635	7975658	6094	6117	23	RIGHT	A18.EDF	A18	.
191	7977404	7978120	57	773	716	RIGHT	A18.EDF	A18	.
191	7978141	7978141	794	794	0	RIGHT	A18.EDF	A18	.
191	7978546	7978740	1199	1393	194	RIGHT	A18.EDF	A18	.
191	7981123	7984124	3776	6777	3001	RIGHT	A18.EDF	A18	.
192	7986898	7987175	58	335	277	RIGHT	A18.EDF	A18	.
192	7987234	7988492	394	1652	1258	RIGHT	A18.EDF	A18	.
192	7989317	7989677	2477	2837	360	RIGHT	A18.EDF	A18	.
192	7990640	7991764	3800	4924	1124	RIGHT	A18.EDF	A18	.
193	7994763	7995504	58	799	741	RIGHT	A18.EDF	A18	.
193	7995542	7996799	837	2094	1257	RIGHT	A18.EDF	A18	.
193	7997394	7997753	2689	3048	359	RIGHT	A18.EDF	A18	.
193	7997835	7998546	3130	3841	711	RIGHT	A18.EDF	A18	.
193	7998567	7998582	3862	3877	15	RIGHT	A18.EDF	A18	.
193	7998867	7999136	4162	4431	269	RIGHT	A18.EDF	A18	.
193	7999212	7999215	4507	4510	3	RIGHT	A18.EDF	A18	.
193	7999335	8000524	4630	5819	1189	RIGHT	A18.EDF	A18	.
194	8003251	8003635	58	442	384	RIGHT	A18.EDF	A18	.
194	8003865	8003883	672	690	18	RIGHT	A18.EDF	A18	.
194	8003914	8003984	721	791	70	RIGHT	A18.EDF	A18	.
194	8004043	8004063	850	870	20	RIGHT	A18.EDF	A18	.
194	8004129	8004145	936	952	16	RIGHT	A18.EDF	A18	.
194	8004320	8004359	1127	1166	39	RIGHT	A18.EDF	A18	.
194	8004397	8004429	1204	1236	32	RIGHT	A18.EDF	A18	.
194	8004499	8004526	1306	1333	27	RIGHT	A18.EDF	A18	.
194	8004566	8004569	1373	1376	3	RIGHT	A18.EDF	A18	.
194	8004610	8004611	1417	1418	1	RIGHT	A18.EDF	A18	.
194	8005070	8006990	1877	3797	1920	RIGHT	A18.EDF	A18	.
194	8007012	8007298	3819	4105	286	RIGHT	A18.EDF	A18	.
194	8007404	8007818	4211	4625	414	RIGHT	A18.EDF	A18	.
194	8007848	8007867	4655	4674	19	RIGHT	A18.EDF	A18	.
194	8007940	8007952	4747	4759	12	RIGHT	A18.EDF	A18	.
194	8007973	8008999	4780	5806	1026	RIGHT	A18.EDF	A18	.
195	8010874	8011093	57	276	219	RIGHT	A18.EDF	A18	.
195	8011203	8012105	386	1288	902	RIGHT	A18.EDF	A18	.
195	8012126	8012865	1309	2048	739	RIGHT	A18.EDF	A18	.
195	8013216	8013217	2399	2400	1	RIGHT	A18.EDF	A18	.
195	8013287	8013461	2470	2644	174	RIGHT	A18.EDF	A18	.
195	8013555	8013629	2738	2812	74	RIGHT	A18.EDF	A18	.
195	8013740	8013981	2923	3164	241	RIGHT	A18.EDF	A18	.
195	8014065	8014127	3248	3310	62	RIGHT	A18.EDF	A18	.
195	8014148	8014149	3331	3332	1	RIGHT	A18.EDF	A18	.
195	8014190	8014393	3373	3576	203	RIGHT	A18.EDF	A18	.
195	8014519	8014726	3702	3909	207	RIGHT	A18.EDF	A18	.
195	8014780	8014781	3963	3964	1	RIGHT	A18.EDF	A18	.
195	8014865	8014903	4048	4086	38	RIGHT	A18.EDF	A18	.
195	8014957	8015392	4140	4575	435	RIGHT	A18.EDF	A18	.
195	8015425	8015768	4608	4951	343	RIGHT	A18.EDF	A18	.
195	8016158	8016159	5341	5342	1	RIGHT	A18.EDF	A18	.
195	8016398	8016411	5581	5594	13	RIGHT	A18.EDF	A18	.
195	8016565	8016734	5748	5917	169	RIGHT	A18.EDF	A18	.
196	8019594	8019611	363	380	17	RIGHT	A18.EDF	A18	.
196	8019667	8020012	436	781	345	RIGHT	A18.EDF	A18	.
196	8020033	8020174	802	943	141	RIGHT	A18.EDF	A18	.
196	8024077	8024081	4846	4850	4	RIGHT	A18.EDF	A18	.
196	8024106	8024389	4875	5158	283	RIGHT	A18.EDF	A18	.
196	8024414	8024458	5183	5227	44	RIGHT	A18.EDF	A18	.
197	8027531	8027531	400	400	0	RIGHT	A18.EDF	A18	.
197	8027610	8027611	479	480	1	RIGHT	A18.EDF	A18	.
197	8027640	8028160	509	1029	520	RIGHT	A18.EDF	A18	.
197	8028362	8028464	1231	1333	102	RIGHT	A18.EDF	A18	.
197	8028492	8028515	1361	1384	23	RIGHT	A18.EDF	A18	.
197	8030952	8031274	3821	4143	322	RIGHT	A18.EDF	A18	.
197	8031297	8031316	4166	4185	19	RIGHT	A18.EDF	A18	.
197	8031671	8031693	4540	4562	22	RIGHT	A18.EDF	A18	.
198	8033762	8033843	58	139	81	RIGHT	A18.EDF	A18	.
198	8033933	8033933	229	229	0	RIGHT	A18.EDF	A18	.
198	8033957	8034016	253	312	59	RIGHT	A18.EDF	A18	.
198	8034038	8034153	334	449	115	RIGHT	A18.EDF	A18	.
198	8035857	8036930	2153	3226	1073	RIGHT	A18.EDF	A18	.
198	8038077	8038472	4373	4768	395	RIGHT	A18.EDF	A18	.
198	8038658	8038661	4954	4957	3	RIGHT	A18.EDF	A18	.
198	8038684	8038795	4980	5091	111	RIGHT	A18.EDF	A18	.
198	8039335	8039338	5631	5634	3	RIGHT	A18.EDF	A18	.
198	8039386	8039452	5682	5748	66	RIGHT	A18.EDF	A18	.
199	8042451	8043322	641	1512	871	RIGHT	A18.EDF	A18	.
199	8043343	8043354	1533	1544	11	RIGHT	A18.EDF	A18	.
199	8043375	8043409	1565	1599	34	RIGHT	A18.EDF	A18	.
199	8043462	8043649	1652	1839	187	RIGHT	A18.EDF	A18	.
199	8043891	8043918	2081	2108	27	RIGHT	A18.EDF	A18	.
199	8047769	8047911	5959	6101	142	RIGHT	A18.EDF	A18	.
199	8047937	8047964	6127	6154	27	RIGHT	A18.EDF	A18	.
200	8050202	8050355	58	211	153	RIGHT	A18.EDF	A18	.
200	8050383	8052076	239	1932	1693	RIGHT	A18.EDF	A18	.
200	8053033	8053751	2889	3607	718	RIGHT	A18.EDF	A18	.
200	8054098	8054538	3954	4394	440	RIGHT	A18.EDF	A18	.
201	8057103	8057372	57	326	269	RIGHT	A18.EDF	A18	.
201	8061217	8061235	4171	4189	18	RIGHT	A18.EDF	A18	.
201	8061333	8061335	4287	4289	2	RIGHT	A18.EDF	A18	.
201	8061595	8061595	4549	4549	0	RIGHT	A18.EDF	A18	.
201	8061619	8061824	4573	4778	205	RIGHT	A18.EDF	A18	.
201	8061872	8062149	4826	5103	277	RIGHT	A18.EDF	A18	.
202	8065135	8065637	57	559	502	RIGHT	A18.EDF	A18	.
202	8067329	8067666	2251	2588	337	RIGHT	A18.EDF	A18	.
202	8067688	8067705	2610	2627	17	RIGHT	A18.EDF	A18	.
202	8067801	8067805	2723	2727	4	RIGHT	A18.EDF	A18	.
202	8067846	8067847	2768	2769	1	RIGHT	A18.EDF	A18	.
202	8067868	8068043	2790	2965	175	RIGHT	A18.EDF	A18	.
202	8068238	8068238	3160	3160	0	RIGHT	A18.EDF	A18	.
202	8068343	8068355	3265	3277	12	RIGHT	A18.EDF	A18	.
202	8068379	8068865	3301	3787	486	RIGHT	A18.EDF	A18	.
202	8069339	8069407	4261	4329	68	RIGHT	A18.EDF	A18	.
202	8069469	8070018	4391	4940	549	RIGHT	A18.EDF	A18	.
202	8071385	8071718	6307	6640	333	RIGHT	A18.EDF	A18	.
203	8073834	8074163	57	386	329	RIGHT	A18.EDF	A18	.
203	8074596	8074597	819	820	1	RIGHT	A18.EDF	A18	.
203	8074687	8074687	910	910	0	RIGHT	A18.EDF	A18	.
203	8074772	8074772	995	995	0	RIGHT	A18.EDF	A18	.
203	8074827	8074843	1050	1066	16	RIGHT	A18.EDF	A18	.
203	8074870	8074916	1093	1139	46	RIGHT	A18.EDF	A18	.
203	8076898	8077093	3121	3316	195	RIGHT	A18.EDF	A18	.
203	8077121	8077272	3344	3495	151	RIGHT	A18.EDF	A18	.
203	8077300	8077536	3523	3759	236	RIGHT	A18.EDF	A18	.
203	8077656	8078059	3879	4282	403	RIGHT	A18.EDF	A18	.
203	8078375	8078473	4598	4696	98	RIGHT	A18.EDF	A18	.
203	8078598	8078598	4821	4821	0	RIGHT	A18.EDF	A18	.
203	8078703	8079196	4926	5419	493	RIGHT	A18.EDF	A18	.
204	8081672	8081887	57	272	215	RIGHT	A18.EDF	A18	.
204	8082522	8082532	907	917	10	RIGHT	A18.EDF	A18	.
204	8082615	8082640	1000	1025	25	RIGHT	A18.EDF	A18	.
204	8083113	8083125	1498	1510	12	RIGHT	A18.EDF	A18	.
204	8083176	8083387	1561	1772	211	RIGHT	A18.EDF	A18	.
204	8083751	8083833	2136	2218	82	RIGHT	A18.EDF	A18	.
204	8084286	8085107	2671	3492	821	RIGHT	A18.EDF	A18	.
204	8085136	8085161	3521	3546	25	RIGHT	A18.EDF	A18	.
204	8085300	8085385	3685	3770	85	RIGHT	A18.EDF	A18	.
204	8085463	8085503	3848	3888	40	RIGHT	A18.EDF	A18	.
204	8085534	8085815	3919	4200	281	RIGHT	A18.EDF	A18	.
204	8085852	8085854	4237	4239	2	RIGHT	A18.EDF	A18	.
204	8085915	8085917	4300	4302	2	RIGHT	A18.EDF	A18	.
204	8085957	8085977	4342	4362	20	RIGHT	A18.EDF	A18	.
204	8085998	8086052	4383	4437	54	RIGHT	A18.EDF	A18	.
204	8086117	8086283	4502	4668	166	RIGHT	A18.EDF	A18	.
204	8087105	8087278	5490	5663	173	RIGHT	A18.EDF	A18	.
205	8090412	8091106	210	904	694	RIGHT	A18.EDF	A18	.
205	8091747	8091851	1545	1649	104	RIGHT	A18.EDF	A18	.
205	8093111	8093430	2909	3228	319	RIGHT	A18.EDF	A18	.
205	8093675	8093676	3473	3474	1	RIGHT	A18.EDF	A18	.
205	8093795	8093795	3593	3593	0	RIGHT	A18.EDF	A18	.
205	8093821	8094064	3619	3862	243	RIGHT	A18.EDF	A18	.
205	8094828	8094832	4626	4630	4	RIGHT	A18.EDF	A18	.
205	8094869	8095075	4667	4873	206	RIGHT	A18.EDF	A18	.
205	8095305	8095512	5103	5310	207	RIGHT	A18.EDF	A18	.
206	8099339	8099707	58	426	368	RIGHT	A18.EDF	A18	.
206	8100493	8100515	1212	1234	22	RIGHT	A18.EDF	A18	.
206	8103758	8104013	4477	4732	255	RIGHT	A18.EDF	A18	.
206	8104114	8104310	4833	5029	196	RIGHT	A18.EDF	A18	.
206	8105059	8105082	5778	5801	23	RIGHT	A18.EDF	A18	.
206	8105182	8105228	5901	5947	46	RIGHT	A18.EDF	A18	.
206	8105250	8105464	5969	6183	214	RIGHT	A18.EDF	A18	.
206	8105488	8105596	6207	6315	108	RIGHT	A18.EDF	A18	.
207	8107687	8108189	58	560	502	RIGHT	A18.EDF	A18	.
207	8108221	8108254	592	625	33	RIGHT	A18.EDF	A18	.
207	8108459	8108460	830	831	1	RIGHT	A18.EDF	A18	.
207	8108501	8109339	872	1710	838	RIGHT	A18.EDF	A18	.
207	8109591	8109591	1962	1962	0	RIGHT	A18.EDF	A18	.
207	8109724	8110344	2095	2715	620	RIGHT	A18.EDF	A18	.
207	8111996	8112279	4367	4650	283	RIGHT	A18.EDF	A18	.
207	8112305	8112643	4676	5014	338	RIGHT	A18.EDF	A18	.
208	8114666	8114893	58	285	227	RIGHT	A18.EDF	A18	.
208	8115236	8115236	628	628	0	RIGHT	A18.EDF	A18	.
208	8115274	8116875	666	2267	1601	RIGHT	A18.EDF	A18	.
208	8117012	8117012	2404	2404	0	RIGHT	A18.EDF	A18	.
208	8117087	8117809	2479	3201	722	RIGHT	A18.EDF	A18	.
208	8117851	8118251	3243	3643	400	RIGHT	A18.EDF	A18	.
208	8118344	8118344	3736	3736	0	RIGHT	A18.EDF	A18	.
208	8118377	8118378	3769	3770	1	RIGHT	A18.EDF	A18	.
208	8118429	8118669	3821	4061	240	RIGHT	A18.EDF	A18	.
208	8118701	8119201	4093	4593	500	RIGHT	A18.EDF	A18	.
208	8119334	8119335	4726	4727	1	RIGHT	A18.EDF	A18	.
208	8119402	8119429	4794	4821	27	RIGHT	A18.EDF	A18	.
208	8119522	8119550	4914	4942	28	RIGHT	A18.EDF	A18	.
208	8119614	8119618	5006	5010	4	RIGHT	A18.EDF	A18	.
208	8119652	8120122	5044	5514	470	RIGHT	A18.EDF	A18	.
208	8120173	8120442	5565	5834	269	RIGHT	A18.EDF	A18	.
209	8122511	8122533	57	79	22	RIGHT	A18.EDF	A18	.
209	8122558	8123235	104	781	677	RIGHT	A18.EDF	A18	.
209	8123649	8123657	1195	1203	8	RIGHT	A18.EDF	A18	.
209	8123724	8123801	1270	1347	77	RIGHT	A18.EDF	A18	.
209	8123827	8124121	1373	1667	294	RIGHT	A18.EDF	A18	.
209	8124143	8124537	1689	2083	394	RIGHT	A18.EDF	A18	.
209	8124692	8125657	2238	3203	965	RIGHT	A18.EDF	A18	.
209	8125684	8126547	3230	4093	863	RIGHT	A18.EDF	A18	.
209	8126901	8127195	4447	4741	294	RIGHT	A18.EDF	A18	.
209	8127678	8128303	5224	5849	625	RIGHT	A18.EDF	A18	.
209	8128334	8128635	5880	6181	301	RIGHT	A18.EDF	A18	.
209	8128678	8129059	6224	6605	381	RIGHT	A18.EDF	A18	.
209	8129165	8129403	6711	6949	238	RIGHT	A18.EDF	A18	.
210	8131737	8131748	126	137	11	RIGHT	A18.EDF	A18	.
210	8131771	8131774	160	163	3	RIGHT	A18.EDF	A18	.
210	8132153	8133315	542	1704	1162	RIGHT	A18.EDF	A18	.
210	8133361	8133652	1750	2041	291	RIGHT	A18.EDF	A18	.
210	8133744	8133798	2133	2187	54	RIGHT	A18.EDF	A18	.
210	8133837	8134283	2226	2672	446	RIGHT	A18.EDF	A18	.
210	8134307	8134308	2696	2697	1	RIGHT	A18.EDF	A18	.
210	8134554	8135597	2943	3986	1043	RIGHT	A18.EDF	A18	.
210	8135639	8135641	4028	4030	2	RIGHT	A18.EDF	A18	.
210	8135669	8135687	4058	4076	18	RIGHT	A18.EDF	A18	.
210	8135708	8135864	4097	4253	156	RIGHT	A18.EDF	A18	.
210	8135885	8136184	4274	4573	299	RIGHT	A18.EDF	A18	.
210	8136323	8136778	4712	5167	455	RIGHT	A18.EDF	A18	.
211	8140176	8140230	457	511	54	RIGHT	A18.EDF	A18	.
211	8140255	8141234	536	1515	979	RIGHT	A18.EDF	A18	.
211	8141655	8141668	1936	1949	13	RIGHT	A18.EDF	A18	.
211	8141722	8143609	2003	3890	1887	RIGHT	A18.EDF	A18	.
211	8143643	8143949	3924	4230	306	RIGHT	A18.EDF	A18	.
211	8143984	8144002	4265	4283	18	RIGHT	A18.EDF	A18	.
211	8144321	8146143	4602	6424	1822	RIGHT	A18.EDF	A18	.
212	8148244	8148472	57	285	228	RIGHT	A18.EDF	A18	.
212	8148619	8148694	432	507	75	RIGHT	A18.EDF	A18	.
212	8148723	8148880	536	693	157	RIGHT	A18.EDF	A18	.
212	8148936	8149423	749	1236	487	RIGHT	A18.EDF	A18	.
212	8149868	8149871	1681	1684	3	RIGHT	A18.EDF	A18	.
212	8150403	8151228	2216	3041	825	RIGHT	A18.EDF	A18	.
212	8151306	8151515	3119	3328	209	RIGHT	A18.EDF	A18	.
212	8151580	8152382	3393	4195	802	RIGHT	A18.EDF	A18	.
212	8153484	8154559	5297	6372	1075	RIGHT	A18.EDF	A18	.
213	8156367	8156545	57	235	178	RIGHT	A18.EDF	A18	.
213	8156577	8158512	267	2202	1935	RIGHT	A18.EDF	A18	.
213	8158750	8158751	2440	2441	1	RIGHT	A18.EDF	A18	.
213	8158779	8158946	2469	2636	167	RIGHT	A18.EDF	A18	.
213	8158978	8159258	2668	2948	280	RIGHT	A18.EDF	A18	.
213	8159384	8159384	3074	3074	0	RIGHT	A18.EDF	A18	.
213	8159411	8159637	3101	3327	226	RIGHT	A18.EDF	A18	.
213	8159667	8160299	3357	3989	632	RIGHT	A18.EDF	A18	.
213	8160322	8160326	4012	4016	4	RIGHT	A18.EDF	A18	.
213	8160595	8160595	4285	4285	0	RIGHT	A18.EDF	A18	.
213	8161852	8161852	5542	5542	0	RIGHT	A18.EDF	A18	.
214	8164010	8164352	99	441	342	RIGHT	A18.EDF	A18	.
214	8164476	8164476	565	565	0	RIGHT	A18.EDF	A18	.
214	8164582	8164582	671	671	0	RIGHT	A18.EDF	A18	.
214	8164912	8164912	1001	1001	0	RIGHT	A18.EDF	A18	.
214	8164957	8164957	1046	1046	0	RIGHT	A18.EDF	A18	.
214	8164998	8165007	1087	1096	9	RIGHT	A18.EDF	A18	.
214	8165213	8165213	1302	1302	0	RIGHT	A18.EDF	A18	.
214	8165326	8165500	1415	1589	174	RIGHT	A18.EDF	A18	.
214	8165877	8165961	1966	2050	84	RIGHT	A18.EDF	A18	.
214	8166412	8166437	2501	2526	25	RIGHT	A18.EDF	A18	.
214	8166465	8166636	2554	2725	171	RIGHT	A18.EDF	A18	.
214	8166719	8166775	2808	2864	56	RIGHT	A18.EDF	A18	.
214	8166821	8167037	2910	3126	216	RIGHT	A18.EDF	A18	.
214	8167153	8167153	3242	3242	0	RIGHT	A18.EDF	A18	.
214	8167179	8167179	3268	3268	0	RIGHT	A18.EDF	A18	.
214	8167215	8167237	3304	3326	22	RIGHT	A18.EDF	A18	.
214	8167264	8167281	3353	3370	17	RIGHT	A18.EDF	A18	.
214	8167459	8168054	3548	4143	595	RIGHT	A18.EDF	A18	.
214	8168081	8168234	4170	4323	153	RIGHT	A18.EDF	A18	.
214	8168279	8168555	4368	4644	276	RIGHT	A18.EDF	A18	.
214	8169182	8169198	5271	5287	16	RIGHT	A18.EDF	A18	.
214	8169237	8169363	5326	5452	126	RIGHT	A18.EDF	A18	.
214	8169451	8169714	5540	5803	263	RIGHT	A18.EDF	A18	.
215	8174948	8175180	2972	3204	232	RIGHT	A18.EDF	A18	.
215	8175477	8176055	3501	4079	578	RIGHT	A18.EDF	A18	.
215	8176153	8176450	4177	4474	297	RIGHT	A18.EDF	A18	.
215	8176587	8176587	4611	4611	0	RIGHT	A18.EDF	A18	.
215	8176672	8177799	4696	5823	1127	RIGHT	A18.EDF	A18	.
215	8177912	8177936	5936	5960	24	RIGHT	A18.EDF	A18	.
215	8177962	8178043	5986	6067	81	RIGHT	A18.EDF	A18	.
215	8178069	8178161	6093	6185	92	RIGHT	A18.EDF	A18	.
215	8178263	8178263	6287	6287	0	RIGHT	A18.EDF	A18	.
215	8178308	8178312	6332	6336	4	RIGHT	A18.EDF	A18	.
215	8178993	8179184	7017	7208	191	RIGHT	A18.EDF	A18	.
216	8181372	8181751	57	436	379	RIGHT	A18.EDF	A18	.
216	8181858	8182381	543	1066	523	RIGHT	A18.EDF	A18	.
217	8189288	8190045	57	814	757	RIGHT	A18.EDF	A18	.
217	8190070	8190078	839	847	8	RIGHT	A18.EDF	A18	.
217	8190111	8190134	880	903	23	RIGHT	A18.EDF	A18	.
217	8190178	8190179	947	948	1	RIGHT	A18.EDF	A18	.
217	8191343	8191385	2112	2154	42	RIGHT	A18.EDF	A18	.
217	8191406	8191517	2175	2286	111	RIGHT	A18.EDF	A18	.
217	8191575	8192038	2344	2807	463	RIGHT	A18.EDF	A18	.
217	8192083	8192117	2852	2886	34	RIGHT	A18.EDF	A18	.
217	8192154	8192154	2923	2923	0	RIGHT	A18.EDF	A18	.
217	8192181	8192181	2950	2950	0	RIGHT	A18.EDF	A18	.
217	8192214	8192215	2983	2984	1	RIGHT	A18.EDF	A18	.
217	8192591	8192934	3360	3703	343	RIGHT	A18.EDF	A18	.
217	8193276	8193829	4045	4598	553	RIGHT	A18.EDF	A18	.
217	8194487	8194776	5256	5545	289	RIGHT	A18.EDF	A18	.
217	8194807	8194859	5576	5628	52	RIGHT	A18.EDF	A18	.
217	8194914	8194914	5683	5683	0	RIGHT	A18.EDF	A18	.
217	8195090	8195111	5859	5880	21	RIGHT	A18.EDF	A18	.
217	8195186	8195187	5955	5956	1	RIGHT	A18.EDF	A18	.
217	8195410	8195639	6179	6408	229	RIGHT	A18.EDF	A18	.
217	8195813	8196014	6582	6783	201	RIGHT	A18.EDF	A18	.
218	8197899	8198312	57	470	413	RIGHT	A18.EDF	A18	.
218	8199582	8199582	1740	1740	0	RIGHT	A18.EDF	A18	.
218	8199613	8199631	1771	1789	18	RIGHT	A18.EDF	A18	.
218	8199677	8199688	1835	1846	11	RIGHT	A18.EDF	A18	.
218	8199721	8199722	1879	1880	1	RIGHT	A18.EDF	A18	.
218	8199753	8199753	1911	1911	0	RIGHT	A18.EDF	A18	.
218	8199785	8199863	1943	2021	78	RIGHT	A18.EDF	A18	.
218	8199891	8199976	2049	2134	85	RIGHT	A18.EDF	A18	.
218	8199997	8200190	2155	2348	193	RIGHT	A18.EDF	A18	.
218	8200223	8200491	2381	2649	268	RIGHT	A18.EDF	A18	.
218	8200515	8200602	2673	2760	87	RIGHT	A18.EDF	A18	.
218	8200637	8203139	2795	5297	2502	RIGHT	A18.EDF	A18	.
219	8205138	8205375	58	295	237	RIGHT	A18.EDF	A18	.
219	8205433	8205499	353	419	66	RIGHT	A18.EDF	A18	.
219	8206137	8206137	1057	1057	0	RIGHT	A18.EDF	A18	.
219	8206161	8206163	1081	1083	2	RIGHT	A18.EDF	A18	.
219	8206889	8206891	1809	1811	2	RIGHT	A18.EDF	A18	.
219	8206914	8207263	1834	2183	349	RIGHT	A18.EDF	A18	.
219	8207905	8207942	2825	2862	37	RIGHT	A18.EDF	A18	.
219	8207964	8207964	2884	2884	0	RIGHT	A18.EDF	A18	.
219	8208006	8208364	2926	3284	358	RIGHT	A18.EDF	A18	.
219	8208392	8208418	3312	3338	26	RIGHT	A18.EDF	A18	.
219	8208449	8208461	3369	3381	12	RIGHT	A18.EDF	A18	.
219	8208529	8208535	3449	3455	6	RIGHT	A18.EDF	A18	.
219	8208566	8208847	3486	3767	281	RIGHT	A18.EDF	A18	.
219	8208877	8208896	3797	3816	19	RIGHT	A18.EDF	A18	.
219	8208945	8209023	3865	3943	78	RIGHT	A18.EDF	A18	.
219	8209075	8209075	3995	3995	0	RIGHT	A18.EDF	A18	.
219	8209161	8209207	4081	4127	46	RIGHT	A18.EDF	A18	.
219	8209242	8209258	4162	4178	16	RIGHT	A18.EDF	A18	.
219	8209319	8209365	4239	4285	46	RIGHT	A18.EDF	A18	.
219	8209391	8209443	4311	4363	52	RIGHT	A18.EDF	A18	.
219	8209465	8209563	4385	4483	98	RIGHT	A18.EDF	A18	.
219	8209595	8209633	4515	4553	38	RIGHT	A18.EDF	A18	.
219	8209691	8209760	4611	4680	69	RIGHT	A18.EDF	A18	.
219	8209803	8211088	4723	6008	1285	RIGHT	A18.EDF	A18	.
219	8211126	8211144	6046	6064	18	RIGHT	A18.EDF	A18	.
219	8211306	8211317	6226	6237	11	RIGHT	A18.EDF	A18	.
219	8211344	8211504	6264	6424	160	RIGHT	A18.EDF	A18	.
219	8211528	8211604	6448	6524	76	RIGHT	A18.EDF	A18	.
220	8213433	8214076	57	700	643	RIGHT	A18.EDF	A18	.
220	8215570	8215570	2194	2194	0	RIGHT	A18.EDF	A18	.
220	8215591	8215591	2215	2215	0	RIGHT	A18.EDF	A18	.
220	8215705	8215706	2329	2330	1	RIGHT	A18.EDF	A18	.
220	8215826	8215856	2450	2480	30	RIGHT	A18.EDF	A18	.
220	8215884	8215897	2508	2521	13	RIGHT	A18.EDF	A18	.
220	8215918	8216283	2542	2907	365	RIGHT	A18.EDF	A18	.
220	8216387	8216489	3011	3113	102	RIGHT	A18.EDF	A18	.
220	8217325	8217335	3949	3959	10	RIGHT	A18.EDF	A18	.
220	8217357	8217358	3981	3982	1	RIGHT	A18.EDF	A18	.
220	8217382	8217600	4006	4224	218	RIGHT	A18.EDF	A18	.
220	8217623	8217650	4247	4274	27	RIGHT	A18.EDF	A18	.
220	8217699	8217700	4323	4324	1	RIGHT	A18.EDF	A18	.
220	8217729	8217729	4353	4353	0	RIGHT	A18.EDF	A18	.
220	8217772	8217830	4396	4454	58	RIGHT	A18.EDF	A18	.
220	8217869	8217950	4493	4574	81	RIGHT	A18.EDF	A18	.
220	8217971	8217985	4595	4609	14	RIGHT	A18.EDF	A18	.
220	8218040	8218042	4664	4666	2	RIGHT	A18.EDF	A18	.
220	8218080	8218081	4704	4705	1	RIGHT	A18.EDF	A18	.
220	8218104	8218131	4728	4755	27	RIGHT	A18.EDF	A18	.
220	8218194	8218198	4818	4822	4	RIGHT	A18.EDF	A18	.
220	8218222	8218555	4846	5179	333	RIGHT	A18.EDF	A18	.
220	8218765	8219640	5389	6264	875	RIGHT	A18.EDF	A18	.
220	8219710	8219952	6334	6576	242	RIGHT	A18.EDF	A18	.
221	8222599	8222763	57	221	164	RIGHT	A18.EDF	A18	.
221	8222898	8222921	356	379	23	RIGHT	A18.EDF	A18	.
221	8224103	8224566	1561	2024	463	RIGHT	A18.EDF	A18	.
221	8225309	8226382	2767	3840	1073	RIGHT	A18.EDF	A18	.
221	8226413	8226966	3871	4424	553	RIGHT	A18.EDF	A18	.
221	8227497	8227594	4955	5052	97	RIGHT	A18.EDF	A18	.
222	8230429	8230976	58	605	547	RIGHT	A18.EDF	A18	.
222	8231209	8231210	838	839	1	RIGHT	A18.EDF	A18	.
222	8231602	8231623	1231	1252	21	RIGHT	A18.EDF	A18	.
222	8231649	8231700	1278	1329	51	RIGHT	A18.EDF	A18	.
222	8231723	8231745	1352	1374	22	RIGHT	A18.EDF	A18	.
222	8231781	8231855	1410	1484	74	RIGHT	A18.EDF	A18	.
222	8231885	8232528	1514	2157	643	RIGHT	A18.EDF	A18	.
222	8233454	8236709	3083	6338	3255	RIGHT	A18.EDF	A18	.
223	8239658	8239844	57	243	186	RIGHT	A18.EDF	A18	.
223	8239901	8240769	300	1168	868	RIGHT	A18.EDF	A18	.
223	8240855	8241245	1254	1644	390	RIGHT	A18.EDF	A18	.
223	8243774	8244417	4173	4816	643	RIGHT	A18.EDF	A18	.
224	8248337	8248409	58	130	72	RIGHT	A18.EDF	A18	.
224	8251378	8251933	3099	3654	555	RIGHT	A18.EDF	A18	.
224	8252415	8252975	4136	4696	560	RIGHT	A18.EDF	A18	.
224	8253023	8253023	4744	4744	0	RIGHT	A18.EDF	A18	.
224	8253047	8253047	4768	4768	0	RIGHT	A18.EDF	A18	.
224	8253267	8253435	4988	5156	168	RIGHT	A18.EDF	A18	.
224	8253462	8253462	5183	5183	0	RIGHT	A18.EDF	A18	.
225	8257272	8257681	109	518	409	RIGHT	A18.EDF	A18	.
225	8257768	8257775	605	612	7	RIGHT	A18.EDF	A18	.
225	8258554	8260342	1391	3179	1788	RIGHT	A18.EDF	A18	.
225	8262755	8262889	5592	5726	134	RIGHT	A18.EDF	A18	.
225	8262926	8263455	5763	6292	529	RIGHT	A18.EDF	A18	.
226	8266993	8268604	58	1669	1611	RIGHT	A18.EDF	A18	.
226	8269199	8269219	2264	2284	20	RIGHT	A18.EDF	A18	.
226	8269241	8269428	2306	2493	187	RIGHT	A18.EDF	A18	.
226	8269459	8269729	2524	2794	270	RIGHT	A18.EDF	A18	.
226	8269816	8270056	2881	3121	240	RIGHT	A18.EDF	A18	.
226	8270087	8271571	3152	4636	1484	RIGHT	A18.EDF	A18	.
226	8272604	8272792	5669	5857	188	RIGHT	A18.EDF	A18	.
226	8272826	8273269	5891	6334	443	RIGHT	A18.EDF	A18	.
227	8275167	8275601	57	491	434	RIGHT	A18.EDF	A18	.
227	8275986	8277214	876	2104	1228	RIGHT	A18.EDF	A18	.
227	8279729	8279736	4619	4626	7	RIGHT	A18.EDF	A18	.
227	8279759	8279977	4649	4867	218	RIGHT	A18.EDF	A18	.
227	8280055	8280055	4945	4945	0	RIGHT	A18.EDF	A18	.
227	8280100	8280309	4990	5199	209	RIGHT	A18.EDF	A18	.
227	8280472	8280689	5362	5579	217	RIGHT	A18.EDF	A18	.
227	8280839	8281215	5729	6105	376	RIGHT	A18.EDF	A18	.
227	8281254	8281273	6144	6163	19	RIGHT	A18.EDF	A18	.
228	8283256	8283610	57	411	354	RIGHT	A18.EDF	A18	.
228	8284008	8284187	809	988	179	RIGHT	A18.EDF	A18	.
228	8284764	8284984	1565	1785	220	RIGHT	A18.EDF	A18	.
228	8285146	8285165	1947	1966	19	RIGHT	A18.EDF	A18	.
228	8285224	8285224	2025	2025	0	RIGHT	A18.EDF	A18	.
228	8285288	8285353	2089	2154	65	RIGHT	A18.EDF	A18	.
228	8285684	8286153	2485	2954	469	RIGHT	A18.EDF	A18	.
228	8286239	8286244	3040	3045	5	RIGHT	A18.EDF	A18	.
228	8286650	8286650	3451	3451	0	RIGHT	A18.EDF	A18	.
228	8286871	8287260	3672	4061	389	RIGHT	A18.EDF	A18	.
228	8287300	8288161	4101	4962	861	RIGHT	A18.EDF	A18	.
228	8290092	8290682	6893	7483	590	RIGHT	A18.EDF	A18	.
229	8293570	8293669	58	157	99	RIGHT	A18.EDF	A18	.
229	8295391	8295708	1879	2196	317	RIGHT	A18.EDF	A18	.
229	8295803	8295877	2291	2365	74	RIGHT	A18.EDF	A18	.
229	8295912	8295914	2400	2402	2	RIGHT	A18.EDF	A18	.
229	8296298	8296298	2786	2786	0	RIGHT	A18.EDF	A18	.
229	8296689	8296690	3177	3178	1	RIGHT	A18.EDF	A18	.
229	8298724	8298894	5212	5382	170	RIGHT	A18.EDF	A18	.
230	8305479	8306075	58	654	596	RIGHT	A18.EDF	A18	.
230	8308849	8309083	3428	3662	234	RIGHT	A18.EDF	A18	.
231	8312925	8313110	57	242	185	RIGHT	A18.EDF	A18	.
231	8314967	8315233	2099	2365	266	RIGHT	A18.EDF	A18	.
231	8315875	8316078	3007	3210	203	RIGHT	A18.EDF	A18	.
231	8316626	8316878	3758	4010	252	RIGHT	A18.EDF	A18	.
231	8317747	8317869	4879	5001	122	RIGHT	A18.EDF	A18	.
232	8320151	8320388	58	295	237	RIGHT	A18.EDF	A18	.
232	8321337	8321695	1244	1602	358	RIGHT	A18.EDF	A18	.
232	8322455	8322939	2362	2846	484	RIGHT	A18.EDF	A18	.
232	8324068	8324275	3975	4182	207	RIGHT	A18.EDF	A18	.
232	8324711	8325144	4618	5051	433	RIGHT	A18.EDF	A18	.
233	8332027	8332593	2941	3507	566	RIGHT	A18.EDF	A18	.
233	8333874	8334156	4788	5070	282	RIGHT	A18.EDF	A18	.
234	8340768	8340861	58	151	93	RIGHT	A18.EDF	A18	.
234	8341692	8342146	982	1436	454	RIGHT	A18.EDF	A18	.
234	8343981	8344439	3271	3729	458	RIGHT	A18.EDF	A18	.
234	8344595	8344626	3885	3916	31	RIGHT	A18.EDF	A18	.
234	8344693	8344753	3983	4043	60	RIGHT	A18.EDF	A18	.
234	8344813	8344922	4103	4212	109	RIGHT	A18.EDF	A18	.
234	8345211	8346087	4501	5377	876	RIGHT	A18.EDF	A18	.
235	8347663	8347957	57	351	294	RIGHT	A18.EDF	A18	.
235	8348031	8348032	425	426	1	RIGHT	A18.EDF	A18	.
235	8348086	8348086	480	480	0	RIGHT	A18.EDF	A18	.
235	8348161	8348193	555	587	32	RIGHT	A18.EDF	A18	.
235	8348218	8348243	612	637	25	RIGHT	A18.EDF	A18	.
235	8348286	8348346	680	740	60	RIGHT	A18.EDF	A18	.
235	8351140	8351472	3534	3866	332	RIGHT	A18.EDF	A18	.
235	8351499	8351617	3893	4011	118	RIGHT	A18.EDF	A18	.
236	8354118	8354524	57	463	406	RIGHT	A18.EDF	A18	.
236	8355222	8355223	1161	1162	1	RIGHT	A18.EDF	A18	.
236	8355378	8355434	1317	1373	56	RIGHT	A18.EDF	A18	.
236	8355464	8355484	1403	1423	20	RIGHT	A18.EDF	A18	.
236	8355510	8355558	1449	1497	48	RIGHT	A18.EDF	A18	.
236	8355591	8355602	1530	1541	11	RIGHT	A18.EDF	A18	.
236	8355709	8355734	1648	1673	25	RIGHT	A18.EDF	A18	.
236	8355755	8356178	1694	2117	423	RIGHT	A18.EDF	A18	.
236	8356362	8356499	2301	2438	137	RIGHT	A18.EDF	A18	.
236	8356587	8357019	2526	2958	432	RIGHT	A18.EDF	A18	.
236	8357040	8357046	2979	2985	6	RIGHT	A18.EDF	A18	.
236	8357070	8357071	3009	3010	1	RIGHT	A18.EDF	A18	.
236	8357147	8357147	3086	3086	0	RIGHT	A18.EDF	A18	.
236	8357174	8357182	3113	3121	8	RIGHT	A18.EDF	A18	.
236	8357485	8357513	3424	3452	28	RIGHT	A18.EDF	A18	.
236	8357581	8358149	3520	4088	568	RIGHT	A18.EDF	A18	.
236	8358289	8358419	4228	4358	130	RIGHT	A18.EDF	A18	.
236	8358460	8359022	4399	4961	562	RIGHT	A18.EDF	A18	.
236	8359122	8360426	5061	6365	1304	RIGHT	A18.EDF	A18	.
236	8360490	8360952	6429	6891	462	RIGHT	A18.EDF	A18	.
236	8361011	8361351	6950	7290	340	RIGHT	A18.EDF	A18	.
237	8363981	8364451	57	527	470	RIGHT	A18.EDF	A18	.
237	8367932	8368081	4008	4157	149	RIGHT	A18.EDF	A18	.
237	8368371	8368508	4447	4584	137	RIGHT	A18.EDF	A18	.
238	8371927	8372054	58	185	127	RIGHT	A18.EDF	A18	.
238	8373719	8374147	1850	2278	428	RIGHT	A18.EDF	A18	.
238	8374968	8375333	3099	3464	365	RIGHT	A18.EDF	A18	.
238	8375912	8376270	4043	4401	358	RIGHT	A18.EDF	A18	.
239	8381317	8381690	420	793	373	RIGHT	A18.EDF	A18	.
239	8382227	8382379	1330	1482	152	RIGHT	A18.EDF	A18	.
239	8382845	8383233	1948	2336	388	RIGHT	A18.EDF	A18	.
239	8384001	8384234	3104	3337	233	RIGHT	A18.EDF	A18	.
239	8385903	8386080	5006	5183	177	RIGHT	A18.EDF	A18	.
239	8386697	8386851	5800	5954	154	RIGHT	A18.EDF	A18	.
240	8390999	8391225	1564	1790	226	RIGHT	A18.EDF	A18	.
240	8391256	8391277	1821	1842	21	RIGHT	A18.EDF	A18	.
240	8391555	8392090	2120	2655	535	RIGHT	A18.EDF	A18	.
240	8394000	8394221	4565	4786	221	RIGHT	A18.EDF	A18	.
240	8395320	8395448	5885	6013	128	RIGHT	A18.EDF	A18	.
241	8401184	8401203	3353	3372	19	RIGHT	A18.EDF	A18	.
241	8401417	8401612	3586	3781	195	RIGHT	A18.EDF	A18	.
241	8402487	8402646	4656	4815	159	RIGHT	A18.EDF	A18	.
242	8405311	8405415	57	161	104	RIGHT	A18.EDF	A18	.
242	8406490	8406651	1236	1397	161	RIGHT	A18.EDF	A18	.
242	8406684	8406684	1430	1430	0	RIGHT	A18.EDF	A18	.
242	8406829	8407217	1575	1963	388	RIGHT	A18.EDF	A18	.
242	8408138	8408362	2884	3108	224	RIGHT	A18.EDF	A18	.
242	8409017	8409190	3763	3936	173	RIGHT	A18.EDF	A18	.
243	8412381	8412712	57	388	331	RIGHT	A18.EDF	A18	.
243	8414935	8415123	2611	2799	188	RIGHT	A18.EDF	A18	.
243	8416002	8416088	3678	3764	86	RIGHT	A18.EDF	A18	.
243	8416165	8416355	3841	4031	190	RIGHT	A18.EDF	A18	.
243	8416403	8416419	4079	4095	16	RIGHT	A18.EDF	A18	.
244	8421797	8421900	483	586	103	RIGHT	A18.EDF	A18	.
245	8431095	8432063	3080	4048	968	RIGHT	A18.EDF	A18	.
245	8432220	8432851	4205	4836	631	RIGHT	A18.EDF	A18	.
246	8435027	8435583	58	614	556	RIGHT	A18.EDF	A18	.
246	8435691	8437105	722	2136	1414	RIGHT	A18.EDF	A18	.
246	8437199	8437981	2230	3012	782	RIGHT	A18.EDF	A18	.
246	8438022	8438294	3053	3325	272	RIGHT	A18.EDF	A18	.
246	8438356	8439054	3387	4085	698	RIGHT	A18.EDF	A18	.
246	8440314	8440395	5345	5426	81	RIGHT	A18.EDF	A18	.
247	8443235	8443868	58	691	633	RIGHT	A18.EDF	A18	.
247	8443936	8444473	759	1296	537	RIGHT	A18.EDF	A18	.
247	8444593	8444594	1416	1417	1	RIGHT	A18.EDF	A18	.
247	8444633	8444633	1456	1456	0	RIGHT	A18.EDF	A18	.
247	8444662	8444994	1485	1817	332	RIGHT	A18.EDF	A18	.
247	8445039	8445050	1862	1873	11	RIGHT	A18.EDF	A18	.
247	8445104	8445522	1927	2345	418	RIGHT	A18.EDF	A18	.
247	8445598	8445685	2421	2508	87	RIGHT	A18.EDF	A18	.
247	8445709	8445907	2532	2730	198	RIGHT	A18.EDF	A18	.
247	8445929	8445937	2752	2760	8	RIGHT	A18.EDF	A18	.
247	8445960	8446648	2783	3471	688	RIGHT	A18.EDF	A18	.
247	8446813	8446819	3636	3642	6	RIGHT	A18.EDF	A18	.
247	8446853	8448190	3676	5013	1337	RIGHT	A18.EDF	A18	.
247	8448211	8448228	5034	5051	17	RIGHT	A18.EDF	A18	.
248	8452225	8452549	57	381	324	RIGHT	A18.EDF	A18	.
248	8452667	8452668	499	500	1	RIGHT	A18.EDF	A18	.
248	8452689	8452715	521	547	26	RIGHT	A18.EDF	A18	.
248	8452943	8452945	775	777	2	RIGHT	A18.EDF	A18	.
248	8453042	8453043	874	875	1	RIGHT	A18.EDF	A18	.
248	8454036	8454082	1868	1914	46	RIGHT	A18.EDF	A18	.
248	8454413	8458916	2245	6748	4503	RIGHT	A18.EDF	A18	.
249	8461236	8466941	58	5763	5705	RIGHT	A18.EDF	A18	.
250	8470262	8475596	58	5392	5334	RIGHT	A18.EDF	A18	.
251	8479726	8485413	57	5744	5687	RIGHT	A18.EDF	A18	.
252	8487578	8493137	58	5617	5559	RIGHT	A18.EDF	A18	.
253	8496898	8503895	58	7055	6997	RIGHT	A18.EDF	A18	.
254	8505970	8506636	58	724	666	RIGHT	A18.EDF	A18	.
254	8507310	8511669	1398	5757	4359	RIGHT	A18.EDF	A18	.
255	8513708	8513971	58	321	263	RIGHT	A18.EDF	A18	.
255	8514451	8515007	801	1357	556	RIGHT	A18.EDF	A18	.
255	8517056	8517427	3406	3777	371	RIGHT	A18.EDF	A18	.
255	8517466	8517660	3816	4010	194	RIGHT	A18.EDF	A18	.
255	8517847	8518356	4197	4706	509	RIGHT	A18.EDF	A18	.
255	8518390	8518923	4740	5273	533	RIGHT	A18.EDF	A18	.
256	8521233	8522101	58	926	868	RIGHT	A18.EDF	A18	.
256	8522265	8522265	1090	1090	0	RIGHT	A18.EDF	A18	.
256	8522494	8522512	1319	1337	18	RIGHT	A18.EDF	A18	.
256	8522583	8523204	1408	2029	621	RIGHT	A18.EDF	A18	.
256	8523256	8523317	2081	2142	61	RIGHT	A18.EDF	A18	.
256	8523998	8524165	2823	2990	167	RIGHT	A18.EDF	A18	.
256	8524206	8524528	3031	3353	322	RIGHT	A18.EDF	A18	.
256	8524746	8525456	3571	4281	710	RIGHT	A18.EDF	A18	.
257	8529194	8530059	281	1146	865	RIGHT	A18.EDF	A18	.
257	8530101	8530285	1188	1372	184	RIGHT	A18.EDF	A18	.
257	8530909	8531261	1996	2348	352	RIGHT	A18.EDF	A18	.
257	8531298	8531298	2385	2385	0	RIGHT	A18.EDF	A18	.
257	8531323	8532110	2410	3197	787	RIGHT	A18.EDF	A18	.
257	8532654	8532691	3741	3778	37	RIGHT	A18.EDF	A18	.
257	8532729	8533004	3816	4091	275	RIGHT	A18.EDF	A18	.
257	8533025	8533058	4112	4145	33	RIGHT	A18.EDF	A18	.
257	8533657	8533873	4744	4960	216	RIGHT	A18.EDF	A18	.
257	8533898	8534843	4985	5930	945	RIGHT	A18.EDF	A18	.
258	8536916	8536950	57	91	34	RIGHT	A18.EDF	A18	.
258	8536984	8537507	125	648	523	RIGHT	A18.EDF	A18	.
258	8538590	8538591	1731	1732	1	RIGHT	A18.EDF	A18	.
258	8538638	8538912	1779	2053	274	RIGHT	A18.EDF	A18	.
258	8538962	8538991	2103	2132	29	RIGHT	A18.EDF	A18	.
258	8539911	8541041	3052	4182	1130	RIGHT	A18.EDF	A18	.
258	8541083	8541086	4224	4227	3	RIGHT	A18.EDF	A18	.
258	8541108	8541168	4249	4309	60	RIGHT	A18.EDF	A18	.
258	8541208	8541212	4349	4353	4	RIGHT	A18.EDF	A18	.
258	8541238	8541265	4379	4406	27	RIGHT	A18.EDF	A18	.
258	8541289	8541851	4430	4992	562	RIGHT	A18.EDF	A18	.
258	8541883	8541890	5024	5031	7	RIGHT	A18.EDF	A18	.
258	8541917	8543258	5058	6399	1341	RIGHT	A18.EDF	A18	.
259	8545343	8545829	58	544	486	RIGHT	A18.EDF	A18	.
259	8545871	8546149	586	864	278	RIGHT	A18.EDF	A18	.
259	8546347	8546407	1062	1122	60	RIGHT	A18.EDF	A18	.
259	8547034	8548149	1749	2864	1115	RIGHT	A18.EDF	A18	.
259	8549903	8550149	4618	4864	246	RIGHT	A18.EDF	A18	.
259	8550170	8550707	4885	5422	537	RIGHT	A18.EDF	A18	.
259	8550744	8551063	5459	5778	319	RIGHT	A18.EDF	A18	.
260	8554159	8554734	57	632	575	RIGHT	A18.EDF	A18	.
260	8554805	8555237	703	1135	432	RIGHT	A18.EDF	A18	.
260	8555269	8555319	1167	1217	50	RIGHT	A18.EDF	A18	.
260	8555355	8555923	1253	1821	568	RIGHT	A18.EDF	A18	.
260	8555983	8556177	1881	2075	194	RIGHT	A18.EDF	A18	.
260	8556493	8556575	2391	2473	82	RIGHT	A18.EDF	A18	.
260	8556857	8557094	2755	2992	237	RIGHT	A18.EDF	A18	.
260	8557120	8557581	3018	3479	461	RIGHT	A18.EDF	A18	.
260	8557640	8557641	3538	3539	1	RIGHT	A18.EDF	A18	.
260	8557680	8558116	3578	4014	436	RIGHT	A18.EDF	A18	.
260	8558159	8559026	4057	4924	867	RIGHT	A18.EDF	A18	.
260	8559050	8560369	4948	6267	1319	RIGHT	A18.EDF	A18	.
261	8562538	8564018	57	1537	1480	RIGHT	A18.EDF	A18	.
261	8564068	8564114	1587	1633	46	RIGHT	A18.EDF	A18	.
261	8564146	8564336	1665	1855	190	RIGHT	A18.EDF	A18	.
261	8564370	8564736	1889	2255	366	RIGHT	A18.EDF	A18	.
261	8564948	8568686	2467	6205	3738	RIGHT	A18.EDF	A18	.
261	8568721	8569055	6240	6574	334	RIGHT	A18.EDF	A18	.
262	8571562	8574086	58	2582	2524	RIGHT	A18.EDF	A18	.
262	8574453	8574656	2949	3152	203	RIGHT	A18.EDF	A18	.
262	8574681	8574782	3177	3278	101	RIGHT	A18.EDF	A18	.
263	8578626	8578659	58	91	33	RIGHT	A18.EDF	A18	.
263	8579338	8579943	770	1375	605	RIGHT	A18.EDF	A18	.
264	8586273	8586555	58	340	282	RIGHT	A18.EDF	A18	.
264	8587489	8587491	1274	1276	2	RIGHT	A18.EDF	A18	.
264	8587517	8587729	1302	1514	212	RIGHT	A18.EDF	A18	.
264	8587755	8587765	1540	1550	10	RIGHT	A18.EDF	A18	.
265	8596526	8596540	1789	1803	14	RIGHT	A18.EDF	A18	.
265	8596572	8596697	1835	1960	125	RIGHT	A18.EDF	A18	.
265	8596720	8596731	1983	1994	11	RIGHT	A18.EDF	A18	.
265	8599480	8599617	4743	4880	137	RIGHT	A18.EDF	A18	.
265	8599649	8599661	4912	4924	12	RIGHT	A18.EDF	A18	.
265	8599713	8599713	4976	4976	0	RIGHT	A18.EDF	A18	.
265	8600540	8600889	5803	6152	349	RIGHT	A18.EDF	A18	.
265	8600913	8600940	6176	6203	27	RIGHT	A18.EDF	A18	.
265	8601120	8601197	6383	6460	77	RIGHT	A18.EDF	A18	.
265	8601271	8601323	6534	6586	52	RIGHT	A18.EDF	A18	.
265	8601534	8601589	6797	6852	55	RIGHT	A18.EDF	A18	.
265	8601616	8601644	6879	6907	28	RIGHT	A18.EDF	A18	.
266	8604471	8604890	58	477	419	RIGHT	A18.EDF	A18	.
266	8604949	8604949	536	536	0	RIGHT	A18.EDF	A18	.
266	8608805	8609253	4392	4840	448	RIGHT	A18.EDF	A18	.
266	8609278	8610580	4865	6167	1302	RIGHT	A18.EDF	A18	.
267	8613507	8614930	57	1480	1423	RIGHT	A18.EDF	A18	.
267	8615382	8615448	1932	1998	66	RIGHT	A18.EDF	A18	.
267	8617499	8617771	4049	4321	272	RIGHT	A18.EDF	A18	.
267	8617954	8618293	4504	4843	339	RIGHT	A18.EDF	A18	.
267	8618825	8619169	5375	5719	344	RIGHT	A18.EDF	A18	.
268	8621815	8622200	58	443	385	RIGHT	A18.EDF	A18	.
268	8625751	8625751	3994	3994	0	RIGHT	A18.EDF	A18	.
268	8625781	8625983	4024	4226	202	RIGHT	A18.EDF	A18	.
268	8626024	8626154	4267	4397	130	RIGHT	A18.EDF	A18	.
268	8627196	8627316	5439	5559	120	RIGHT	A18.EDF	A18	.
268	8627362	8627659	5605	5902	297	RIGHT	A18.EDF	A18	.
269	8630860	8631300	57	497	440	RIGHT	A18.EDF	A18	.
269	8634758	8634831	3955	4028	73	RIGHT	A18.EDF	A18	.
269	8635223	8635458	4420	4655	235	RIGHT	A18.EDF	A18	.
269	8635943	8635965	5140	5162	22	RIGHT	A18.EDF	A18	.
270	8643533	8643739	906	1112	206	RIGHT	A18.EDF	A18	.
270	8643766	8643797	1139	1170	31	RIGHT	A18.EDF	A18	.
270	8644734	8644920	2107	2293	186	RIGHT	A18.EDF	A18	.
270	8644947	8644972	2320	2345	25	RIGHT	A18.EDF	A18	.
270	8646084	8646085	3457	3458	1	RIGHT	A18.EDF	A18	.
270	8646124	8646127	3497	3500	3	RIGHT	A18.EDF	A18	.
270	8646150	8646167	3523	3540	17	RIGHT	A18.EDF	A18	.
270	8646251	8646252	3624	3625	1	RIGHT	A18.EDF	A18	.
270	8646359	8646360	3732	3733	1	RIGHT	A18.EDF	A18	.
270	8646398	8646480	3771	3853	82	RIGHT	A18.EDF	A18	.
270	8646502	8646582	3875	3955	80	RIGHT	A18.EDF	A18	.
270	8646612	8646892	3985	4265	280	RIGHT	A18.EDF	A18	.
270	8646958	8646960	4331	4333	2	RIGHT	A18.EDF	A18	.
270	8647028	8647089	4401	4462	61	RIGHT	A18.EDF	A18	.
270	8647122	8647146	4495	4519	24	RIGHT	A18.EDF	A18	.
270	8647216	8647216	4589	4589	0	RIGHT	A18.EDF	A18	.
270	8647268	8647279	4641	4652	11	RIGHT	A18.EDF	A18	.
270	8647456	8647457	4829	4830	1	RIGHT	A18.EDF	A18	.
270	8647529	8647530	4902	4903	1	RIGHT	A18.EDF	A18	.
270	8647706	8647733	5079	5106	27	RIGHT	A18.EDF	A18	.
270	8647872	8647887	5245	5260	15	RIGHT	A18.EDF	A18	.
270	8647915	8648172	5288	5545	257	RIGHT	A18.EDF	A18	.
270	8648199	8648238	5572	5611	39	RIGHT	A18.EDF	A18	.
270	8648266	8648267	5639	5640	1	RIGHT	A18.EDF	A18	.
270	8648288	8649253	5661	6626	965	RIGHT	A18.EDF	A18	.
271	8651548	8651896	57	405	348	RIGHT	A18.EDF	A18	.
271	8651943	8652029	452	538	86	RIGHT	A18.EDF	A18	.
271	8652055	8652256	564	765	201	RIGHT	A18.EDF	A18	.
271	8652286	8652321	795	830	35	RIGHT	A18.EDF	A18	.
271	8652343	8653447	852	1956	1104	RIGHT	A18.EDF	A18	.
271	8653475	8654861	1984	3370	1386	RIGHT	A18.EDF	A18	.
271	8654946	8655033	3455	3542	87	RIGHT	A18.EDF	A18	.
271	8657533	8657914	6042	6423	381	RIGHT	A18.EDF	A18	.
271	8657944	8658084	6453	6593	140	RIGHT	A18.EDF	A18	.
271	8658350	8658499	6859	7008	149	RIGHT	A18.EDF	A18	.
272	8660499	8660774	57	332	275	RIGHT	A18.EDF	A18	.
272	8660815	8660925	373	483	110	RIGHT	A18.EDF	A18	.
272	8660948	8661119	506	677	171	RIGHT	A18.EDF	A18	.
272	8661144	8663392	702	2950	2248	RIGHT	A18.EDF	A18	.
272	8663417	8663728	2975	3286	311	RIGHT	A18.EDF	A18	.
272	8666216	8666419	5774	5977	203	RIGHT	A18.EDF	A18	.
272	8666534	8666580	6092	6138	46	RIGHT	A18.EDF	A18	.
272	8666637	8666644	6195	6202	7	RIGHT	A18.EDF	A18	.
273	8668575	8668758	57	240	183	RIGHT	A18.EDF	A18	.
273	8669116	8669596	598	1078	480	RIGHT	A18.EDF	A18	.
273	8670190	8670930	1672	2412	740	RIGHT	A18.EDF	A18	.
273	8670956	8670959	2438	2441	3	RIGHT	A18.EDF	A18	.
273	8671076	8671124	2558	2606	48	RIGHT	A18.EDF	A18	.
273	8671154	8671553	2636	3035	399	RIGHT	A18.EDF	A18	.
273	8672504	8672663	3986	4145	159	RIGHT	A18.EDF	A18	.
273	8672687	8672693	4169	4175	6	RIGHT	A18.EDF	A18	.
273	8672759	8672759	4241	4241	0	RIGHT	A18.EDF	A18	.
273	8673693	8674341	5175	5823	648	RIGHT	A18.EDF	A18	.
273	8674452	8674481	5934	5963	29	RIGHT	A18.EDF	A18	.
273	8674529	8674529	6011	6011	0	RIGHT	A18.EDF	A18	.
273	8674598	8674602	6080	6084	4	RIGHT	A18.EDF	A18	.
274	8678138	8678512	57	431	374	RIGHT	A18.EDF	A18	.
274	8678929	8678956	848	875	27	RIGHT	A18.EDF	A18	.
274	8678979	8679024	898	943	45	RIGHT	A18.EDF	A18	.
274	8679061	8679084	980	1003	23	RIGHT	A18.EDF	A18	.
274	8679113	8679370	1032	1289	257	RIGHT	A18.EDF	A18	.
274	8679391	8679426	1310	1345	35	RIGHT	A18.EDF	A18	.
274	8679453	8679724	1372	1643	271	RIGHT	A18.EDF	A18	.
274	8679749	8679834	1668	1753	85	RIGHT	A18.EDF	A18	.
274	8679872	8679874	1791	1793	2	RIGHT	A18.EDF	A18	.
274	8680163	8681028	2082	2947	865	RIGHT	A18.EDF	A18	.
274	8681128	8682348	3047	4267	1220	RIGHT	A18.EDF	A18	.
274	8682569	8682623	4488	4542	54	RIGHT	A18.EDF	A18	.
274	8682662	8683661	4581	5580	999	RIGHT	A18.EDF	A18	.
274	8683711	8684435	5630	6354	724	RIGHT	A18.EDF	A18	.
275	8687802	8688033	57	288	231	RIGHT	A18.EDF	A18	.
275	8688058	8688423	313	678	365	RIGHT	A18.EDF	A18	.
275	8688495	8690750	750	3005	2255	RIGHT	A18.EDF	A18	.
275	8692029	8692643	4284	4898	614	RIGHT	A18.EDF	A18	.
275	8693129	8693821	5384	6076	692	RIGHT	A18.EDF	A18	.
276	8695697	8697074	57	1434	1377	RIGHT	A18.EDF	A18	.
276	8697270	8697273	1630	1633	3	RIGHT	A18.EDF	A18	.
276	8697309	8697332	1669	1692	23	RIGHT	A18.EDF	A18	.
276	8697362	8697864	1722	2224	502	RIGHT	A18.EDF	A18	.
276	8698414	8699343	2774	3703	929	RIGHT	A18.EDF	A18	.
276	8699369	8699478	3729	3838	109	RIGHT	A18.EDF	A18	.
276	8699503	8699795	3863	4155	292	RIGHT	A18.EDF	A18	.
276	8699816	8700598	4176	4958	782	RIGHT	A18.EDF	A18	.
276	8700619	8701086	4979	5446	467	RIGHT	A18.EDF	A18	.
276	8701139	8701561	5499	5921	422	RIGHT	A18.EDF	A18	.
276	8701599	8701638	5959	5998	39	RIGHT	A18.EDF	A18	.
276	8702111	8702326	6471	6686	215	RIGHT	A18.EDF	A18	.
277	8704817	8704864	623	670	47	RIGHT	A18.EDF	A18	.
277	8704929	8705345	735	1151	416	RIGHT	A18.EDF	A18	.
277	8705548	8705570	1354	1376	22	RIGHT	A18.EDF	A18	.
277	8705602	8705813	1408	1619	211	RIGHT	A18.EDF	A18	.
277	8705896	8705898	1702	1704	2	RIGHT	A18.EDF	A18	.
277	8705919	8706320	1725	2126	401	RIGHT	A18.EDF	A18	.
277	8706726	8706745	2532	2551	19	RIGHT	A18.EDF	A18	.
277	8706772	8707781	2578	3587	1009	RIGHT	A18.EDF	A18	.
277	8707995	8708321	3801	4127	326	RIGHT	A18.EDF	A18	.
277	8708516	8708730	4322	4536	214	RIGHT	A18.EDF	A18	.
277	8708788	8708800	4594	4606	12	RIGHT	A18.EDF	A18	.
277	8709577	8710932	5383	6738	1355	RIGHT	A18.EDF	A18	.
278	8714593	8715201	499	1107	608	RIGHT	A18.EDF	A18	.
278	8715465	8715868	1371	1774	403	RIGHT	A18.EDF	A18	.
278	8716588	8716598	2494	2504	10	RIGHT	A18.EDF	A18	.
278	8716662	8717803	2568	3709	1141	RIGHT	A18.EDF	A18	.
278	8717871	8719770	3777	5676	1899	RIGHT	A18.EDF	A18	.
279	8722121	8722344	58	281	223	RIGHT	A18.EDF	A18	.
279	8722446	8722474	383	411	28	RIGHT	A18.EDF	A18	.
279	8722595	8724201	532	2138	1606	RIGHT	A18.EDF	A18	.
279	8724244	8724244	2181	2181	0	RIGHT	A18.EDF	A18	.
279	8725171	8725172	3108	3109	1	RIGHT	A18.EDF	A18	.
279	8725219	8725372	3156	3309	153	RIGHT	A18.EDF	A18	.
279	8727302	8727302	5239	5239	0	RIGHT	A18.EDF	A18	.
279	8727400	8727625	5337	5562	225	RIGHT	A18.EDF	A18	.
280	8729812	8730211	57	456	399	RIGHT	A18.EDF	A18	.
280	8730241	8730248	486	493	7	RIGHT	A18.EDF	A18	.
280	8730916	8730918	1161	1163	2	RIGHT	A18.EDF	A18	.
280	8730989	8731662	1234	1907	673	RIGHT	A18.EDF	A18	.
280	8731700	8731700	1945	1945	0	RIGHT	A18.EDF	A18	.
280	8731760	8731849	2005	2094	89	RIGHT	A18.EDF	A18	.
280	8731900	8732165	2145	2410	265	RIGHT	A18.EDF	A18	.
280	8732281	8733019	2526	3264	738	RIGHT	A18.EDF	A18	.
280	8733247	8733598	3492	3843	351	RIGHT	A18.EDF	A18	.
280	8734290	8734291	4535	4536	1	RIGHT	A18.EDF	A18	.
280	8734329	8734329	4574	4574	0	RIGHT	A18.EDF	A18	.
280	8734542	8734961	4787	5206	419	RIGHT	A18.EDF	A18	.
280	8735195	8735195	5440	5440	0	RIGHT	A18.EDF	A18	.
280	8735243	8735243	5488	5488	0	RIGHT	A18.EDF	A18	.
280	8735283	8735284	5528	5529	1	RIGHT	A18.EDF	A18	.
280	8735322	8735326	5567	5571	4	RIGHT	A18.EDF	A18	.
280	8735351	8735617	5596	5862	266	RIGHT	A18.EDF	A18	.
281	8738653	8742334	58	3739	3681	RIGHT	A18.EDF	A18	.
282	8747191	8747380	58	247	189	RIGHT	A18.EDF	A18	.
282	8749866	8750034	2733	2901	168	RIGHT	A18.EDF	A18	.
282	8750073	8750218	2940	3085	145	RIGHT	A18.EDF	A18	.
282	8751170	8751449	4037	4316	279	RIGHT	A18.EDF	A18	.
282	8751764	8752179	4631	5046	415	RIGHT	A18.EDF	A18	.
282	8752217	8752656	5084	5523	439	RIGHT	A18.EDF	A18	.
282	8754295	8754435	7162	7302	140	RIGHT	A18.EDF	A18	.
282	8754459	8754519	7326	7386	60	RIGHT	A18.EDF	A18	.
283	8756844	8756878	58	92	34	RIGHT	A18.EDF	A18	.
283	8757104	8757522	318	736	418	RIGHT	A18.EDF	A18	.
283	8757615	8758439	829	1653	824	RIGHT	A18.EDF	A18	.
283	8759544	8759909	2758	3123	365	RIGHT	A18.EDF	A18	.
283	8760340	8761173	3554	4387	833	RIGHT	A18.EDF	A18	.
284	8764741	8766748	57	2064	2007	RIGHT	A18.EDF	A18	.
284	8767200	8767902	2516	3218	702	RIGHT	A18.EDF	A18	.
284	8767935	8768064	3251	3380	129	RIGHT	A18.EDF	A18	.
284	8768106	8768111	3422	3427	5	RIGHT	A18.EDF	A18	.
284	8768138	8768812	3454	4128	674	RIGHT	A18.EDF	A18	.
284	8768861	8768863	4177	4179	2	RIGHT	A18.EDF	A18	.
284	8768911	8768923	4227	4239	12	RIGHT	A18.EDF	A18	.
284	8768950	8768951	4266	4267	1	RIGHT	A18.EDF	A18	.
284	8769012	8769025	4328	4341	13	RIGHT	A18.EDF	A18	.
284	8769144	8770035	4460	5351	891	RIGHT	A18.EDF	A18	.
284	8770624	8770898	5940	6214	274	RIGHT	A18.EDF	A18	.
285	8773550	8773684	66	200	134	RIGHT	A18.EDF	A18	.
285	8773872	8774693	388	1209	821	RIGHT	A18.EDF	A18	.
285	8775051	8775309	1567	1825	258	RIGHT	A18.EDF	A18	.
285	8775657	8778791	2173	5307	3134	RIGHT	A18.EDF	A18	.
285	8778847	8779194	5363	5710	347	RIGHT	A18.EDF	A18	.
286	8782594	8789160	57	6623	6566	RIGHT	A18.EDF	A18	.
287	8791642	8792295	58	711	653	RIGHT	A18.EDF	A18	.
287	8792412	8793909	828	2325	1497	RIGHT	A18.EDF	A18	.
287	8794082	8794914	2498	3330	832	RIGHT	A18.EDF	A18	.
287	8794945	8794946	3361	3362	1	RIGHT	A18.EDF	A18	.
287	8794973	8795146	3389	3562	173	RIGHT	A18.EDF	A18	.
287	8795634	8796564	4050	4980	930	RIGHT	A18.EDF	A18	.
288	8799459	8800977	57	1575	1518	RIGHT	A18.EDF	A18	.
288	8801189	8801450	1787	2048	261	RIGHT	A18.EDF	A18	.
288	8801935	8802222	2533	2820	287	RIGHT	A18.EDF	A18	.
288	8804882	8805087	5480	5685	205	RIGHT	A18.EDF	A18	.
1	9421979	9422155	1472	1648	176	RIGHT	A421.EDF	A42	1
1	9422178	9422179	1671	1672	1	RIGHT	A421.EDF	A42	1
2	9430933	9431125	978	1170	192	RIGHT	A421.EDF	A42	1
5	9459319	9459415	4219	4315	96	RIGHT	A421.EDF	A42	1
6	9465772	9466037	514	779	265	RIGHT	A421.EDF	A42	1
6	9466265	9466377	1007	1119	112	RIGHT	A421.EDF	A42	1
8	9486313	9486437	4282	4406	124	RIGHT	A421.EDF	A42	1
12	9517158	9517271	57	170	113	RIGHT	A421.EDF	A42	1
16	9551531	9551688	568	725	157	RIGHT	A421.EDF	A42	1
18	9571744	9571885	2600	2741	141	RIGHT	A421.EDF	A42	1
24	9622982	9623095	2688	2801	113	RIGHT	A421.EDF	A42	1
29	9668288	9668407	2579	2698	119	RIGHT	A421.EDF	A42	1
32	9694392	9694521	2503	2632	129	RIGHT	A421.EDF	A42	1
32	9694783	9694936	2894	3047	153	RIGHT	A421.EDF	A42	1
32	9697395	9697502	5506	5613	107	RIGHT	A421.EDF	A42	1
32	9697552	9697557	5663	5668	5	RIGHT	A421.EDF	A42	1
36	9729243	9729369	592	718	126	RIGHT	A421.EDF	A42	1
36	9729536	9729627	885	976	91	RIGHT	A421.EDF	A42	1
36	9732335	9732355	3684	3704	20	RIGHT	A421.EDF	A42	1
37	9738440	9738616	507	683	176	RIGHT	A421.EDF	A42	1
38	9745750	9745898	199	347	148	RIGHT	A421.EDF	A42	1
39	9755398	9755521	288	411	123	RIGHT	A421.EDF	A42	1
39	9757934	9758147	2824	3037	213	RIGHT	A421.EDF	A42	1
40	9765506	9765544	521	559	38	RIGHT	A421.EDF	A42	1
41	9774774	9774934	648	808	160	RIGHT	A421.EDF	A42	1
42	9782511	9782594	57	140	83	RIGHT	A421.EDF	A42	1
46	9821262	9821421	454	613	159	RIGHT	A421.EDF	A42	1
46	9821448	9821481	640	673	33	RIGHT	A421.EDF	A42	1
47	9831007	9831167	433	593	160	RIGHT	A421.EDF	A42	1
49	9847882	9848013	502	633	131	RIGHT	A421.EDF	A42	1
51	9870278	9870350	500	572	72	RIGHT	A421.EDF	A42	1
51	9870396	9870396	618	618	0	RIGHT	A421.EDF	A42	1
53	9887094	9887199	549	654	105	RIGHT	A421.EDF	A42	1
53	9887238	9887238	693	693	0	RIGHT	A421.EDF	A42	1
54	9894217	9894414	404	601	197	RIGHT	A421.EDF	A42	1
57	9920818	9920992	497	671	174	RIGHT	A421.EDF	A42	1
57	9921014	9921026	693	705	12	RIGHT	A421.EDF	A42	1
58	9927950	9928083	485	618	133	RIGHT	A421.EDF	A42	1
58	9928105	9928105	640	640	0	RIGHT	A421.EDF	A42	1
60	9944768	9944966	395	593	198	RIGHT	A421.EDF	A42	1
60	9947274	9947518	2901	3145	244	RIGHT	A421.EDF	A42	1
62	9962124	9962182	312	370	58	RIGHT	A421.EDF	A42	1
62	9962208	9962228	396	416	20	RIGHT	A421.EDF	A42	1
64	9978326	9978545	344	563	219	RIGHT	A421.EDF	A42	1
65	9987085	9987292	496	703	207	RIGHT	A421.EDF	A42	1
66	9995924	9996197	419	692	273	RIGHT	A421.EDF	A42	1
68	10014117	10014292	502	677	175	RIGHT	A421.EDF	A42	1
73	10052965	10052988	57	80	23	RIGHT	A421.EDF	A42	1
73	10053046	10053062	138	154	16	RIGHT	A421.EDF	A42	1
74	10060581	10060769	537	725	188	RIGHT	A421.EDF	A42	1
75	10070301	10070490	57	246	189	RIGHT	A421.EDF	A42	1
75	10072655	10072789	2411	2545	134	RIGHT	A421.EDF	A42	1
76	10079438	10079663	469	694	225	RIGHT	A421.EDF	A42	1
77	10088276	10088560	454	738	284	RIGHT	A421.EDF	A42	1
77	10093935	10093936	6113	6114	1	RIGHT	A421.EDF	A42	1
78	10096214	10101861	57	5704	5647	RIGHT	A421.EDF	A42	1
79	10104569	10105393	58	882	824	RIGHT	A421.EDF	A42	1
80	10112753	10113171	466	884	418	RIGHT	A421.EDF	A42	1
81	10121517	10121614	57	154	97	RIGHT	A421.EDF	A42	1
81	10124073	10125588	2613	4128	1515	RIGHT	A421.EDF	A42	1
82	10129348	10129503	57	212	155	RIGHT	A421.EDF	A42	1
82	10129755	10129761	464	470	6	RIGHT	A421.EDF	A42	1
82	10129783	10129939	492	648	156	RIGHT	A421.EDF	A42	1
83	10137588	10137723	468	603	135	RIGHT	A421.EDF	A42	1
85	10156443	10156703	487	747	260	RIGHT	A421.EDF	A42	1
85	10156748	10156751	792	795	3	RIGHT	A421.EDF	A42	1
86	10165100	10165653	351	904	553	RIGHT	A421.EDF	A42	1
87	10174819	10176430	58	1669	1611	RIGHT	A421.EDF	A42	1
87	10177163	10177364	2402	2603	201	RIGHT	A421.EDF	A42	1
87	10178228	10178680	3467	3919	452	RIGHT	A421.EDF	A42	1
87	10178748	10178784	3987	4023	36	RIGHT	A421.EDF	A42	1
87	10180623	10181530	5862	6769	907	RIGHT	A421.EDF	A42	1
88	10184357	10190976	57	6676	6619	RIGHT	A421.EDF	A42	1
89	10193742	10199511	58	5827	5769	RIGHT	A421.EDF	A42	1
90	10202751	10208797	58	6104	6046	RIGHT	A421.EDF	A42	1
91	10211214	10218683	57	7526	7469	RIGHT	A421.EDF	A42	1
92	10221221	10223731	58	2568	2510	RIGHT	A421.EDF	A42	1
93	10229977	10229985	555	563	8	RIGHT	A421.EDF	A42	1
94	10238581	10238908	310	637	327	RIGHT	A421.EDF	A42	1
94	10240918	10241028	2647	2757	110	RIGHT	A421.EDF	A42	1
94	10241071	10241073	2800	2802	2	RIGHT	A421.EDF	A42	1
94	10243433	10243509	5162	5238	76	RIGHT	A421.EDF	A42	1
95	10246299	10246516	329	546	217	RIGHT	A421.EDF	A42	1
95	10246539	10246556	569	586	17	RIGHT	A421.EDF	A42	1
96	10254770	10255084	433	747	314	RIGHT	A421.EDF	A42	1
98	10271900	10271952	57	109	52	RIGHT	A421.EDF	A42	1
100	10292440	10292680	459	699	240	RIGHT	A421.EDF	A42	1
100	10292705	10292924	724	943	219	RIGHT	A421.EDF	A42	1
101	10301053	10301306	459	712	253	RIGHT	A421.EDF	A42	1
101	10303426	10303662	2832	3068	236	RIGHT	A421.EDF	A42	1
102	10309298	10309503	302	507	205	RIGHT	A421.EDF	A42	1
103	10318041	10318325	57	341	284	RIGHT	A421.EDF	A42	1
103	10318460	10318528	476	544	68	RIGHT	A421.EDF	A42	1
105	10334139	10336921	57	2839	2782	RIGHT	A421.EDF	A42	1
107	10352546	10352740	485	679	194	RIGHT	A421.EDF	A42	1
108	10363224	10363384	531	691	160	RIGHT	A421.EDF	A42	1
109	10373732	10373752	1203	1223	20	RIGHT	A421.EDF	A42	1
109	10375359	10375536	2830	3007	177	RIGHT	A421.EDF	A42	1
110	10383518	10383763	367	612	245	RIGHT	A421.EDF	A42	1
110	10383877	10388227	726	5076	4350	RIGHT	A421.EDF	A42	1
111	10391045	10396872	57	5884	5827	RIGHT	A421.EDF	A42	1
112	10399475	10400390	57	972	915	RIGHT	A421.EDF	A42	1
113	10409412	10409890	473	951	478	RIGHT	A421.EDF	A42	1
114	10418429	10418598	273	442	169	RIGHT	A421.EDF	A42	1
116	10436355	10436604	387	636	249	RIGHT	A421.EDF	A42	1
116	10437841	10443381	1873	7413	5540	RIGHT	A421.EDF	A42	1
117	10446351	10453457	57	7163	7106	RIGHT	A421.EDF	A42	1
118	10456554	10459004	58	2508	2450	RIGHT	A421.EDF	A42	1
118	10461848	10462073	5352	5577	225	RIGHT	A421.EDF	A42	1
119	10467206	10471911	58	4763	4705	RIGHT	A421.EDF	A42	1
119	10472652	10474270	5504	7122	1618	RIGHT	A421.EDF	A42	1
120	10477147	10483706	58	6617	6559	RIGHT	A421.EDF	A42	1
1	11226016	11226520	1371	1875	504	RIGHT	A422.EDF	A42	2
3	11246390	11246445	3835	3890	55	RIGHT	A422.EDF	A42	2
4	11252349	11252359	481	491	10	RIGHT	A422.EDF	A42	2
5	11261285	11261512	57	284	227	RIGHT	A422.EDF	A42	2
6	11269233	11269414	57	238	181	RIGHT	A422.EDF	A42	2
6	11269719	11269993	543	817	274	RIGHT	A422.EDF	A42	2
7	11279586	11280079	2328	2821	493	RIGHT	A422.EDF	A42	2
7	11280293	11280476	3035	3218	183	RIGHT	A422.EDF	A42	2
7	11280662	11281020	3404	3762	358	RIGHT	A422.EDF	A42	2
8	11285108	11285376	57	325	268	RIGHT	A422.EDF	A42	2
8	11285520	11285833	469	782	313	RIGHT	A422.EDF	A42	2
8	11287988	11288270	2937	3219	282	RIGHT	A422.EDF	A42	2
10	11304331	11304527	225	421	196	RIGHT	A422.EDF	A42	2
11	11313312	11313715	500	903	403	RIGHT	A422.EDF	A42	2
11	11315698	11315699	2886	2887	1	RIGHT	A422.EDF	A42	2
11	11316461	11316472	3649	3660	11	RIGHT	A422.EDF	A42	2
12	11322194	11322642	209	657	448	RIGHT	A422.EDF	A42	2
12	11322815	11324229	830	2244	1414	RIGHT	A422.EDF	A42	2
12	11324268	11325306	2283	3321	1038	RIGHT	A422.EDF	A42	2
12	11325731	11328179	3746	6194	2448	RIGHT	A422.EDF	A42	2
12	11328261	11328791	6276	6806	530	RIGHT	A422.EDF	A42	2
13	11331120	11331268	57	205	148	RIGHT	A422.EDF	A42	2
13	11331338	11331833	275	770	495	RIGHT	A422.EDF	A42	2
13	11333303	11334117	2240	3054	814	RIGHT	A422.EDF	A42	2
13	11334274	11334322	3211	3259	48	RIGHT	A422.EDF	A42	2
13	11334732	11335041	3669	3978	309	RIGHT	A422.EDF	A42	2
13	11335120	11335164	4057	4101	44	RIGHT	A422.EDF	A42	2
13	11335460	11335662	4397	4599	202	RIGHT	A422.EDF	A42	2
13	11335739	11336218	4676	5155	479	RIGHT	A422.EDF	A42	2
13	11336851	11336876	5788	5813	25	RIGHT	A422.EDF	A42	2
14	11344622	11344848	3964	4190	226	RIGHT	A422.EDF	A42	2
15	11349214	11353957	400	5143	4743	RIGHT	A422.EDF	A42	2
16	11356854	11362693	57	5896	5839	RIGHT	A422.EDF	A42	2
17	11365511	11372198	57	6744	6687	RIGHT	A422.EDF	A42	2
18	11376107	11381664	57	5614	5557	RIGHT	A422.EDF	A42	2
19	11384083	11390990	58	6965	6907	RIGHT	A422.EDF	A42	2
20	11393074	11399786	58	6770	6712	RIGHT	A422.EDF	A42	2
21	11402380	11408670	57	6347	6290	RIGHT	A422.EDF	A42	2
22	11411245	11416315	58	5128	5070	RIGHT	A422.EDF	A42	2
23	11418367	11420507	58	2198	2140	RIGHT	A422.EDF	A42	2
23	11421215	11421502	2906	3193	287	RIGHT	A422.EDF	A42	2
23	11423894	11424480	5585	6171	586	RIGHT	A422.EDF	A42	2
24	11426580	11431776	57	5253	5196	RIGHT	A422.EDF	A42	2
25	11434350	11439659	57	5366	5309	RIGHT	A422.EDF	A42	2
26	11442388	11448235	57	5904	5847	RIGHT	A422.EDF	A42	2
27	11452278	11452537	565	824	259	RIGHT	A422.EDF	A42	2
27	11453123	11456940	1410	5227	3817	RIGHT	A422.EDF	A42	2
28	11460747	11466467	1207	6927	5720	RIGHT	A422.EDF	A42	2
29	11469224	11470345	57	1178	1121	RIGHT	A422.EDF	A42	2
29	11471940	11472176	2773	3009	236	RIGHT	A422.EDF	A42	2
29	11472362	11472390	3195	3223	28	RIGHT	A422.EDF	A42	2
29	11472464	11472551	3297	3384	87	RIGHT	A422.EDF	A42	2
29	11474159	11474821	4992	5654	662	RIGHT	A422.EDF	A42	2
30	11477875	11478010	208	343	135	RIGHT	A422.EDF	A42	2
30	11478188	11478391	521	724	203	RIGHT	A422.EDF	A42	2
30	11479094	11483376	1427	5709	4282	RIGHT	A422.EDF	A42	2
31	11485775	11493092	57	7374	7317	RIGHT	A422.EDF	A42	2
32	11495413	11501718	57	6362	6305	RIGHT	A422.EDF	A42	2
33	11504613	11510833	57	6277	6220	RIGHT	A422.EDF	A42	2
34	11513612	11518998	57	5443	5386	RIGHT	A422.EDF	A42	2
35	11522993	11528054	57	5118	5061	RIGHT	A422.EDF	A42	2
36	11530263	11531097	58	892	834	RIGHT	A422.EDF	A42	2
37	11537804	11544124	57	6377	6320	RIGHT	A422.EDF	A42	2
38	11546950	11552520	57	5627	5570	RIGHT	A422.EDF	A42	2
39	11555427	11559621	57	4251	4194	RIGHT	A422.EDF	A42	2
39	11559733	11559860	4363	4490	127	RIGHT	A422.EDF	A42	2
39	11559958	11560000	4588	4630	42	RIGHT	A422.EDF	A42	2
39	11560272	11561004	4902	5634	732	RIGHT	A422.EDF	A42	2
40	11565276	11565381	58	163	105	RIGHT	A422.EDF	A42	2
40	11565676	11565873	458	655	197	RIGHT	A422.EDF	A42	2
40	11567648	11567809	2430	2591	161	RIGHT	A422.EDF	A42	2
41	11576088	11576261	228	401	173	RIGHT	A422.EDF	A42	2
41	11576430	11583318	570	7458	6888	RIGHT	A422.EDF	A42	2
42	11585407	11591053	57	5703	5646	RIGHT	A422.EDF	A42	2
43	11593178	11598587	57	5466	5409	RIGHT	A422.EDF	A42	2
44	11600485	11607873	57	7445	7388	RIGHT	A422.EDF	A42	2
45	11610304	11615308	57	5061	5004	RIGHT	A422.EDF	A42	2
46	11618105	11621702	57	3654	3597	RIGHT	A422.EDF	A42	2
48	11635591	11635795	270	474	204	RIGHT	A422.EDF	A42	2
49	11645015	11646843	398	2226	1828	RIGHT	A422.EDF	A42	2
50	11653706	11653778	69	141	72	RIGHT	A422.EDF	A42	2
50	11654036	11654299	399	662	263	RIGHT	A422.EDF	A42	2
50	11654983	11655322	1346	1685	339	RIGHT	A422.EDF	A42	2
50	11655361	11655361	1724	1724	0	RIGHT	A422.EDF	A42	2
50	11655385	11658138	1748	4501	2753	RIGHT	A422.EDF	A42	2
50	11658825	11658926	5188	5289	101	RIGHT	A422.EDF	A42	2
51	11662245	11667970	57	5782	5725	RIGHT	A422.EDF	A42	2
52	11670621	11675446	58	4883	4825	RIGHT	A422.EDF	A42	2
53	11679273	11679538	393	658	265	RIGHT	A422.EDF	A42	2
53	11680141	11686022	1261	7142	5881	RIGHT	A422.EDF	A42	2
54	11688260	11693766	57	5563	5506	RIGHT	A422.EDF	A42	2
55	11698925	11699081	446	602	156	RIGHT	A422.EDF	A42	2
55	11701092	11701178	2613	2699	86	RIGHT	A422.EDF	A42	2
56	11706948	11707036	58	146	88	RIGHT	A422.EDF	A42	2
57	11714115	11714306	57	248	191	RIGHT	A422.EDF	A42	2
58	11723728	11723810	253	335	82	RIGHT	A422.EDF	A42	2
58	11723985	11730568	510	7093	6583	RIGHT	A422.EDF	A42	2
59	11733776	11738874	57	5155	5098	RIGHT	A422.EDF	A42	2
60	11741406	11746778	57	5429	5372	RIGHT	A422.EDF	A42	2
61	11749376	11754183	58	4865	4807	RIGHT	A422.EDF	A42	2
62	11756733	11762398	57	5722	5665	RIGHT	A422.EDF	A42	2
63	11765040	11766028	57	1045	988	RIGHT	A422.EDF	A42	2
64	11772440	11772554	257	371	114	RIGHT	A422.EDF	A42	2
64	11772597	11772598	414	415	1	RIGHT	A422.EDF	A42	2
65	11781617	11783610	256	2249	1993	RIGHT	A422.EDF	A42	2
66	11791203	11791401	297	495	198	RIGHT	A422.EDF	A42	2
71	11836169	11836365	834	1030	196	RIGHT	A422.EDF	A42	2
72	11844434	11844822	201	589	388	RIGHT	A422.EDF	A42	2
73	11855935	11856046	518	629	111	RIGHT	A422.EDF	A42	2
74	11864296	11864440	573	717	144	RIGHT	A422.EDF	A42	2
75	11871022	11871071	87	136	49	RIGHT	A422.EDF	A42	2
75	11871367	11871845	432	910	478	RIGHT	A422.EDF	A42	2
76	11881382	11881452	570	640	70	RIGHT	A422.EDF	A42	2
76	11881551	11883259	739	2447	1708	RIGHT	A422.EDF	A42	2
77	11890362	11892205	58	1901	1843	RIGHT	A422.EDF	A42	2
78	11898396	11899810	57	1471	1414	RIGHT	A422.EDF	A42	2
78	11900429	11900618	2090	2279	189	RIGHT	A422.EDF	A42	2
79	11906784	11907108	276	600	324	RIGHT	A422.EDF	A42	2
79	11907623	11908431	1115	1923	808	RIGHT	A422.EDF	A42	2
79	11908485	11908495	1977	1987	10	RIGHT	A422.EDF	A42	2
80	11915425	11915611	450	636	186	RIGHT	A422.EDF	A42	2
81	11921826	11927540	57	5771	5714	RIGHT	A422.EDF	A42	2
82	11929998	11931029	57	1088	1031	RIGHT	A422.EDF	A42	2
82	11932749	11932877	2808	2936	128	RIGHT	A422.EDF	A42	2
83	11939194	11939567	537	910	373	RIGHT	A422.EDF	A42	2
85	11957384	11957547	166	329	163	RIGHT	A422.EDF	A42	2
85	11957688	11962641	470	5423	4953	RIGHT	A422.EDF	A42	2
86	11965596	11971327	57	5788	5731	RIGHT	A422.EDF	A42	2
87	11974404	11974476	57	129	72	RIGHT	A422.EDF	A42	2
93	12027667	12027812	242	387	145	RIGHT	A422.EDF	A42	2
93	12027856	12027858	431	433	2	RIGHT	A422.EDF	A42	2
93	12027971	12028160	546	735	189	RIGHT	A422.EDF	A42	2
93	12030748	12030932	3323	3507	184	RIGHT	A422.EDF	A42	2
94	12037032	12037080	244	292	48	RIGHT	A422.EDF	A42	2
94	12037254	12037792	466	1004	538	RIGHT	A422.EDF	A42	2
95	12045249	12045370	196	317	121	RIGHT	A422.EDF	A42	2
95	12045550	12048038	497	2985	2488	RIGHT	A422.EDF	A42	2
96	12053812	12053864	525	577	52	RIGHT	A422.EDF	A42	2
97	12061463	12061791	449	777	328	RIGHT	A422.EDF	A42	2
97	12062240	12062261	1226	1247	21	RIGHT	A422.EDF	A42	2
99	12079501	12085987	57	6543	6486	RIGHT	A422.EDF	A42	2
100	12089398	12095453	57	6112	6055	RIGHT	A422.EDF	A42	2
101	12099513	12101375	57	1919	1862	RIGHT	A422.EDF	A42	2
102	12108865	12109253	493	881	388	RIGHT	A422.EDF	A42	2
103	12116585	12118126	58	1599	1541	RIGHT	A422.EDF	A42	2
103	12118914	12123270	2387	6743	4356	RIGHT	A422.EDF	A42	2
104	12125807	12130595	57	4845	4788	RIGHT	A422.EDF	A42	2
105	12133249	12140381	58	7190	7132	RIGHT	A422.EDF	A42	2
106	12142337	12146906	57	4626	4569	RIGHT	A422.EDF	A42	2
107	12149712	12149782	57	127	70	RIGHT	A422.EDF	A42	2
108	12159166	12159917	57	808	751	RIGHT	A422.EDF	A42	2
108	12162616	12164204	3507	5095	1588	RIGHT	A422.EDF	A42	2
109	12167277	12167379	459	561	102	RIGHT	A422.EDF	A42	2
109	12169027	12169144	2209	2326	117	RIGHT	A422.EDF	A42	2
110	12174370	12180056	58	5744	5686	RIGHT	A422.EDF	A42	2
111	12182085	12187050	58	5023	4965	RIGHT	A422.EDF	A42	2
112	12189840	12195765	57	5982	5925	RIGHT	A422.EDF	A42	2
113	12198491	12199087	57	653	596	RIGHT	A422.EDF	A42	2
113	12201673	12201797	3239	3363	124	RIGHT	A422.EDF	A42	2
114	12208426	12208433	82	89	7	RIGHT	A422.EDF	A42	2
115	12218290	12218409	481	600	119	RIGHT	A422.EDF	A42	2
116	12226095	12226201	265	371	106	RIGHT	A422.EDF	A42	2
116	12226229	12226234	399	404	5	RIGHT	A422.EDF	A42	2
116	12228850	12228983	3020	3153	133	RIGHT	A422.EDF	A42	2
116	12229021	12229025	3191	3195	4	RIGHT	A422.EDF	A42	2
119	12250962	12251169	482	689	207	RIGHT	A422.EDF	A42	2
119	12251217	12251226	737	746	9	RIGHT	A422.EDF	A42	2
1	12810089	12810604	57	572	515	RIGHT	A423.EDF	A42	3
1	12810845	12811012	813	980	167	RIGHT	A423.EDF	A42	3
2	12822014	12822039	57	82	25	RIGHT	A423.EDF	A42	3
2	12822691	12823019	734	1062	328	RIGHT	A423.EDF	A42	3
3	12830819	12831192	558	931	373	RIGHT	A423.EDF	A42	3
3	12832639	12832900	2378	2639	261	RIGHT	A423.EDF	A42	3
4	12840223	12840626	489	892	403	RIGHT	A423.EDF	A42	3
5	12848022	12848313	557	848	291	RIGHT	A423.EDF	A42	3
6	12855189	12855495	57	363	306	RIGHT	A423.EDF	A42	3
6	12855659	12855862	527	730	203	RIGHT	A423.EDF	A42	3
7	12864471	12864634	224	387	163	RIGHT	A423.EDF	A42	3
7	12865038	12865177	791	930	139	RIGHT	A423.EDF	A42	3
7	12868941	12869065	4694	4818	124	RIGHT	A423.EDF	A42	3
8	12872680	12872819	57	196	139	RIGHT	A423.EDF	A42	3
8	12872924	12873153	301	530	229	RIGHT	A423.EDF	A42	3
9	12882393	12882536	57	200	143	RIGHT	A423.EDF	A42	3
9	12882645	12882892	309	556	247	RIGHT	A423.EDF	A42	3
10	12891218	12891359	57	198	141	RIGHT	A423.EDF	A42	3
10	12891395	12891612	234	451	217	RIGHT	A423.EDF	A42	3
10	12896824	12896956	5663	5795	132	RIGHT	A423.EDF	A42	3
11	12903283	12903523	103	343	240	RIGHT	A423.EDF	A42	3
11	12903657	12903873	477	693	216	RIGHT	A423.EDF	A42	3
11	12904666	12904724	1486	1544	58	RIGHT	A423.EDF	A42	3
11	12905785	12906041	2605	2861	256	RIGHT	A423.EDF	A42	3
11	12909491	12909680	6311	6500	189	RIGHT	A423.EDF	A42	3
12	12913578	12913810	134	366	232	RIGHT	A423.EDF	A42	3
12	12913890	12914120	446	676	230	RIGHT	A423.EDF	A42	3
12	12914245	12914422	801	978	177	RIGHT	A423.EDF	A42	3
13	12924367	12924499	57	189	132	RIGHT	A423.EDF	A42	3
13	12928035	12928208	3725	3898	173	RIGHT	A423.EDF	A42	3
13	12928233	12928256	3923	3946	23	RIGHT	A423.EDF	A42	3
14	12934394	12934573	57	236	179	RIGHT	A423.EDF	A42	3
14	12934618	12934637	281	300	19	RIGHT	A423.EDF	A42	3
14	12934681	12934882	344	545	201	RIGHT	A423.EDF	A42	3
14	12934911	12934922	574	585	11	RIGHT	A423.EDF	A42	3
14	12936657	12936809	2320	2472	152	RIGHT	A423.EDF	A42	3
14	12936831	12936839	2494	2502	8	RIGHT	A423.EDF	A42	3
15	12943768	12943968	302	502	200	RIGHT	A423.EDF	A42	3
15	12944004	12944024	538	558	20	RIGHT	A423.EDF	A42	3
15	12948146	12948338	4680	4872	192	RIGHT	A423.EDF	A42	3
15	12948366	12948386	4900	4920	20	RIGHT	A423.EDF	A42	3
16	12952558	12952700	58	200	142	RIGHT	A423.EDF	A42	3
16	12952993	12953350	493	850	357	RIGHT	A423.EDF	A42	3
17	12960399	12961164	58	823	765	RIGHT	A423.EDF	A42	3
17	12962982	12963217	2641	2876	235	RIGHT	A423.EDF	A42	3
17	12963829	12964087	3488	3746	258	RIGHT	A423.EDF	A42	3
17	12964114	12964118	3773	3777	4	RIGHT	A423.EDF	A42	3
17	12965009	12965266	4668	4925	257	RIGHT	A423.EDF	A42	3
17	12965302	12965304	4961	4963	2	RIGHT	A423.EDF	A42	3
17	12965329	12965337	4988	4996	8	RIGHT	A423.EDF	A42	3
17	12965980	12966196	5639	5855	216	RIGHT	A423.EDF	A42	3
17	12966228	12966261	5887	5920	33	RIGHT	A423.EDF	A42	3
18	12970809	12971182	496	869	373	RIGHT	A423.EDF	A42	3
19	12979315	12979459	57	201	144	RIGHT	A423.EDF	A42	3
19	12979486	12979503	228	245	17	RIGHT	A423.EDF	A42	3
19	12979541	12979802	283	544	261	RIGHT	A423.EDF	A42	3
19	12979845	12979846	587	588	1	RIGHT	A423.EDF	A42	3
19	12980154	12980401	896	1143	247	RIGHT	A423.EDF	A42	3
20	12987685	12987881	58	254	196	RIGHT	A423.EDF	A42	3
21	12998408	12998736	102	430	328	RIGHT	A423.EDF	A42	3
21	12998816	12999309	510	1003	493	RIGHT	A423.EDF	A42	3
22	13010351	13010579	147	375	228	RIGHT	A423.EDF	A42	3
22	13010705	13010953	501	749	248	RIGHT	A423.EDF	A42	3
22	13017079	13017260	6875	7056	181	RIGHT	A423.EDF	A42	3
23	13019962	13020046	57	141	84	RIGHT	A423.EDF	A42	3
23	13020148	13020346	243	441	198	RIGHT	A423.EDF	A42	3
23	13020648	13020961	743	1056	313	RIGHT	A423.EDF	A42	3
23	13021723	13021837	1818	1932	114	RIGHT	A423.EDF	A42	3
24	13028288	13028315	58	85	27	RIGHT	A423.EDF	A42	3
25	13036710	13036931	653	874	221	RIGHT	A423.EDF	A42	3
25	13041466	13041609	5409	5552	143	RIGHT	A423.EDF	A42	3
25	13041649	13041650	5592	5593	1	RIGHT	A423.EDF	A42	3
26	13046544	13046747	430	633	203	RIGHT	A423.EDF	A42	3
26	13046810	13047000	696	886	190	RIGHT	A423.EDF	A42	3
27	13053441	13053532	57	148	91	RIGHT	A423.EDF	A42	3
27	13053580	13053580	196	196	0	RIGHT	A423.EDF	A42	3
27	13053641	13053808	257	424	167	RIGHT	A423.EDF	A42	3
27	13054028	13054181	644	797	153	RIGHT	A423.EDF	A42	3
27	13054219	13054221	835	837	2	RIGHT	A423.EDF	A42	3
28	13062287	13062332	57	102	45	RIGHT	A423.EDF	A42	3
28	13062365	13062373	135	143	8	RIGHT	A423.EDF	A42	3
28	13065367	13065596	3137	3366	229	RIGHT	A423.EDF	A42	3
29	13072929	13073125	108	304	196	RIGHT	A423.EDF	A42	3
29	13073164	13073166	343	345	2	RIGHT	A423.EDF	A42	3
29	13073328	13073558	507	737	230	RIGHT	A423.EDF	A42	3
29	13073579	13073589	758	768	10	RIGHT	A423.EDF	A42	3
30	13082396	13082603	57	264	207	RIGHT	A423.EDF	A42	3
30	13083003	13083361	664	1022	358	RIGHT	A423.EDF	A42	3
31	13093897	13094103	660	866	206	RIGHT	A423.EDF	A42	3
31	13094138	13094138	901	901	0	RIGHT	A423.EDF	A42	3
32	13102790	13102948	57	215	158	RIGHT	A423.EDF	A42	3
32	13103270	13103272	537	539	2	RIGHT	A423.EDF	A42	3
32	13103301	13103536	568	803	235	RIGHT	A423.EDF	A42	3
33	13111955	13112313	339	697	358	RIGHT	A423.EDF	A42	3
34	13120496	13120854	113	471	358	RIGHT	A423.EDF	A42	3
35	13128625	13128938	377	690	313	RIGHT	A423.EDF	A42	3
36	13135581	13135645	57	121	64	RIGHT	A423.EDF	A42	3
36	13135996	13136246	472	722	250	RIGHT	A423.EDF	A42	3
37	13144874	13145247	479	852	373	RIGHT	A423.EDF	A42	3
37	13145291	13145292	896	897	1	RIGHT	A423.EDF	A42	3
37	13147315	13147571	2920	3176	256	RIGHT	A423.EDF	A42	3
37	13147635	13147635	3240	3240	0	RIGHT	A423.EDF	A42	3
38	13153327	13153418	57	148	91	RIGHT	A423.EDF	A42	3
39	13163051	13163266	454	669	215	RIGHT	A423.EDF	A42	3
40	13173433	13173596	2171	2334	163	RIGHT	A423.EDF	A42	3
41	13179855	13180348	100	593	493	RIGHT	A423.EDF	A42	3
41	13180372	13180373	617	618	1	RIGHT	A423.EDF	A42	3
43	13197792	13198032	458	698	240	RIGHT	A423.EDF	A42	3
44	13208675	13208979	340	644	304	RIGHT	A423.EDF	A42	3
45	13220645	13220868	522	745	223	RIGHT	A423.EDF	A42	3
46	13231269	13231564	373	668	295	RIGHT	A423.EDF	A42	3
47	13243604	13244116	248	760	512	RIGHT	A423.EDF	A42	3
48	13252404	13252505	57	158	101	RIGHT	A423.EDF	A42	3
48	13252848	13253157	501	810	309	RIGHT	A423.EDF	A42	3
48	13258302	13258434	5955	6087	132	RIGHT	A423.EDF	A42	3
48	13258473	13258473	6126	6126	0	RIGHT	A423.EDF	A42	3
49	13262574	13263106	397	929	532	RIGHT	A423.EDF	A42	3
49	13265472	13265612	3295	3435	140	RIGHT	A423.EDF	A42	3
50	13270469	13270688	57	276	219	RIGHT	A423.EDF	A42	3
50	13270856	13271112	444	700	256	RIGHT	A423.EDF	A42	3
51	13279817	13280145	650	978	328	RIGHT	A423.EDF	A42	3
52	13287107	13292730	178	5801	5623	RIGHT	A423.EDF	A42	3
53	13295488	13298306	57	2875	2818	RIGHT	A423.EDF	A42	3
54	13306152	13307548	58	1454	1396	RIGHT	A423.EDF	A42	3
55	13315885	13321978	352	6445	6093	RIGHT	A423.EDF	A42	3
56	13326324	13331964	58	5698	5640	RIGHT	A423.EDF	A42	3
57	13335279	13340883	57	5661	5604	RIGHT	A423.EDF	A42	3
58	13343735	13350915	58	7238	7180	RIGHT	A423.EDF	A42	3
59	13353354	13358050	57	4753	4696	RIGHT	A423.EDF	A42	3
60	13359869	13364634	57	4822	4765	RIGHT	A423.EDF	A42	3
61	13367490	13372700	57	5267	5210	RIGHT	A423.EDF	A42	3
62	13375056	13376498	57	1499	1442	RIGHT	A423.EDF	A42	3
62	13377628	13377761	2629	2762	133	RIGHT	A423.EDF	A42	3
63	13383371	13383684	195	508	313	RIGHT	A423.EDF	A42	3
64	13392956	13393269	366	679	313	RIGHT	A423.EDF	A42	3
65	13401463	13401687	429	653	224	RIGHT	A423.EDF	A42	3
65	13405609	13405772	4575	4738	163	RIGHT	A423.EDF	A42	3
65	13405810	13405815	4776	4781	5	RIGHT	A423.EDF	A42	3
66	13408966	13409176	494	704	210	RIGHT	A423.EDF	A42	3
67	13418305	13418753	360	808	448	RIGHT	A423.EDF	A42	3
68	13427567	13427785	57	275	218	RIGHT	A423.EDF	A42	3
68	13428129	13428353	619	843	224	RIGHT	A423.EDF	A42	3
68	13431497	13431563	3987	4053	66	RIGHT	A423.EDF	A42	3
69	13436794	13437025	446	677	231	RIGHT	A423.EDF	A42	3
69	13437290	13437323	942	975	33	RIGHT	A423.EDF	A42	3
69	13437358	13437372	1010	1024	14	RIGHT	A423.EDF	A42	3
69	13437404	13437414	1056	1066	10	RIGHT	A423.EDF	A42	3
70	13445378	13445958	393	973	580	RIGHT	A423.EDF	A42	3
71	13452703	13452959	357	613	256	RIGHT	A423.EDF	A42	3
71	13452997	13453002	651	656	5	RIGHT	A423.EDF	A42	3
71	13457698	13457727	5352	5381	29	RIGHT	A423.EDF	A42	3
71	13457776	13457782	5430	5436	6	RIGHT	A423.EDF	A42	3
72	13463964	13464139	492	667	175	RIGHT	A423.EDF	A42	3
72	13464187	13464192	715	720	5	RIGHT	A423.EDF	A42	3
73	13471837	13471995	561	719	158	RIGHT	A423.EDF	A42	3
73	13472036	13472036	760	760	0	RIGHT	A423.EDF	A42	3
73	13474404	13474531	3128	3255	127	RIGHT	A423.EDF	A42	3
74	13481813	13482061	601	849	248	RIGHT	A423.EDF	A42	3
75	13492946	13493072	57	183	126	RIGHT	A423.EDF	A42	3
75	13493348	13493509	459	620	161	RIGHT	A423.EDF	A42	3
75	13493661	13493832	772	943	171	RIGHT	A423.EDF	A42	3
75	13493939	13494066	1050	1177	127	RIGHT	A423.EDF	A42	3
75	13497703	13497813	4814	4924	110	RIGHT	A423.EDF	A42	3
76	13503649	13504179	248	778	530	RIGHT	A423.EDF	A42	3
77	13512820	13512957	57	194	137	RIGHT	A423.EDF	A42	3
77	13512991	13513664	228	901	673	RIGHT	A423.EDF	A42	3
79	13530173	13530328	58	213	155	RIGHT	A423.EDF	A42	3
79	13530636	13530766	521	651	130	RIGHT	A423.EDF	A42	3
80	13540012	13540175	298	461	163	RIGHT	A423.EDF	A42	3
80	13540323	13540551	609	837	228	RIGHT	A423.EDF	A42	3
81	13548242	13548378	57	193	136	RIGHT	A423.EDF	A42	3
81	13548661	13548915	476	730	254	RIGHT	A423.EDF	A42	3
82	13556205	13556243	57	95	38	RIGHT	A423.EDF	A42	3
82	13556573	13556946	425	798	373	RIGHT	A423.EDF	A42	3
83	13563914	13564021	58	165	107	RIGHT	A423.EDF	A42	3
83	13564323	13564555	467	699	232	RIGHT	A423.EDF	A42	3
84	13570650	13570881	57	288	231	RIGHT	A423.EDF	A42	3
84	13571216	13571574	623	981	358	RIGHT	A423.EDF	A42	3
85	13578610	13578959	58	407	349	RIGHT	A423.EDF	A42	3
86	13587327	13587537	58	268	210	RIGHT	A423.EDF	A42	3
86	13587754	13588097	485	828	343	RIGHT	A423.EDF	A42	3
87	13596228	13596527	495	794	299	RIGHT	A423.EDF	A42	3
87	13596568	13596569	835	836	1	RIGHT	A423.EDF	A42	3
87	13599633	13599727	3900	3994	94	RIGHT	A423.EDF	A42	3
87	13599762	13599766	4029	4033	4	RIGHT	A423.EDF	A42	3
88	13603937	13603944	88	95	7	RIGHT	A423.EDF	A42	3
88	13604318	13604563	469	714	245	RIGHT	A423.EDF	A42	3
89	13614179	13614180	91	92	1	RIGHT	A423.EDF	A42	3
90	13623644	13623834	444	634	190	RIGHT	A423.EDF	A42	3
90	13623893	13623895	693	695	2	RIGHT	A423.EDF	A42	3
90	13629921	13629948	6721	6748	27	RIGHT	A423.EDF	A42	3
91	13632654	13632815	516	677	161	RIGHT	A423.EDF	A42	3
92	13642194	13642335	487	628	141	RIGHT	A423.EDF	A42	3
92	13642367	13642372	660	665	5	RIGHT	A423.EDF	A42	3
92	13646009	13646084	4302	4377	75	RIGHT	A423.EDF	A42	3
93	13650956	13651048	58	150	92	RIGHT	A423.EDF	A42	3
93	13651582	13651767	684	869	185	RIGHT	A423.EDF	A42	3
93	13651801	13651809	903	911	8	RIGHT	A423.EDF	A42	3
94	13659513	13659557	57	101	44	RIGHT	A423.EDF	A42	3
94	13659602	13659621	146	165	19	RIGHT	A423.EDF	A42	3
94	13659775	13660033	319	577	258	RIGHT	A423.EDF	A42	3
94	13662049	13662220	2593	2764	171	RIGHT	A423.EDF	A42	3
95	13669538	13669695	2320	2477	157	RIGHT	A423.EDF	A42	3
96	13677081	13677469	648	1036	388	RIGHT	A423.EDF	A42	3
97	13685037	13685153	57	173	116	RIGHT	A423.EDF	A42	3
97	13685185	13685194	205	214	9	RIGHT	A423.EDF	A42	3
97	13685457	13685606	477	626	149	RIGHT	A423.EDF	A42	3
97	13685650	13685651	670	671	1	RIGHT	A423.EDF	A42	3
98	13695362	13695458	57	153	96	RIGHT	A423.EDF	A42	3
98	13695777	13695969	472	664	192	RIGHT	A423.EDF	A42	3
99	13703887	13704328	57	498	441	RIGHT	A423.EDF	A42	3
99	13708811	13708931	4981	5101	120	RIGHT	A423.EDF	A42	3
100	13712366	13712395	58	87	29	RIGHT	A423.EDF	A42	3
100	13712430	13712433	122	125	3	RIGHT	A423.EDF	A42	3
100	13712765	13712995	457	687	230	RIGHT	A423.EDF	A42	3
101	13719248	13719426	425	603	178	RIGHT	A423.EDF	A42	3
102	13727050	13727105	566	621	55	RIGHT	A423.EDF	A42	3
103	13734438	13734656	449	667	218	RIGHT	A423.EDF	A42	3
104	13742916	13742918	355	357	2	RIGHT	A423.EDF	A42	3
104	13742942	13743226	381	665	284	RIGHT	A423.EDF	A42	3
105	13753438	13753818	337	717	380	RIGHT	A423.EDF	A42	3
105	13756157	13756280	3056	3179	123	RIGHT	A423.EDF	A42	3
106	13761596	13761812	241	457	216	RIGHT	A423.EDF	A42	3
107	13773203	13773304	1927	2028	101	RIGHT	A423.EDF	A42	3
107	13773328	13773329	2052	2053	1	RIGHT	A423.EDF	A42	3
108	13779278	13779517	58	297	239	RIGHT	A423.EDF	A42	3
108	13779591	13779866	371	646	275	RIGHT	A423.EDF	A42	3
109	13789127	13789283	252	408	156	RIGHT	A423.EDF	A42	3
109	13789343	13789343	468	468	0	RIGHT	A423.EDF	A42	3
109	13789509	13789549	634	674	40	RIGHT	A423.EDF	A42	3
109	13789773	13789959	898	1084	186	RIGHT	A423.EDF	A42	3
109	13790000	13790001	1125	1126	1	RIGHT	A423.EDF	A42	3
110	13798415	13798923	307	815	508	RIGHT	A423.EDF	A42	3
111	13809953	13810109	499	655	156	RIGHT	A423.EDF	A42	3
111	13810163	13810163	709	709	0	RIGHT	A423.EDF	A42	3
111	13814307	13814347	4853	4893	40	RIGHT	A423.EDF	A42	3
111	13814386	13814580	4932	5126	194	RIGHT	A423.EDF	A42	3
112	13819312	13819479	481	648	167	RIGHT	A423.EDF	A42	3
113	13826848	13827003	158	313	155	RIGHT	A423.EDF	A42	3
113	13827113	13827288	423	598	175	RIGHT	A423.EDF	A42	3
114	13835462	13835530	57	125	68	RIGHT	A423.EDF	A42	3
114	13835855	13836168	450	763	313	RIGHT	A423.EDF	A42	3
115	13845039	13845239	433	633	200	RIGHT	A423.EDF	A42	3
115	13845282	13845283	676	677	1	RIGHT	A423.EDF	A42	3
115	13847440	13847549	2834	2943	109	RIGHT	A423.EDF	A42	3
115	13847752	13847859	3146	3253	107	RIGHT	A423.EDF	A42	3
116	13854233	13854651	431	849	418	RIGHT	A423.EDF	A42	3
117	13861129	13861215	57	143	86	RIGHT	A423.EDF	A42	3
117	13861534	13861686	462	614	152	RIGHT	A423.EDF	A42	3
117	13865186	13865243	4114	4171	57	RIGHT	A423.EDF	A42	3
117	13865298	13865299	4226	4227	1	RIGHT	A423.EDF	A42	3
118	13870551	13870924	684	1057	373	RIGHT	A423.EDF	A42	3
119	13879449	13879634	607	792	185	RIGHT	A423.EDF	A42	3
119	13879676	13879695	834	853	19	RIGHT	A423.EDF	A42	3
120	13887230	13887668	58	496	438	RIGHT	A423.EDF	A42	3
1	9226364	9226559	732	927	195	RIGHT	A441.EDF	A44	1
1	9226922	9226933	1290	1301	11	RIGHT	A441.EDF	A44	1
1	9226978	9226978	1346	1346	0	RIGHT	A441.EDF	A44	1
1	9227023	9227025	1391	1393	2	RIGHT	A441.EDF	A44	1
1	9227055	9227131	1423	1499	76	RIGHT	A441.EDF	A44	1
1	9227158	9227184	1526	1552	26	RIGHT	A441.EDF	A44	1
1	9227205	9227782	1573	2150	577	RIGHT	A441.EDF	A44	1
1	9227991	9230659	2359	5027	2668	RIGHT	A441.EDF	A44	1
2	9233475	9240404	58	6987	6929	RIGHT	A441.EDF	A44	1
3	9243312	9248227	57	4972	4915	RIGHT	A441.EDF	A44	1
3	9248251	9248264	4996	5009	13	RIGHT	A441.EDF	A44	1
3	9248303	9248982	5048	5727	679	RIGHT	A441.EDF	A44	1
3	9249034	9249041	5779	5786	7	RIGHT	A441.EDF	A44	1
3	9249069	9249848	5814	6593	779	RIGHT	A441.EDF	A44	1
3	9249889	9249960	6634	6705	71	RIGHT	A441.EDF	A44	1
4	9252223	9255060	138	2975	2837	RIGHT	A441.EDF	A44	1
4	9255088	9256493	3003	4408	1405	RIGHT	A441.EDF	A44	1
4	9256619	9256649	4534	4564	30	RIGHT	A441.EDF	A44	1
4	9256674	9256674	4589	4589	0	RIGHT	A441.EDF	A44	1
4	9256697	9256711	4612	4626	14	RIGHT	A441.EDF	A44	1
4	9256732	9257045	4647	4960	313	RIGHT	A441.EDF	A44	1
4	9257089	9257090	5004	5005	1	RIGHT	A441.EDF	A44	1
4	9257116	9257748	5031	5663	632	RIGHT	A441.EDF	A44	1
4	9257781	9257854	5696	5769	73	RIGHT	A441.EDF	A44	1
4	9257882	9257890	5797	5805	8	RIGHT	A441.EDF	A44	1
4	9257914	9257915	5829	5830	1	RIGHT	A441.EDF	A44	1
4	9257963	9257963	5878	5878	0	RIGHT	A441.EDF	A44	1
4	9257991	9258015	5906	5930	24	RIGHT	A441.EDF	A44	1
4	9258049	9258071	5964	5986	22	RIGHT	A441.EDF	A44	1
4	9258124	9258131	6039	6046	7	RIGHT	A441.EDF	A44	1
4	9258155	9258173	6070	6088	18	RIGHT	A441.EDF	A44	1
4	9258221	9258229	6136	6144	8	RIGHT	A441.EDF	A44	1
4	9258263	9258286	6178	6201	23	RIGHT	A441.EDF	A44	1
4	9258336	9258665	6251	6580	329	RIGHT	A441.EDF	A44	1
5	9261788	9261817	70	99	29	RIGHT	A441.EDF	A44	1
5	9261849	9261876	131	158	27	RIGHT	A441.EDF	A44	1
5	9261901	9267821	183	6103	5920	RIGHT	A441.EDF	A44	1
6	9271501	9275062	57	3618	3561	RIGHT	A441.EDF	A44	1
6	9275085	9278517	3641	7073	3432	RIGHT	A441.EDF	A44	1
7	9281089	9282883	58	1852	1794	RIGHT	A441.EDF	A44	1
7	9282918	9282918	1887	1887	0	RIGHT	A441.EDF	A44	1
7	9282949	9286142	1918	5111	3193	RIGHT	A441.EDF	A44	1
8	9288702	9289759	57	1114	1057	RIGHT	A441.EDF	A44	1
8	9289784	9294815	1139	6170	5031	RIGHT	A441.EDF	A44	1
8	9294849	9295728	6204	7083	879	RIGHT	A441.EDF	A44	1
9	9298493	9299447	73	1027	954	RIGHT	A441.EDF	A44	1
9	9299481	9305464	1061	7044	5983	RIGHT	A441.EDF	A44	1
10	9307954	9308725	61	832	771	RIGHT	A441.EDF	A44	1
10	9308750	9309437	857	1544	687	RIGHT	A441.EDF	A44	1
10	9309463	9309486	1570	1593	23	RIGHT	A441.EDF	A44	1
10	9309511	9309511	1618	1618	0	RIGHT	A441.EDF	A44	1
10	9309547	9309629	1654	1736	82	RIGHT	A441.EDF	A44	1
10	9309657	9311245	1764	3352	1588	RIGHT	A441.EDF	A44	1
10	9311268	9312033	3375	4140	765	RIGHT	A441.EDF	A44	1
10	9312055	9312232	4162	4339	177	RIGHT	A441.EDF	A44	1
10	9312261	9312651	4368	4758	390	RIGHT	A441.EDF	A44	1
10	9312697	9314559	4804	6666	1862	RIGHT	A441.EDF	A44	1
11	9316953	9316966	74	87	13	RIGHT	A441.EDF	A44	1
11	9316987	9317063	108	184	76	RIGHT	A441.EDF	A44	1
11	9317084	9317203	205	324	119	RIGHT	A441.EDF	A44	1
11	9317237	9317237	358	358	0	RIGHT	A441.EDF	A44	1
11	9317318	9317756	439	877	438	RIGHT	A441.EDF	A44	1
11	9317781	9317862	902	983	81	RIGHT	A441.EDF	A44	1
11	9317885	9322699	1006	5820	4814	RIGHT	A441.EDF	A44	1
11	9322727	9322734	5848	5855	7	RIGHT	A441.EDF	A44	1
11	9322765	9322767	5886	5888	2	RIGHT	A441.EDF	A44	1
11	9322790	9322866	5911	5987	76	RIGHT	A441.EDF	A44	1
11	9322890	9322901	6011	6022	11	RIGHT	A441.EDF	A44	1
11	9322927	9323095	6048	6216	168	RIGHT	A441.EDF	A44	1
12	9325804	9325804	77	77	0	RIGHT	A441.EDF	A44	1
12	9325835	9325837	108	110	2	RIGHT	A441.EDF	A44	1
12	9326099	9328954	372	3227	2855	RIGHT	A441.EDF	A44	1
12	9329406	9329824	3679	4097	418	RIGHT	A441.EDF	A44	1
12	9329857	9330407	4130	4680	550	RIGHT	A441.EDF	A44	1
12	9330434	9330439	4707	4712	5	RIGHT	A441.EDF	A44	1
13	9333588	9335902	58	2372	2314	RIGHT	A441.EDF	A44	1
13	9335980	9335980	2450	2450	0	RIGHT	A441.EDF	A44	1
13	9336043	9336044	2513	2514	1	RIGHT	A441.EDF	A44	1
13	9336067	9336098	2537	2568	31	RIGHT	A441.EDF	A44	1
13	9336119	9338917	2589	5387	2798	RIGHT	A441.EDF	A44	1
13	9338954	9338972	5424	5442	18	RIGHT	A441.EDF	A44	1
13	9339028	9339029	5498	5499	1	RIGHT	A441.EDF	A44	1
13	9339072	9339072	5542	5542	0	RIGHT	A441.EDF	A44	1
13	9339119	9339119	5589	5589	0	RIGHT	A441.EDF	A44	1
13	9339193	9339195	5663	5665	2	RIGHT	A441.EDF	A44	1
14	9341408	9347707	58	6357	6299	RIGHT	A441.EDF	A44	1
14	9347730	9348350	6380	7000	620	RIGHT	A441.EDF	A44	1
15	9350719	9351505	58	844	786	RIGHT	A441.EDF	A44	1
15	9351536	9354873	875	4212	3337	RIGHT	A441.EDF	A44	1
15	9354894	9357666	4233	7005	2772	RIGHT	A441.EDF	A44	1
16	9359871	9365120	58	5307	5249	RIGHT	A441.EDF	A44	1
17	9367470	9370494	57	3081	3024	RIGHT	A441.EDF	A44	1
17	9370528	9370546	3115	3133	18	RIGHT	A441.EDF	A44	1
17	9370608	9370609	3195	3196	1	RIGHT	A441.EDF	A44	1
17	9370683	9373644	3270	6231	2961	RIGHT	A441.EDF	A44	1
17	9373669	9373686	6256	6273	17	RIGHT	A441.EDF	A44	1
17	9373748	9373752	6335	6339	4	RIGHT	A441.EDF	A44	1
17	9373792	9373843	6379	6430	51	RIGHT	A441.EDF	A44	1
17	9373897	9374456	6484	7043	559	RIGHT	A441.EDF	A44	1
18	9377085	9380624	57	3596	3539	RIGHT	A441.EDF	A44	1
18	9380688	9380731	3660	3703	43	RIGHT	A441.EDF	A44	1
18	9380761	9381641	3733	4613	880	RIGHT	A441.EDF	A44	1
18	9381682	9381981	4654	4953	299	RIGHT	A441.EDF	A44	1
18	9382070	9382070	5042	5042	0	RIGHT	A441.EDF	A44	1
18	9382120	9382120	5092	5092	0	RIGHT	A441.EDF	A44	1
18	9382145	9383213	5117	6185	1068	RIGHT	A441.EDF	A44	1
18	9383242	9384049	6214	7021	807	RIGHT	A441.EDF	A44	1
18	9384081	9384081	7053	7053	0	RIGHT	A441.EDF	A44	1
18	9384104	9384222	7076	7194	118	RIGHT	A441.EDF	A44	1
19	9387724	9388589	58	923	865	RIGHT	A441.EDF	A44	1
19	9388613	9390399	947	2733	1786	RIGHT	A441.EDF	A44	1
19	9390424	9390474	2758	2808	50	RIGHT	A441.EDF	A44	1
19	9390495	9390730	2829	3064	235	RIGHT	A441.EDF	A44	1
19	9390752	9390801	3086	3135	49	RIGHT	A441.EDF	A44	1
19	9390827	9390828	3161	3162	1	RIGHT	A441.EDF	A44	1
19	9390866	9390883	3200	3217	17	RIGHT	A441.EDF	A44	1
19	9390921	9390921	3255	3255	0	RIGHT	A441.EDF	A44	1
19	9390969	9390969	3303	3303	0	RIGHT	A441.EDF	A44	1
19	9391005	9391005	3339	3339	0	RIGHT	A441.EDF	A44	1
19	9391050	9391050	3384	3384	0	RIGHT	A441.EDF	A44	1
19	9391211	9391211	3545	3545	0	RIGHT	A441.EDF	A44	1
19	9391304	9392004	3638	4338	700	RIGHT	A441.EDF	A44	1
19	9392026	9392190	4360	4524	164	RIGHT	A441.EDF	A44	1
19	9392214	9392551	4548	4885	337	RIGHT	A441.EDF	A44	1
19	9392573	9392573	4907	4907	0	RIGHT	A441.EDF	A44	1
19	9392594	9392597	4928	4931	3	RIGHT	A441.EDF	A44	1
19	9392643	9392653	4977	4987	10	RIGHT	A441.EDF	A44	1
19	9392674	9392698	5008	5032	24	RIGHT	A441.EDF	A44	1
19	9392787	9392788	5121	5122	1	RIGHT	A441.EDF	A44	1
19	9392811	9392848	5145	5182	37	RIGHT	A441.EDF	A44	1
19	9392870	9392920	5204	5254	50	RIGHT	A441.EDF	A44	1
19	9392959	9393056	5293	5390	97	RIGHT	A441.EDF	A44	1
19	9393079	9393210	5413	5544	131	RIGHT	A441.EDF	A44	1
19	9393251	9393275	5585	5609	24	RIGHT	A441.EDF	A44	1
19	9393309	9393320	5643	5654	11	RIGHT	A441.EDF	A44	1
19	9393351	9393390	5685	5724	39	RIGHT	A441.EDF	A44	1
19	9393423	9393423	5757	5757	0	RIGHT	A441.EDF	A44	1
19	9393451	9393463	5785	5797	12	RIGHT	A441.EDF	A44	1
19	9393519	9393524	5853	5858	5	RIGHT	A441.EDF	A44	1
19	9393546	9393547	5880	5881	1	RIGHT	A441.EDF	A44	1
19	9393568	9393568	5902	5902	0	RIGHT	A441.EDF	A44	1
19	9393614	9393619	5948	5953	5	RIGHT	A441.EDF	A44	1
19	9393640	9393643	5974	5977	3	RIGHT	A441.EDF	A44	1
19	9393665	9393678	5999	6012	13	RIGHT	A441.EDF	A44	1
19	9393707	9393707	6041	6041	0	RIGHT	A441.EDF	A44	1
19	9393737	9393844	6071	6178	107	RIGHT	A441.EDF	A44	1
19	9393886	9393939	6220	6273	53	RIGHT	A441.EDF	A44	1
20	9395956	9396084	57	185	128	RIGHT	A441.EDF	A44	1
20	9396120	9396455	221	556	335	RIGHT	A441.EDF	A44	1
20	9396486	9401473	587	5574	4987	RIGHT	A441.EDF	A44	1
21	9403788	9405166	64	1442	1378	RIGHT	A441.EDF	A44	1
21	9405190	9410468	1466	6744	5278	RIGHT	A441.EDF	A44	1
22	9412507	9412514	107	114	7	RIGHT	A441.EDF	A44	1
22	9412545	9412726	145	326	181	RIGHT	A441.EDF	A44	1
22	9412758	9418763	358	6363	6005	RIGHT	A441.EDF	A44	1
23	9420887	9421942	57	1112	1055	RIGHT	A441.EDF	A44	1
23	9421968	9422443	1138	1613	475	RIGHT	A441.EDF	A44	1
23	9422476	9422476	1646	1646	0	RIGHT	A441.EDF	A44	1
23	9422616	9422618	1786	1788	2	RIGHT	A441.EDF	A44	1
23	9423020	9423020	2190	2190	0	RIGHT	A441.EDF	A44	1
23	9423292	9423292	2462	2462	0	RIGHT	A441.EDF	A44	1
23	9423361	9423473	2531	2643	112	RIGHT	A441.EDF	A44	1
23	9423522	9423546	2692	2716	24	RIGHT	A441.EDF	A44	1
23	9424250	9424255	3420	3425	5	RIGHT	A441.EDF	A44	1
23	9424300	9424300	3470	3470	0	RIGHT	A441.EDF	A44	1
23	9424558	9424559	3728	3729	1	RIGHT	A441.EDF	A44	1
23	9424615	9424730	3785	3900	115	RIGHT	A441.EDF	A44	1
23	9424773	9424778	3943	3948	5	RIGHT	A441.EDF	A44	1
23	9424896	9424896	4066	4066	0	RIGHT	A441.EDF	A44	1
23	9425244	9425244	4414	4414	0	RIGHT	A441.EDF	A44	1
23	9425273	9425273	4443	4443	0	RIGHT	A441.EDF	A44	1
23	9425311	9425311	4481	4481	0	RIGHT	A441.EDF	A44	1
23	9425506	9425664	4676	4834	158	RIGHT	A441.EDF	A44	1
23	9425702	9425703	4872	4873	1	RIGHT	A441.EDF	A44	1
23	9425731	9425742	4901	4912	11	RIGHT	A441.EDF	A44	1
23	9425805	9425805	4975	4975	0	RIGHT	A441.EDF	A44	1
23	9425842	9425866	5012	5036	24	RIGHT	A441.EDF	A44	1
23	9425899	9425929	5069	5099	30	RIGHT	A441.EDF	A44	1
23	9425957	9425978	5127	5148	21	RIGHT	A441.EDF	A44	1
23	9426002	9426002	5172	5172	0	RIGHT	A441.EDF	A44	1
23	9426023	9426027	5193	5197	4	RIGHT	A441.EDF	A44	1
23	9426066	9426133	5236	5303	67	RIGHT	A441.EDF	A44	1
23	9426167	9426167	5337	5337	0	RIGHT	A441.EDF	A44	1
23	9426281	9426281	5451	5451	0	RIGHT	A441.EDF	A44	1
23	9426306	9426308	5476	5478	2	RIGHT	A441.EDF	A44	1
23	9426349	9426349	5519	5519	0	RIGHT	A441.EDF	A44	1
23	9426451	9426481	5621	5651	30	RIGHT	A441.EDF	A44	1
23	9426555	9426615	5725	5785	60	RIGHT	A441.EDF	A44	1
23	9426636	9426636	5806	5806	0	RIGHT	A441.EDF	A44	1
23	9426685	9426998	5855	6168	313	RIGHT	A441.EDF	A44	1
23	9427022	9427022	6192	6192	0	RIGHT	A441.EDF	A44	1
23	9427066	9427067	6236	6237	1	RIGHT	A441.EDF	A44	1
23	9427151	9427330	6321	6500	179	RIGHT	A441.EDF	A44	1
23	9427351	9427404	6521	6574	53	RIGHT	A441.EDF	A44	1
23	9427429	9427433	6599	6603	4	RIGHT	A441.EDF	A44	1
23	9427491	9427512	6661	6682	21	RIGHT	A441.EDF	A44	1
23	9427554	9427555	6724	6725	1	RIGHT	A441.EDF	A44	1
23	9427688	9427699	6858	6869	11	RIGHT	A441.EDF	A44	1
24	9429257	9430058	58	859	801	RIGHT	A441.EDF	A44	1
24	9430080	9430669	881	1470	589	RIGHT	A441.EDF	A44	1
24	9430701	9430701	1502	1502	0	RIGHT	A441.EDF	A44	1
24	9430732	9430751	1533	1552	19	RIGHT	A441.EDF	A44	1
24	9430777	9430876	1578	1677	99	RIGHT	A441.EDF	A44	1
24	9430903	9430929	1704	1730	26	RIGHT	A441.EDF	A44	1
24	9430950	9431209	1751	2010	259	RIGHT	A441.EDF	A44	1
24	9431231	9431239	2032	2040	8	RIGHT	A441.EDF	A44	1
24	9431266	9431266	2067	2067	0	RIGHT	A441.EDF	A44	1
24	9431374	9431374	2175	2175	0	RIGHT	A441.EDF	A44	1
24	9431462	9431484	2263	2285	22	RIGHT	A441.EDF	A44	1
24	9431521	9431521	2322	2322	0	RIGHT	A441.EDF	A44	1
24	9431542	9431542	2343	2343	0	RIGHT	A441.EDF	A44	1
24	9431570	9431650	2371	2451	80	RIGHT	A441.EDF	A44	1
24	9431672	9431756	2473	2557	84	RIGHT	A441.EDF	A44	1
24	9431779	9432458	2580	3259	679	RIGHT	A441.EDF	A44	1
24	9432499	9432507	3300	3308	8	RIGHT	A441.EDF	A44	1
24	9432541	9432541	3342	3342	0	RIGHT	A441.EDF	A44	1
24	9432602	9432605	3403	3406	3	RIGHT	A441.EDF	A44	1
24	9432637	9432648	3438	3449	11	RIGHT	A441.EDF	A44	1
24	9432713	9432713	3514	3514	0	RIGHT	A441.EDF	A44	1
24	9432736	9432795	3537	3596	59	RIGHT	A441.EDF	A44	1
24	9432893	9432893	3694	3694	0	RIGHT	A441.EDF	A44	1
24	9432914	9432923	3715	3724	9	RIGHT	A441.EDF	A44	1
24	9432967	9433555	3768	4356	588	RIGHT	A441.EDF	A44	1
24	9433594	9433978	4395	4779	384	RIGHT	A441.EDF	A44	1
24	9434054	9434404	4855	5205	350	RIGHT	A441.EDF	A44	1
24	9434449	9434449	5250	5250	0	RIGHT	A441.EDF	A44	1
24	9434476	9434476	5277	5277	0	RIGHT	A441.EDF	A44	1
24	9434515	9434515	5316	5316	0	RIGHT	A441.EDF	A44	1
24	9434583	9434583	5384	5384	0	RIGHT	A441.EDF	A44	1
24	9434674	9434683	5475	5484	9	RIGHT	A441.EDF	A44	1
24	9434724	9434732	5525	5533	8	RIGHT	A441.EDF	A44	1
24	9434760	9434762	5561	5563	2	RIGHT	A441.EDF	A44	1
24	9434842	9434883	5643	5684	41	RIGHT	A441.EDF	A44	1
24	9434914	9434915	5715	5716	1	RIGHT	A441.EDF	A44	1
24	9434938	9434939	5739	5740	1	RIGHT	A441.EDF	A44	1
24	9434961	9434961	5762	5762	0	RIGHT	A441.EDF	A44	1
24	9434995	9435039	5796	5840	44	RIGHT	A441.EDF	A44	1
24	9435078	9435079	5879	5880	1	RIGHT	A441.EDF	A44	1
24	9435103	9435123	5904	5924	20	RIGHT	A441.EDF	A44	1
24	9435161	9435179	5962	5980	18	RIGHT	A441.EDF	A44	1
24	9435221	9435245	6022	6046	24	RIGHT	A441.EDF	A44	1
24	9435281	9435291	6082	6092	10	RIGHT	A441.EDF	A44	1
24	9435328	9435329	6129	6130	1	RIGHT	A441.EDF	A44	1
24	9435374	9435623	6175	6424	249	RIGHT	A441.EDF	A44	1
24	9435655	9436144	6456	6945	489	RIGHT	A441.EDF	A44	1
25	9438353	9438399	57	103	46	RIGHT	A441.EDF	A44	1
25	9438481	9438504	185	208	23	RIGHT	A441.EDF	A44	1
25	9438598	9438598	302	302	0	RIGHT	A441.EDF	A44	1
25	9438621	9438621	325	325	0	RIGHT	A441.EDF	A44	1
25	9438744	9438758	448	462	14	RIGHT	A441.EDF	A44	1
25	9438865	9438865	569	569	0	RIGHT	A441.EDF	A44	1
25	9438917	9438950	621	654	33	RIGHT	A441.EDF	A44	1
25	9438973	9438974	677	678	1	RIGHT	A441.EDF	A44	1
25	9439030	9439036	734	740	6	RIGHT	A441.EDF	A44	1
25	9439058	9439064	762	768	6	RIGHT	A441.EDF	A44	1
25	9439135	9439195	839	899	60	RIGHT	A441.EDF	A44	1
25	9439219	9440685	923	2389	1466	RIGHT	A441.EDF	A44	1
25	9440712	9440788	2416	2492	76	RIGHT	A441.EDF	A44	1
25	9440817	9441139	2521	2843	322	RIGHT	A441.EDF	A44	1
25	9441243	9441254	2947	2958	11	RIGHT	A441.EDF	A44	1
25	9441277	9441277	2981	2981	0	RIGHT	A441.EDF	A44	1
25	9441303	9441323	3007	3027	20	RIGHT	A441.EDF	A44	1
25	9441350	9441353	3054	3057	3	RIGHT	A441.EDF	A44	1
25	9441391	9441443	3095	3147	52	RIGHT	A441.EDF	A44	1
25	9441467	9442537	3171	4241	1070	RIGHT	A441.EDF	A44	1
25	9442560	9442573	4264	4277	13	RIGHT	A441.EDF	A44	1
25	9442612	9443631	4316	5335	1019	RIGHT	A441.EDF	A44	1
25	9443658	9443674	5362	5378	16	RIGHT	A441.EDF	A44	1
25	9443717	9443721	5421	5425	4	RIGHT	A441.EDF	A44	1
25	9443755	9443824	5459	5528	69	RIGHT	A441.EDF	A44	1
25	9443863	9443884	5567	5588	21	RIGHT	A441.EDF	A44	1
25	9443919	9443921	5623	5625	2	RIGHT	A441.EDF	A44	1
25	9443949	9444109	5653	5813	160	RIGHT	A441.EDF	A44	1
26	9446819	9446847	57	85	28	RIGHT	A441.EDF	A44	1
26	9446875	9447290	113	528	415	RIGHT	A441.EDF	A44	1
26	9447330	9447335	568	573	5	RIGHT	A441.EDF	A44	1
26	9447373	9447394	611	632	21	RIGHT	A441.EDF	A44	1
26	9447417	9447417	655	655	0	RIGHT	A441.EDF	A44	1
26	9447438	9447460	676	698	22	RIGHT	A441.EDF	A44	1
26	9447484	9447502	722	740	18	RIGHT	A441.EDF	A44	1
26	9447527	9447530	765	768	3	RIGHT	A441.EDF	A44	1
26	9447551	9447566	789	804	15	RIGHT	A441.EDF	A44	1
26	9447643	9447669	881	907	26	RIGHT	A441.EDF	A44	1
26	9447693	9447701	931	939	8	RIGHT	A441.EDF	A44	1
26	9447722	9447722	960	960	0	RIGHT	A441.EDF	A44	1
26	9447757	9447757	995	995	0	RIGHT	A441.EDF	A44	1
26	9447807	9447808	1045	1046	1	RIGHT	A441.EDF	A44	1
26	9447851	9447851	1089	1089	0	RIGHT	A441.EDF	A44	1
26	9447891	9447891	1129	1129	0	RIGHT	A441.EDF	A44	1
26	9447912	9447913	1150	1151	1	RIGHT	A441.EDF	A44	1
26	9447947	9447947	1185	1185	0	RIGHT	A441.EDF	A44	1
26	9447986	9448002	1224	1240	16	RIGHT	A441.EDF	A44	1
26	9448035	9448035	1273	1273	0	RIGHT	A441.EDF	A44	1
26	9448060	9448157	1298	1395	97	RIGHT	A441.EDF	A44	1
26	9448195	9448825	1433	2063	630	RIGHT	A441.EDF	A44	1
26	9448847	9450168	2085	3406	1321	RIGHT	A441.EDF	A44	1
26	9450207	9450216	3445	3454	9	RIGHT	A441.EDF	A44	1
26	9450242	9450699	3480	3937	457	RIGHT	A441.EDF	A44	1
26	9450725	9451077	3963	4315	352	RIGHT	A441.EDF	A44	1
26	9451104	9451123	4342	4361	19	RIGHT	A441.EDF	A44	1
26	9451167	9451168	4405	4406	1	RIGHT	A441.EDF	A44	1
26	9451263	9451291	4501	4529	28	RIGHT	A441.EDF	A44	1
26	9451346	9451381	4584	4619	35	RIGHT	A441.EDF	A44	1
26	9451403	9451832	4641	5070	429	RIGHT	A441.EDF	A44	1
26	9451856	9451896	5094	5134	40	RIGHT	A441.EDF	A44	1
26	9451919	9452024	5157	5262	105	RIGHT	A441.EDF	A44	1
26	9452062	9452184	5300	5422	122	RIGHT	A441.EDF	A44	1
27	9454904	9454910	76	82	6	RIGHT	A441.EDF	A44	1
27	9454932	9454932	104	104	0	RIGHT	A441.EDF	A44	1
27	9454979	9455113	151	285	134	RIGHT	A441.EDF	A44	1
27	9455146	9455147	318	319	1	RIGHT	A441.EDF	A44	1
27	9455238	9455268	410	440	30	RIGHT	A441.EDF	A44	1
27	9455289	9455319	461	491	30	RIGHT	A441.EDF	A44	1
27	9455342	9455365	514	537	23	RIGHT	A441.EDF	A44	1
27	9455391	9455416	563	588	25	RIGHT	A441.EDF	A44	1
27	9455442	9456002	614	1174	560	RIGHT	A441.EDF	A44	1
27	9456035	9456357	1207	1529	322	RIGHT	A441.EDF	A44	1
27	9456379	9456409	1551	1581	30	RIGHT	A441.EDF	A44	1
27	9456432	9457642	1604	2814	1210	RIGHT	A441.EDF	A44	1
27	9457673	9458177	2845	3349	504	RIGHT	A441.EDF	A44	1
27	9458200	9458249	3372	3421	49	RIGHT	A441.EDF	A44	1
27	9458282	9459371	3454	4543	1089	RIGHT	A441.EDF	A44	1
27	9459392	9459791	4564	4963	399	RIGHT	A441.EDF	A44	1
27	9459906	9459906	5078	5078	0	RIGHT	A441.EDF	A44	1
27	9459931	9459951	5103	5123	20	RIGHT	A441.EDF	A44	1
27	9459975	9459981	5147	5153	6	RIGHT	A441.EDF	A44	1
27	9460003	9460029	5175	5201	26	RIGHT	A441.EDF	A44	1
27	9460050	9460184	5222	5356	134	RIGHT	A441.EDF	A44	1
27	9460211	9460297	5383	5469	86	RIGHT	A441.EDF	A44	1
27	9460318	9460754	5490	5926	436	RIGHT	A441.EDF	A44	1
27	9460784	9460784	5956	5956	0	RIGHT	A441.EDF	A44	1
27	9460807	9460838	5979	6010	31	RIGHT	A441.EDF	A44	1
27	9460872	9460872	6044	6044	0	RIGHT	A441.EDF	A44	1
27	9460895	9461174	6067	6346	279	RIGHT	A441.EDF	A44	1
27	9461199	9461199	6371	6371	0	RIGHT	A441.EDF	A44	1
27	9461259	9461273	6431	6445	14	RIGHT	A441.EDF	A44	1
27	9461297	9461313	6469	6485	16	RIGHT	A441.EDF	A44	1
27	9461336	9461336	6508	6508	0	RIGHT	A441.EDF	A44	1
27	9461359	9461424	6531	6596	65	RIGHT	A441.EDF	A44	1
27	9461449	9461470	6621	6642	21	RIGHT	A441.EDF	A44	1
27	9461495	9461600	6667	6772	105	RIGHT	A441.EDF	A44	1
28	9463886	9466542	57	2713	2656	RIGHT	A441.EDF	A44	1
28	9466565	9467897	2736	4068	1332	RIGHT	A441.EDF	A44	1
28	9467919	9467946	4090	4117	27	RIGHT	A441.EDF	A44	1
28	9467972	9468211	4143	4382	239	RIGHT	A441.EDF	A44	1
28	9468249	9468262	4420	4433	13	RIGHT	A441.EDF	A44	1
28	9468288	9469190	4459	5361	902	RIGHT	A441.EDF	A44	1
28	9469215	9469240	5386	5411	25	RIGHT	A441.EDF	A44	1
28	9469269	9469326	5440	5497	57	RIGHT	A441.EDF	A44	1
29	9471313	9471368	57	112	55	RIGHT	A441.EDF	A44	1
29	9471391	9471405	135	149	14	RIGHT	A441.EDF	A44	1
29	9471434	9476248	178	4992	4814	RIGHT	A441.EDF	A44	1
29	9476269	9476569	5013	5313	300	RIGHT	A441.EDF	A44	1
30	9478480	9481911	58	3489	3431	RIGHT	A441.EDF	A44	1
30	9481933	9481970	3511	3548	37	RIGHT	A441.EDF	A44	1
30	9482023	9482391	3601	3969	368	RIGHT	A441.EDF	A44	1
30	9482436	9482476	4014	4054	40	RIGHT	A441.EDF	A44	1
30	9482505	9484294	4083	5872	1789	RIGHT	A441.EDF	A44	1
31	9486178	9491709	58	5589	5531	RIGHT	A441.EDF	A44	1
31	9491744	9491744	5624	5624	0	RIGHT	A441.EDF	A44	1
31	9491772	9491779	5652	5659	7	RIGHT	A441.EDF	A44	1
31	9491860	9492089	5740	5969	229	RIGHT	A441.EDF	A44	1
32	9494988	9495327	57	396	339	RIGHT	A441.EDF	A44	1
32	9495365	9498431	434	3500	3066	RIGHT	A441.EDF	A44	1
32	9498480	9498578	3549	3647	98	RIGHT	A441.EDF	A44	1
32	9498634	9498640	3703	3709	6	RIGHT	A441.EDF	A44	1
32	9498677	9498698	3746	3767	21	RIGHT	A441.EDF	A44	1
32	9498736	9499140	3805	4209	404	RIGHT	A441.EDF	A44	1
32	9499161	9499780	4230	4849	619	RIGHT	A441.EDF	A44	1
32	9499803	9500100	4872	5169	297	RIGHT	A441.EDF	A44	1
33	9501591	9506778	76	5263	5187	RIGHT	A441.EDF	A44	1
34	9509063	9509976	77	990	913	RIGHT	A441.EDF	A44	1
34	9510006	9510006	1020	1020	0	RIGHT	A441.EDF	A44	1
34	9510057	9510061	1071	1075	4	RIGHT	A441.EDF	A44	1
34	9510098	9510116	1112	1130	18	RIGHT	A441.EDF	A44	1
34	9510137	9510177	1151	1191	40	RIGHT	A441.EDF	A44	1
34	9510199	9512895	1213	3909	2696	RIGHT	A441.EDF	A44	1
34	9512924	9512955	3938	3969	31	RIGHT	A441.EDF	A44	1
34	9513010	9513084	4024	4098	74	RIGHT	A441.EDF	A44	1
34	9513113	9513113	4127	4127	0	RIGHT	A441.EDF	A44	1
34	9513145	9513963	4159	4977	818	RIGHT	A441.EDF	A44	1
35	9515669	9520929	57	5317	5260	RIGHT	A441.EDF	A44	1
35	9520960	9520987	5348	5375	27	RIGHT	A441.EDF	A44	1
35	9521016	9521026	5404	5414	10	RIGHT	A441.EDF	A44	1
35	9521049	9521049	5437	5437	0	RIGHT	A441.EDF	A44	1
35	9521074	9522480	5462	6868	1406	RIGHT	A441.EDF	A44	1
35	9522503	9522568	6891	6956	65	RIGHT	A441.EDF	A44	1
36	9525405	9525469	76	140	64	RIGHT	A441.EDF	A44	1
36	9525503	9525504	174	175	1	RIGHT	A441.EDF	A44	1
36	9525547	9525547	218	218	0	RIGHT	A441.EDF	A44	1
36	9525778	9525868	449	539	90	RIGHT	A441.EDF	A44	1
36	9525895	9528792	566	3463	2897	RIGHT	A441.EDF	A44	1
36	9528813	9529829	3484	4500	1016	RIGHT	A441.EDF	A44	1
36	9529899	9529931	4570	4602	32	RIGHT	A441.EDF	A44	1
36	9529955	9529979	4626	4650	24	RIGHT	A441.EDF	A44	1
36	9530022	9530022	4693	4693	0	RIGHT	A441.EDF	A44	1
36	9530056	9531393	4727	6064	1337	RIGHT	A441.EDF	A44	1
37	9533402	9534052	57	707	650	RIGHT	A441.EDF	A44	1
37	9534104	9534106	759	761	2	RIGHT	A441.EDF	A44	1
37	9534130	9534142	785	797	12	RIGHT	A441.EDF	A44	1
37	9534192	9534213	847	868	21	RIGHT	A441.EDF	A44	1
37	9534259	9536670	914	3325	2411	RIGHT	A441.EDF	A44	1
37	9536704	9536704	3359	3359	0	RIGHT	A441.EDF	A44	1
37	9536741	9536747	3396	3402	6	RIGHT	A441.EDF	A44	1
37	9536770	9536799	3425	3454	29	RIGHT	A441.EDF	A44	1
37	9536825	9536844	3480	3499	19	RIGHT	A441.EDF	A44	1
37	9536877	9536893	3532	3548	16	RIGHT	A441.EDF	A44	1
37	9536921	9536921	3576	3576	0	RIGHT	A441.EDF	A44	1
37	9536949	9537415	3604	4070	466	RIGHT	A441.EDF	A44	1
37	9537438	9537539	4093	4194	101	RIGHT	A441.EDF	A44	1
37	9537561	9538317	4216	4972	756	RIGHT	A441.EDF	A44	1
37	9538353	9538365	5008	5020	12	RIGHT	A441.EDF	A44	1
37	9538395	9538419	5050	5074	24	RIGHT	A441.EDF	A44	1
37	9538496	9538885	5151	5540	389	RIGHT	A441.EDF	A44	1
37	9538913	9538935	5568	5590	22	RIGHT	A441.EDF	A44	1
37	9538996	9538997	5651	5652	1	RIGHT	A441.EDF	A44	1
37	9539018	9539062	5673	5717	44	RIGHT	A441.EDF	A44	1
37	9539094	9539174	5749	5829	80	RIGHT	A441.EDF	A44	1
37	9539218	9539358	5873	6013	140	RIGHT	A441.EDF	A44	1
38	9541309	9541338	101	130	29	RIGHT	A441.EDF	A44	1
38	9541362	9543579	154	2371	2217	RIGHT	A441.EDF	A44	1
38	9543600	9544909	2392	3701	1309	RIGHT	A441.EDF	A44	1
38	9544930	9545034	3722	3826	104	RIGHT	A441.EDF	A44	1
38	9545056	9546252	3848	5044	1196	RIGHT	A441.EDF	A44	1
39	9548885	9550327	122	1564	1442	RIGHT	A441.EDF	A44	1
39	9550349	9550364	1586	1601	15	RIGHT	A441.EDF	A44	1
39	9550391	9550398	1628	1635	7	RIGHT	A441.EDF	A44	1
39	9550430	9550431	1667	1668	1	RIGHT	A441.EDF	A44	1
39	9550461	9550467	1698	1704	6	RIGHT	A441.EDF	A44	1
39	9550488	9551510	1725	2747	1022	RIGHT	A441.EDF	A44	1
39	9551538	9552655	2775	3892	1117	RIGHT	A441.EDF	A44	1
39	9552677	9552689	3914	3926	12	RIGHT	A441.EDF	A44	1
39	9552740	9552746	3977	3983	6	RIGHT	A441.EDF	A44	1
39	9552771	9553302	4008	4539	531	RIGHT	A441.EDF	A44	1
39	9553326	9555568	4563	6805	2242	RIGHT	A441.EDF	A44	1
40	9558234	9558939	58	763	705	RIGHT	A441.EDF	A44	1
40	9558961	9558980	785	804	19	RIGHT	A441.EDF	A44	1
40	9559009	9559010	833	834	1	RIGHT	A441.EDF	A44	1
40	9559037	9559139	861	963	102	RIGHT	A441.EDF	A44	1
40	9559173	9559618	997	1442	445	RIGHT	A441.EDF	A44	1
40	9559648	9559980	1472	1804	332	RIGHT	A441.EDF	A44	1
40	9560001	9563573	1825	5397	3572	RIGHT	A441.EDF	A44	1
41	9566572	9567251	57	736	679	RIGHT	A441.EDF	A44	1
41	9567278	9567530	763	1015	252	RIGHT	A441.EDF	A44	1
41	9567577	9567660	1062	1145	83	RIGHT	A441.EDF	A44	1
41	9567688	9567753	1173	1238	65	RIGHT	A441.EDF	A44	1
41	9567826	9567826	1311	1311	0	RIGHT	A441.EDF	A44	1
41	9567865	9568537	1350	2022	672	RIGHT	A441.EDF	A44	1
41	9568573	9568607	2058	2092	34	RIGHT	A441.EDF	A44	1
41	9568752	9568806	2237	2291	54	RIGHT	A441.EDF	A44	1
41	9568840	9568901	2325	2386	61	RIGHT	A441.EDF	A44	1
41	9568931	9568976	2416	2461	45	RIGHT	A441.EDF	A44	1
41	9568998	9569015	2483	2500	17	RIGHT	A441.EDF	A44	1
41	9569039	9569106	2524	2591	67	RIGHT	A441.EDF	A44	1
41	9569162	9569384	2647	2869	222	RIGHT	A441.EDF	A44	1
41	9569407	9571039	2892	4524	1632	RIGHT	A441.EDF	A44	1
41	9571061	9571100	4546	4585	39	RIGHT	A441.EDF	A44	1
41	9571122	9571204	4607	4689	82	RIGHT	A441.EDF	A44	1
41	9571226	9571258	4711	4743	32	RIGHT	A441.EDF	A44	1
41	9571282	9571402	4767	4887	120	RIGHT	A441.EDF	A44	1
41	9571425	9571630	4910	5115	205	RIGHT	A441.EDF	A44	1
41	9571651	9571652	5136	5137	1	RIGHT	A441.EDF	A44	1
41	9571682	9571770	5167	5255	88	RIGHT	A441.EDF	A44	1
41	9571814	9571896	5299	5381	82	RIGHT	A441.EDF	A44	1
41	9571919	9572315	5404	5800	396	RIGHT	A441.EDF	A44	1
41	9572336	9572519	5821	6004	183	RIGHT	A441.EDF	A44	1
41	9572543	9572586	6028	6071	43	RIGHT	A441.EDF	A44	1
41	9572610	9572660	6095	6145	50	RIGHT	A441.EDF	A44	1
41	9572706	9572723	6191	6208	17	RIGHT	A441.EDF	A44	1
41	9572751	9572758	6236	6243	7	RIGHT	A441.EDF	A44	1
41	9572782	9573569	6267	7054	787	RIGHT	A441.EDF	A44	1
42	9575928	9579956	57	4085	4028	RIGHT	A441.EDF	A44	1
42	9580044	9582394	4173	6523	2350	RIGHT	A441.EDF	A44	1
43	9585244	9591420	57	6233	6176	RIGHT	A441.EDF	A44	1
44	9593419	9598424	57	5062	5005	RIGHT	A441.EDF	A44	1
45	9600303	9601814	57	1568	1511	RIGHT	A441.EDF	A44	1
45	9601843	9605487	1597	5241	3644	RIGHT	A441.EDF	A44	1
45	9605521	9605521	5275	5275	0	RIGHT	A441.EDF	A44	1
45	9605543	9606899	5297	6653	1356	RIGHT	A441.EDF	A44	1
46	9608804	9610175	73	1444	1371	RIGHT	A441.EDF	A44	1
46	9610227	9610251	1496	1520	24	RIGHT	A441.EDF	A44	1
46	9610290	9612675	1559	3944	2385	RIGHT	A441.EDF	A44	1
46	9612700	9612706	3969	3975	6	RIGHT	A441.EDF	A44	1
46	9612801	9612814	4070	4083	13	RIGHT	A441.EDF	A44	1
46	9612835	9612900	4104	4169	65	RIGHT	A441.EDF	A44	1
46	9612922	9612922	4191	4191	0	RIGHT	A441.EDF	A44	1
46	9612955	9613204	4224	4473	249	RIGHT	A441.EDF	A44	1
46	9613234	9613234	4503	4503	0	RIGHT	A441.EDF	A44	1
46	9613255	9613336	4524	4605	81	RIGHT	A441.EDF	A44	1
46	9613363	9613385	4632	4654	22	RIGHT	A441.EDF	A44	1
46	9613433	9613457	4702	4726	24	RIGHT	A441.EDF	A44	1
46	9613487	9613504	4756	4773	17	RIGHT	A441.EDF	A44	1
46	9613526	9613536	4795	4805	10	RIGHT	A441.EDF	A44	1
46	9613559	9615084	4828	6353	1525	RIGHT	A441.EDF	A44	1
47	9617349	9617408	57	116	59	RIGHT	A441.EDF	A44	1
47	9617439	9618336	147	1044	897	RIGHT	A441.EDF	A44	1
47	9618359	9619070	1067	1778	711	RIGHT	A441.EDF	A44	1
47	9619094	9620151	1802	2859	1057	RIGHT	A441.EDF	A44	1
47	9620185	9620573	2893	3281	388	RIGHT	A441.EDF	A44	1
47	9620602	9620614	3310	3322	12	RIGHT	A441.EDF	A44	1
47	9620636	9620750	3344	3458	114	RIGHT	A441.EDF	A44	1
47	9620775	9620857	3483	3565	82	RIGHT	A441.EDF	A44	1
47	9620891	9620917	3599	3625	26	RIGHT	A441.EDF	A44	1
47	9620940	9620950	3648	3658	10	RIGHT	A441.EDF	A44	1
47	9620973	9620974	3681	3682	1	RIGHT	A441.EDF	A44	1
47	9621034	9621041	3742	3749	7	RIGHT	A441.EDF	A44	1
47	9621067	9621078	3775	3786	11	RIGHT	A441.EDF	A44	1
47	9621111	9621133	3819	3841	22	RIGHT	A441.EDF	A44	1
47	9621159	9621161	3867	3869	2	RIGHT	A441.EDF	A44	1
47	9621183	9621369	3891	4077	186	RIGHT	A441.EDF	A44	1
47	9621404	9621431	4112	4139	27	RIGHT	A441.EDF	A44	1
47	9621460	9621510	4168	4218	50	RIGHT	A441.EDF	A44	1
47	9621538	9621559	4246	4267	21	RIGHT	A441.EDF	A44	1
47	9621589	9621647	4297	4355	58	RIGHT	A441.EDF	A44	1
47	9621682	9621682	4390	4390	0	RIGHT	A441.EDF	A44	1
47	9621706	9621796	4414	4504	90	RIGHT	A441.EDF	A44	1
47	9621819	9622226	4527	4934	407	RIGHT	A441.EDF	A44	1
47	9622289	9622304	4997	5012	15	RIGHT	A441.EDF	A44	1
47	9622327	9622365	5035	5073	38	RIGHT	A441.EDF	A44	1
47	9622387	9622427	5095	5135	40	RIGHT	A441.EDF	A44	1
47	9622451	9622519	5159	5227	68	RIGHT	A441.EDF	A44	1
48	9624768	9628213	58	3503	3445	RIGHT	A441.EDF	A44	1
48	9628234	9628250	3524	3540	16	RIGHT	A441.EDF	A44	1
48	9628274	9628277	3564	3567	3	RIGHT	A441.EDF	A44	1
48	9628301	9628371	3591	3661	70	RIGHT	A441.EDF	A44	1
48	9628402	9628403	3692	3693	1	RIGHT	A441.EDF	A44	1
48	9628467	9628474	3757	3764	7	RIGHT	A441.EDF	A44	1
48	9628506	9628510	3796	3800	4	RIGHT	A441.EDF	A44	1
48	9628542	9628543	3832	3833	1	RIGHT	A441.EDF	A44	1
48	9628579	9628593	3869	3883	14	RIGHT	A441.EDF	A44	1
48	9628669	9628700	3959	3990	31	RIGHT	A441.EDF	A44	1
48	9628721	9628721	4011	4011	0	RIGHT	A441.EDF	A44	1
48	9628750	9628751	4040	4041	1	RIGHT	A441.EDF	A44	1
48	9628774	9628790	4064	4080	16	RIGHT	A441.EDF	A44	1
48	9628828	9628829	4118	4119	1	RIGHT	A441.EDF	A44	1
48	9628876	9628876	4166	4166	0	RIGHT	A441.EDF	A44	1
48	9628957	9628957	4247	4247	0	RIGHT	A441.EDF	A44	1
48	9628994	9628994	4284	4284	0	RIGHT	A441.EDF	A44	1
48	9629018	9629047	4308	4337	29	RIGHT	A441.EDF	A44	1
48	9629078	9629103	4368	4393	25	RIGHT	A441.EDF	A44	1
48	9629128	9629196	4418	4486	68	RIGHT	A441.EDF	A44	1
48	9629223	9629228	4513	4518	5	RIGHT	A441.EDF	A44	1
48	9629262	9629288	4552	4578	26	RIGHT	A441.EDF	A44	1
48	9629316	9629332	4606	4622	16	RIGHT	A441.EDF	A44	1
48	9629368	9629396	4658	4686	28	RIGHT	A441.EDF	A44	1
48	9629454	9629455	4744	4745	1	RIGHT	A441.EDF	A44	1
48	9629492	9629568	4782	4858	76	RIGHT	A441.EDF	A44	1
48	9629605	9629605	4895	4895	0	RIGHT	A441.EDF	A44	1
48	9629626	9629626	4916	4916	0	RIGHT	A441.EDF	A44	1
48	9629680	9629680	4970	4970	0	RIGHT	A441.EDF	A44	1
48	9629710	9629724	5000	5014	14	RIGHT	A441.EDF	A44	1
48	9629761	9629803	5051	5093	42	RIGHT	A441.EDF	A44	1
49	9631669	9631695	106	132	26	RIGHT	A441.EDF	A44	1
49	9631796	9631821	233	258	25	RIGHT	A441.EDF	A44	1
49	9631853	9631853	290	290	0	RIGHT	A441.EDF	A44	1
49	9631910	9633005	347	1442	1095	RIGHT	A441.EDF	A44	1
49	9633026	9633045	1463	1482	19	RIGHT	A441.EDF	A44	1
49	9633071	9633109	1508	1546	38	RIGHT	A441.EDF	A44	1
49	9633134	9633207	1571	1644	73	RIGHT	A441.EDF	A44	1
49	9633229	9633247	1666	1684	18	RIGHT	A441.EDF	A44	1
49	9633280	9634080	1717	2517	800	RIGHT	A441.EDF	A44	1
49	9634104	9634304	2541	2741	200	RIGHT	A441.EDF	A44	1
49	9634326	9634699	2763	3136	373	RIGHT	A441.EDF	A44	1
49	9634733	9634733	3170	3170	0	RIGHT	A441.EDF	A44	1
49	9634754	9634755	3191	3192	1	RIGHT	A441.EDF	A44	1
49	9634778	9634824	3215	3261	46	RIGHT	A441.EDF	A44	1
49	9634855	9634856	3292	3293	1	RIGHT	A441.EDF	A44	1
49	9634879	9634909	3316	3346	30	RIGHT	A441.EDF	A44	1
49	9634970	9634972	3407	3409	2	RIGHT	A441.EDF	A44	1
49	9635002	9635021	3439	3458	19	RIGHT	A441.EDF	A44	1
49	9635101	9635126	3538	3563	25	RIGHT	A441.EDF	A44	1
49	9635212	9635213	3649	3650	1	RIGHT	A441.EDF	A44	1
49	9635255	9635282	3692	3719	27	RIGHT	A441.EDF	A44	1
49	9635306	9635306	3743	3743	0	RIGHT	A441.EDF	A44	1
49	9635335	9635351	3772	3788	16	RIGHT	A441.EDF	A44	1
49	9635376	9635435	3813	3872	59	RIGHT	A441.EDF	A44	1
49	9635469	9635477	3906	3914	8	RIGHT	A441.EDF	A44	1
49	9635498	9635637	3935	4074	139	RIGHT	A441.EDF	A44	1
49	9635662	9635673	4099	4110	11	RIGHT	A441.EDF	A44	1
49	9635705	9635709	4142	4146	4	RIGHT	A441.EDF	A44	1
49	9635779	9635850	4216	4287	71	RIGHT	A441.EDF	A44	1
49	9635883	9635903	4320	4340	20	RIGHT	A441.EDF	A44	1
49	9635926	9635942	4363	4379	16	RIGHT	A441.EDF	A44	1
49	9636034	9636039	4471	4476	5	RIGHT	A441.EDF	A44	1
49	9636133	9636145	4570	4582	12	RIGHT	A441.EDF	A44	1
49	9636218	9636292	4655	4729	74	RIGHT	A441.EDF	A44	1
49	9636325	9636375	4762	4812	50	RIGHT	A441.EDF	A44	1
49	9636455	9636512	4892	4949	57	RIGHT	A441.EDF	A44	1
49	9636534	9636534	4971	4971	0	RIGHT	A441.EDF	A44	1
49	9636605	9636605	5042	5042	0	RIGHT	A441.EDF	A44	1
49	9636626	9636628	5063	5065	2	RIGHT	A441.EDF	A44	1
50	9638915	9638936	95	116	21	RIGHT	A441.EDF	A44	1
50	9638984	9639017	164	197	33	RIGHT	A441.EDF	A44	1
50	9639048	9639050	228	230	2	RIGHT	A441.EDF	A44	1
50	9639072	9639091	252	271	19	RIGHT	A441.EDF	A44	1
50	9639152	9639153	332	333	1	RIGHT	A441.EDF	A44	1
50	9639191	9639191	371	371	0	RIGHT	A441.EDF	A44	1
50	9639223	9639223	403	403	0	RIGHT	A441.EDF	A44	1
50	9639262	9639277	442	457	15	RIGHT	A441.EDF	A44	1
50	9639303	9639312	483	492	9	RIGHT	A441.EDF	A44	1
50	9639334	9639334	514	514	0	RIGHT	A441.EDF	A44	1
50	9639363	9639371	543	551	8	RIGHT	A441.EDF	A44	1
50	9639397	9640347	577	1527	950	RIGHT	A441.EDF	A44	1
50	9640374	9640394	1554	1574	20	RIGHT	A441.EDF	A44	1
50	9640419	9641148	1599	2328	729	RIGHT	A441.EDF	A44	1
50	9641198	9641221	2378	2401	23	RIGHT	A441.EDF	A44	1
50	9641267	9641289	2447	2469	22	RIGHT	A441.EDF	A44	1
50	9641314	9641351	2494	2531	37	RIGHT	A441.EDF	A44	1
50	9641375	9641375	2555	2555	0	RIGHT	A441.EDF	A44	1
50	9641424	9641424	2604	2604	0	RIGHT	A441.EDF	A44	1
50	9641447	9641512	2627	2692	65	RIGHT	A441.EDF	A44	1
50	9641542	9641542	2722	2722	0	RIGHT	A441.EDF	A44	1
50	9641589	9641589	2769	2769	0	RIGHT	A441.EDF	A44	1
50	9641614	9641664	2794	2844	50	RIGHT	A441.EDF	A44	1
50	9641707	9641710	2887	2890	3	RIGHT	A441.EDF	A44	1
50	9641778	9641780	2958	2960	2	RIGHT	A441.EDF	A44	1
50	9641808	9641811	2988	2991	3	RIGHT	A441.EDF	A44	1
50	9641852	9641889	3032	3069	37	RIGHT	A441.EDF	A44	1
50	9641953	9641954	3133	3134	1	RIGHT	A441.EDF	A44	1
50	9641980	9642027	3160	3207	47	RIGHT	A441.EDF	A44	1
50	9642057	9642057	3237	3237	0	RIGHT	A441.EDF	A44	1
50	9642167	9642185	3347	3365	18	RIGHT	A441.EDF	A44	1
50	9642257	9642257	3437	3437	0	RIGHT	A441.EDF	A44	1
50	9642308	9642335	3488	3515	27	RIGHT	A441.EDF	A44	1
50	9642395	9642395	3575	3575	0	RIGHT	A441.EDF	A44	1
50	9642437	9642437	3617	3617	0	RIGHT	A441.EDF	A44	1
50	9642596	9642635	3776	3815	39	RIGHT	A441.EDF	A44	1
50	9642682	9642683	3862	3863	1	RIGHT	A441.EDF	A44	1
50	9642718	9642718	3898	3898	0	RIGHT	A441.EDF	A44	1
50	9642790	9642862	3970	4042	72	RIGHT	A441.EDF	A44	1
50	9642904	9642936	4084	4116	32	RIGHT	A441.EDF	A44	1
50	9642958	9642970	4138	4150	12	RIGHT	A441.EDF	A44	1
50	9643006	9643006	4186	4186	0	RIGHT	A441.EDF	A44	1
50	9643031	9643040	4211	4220	9	RIGHT	A441.EDF	A44	1
50	9643062	9643071	4242	4251	9	RIGHT	A441.EDF	A44	1
50	9643096	9643201	4276	4381	105	RIGHT	A441.EDF	A44	1
50	9643224	9643303	4404	4483	79	RIGHT	A441.EDF	A44	1
50	9643327	9643386	4507	4566	59	RIGHT	A441.EDF	A44	1
50	9643423	9643427	4603	4607	4	RIGHT	A441.EDF	A44	1
50	9643491	9643566	4671	4746	75	RIGHT	A441.EDF	A44	1
50	9643591	9643602	4771	4782	11	RIGHT	A441.EDF	A44	1
51	9645402	9645684	57	339	282	RIGHT	A441.EDF	A44	1
51	9645706	9645755	361	410	49	RIGHT	A441.EDF	A44	1
51	9645777	9646274	432	929	497	RIGHT	A441.EDF	A44	1
51	9646328	9646340	983	995	12	RIGHT	A441.EDF	A44	1
51	9646372	9646459	1027	1114	87	RIGHT	A441.EDF	A44	1
51	9646495	9646496	1150	1151	1	RIGHT	A441.EDF	A44	1
51	9646524	9646533	1179	1188	9	RIGHT	A441.EDF	A44	1
51	9646556	9646566	1211	1221	10	RIGHT	A441.EDF	A44	1
51	9646589	9646915	1244	1570	326	RIGHT	A441.EDF	A44	1
51	9646936	9646940	1591	1595	4	RIGHT	A441.EDF	A44	1
51	9646976	9647168	1631	1823	192	RIGHT	A441.EDF	A44	1
51	9647193	9649695	1848	4350	2502	RIGHT	A441.EDF	A44	1
51	9649728	9649788	4383	4443	60	RIGHT	A441.EDF	A44	1
51	9649818	9649858	4473	4513	40	RIGHT	A441.EDF	A44	1
51	9649882	9650596	4537	5251	714	RIGHT	A441.EDF	A44	1
52	9652790	9652827	76	113	37	RIGHT	A441.EDF	A44	1
52	9652854	9653150	140	436	296	RIGHT	A441.EDF	A44	1
52	9653187	9653187	473	473	0	RIGHT	A441.EDF	A44	1
52	9653238	9654158	524	1444	920	RIGHT	A441.EDF	A44	1
52	9654182	9654951	1468	2237	769	RIGHT	A441.EDF	A44	1
52	9654987	9654999	2273	2285	12	RIGHT	A441.EDF	A44	1
52	9655367	9655411	2653	2697	44	RIGHT	A441.EDF	A44	1
52	9655443	9655557	2729	2843	114	RIGHT	A441.EDF	A44	1
52	9655579	9657961	2865	5247	2382	RIGHT	A441.EDF	A44	1
53	9660036	9660258	58	280	222	RIGHT	A441.EDF	A44	1
53	9660283	9660960	305	982	677	RIGHT	A441.EDF	A44	1
53	9660996	9660997	1018	1019	1	RIGHT	A441.EDF	A44	1
53	9661027	9661204	1049	1226	177	RIGHT	A441.EDF	A44	1
53	9661255	9661256	1277	1278	1	RIGHT	A441.EDF	A44	1
53	9661291	9661291	1313	1313	0	RIGHT	A441.EDF	A44	1
53	9661318	9661405	1340	1427	87	RIGHT	A441.EDF	A44	1
53	9661429	9661591	1451	1613	162	RIGHT	A441.EDF	A44	1
53	9661613	9661622	1635	1644	9	RIGHT	A441.EDF	A44	1
53	9661644	9661650	1666	1672	6	RIGHT	A441.EDF	A44	1
53	9661696	9661696	1718	1718	0	RIGHT	A441.EDF	A44	1
53	9661722	9661723	1744	1745	1	RIGHT	A441.EDF	A44	1
53	9661746	9661781	1768	1803	35	RIGHT	A441.EDF	A44	1
53	9661811	9661964	1833	1986	153	RIGHT	A441.EDF	A44	1
53	9661986	9662059	2008	2081	73	RIGHT	A441.EDF	A44	1
53	9662107	9662128	2129	2150	21	RIGHT	A441.EDF	A44	1
53	9662150	9662203	2172	2225	53	RIGHT	A441.EDF	A44	1
53	9662228	9662656	2250	2678	428	RIGHT	A441.EDF	A44	1
53	9662695	9662771	2717	2793	76	RIGHT	A441.EDF	A44	1
53	9662795	9663464	2817	3486	669	RIGHT	A441.EDF	A44	1
53	9663485	9663574	3507	3596	89	RIGHT	A441.EDF	A44	1
53	9663621	9663656	3643	3678	35	RIGHT	A441.EDF	A44	1
53	9663697	9663828	3719	3850	131	RIGHT	A441.EDF	A44	1
53	9663873	9663873	3895	3895	0	RIGHT	A441.EDF	A44	1
53	9663900	9663906	3922	3928	6	RIGHT	A441.EDF	A44	1
53	9663940	9663942	3962	3964	2	RIGHT	A441.EDF	A44	1
53	9663968	9663968	3990	3990	0	RIGHT	A441.EDF	A44	1
53	9664011	9664044	4033	4066	33	RIGHT	A441.EDF	A44	1
53	9664066	9664066	4088	4088	0	RIGHT	A441.EDF	A44	1
53	9664131	9664132	4153	4154	1	RIGHT	A441.EDF	A44	1
53	9664179	9664215	4201	4237	36	RIGHT	A441.EDF	A44	1
53	9664241	9664262	4263	4284	21	RIGHT	A441.EDF	A44	1
53	9664285	9664285	4307	4307	0	RIGHT	A441.EDF	A44	1
53	9664323	9664346	4345	4368	23	RIGHT	A441.EDF	A44	1
53	9664368	9664370	4390	4392	2	RIGHT	A441.EDF	A44	1
53	9664393	9664420	4415	4442	27	RIGHT	A441.EDF	A44	1
53	9664449	9664449	4471	4471	0	RIGHT	A441.EDF	A44	1
53	9664495	9664505	4517	4527	10	RIGHT	A441.EDF	A44	1
53	9664551	9664572	4573	4594	21	RIGHT	A441.EDF	A44	1
53	9664604	9664636	4626	4658	32	RIGHT	A441.EDF	A44	1
53	9664674	9664685	4696	4707	11	RIGHT	A441.EDF	A44	1
53	9664709	9664723	4731	4745	14	RIGHT	A441.EDF	A44	1
53	9664756	9664821	4778	4843	65	RIGHT	A441.EDF	A44	1
53	9664856	9664946	4878	4968	90	RIGHT	A441.EDF	A44	1
53	9664971	9665084	4993	5106	113	RIGHT	A441.EDF	A44	1
53	9665115	9665124	5137	5146	9	RIGHT	A441.EDF	A44	1
53	9665146	9665253	5168	5275	107	RIGHT	A441.EDF	A44	1
53	9665275	9665316	5297	5338	41	RIGHT	A441.EDF	A44	1
53	9665344	9665434	5366	5456	90	RIGHT	A441.EDF	A44	1
53	9665457	9666497	5479	6519	1040	RIGHT	A441.EDF	A44	1
54	9668474	9669003	57	586	529	RIGHT	A441.EDF	A44	1
54	9669030	9669054	613	637	24	RIGHT	A441.EDF	A44	1
54	9669078	9669078	661	661	0	RIGHT	A441.EDF	A44	1
54	9669109	9669115	692	698	6	RIGHT	A441.EDF	A44	1
54	9669143	9669150	726	733	7	RIGHT	A441.EDF	A44	1
54	9669175	9669212	758	795	37	RIGHT	A441.EDF	A44	1
54	9669238	9670133	821	1716	895	RIGHT	A441.EDF	A44	1
54	9670155	9670502	1738	2085	347	RIGHT	A441.EDF	A44	1
54	9670536	9672084	2119	3667	1548	RIGHT	A441.EDF	A44	1
54	9672121	9672151	3704	3734	30	RIGHT	A441.EDF	A44	1
54	9672183	9672184	3766	3767	1	RIGHT	A441.EDF	A44	1
54	9672206	9672582	3789	4165	376	RIGHT	A441.EDF	A44	1
54	9672609	9672624	4192	4207	15	RIGHT	A441.EDF	A44	1
54	9672676	9672755	4259	4338	79	RIGHT	A441.EDF	A44	1
54	9672787	9672817	4370	4400	30	RIGHT	A441.EDF	A44	1
54	9672848	9672933	4431	4516	85	RIGHT	A441.EDF	A44	1
54	9672959	9673058	4542	4641	99	RIGHT	A441.EDF	A44	1
54	9673097	9673104	4680	4687	7	RIGHT	A441.EDF	A44	1
54	9673126	9673217	4709	4800	91	RIGHT	A441.EDF	A44	1
54	9673257	9673258	4840	4841	1	RIGHT	A441.EDF	A44	1
54	9673285	9673293	4868	4876	8	RIGHT	A441.EDF	A44	1
54	9673368	9673368	4951	4951	0	RIGHT	A441.EDF	A44	1
54	9673420	9673420	5003	5003	0	RIGHT	A441.EDF	A44	1
54	9673455	9673458	5038	5041	3	RIGHT	A441.EDF	A44	1
54	9673479	9673479	5062	5062	0	RIGHT	A441.EDF	A44	1
54	9673503	9673525	5086	5108	22	RIGHT	A441.EDF	A44	1
54	9673547	9673548	5130	5131	1	RIGHT	A441.EDF	A44	1
54	9673621	9673644	5204	5227	23	RIGHT	A441.EDF	A44	1
54	9673672	9673672	5255	5255	0	RIGHT	A441.EDF	A44	1
54	9673710	9673738	5293	5321	28	RIGHT	A441.EDF	A44	1
54	9673773	9673784	5356	5367	11	RIGHT	A441.EDF	A44	1
54	9673813	9673813	5396	5396	0	RIGHT	A441.EDF	A44	1
54	9673865	9673866	5448	5449	1	RIGHT	A441.EDF	A44	1
54	9673902	9673903	5485	5486	1	RIGHT	A441.EDF	A44	1
54	9673924	9673947	5507	5530	23	RIGHT	A441.EDF	A44	1
54	9673969	9673982	5552	5565	13	RIGHT	A441.EDF	A44	1
54	9674024	9674024	5607	5607	0	RIGHT	A441.EDF	A44	1
54	9674046	9674059	5629	5642	13	RIGHT	A441.EDF	A44	1
54	9674089	9674089	5672	5672	0	RIGHT	A441.EDF	A44	1
54	9674110	9674110	5693	5693	0	RIGHT	A441.EDF	A44	1
54	9674148	9674341	5731	5924	193	RIGHT	A441.EDF	A44	1
55	9676279	9676306	121	148	27	RIGHT	A441.EDF	A44	1
55	9676338	9676340	180	182	2	RIGHT	A441.EDF	A44	1
55	9676372	9676372	214	214	0	RIGHT	A441.EDF	A44	1
55	9676429	9676429	271	271	0	RIGHT	A441.EDF	A44	1
55	9676476	9676476	318	318	0	RIGHT	A441.EDF	A44	1
55	9676522	9676539	364	381	17	RIGHT	A441.EDF	A44	1
55	9676611	9676611	453	453	0	RIGHT	A441.EDF	A44	1
55	9676660	9676660	502	502	0	RIGHT	A441.EDF	A44	1
55	9676684	9679335	526	3177	2651	RIGHT	A441.EDF	A44	1
55	9679361	9679394	3203	3236	33	RIGHT	A441.EDF	A44	1
55	9679416	9679422	3258	3264	6	RIGHT	A441.EDF	A44	1
55	9679451	9679554	3293	3396	103	RIGHT	A441.EDF	A44	1
55	9679583	9681715	3425	5557	2132	RIGHT	A441.EDF	A44	1
55	9681749	9683376	5591	7218	1627	RIGHT	A441.EDF	A44	1
56	9685755	9686654	76	975	899	RIGHT	A441.EDF	A44	1
56	9686676	9686693	997	1014	17	RIGHT	A441.EDF	A44	1
56	9686738	9686738	1059	1059	0	RIGHT	A441.EDF	A44	1
56	9686770	9691318	1091	5639	4548	RIGHT	A441.EDF	A44	1
56	9691364	9691405	5685	5726	41	RIGHT	A441.EDF	A44	1
56	9691443	9691644	5764	5965	201	RIGHT	A441.EDF	A44	1
56	9691675	9692592	5996	6913	917	RIGHT	A441.EDF	A44	1
57	9694553	9694553	132	132	0	RIGHT	A441.EDF	A44	1
57	9694577	9694585	156	164	8	RIGHT	A441.EDF	A44	1
57	9694638	9694670	217	249	32	RIGHT	A441.EDF	A44	1
57	9694701	9694701	280	280	0	RIGHT	A441.EDF	A44	1
57	9694749	9694753	328	332	4	RIGHT	A441.EDF	A44	1
57	9694794	9694831	373	410	37	RIGHT	A441.EDF	A44	1
57	9694861	9694862	440	441	1	RIGHT	A441.EDF	A44	1
57	9694889	9695571	468	1150	682	RIGHT	A441.EDF	A44	1
57	9695592	9695812	1171	1391	220	RIGHT	A441.EDF	A44	1
57	9695888	9698253	1467	3832	2365	RIGHT	A441.EDF	A44	1
57	9698278	9698356	3857	3935	78	RIGHT	A441.EDF	A44	1
57	9698460	9698462	4039	4041	2	RIGHT	A441.EDF	A44	1
57	9698560	9698575	4139	4154	15	RIGHT	A441.EDF	A44	1
57	9698607	9698618	4186	4197	11	RIGHT	A441.EDF	A44	1
57	9698658	9698694	4237	4273	36	RIGHT	A441.EDF	A44	1
57	9698722	9699611	4301	5190	889	RIGHT	A441.EDF	A44	1
57	9699634	9699892	5213	5471	258	RIGHT	A441.EDF	A44	1
57	9699920	9700015	5499	5594	95	RIGHT	A441.EDF	A44	1
57	9700039	9700247	5618	5826	208	RIGHT	A441.EDF	A44	1
57	9700275	9700360	5854	5939	85	RIGHT	A441.EDF	A44	1
57	9700394	9700407	5973	5986	13	RIGHT	A441.EDF	A44	1
58	9702579	9704538	70	2029	1959	RIGHT	A441.EDF	A44	1
58	9704560	9704580	2051	2071	20	RIGHT	A441.EDF	A44	1
58	9704605	9704645	2096	2136	40	RIGHT	A441.EDF	A44	1
58	9704678	9704692	2169	2183	14	RIGHT	A441.EDF	A44	1
58	9704724	9704895	2215	2386	171	RIGHT	A441.EDF	A44	1
58	9704918	9705057	2409	2548	139	RIGHT	A441.EDF	A44	1
58	9705081	9705115	2572	2606	34	RIGHT	A441.EDF	A44	1
58	9705154	9705155	2645	2646	1	RIGHT	A441.EDF	A44	1
58	9705178	9705178	2669	2669	0	RIGHT	A441.EDF	A44	1
58	9705241	9705268	2732	2759	27	RIGHT	A441.EDF	A44	1
58	9705301	9705340	2792	2831	39	RIGHT	A441.EDF	A44	1
58	9705371	9706472	2862	3963	1101	RIGHT	A441.EDF	A44	1
58	9706539	9706539	4030	4030	0	RIGHT	A441.EDF	A44	1
58	9706573	9706574	4064	4065	1	RIGHT	A441.EDF	A44	1
58	9706650	9708882	4141	6373	2232	RIGHT	A441.EDF	A44	1
59	9711532	9711533	120	121	1	RIGHT	A441.EDF	A44	1
59	9711576	9713259	164	1847	1683	RIGHT	A441.EDF	A44	1
59	9713288	9713304	1876	1892	16	RIGHT	A441.EDF	A44	1
59	9713327	9713677	1915	2265	350	RIGHT	A441.EDF	A44	1
59	9713714	9713714	2302	2302	0	RIGHT	A441.EDF	A44	1
59	9713761	9713761	2349	2349	0	RIGHT	A441.EDF	A44	1
59	9713790	9713815	2378	2403	25	RIGHT	A441.EDF	A44	1
59	9713859	9713878	2447	2466	19	RIGHT	A441.EDF	A44	1
59	9713909	9713909	2497	2497	0	RIGHT	A441.EDF	A44	1
59	9713941	9713941	2529	2529	0	RIGHT	A441.EDF	A44	1
59	9713968	9715086	2556	3674	1118	RIGHT	A441.EDF	A44	1
59	9715111	9715277	3699	3865	166	RIGHT	A441.EDF	A44	1
59	9715314	9715741	3902	4329	427	RIGHT	A441.EDF	A44	1
59	9715767	9715792	4355	4380	25	RIGHT	A441.EDF	A44	1
59	9715876	9715901	4464	4489	25	RIGHT	A441.EDF	A44	1
59	9715938	9715939	4526	4527	1	RIGHT	A441.EDF	A44	1
59	9715975	9716039	4563	4627	64	RIGHT	A441.EDF	A44	1
59	9716081	9716081	4669	4669	0	RIGHT	A441.EDF	A44	1
59	9716175	9716177	4763	4765	2	RIGHT	A441.EDF	A44	1
59	9716200	9716229	4788	4817	29	RIGHT	A441.EDF	A44	1
59	9716414	9716414	5002	5002	0	RIGHT	A441.EDF	A44	1
59	9716440	9716452	5028	5040	12	RIGHT	A441.EDF	A44	1
59	9716497	9716553	5085	5141	56	RIGHT	A441.EDF	A44	1
59	9716590	9716627	5178	5215	37	RIGHT	A441.EDF	A44	1
59	9716667	9716687	5255	5275	20	RIGHT	A441.EDF	A44	1
59	9716823	9716872	5411	5460	49	RIGHT	A441.EDF	A44	1
59	9716916	9716927	5504	5515	11	RIGHT	A441.EDF	A44	1
60	9719118	9719527	57	466	409	RIGHT	A441.EDF	A44	1
60	9719552	9719628	491	567	76	RIGHT	A441.EDF	A44	1
60	9719665	9719691	604	630	26	RIGHT	A441.EDF	A44	1
60	9719719	9720115	658	1054	396	RIGHT	A441.EDF	A44	1
60	9720156	9720193	1095	1132	37	RIGHT	A441.EDF	A44	1
60	9720216	9720275	1155	1214	59	RIGHT	A441.EDF	A44	1
60	9720296	9720920	1235	1859	624	RIGHT	A441.EDF	A44	1
60	9720962	9721021	1901	1960	59	RIGHT	A441.EDF	A44	1
60	9721052	9721538	1991	2477	486	RIGHT	A441.EDF	A44	1
60	9721561	9721569	2500	2508	8	RIGHT	A441.EDF	A44	1
60	9721598	9721703	2537	2642	105	RIGHT	A441.EDF	A44	1
60	9721746	9722074	2685	3013	328	RIGHT	A441.EDF	A44	1
60	9722097	9722097	3036	3036	0	RIGHT	A441.EDF	A44	1
60	9722144	9722160	3083	3099	16	RIGHT	A441.EDF	A44	1
60	9722181	9722218	3120	3157	37	RIGHT	A441.EDF	A44	1
60	9722267	9722271	3206	3210	4	RIGHT	A441.EDF	A44	1
60	9722334	9722360	3273	3299	26	RIGHT	A441.EDF	A44	1
60	9722406	9722406	3345	3345	0	RIGHT	A441.EDF	A44	1
60	9722435	9722963	3374	3902	528	RIGHT	A441.EDF	A44	1
60	9723004	9723041	3943	3980	37	RIGHT	A441.EDF	A44	1
60	9723070	9723126	4009	4065	56	RIGHT	A441.EDF	A44	1
60	9723149	9723231	4088	4170	82	RIGHT	A441.EDF	A44	1
60	9723286	9723286	4225	4225	0	RIGHT	A441.EDF	A44	1
60	9723313	9723352	4252	4291	39	RIGHT	A441.EDF	A44	1
60	9723408	9723418	4347	4357	10	RIGHT	A441.EDF	A44	1
60	9723455	9723471	4394	4410	16	RIGHT	A441.EDF	A44	1
60	9723501	9723568	4440	4507	67	RIGHT	A441.EDF	A44	1
60	9723614	9723642	4553	4581	28	RIGHT	A441.EDF	A44	1
60	9723702	9725186	4641	6125	1484	RIGHT	A441.EDF	A44	1
60	9725223	9725223	6162	6162	0	RIGHT	A441.EDF	A44	1
60	9725257	9725262	6196	6201	5	RIGHT	A441.EDF	A44	1
60	9725323	9725341	6262	6280	18	RIGHT	A441.EDF	A44	1
60	9725363	9725364	6302	6303	1	RIGHT	A441.EDF	A44	1
60	9725387	9725515	6326	6454	128	RIGHT	A441.EDF	A44	1
60	9725571	9725598	6510	6537	27	RIGHT	A441.EDF	A44	1
60	9725652	9725954	6591	6893	302	RIGHT	A441.EDF	A44	1
60	9725976	9725980	6915	6919	4	RIGHT	A441.EDF	A44	1
60	9726005	9726027	6944	6966	22	RIGHT	A441.EDF	A44	1
60	9726071	9726098	7010	7037	27	RIGHT	A441.EDF	A44	1
60	9726119	9726120	7058	7059	1	RIGHT	A441.EDF	A44	1
60	9726181	9726183	7120	7122	2	RIGHT	A441.EDF	A44	1
61	9728302	9729074	57	829	772	RIGHT	A441.EDF	A44	1
61	9729100	9729177	855	932	77	RIGHT	A441.EDF	A44	1
61	9729203	9732667	958	4422	3464	RIGHT	A441.EDF	A44	1
61	9732689	9732689	4444	4444	0	RIGHT	A441.EDF	A44	1
61	9732714	9732714	4469	4469	0	RIGHT	A441.EDF	A44	1
61	9732744	9732759	4499	4514	15	RIGHT	A441.EDF	A44	1
61	9732781	9732811	4536	4566	30	RIGHT	A441.EDF	A44	1
61	9732833	9734448	4588	6203	1615	RIGHT	A441.EDF	A44	1
62	9736468	9736868	70	470	400	RIGHT	A441.EDF	A44	1
62	9736889	9737388	491	990	499	RIGHT	A441.EDF	A44	1
62	9737410	9737456	1012	1058	46	RIGHT	A441.EDF	A44	1
62	9737479	9737479	1081	1081	0	RIGHT	A441.EDF	A44	1
62	9737520	9737521	1122	1123	1	RIGHT	A441.EDF	A44	1
62	9737580	9737957	1182	1559	377	RIGHT	A441.EDF	A44	1
62	9737998	9738097	1600	1699	99	RIGHT	A441.EDF	A44	1
62	9738120	9738174	1722	1776	54	RIGHT	A441.EDF	A44	1
62	9738200	9739384	1802	2986	1184	RIGHT	A441.EDF	A44	1
62	9739415	9739458	3017	3060	43	RIGHT	A441.EDF	A44	1
62	9739488	9739603	3090	3205	115	RIGHT	A441.EDF	A44	1
62	9739637	9739740	3239	3342	103	RIGHT	A441.EDF	A44	1
62	9739762	9739762	3364	3364	0	RIGHT	A441.EDF	A44	1
62	9739788	9739788	3390	3390	0	RIGHT	A441.EDF	A44	1
62	9739809	9739809	3411	3411	0	RIGHT	A441.EDF	A44	1
62	9739835	9739845	3437	3447	10	RIGHT	A441.EDF	A44	1
62	9739870	9739928	3472	3530	58	RIGHT	A441.EDF	A44	1
62	9739969	9740163	3571	3765	194	RIGHT	A441.EDF	A44	1
62	9740195	9740253	3797	3855	58	RIGHT	A441.EDF	A44	1
62	9740274	9740398	3876	4000	124	RIGHT	A441.EDF	A44	1
62	9740419	9742128	4021	5730	1709	RIGHT	A441.EDF	A44	1
62	9742163	9742179	5765	5781	16	RIGHT	A441.EDF	A44	1
62	9742204	9742222	5806	5824	18	RIGHT	A441.EDF	A44	1
62	9742403	9742403	6005	6005	0	RIGHT	A441.EDF	A44	1
62	9742495	9742531	6097	6133	36	RIGHT	A441.EDF	A44	1
62	9742555	9742556	6157	6158	1	RIGHT	A441.EDF	A44	1
62	9742589	9743083	6191	6685	494	RIGHT	A441.EDF	A44	1
63	9745162	9745984	71	893	822	RIGHT	A441.EDF	A44	1
63	9746020	9746488	929	1397	468	RIGHT	A441.EDF	A44	1
63	9746511	9746512	1420	1421	1	RIGHT	A441.EDF	A44	1
63	9746550	9746934	1459	1843	384	RIGHT	A441.EDF	A44	1
63	9746962	9746964	1871	1873	2	RIGHT	A441.EDF	A44	1
63	9747009	9747116	1918	2025	107	RIGHT	A441.EDF	A44	1
63	9747137	9747903	2046	2812	766	RIGHT	A441.EDF	A44	1
63	9747931	9748298	2840	3207	367	RIGHT	A441.EDF	A44	1
63	9748319	9748372	3228	3281	53	RIGHT	A441.EDF	A44	1
63	9748394	9748410	3303	3319	16	RIGHT	A441.EDF	A44	1
63	9748435	9748552	3344	3461	117	RIGHT	A441.EDF	A44	1
63	9748582	9748602	3491	3511	20	RIGHT	A441.EDF	A44	1
63	9748643	9748735	3552	3644	92	RIGHT	A441.EDF	A44	1
63	9748828	9748832	3737	3741	4	RIGHT	A441.EDF	A44	1
63	9748855	9748855	3764	3764	0	RIGHT	A441.EDF	A44	1
63	9748888	9749677	3797	4586	789	RIGHT	A441.EDF	A44	1
63	9749704	9749727	4613	4636	23	RIGHT	A441.EDF	A44	1
63	9749749	9749760	4658	4669	11	RIGHT	A441.EDF	A44	1
63	9749783	9749785	4692	4694	2	RIGHT	A441.EDF	A44	1
63	9749807	9749836	4716	4745	29	RIGHT	A441.EDF	A44	1
63	9749886	9749897	4795	4806	11	RIGHT	A441.EDF	A44	1
63	9749921	9750926	4830	5835	1005	RIGHT	A441.EDF	A44	1
63	9750957	9751460	5866	6369	503	RIGHT	A441.EDF	A44	1
63	9751485	9751778	6394	6687	293	RIGHT	A441.EDF	A44	1
64	9753755	9753758	96	99	3	RIGHT	A441.EDF	A44	1
64	9753832	9753832	173	173	0	RIGHT	A441.EDF	A44	1
64	9754093	9754660	434	1001	567	RIGHT	A441.EDF	A44	1
64	9754701	9754702	1042	1043	1	RIGHT	A441.EDF	A44	1
64	9754724	9754756	1065	1097	32	RIGHT	A441.EDF	A44	1
64	9754820	9754837	1161	1178	17	RIGHT	A441.EDF	A44	1
64	9754927	9754927	1268	1268	0	RIGHT	A441.EDF	A44	1
64	9754956	9754956	1297	1297	0	RIGHT	A441.EDF	A44	1
64	9754994	9754997	1335	1338	3	RIGHT	A441.EDF	A44	1
64	9755111	9755132	1452	1473	21	RIGHT	A441.EDF	A44	1
64	9755172	9755243	1513	1584	71	RIGHT	A441.EDF	A44	1
64	9755287	9755357	1628	1698	70	RIGHT	A441.EDF	A44	1
64	9755396	9757318	1737	3659	1922	RIGHT	A441.EDF	A44	1
64	9757354	9759522	3695	5863	2168	RIGHT	A441.EDF	A44	1
64	9759548	9760094	5889	6435	546	RIGHT	A441.EDF	A44	1
65	9761833	9761980	58	205	147	RIGHT	A441.EDF	A44	1
65	9762002	9762030	227	255	28	RIGHT	A441.EDF	A44	1
65	9762056	9762071	281	296	15	RIGHT	A441.EDF	A44	1
65	9762092	9762107	317	332	15	RIGHT	A441.EDF	A44	1
65	9762141	9762171	366	396	30	RIGHT	A441.EDF	A44	1
65	9762194	9762210	419	435	16	RIGHT	A441.EDF	A44	1
65	9762235	9762264	460	489	29	RIGHT	A441.EDF	A44	1
65	9762320	9762354	545	579	34	RIGHT	A441.EDF	A44	1
65	9762409	9762722	634	947	313	RIGHT	A441.EDF	A44	1
65	9762768	9762769	993	994	1	RIGHT	A441.EDF	A44	1
65	9762796	9768367	1021	6592	5571	RIGHT	A441.EDF	A44	1
65	9768395	9768742	6620	6967	347	RIGHT	A441.EDF	A44	1
65	9768764	9768769	6989	6994	5	RIGHT	A441.EDF	A44	1
66	9770384	9770651	58	325	267	RIGHT	A441.EDF	A44	1
66	9770779	9771071	453	745	292	RIGHT	A441.EDF	A44	1
66	9771188	9771215	862	889	27	RIGHT	A441.EDF	A44	1
66	9771236	9771564	910	1238	328	RIGHT	A441.EDF	A44	1
66	9771611	9771624	1285	1298	13	RIGHT	A441.EDF	A44	1
66	9771646	9771655	1320	1329	9	RIGHT	A441.EDF	A44	1
66	9771694	9771695	1368	1369	1	RIGHT	A441.EDF	A44	1
66	9771721	9772089	1395	1763	368	RIGHT	A441.EDF	A44	1
66	9772129	9772129	1803	1803	0	RIGHT	A441.EDF	A44	1
66	9772162	9772164	1836	1838	2	RIGHT	A441.EDF	A44	1
66	9772194	9772200	1868	1874	6	RIGHT	A441.EDF	A44	1
66	9772227	9772227	1901	1901	0	RIGHT	A441.EDF	A44	1
66	9772260	9772261	1934	1935	1	RIGHT	A441.EDF	A44	1
66	9772312	9772313	1986	1987	1	RIGHT	A441.EDF	A44	1
66	9772338	9772351	2012	2025	13	RIGHT	A441.EDF	A44	1
66	9772386	9772397	2060	2071	11	RIGHT	A441.EDF	A44	1
66	9772422	9772425	2096	2099	3	RIGHT	A441.EDF	A44	1
66	9772460	9773091	2134	2765	631	RIGHT	A441.EDF	A44	1
66	9773244	9773256	2918	2930	12	RIGHT	A441.EDF	A44	1
66	9773277	9773286	2951	2960	9	RIGHT	A441.EDF	A44	1
66	9773308	9773309	2982	2983	1	RIGHT	A441.EDF	A44	1
66	9773346	9773351	3020	3025	5	RIGHT	A441.EDF	A44	1
66	9773376	9773407	3050	3081	31	RIGHT	A441.EDF	A44	1
66	9773432	9773485	3106	3159	53	RIGHT	A441.EDF	A44	1
66	9773553	9773572	3227	3246	19	RIGHT	A441.EDF	A44	1
66	9773604	9773605	3278	3279	1	RIGHT	A441.EDF	A44	1
66	9773635	9773639	3309	3313	4	RIGHT	A441.EDF	A44	1
66	9773660	9773661	3334	3335	1	RIGHT	A441.EDF	A44	1
66	9773715	9773732	3389	3406	17	RIGHT	A441.EDF	A44	1
66	9773764	9773766	3438	3440	2	RIGHT	A441.EDF	A44	1
66	9773787	9773814	3461	3488	27	RIGHT	A441.EDF	A44	1
66	9773853	9773859	3527	3533	6	RIGHT	A441.EDF	A44	1
66	9773885	9773911	3559	3585	26	RIGHT	A441.EDF	A44	1
66	9773951	9773952	3625	3626	1	RIGHT	A441.EDF	A44	1
66	9773990	9774007	3664	3681	17	RIGHT	A441.EDF	A44	1
66	9774030	9774085	3704	3759	55	RIGHT	A441.EDF	A44	1
66	9774161	9774261	3835	3935	100	RIGHT	A441.EDF	A44	1
66	9774309	9775287	3983	4961	978	RIGHT	A441.EDF	A44	1
66	9775310	9775334	4984	5008	24	RIGHT	A441.EDF	A44	1
66	9775355	9775355	5029	5029	0	RIGHT	A441.EDF	A44	1
66	9775388	9775405	5062	5079	17	RIGHT	A441.EDF	A44	1
66	9775429	9775460	5103	5134	31	RIGHT	A441.EDF	A44	1
66	9775483	9775494	5157	5168	11	RIGHT	A441.EDF	A44	1
66	9775516	9775553	5190	5227	37	RIGHT	A441.EDF	A44	1
66	9775588	9775590	5262	5264	2	RIGHT	A441.EDF	A44	1
66	9775617	9775671	5291	5345	54	RIGHT	A441.EDF	A44	1
66	9775700	9775865	5374	5539	165	RIGHT	A441.EDF	A44	1
66	9775897	9775897	5571	5571	0	RIGHT	A441.EDF	A44	1
66	9775935	9775967	5609	5641	32	RIGHT	A441.EDF	A44	1
66	9775995	9776038	5669	5712	43	RIGHT	A441.EDF	A44	1
66	9776060	9776167	5734	5841	107	RIGHT	A441.EDF	A44	1
66	9776203	9776203	5877	5877	0	RIGHT	A441.EDF	A44	1
66	9776226	9776227	5900	5901	1	RIGHT	A441.EDF	A44	1
66	9776253	9776273	5927	5947	20	RIGHT	A441.EDF	A44	1
66	9776301	9776314	5975	5988	13	RIGHT	A441.EDF	A44	1
67	9778212	9778386	57	231	174	RIGHT	A441.EDF	A44	1
67	9778411	9778468	256	313	57	RIGHT	A441.EDF	A44	1
67	9778526	9778558	371	403	32	RIGHT	A441.EDF	A44	1
67	9778580	9778603	425	448	23	RIGHT	A441.EDF	A44	1
67	9778690	9778691	535	536	1	RIGHT	A441.EDF	A44	1
67	9778736	9778747	581	592	11	RIGHT	A441.EDF	A44	1
67	9778775	9779151	620	996	376	RIGHT	A441.EDF	A44	1
67	9779172	9779722	1017	1567	550	RIGHT	A441.EDF	A44	1
67	9779767	9779767	1612	1612	0	RIGHT	A441.EDF	A44	1
67	9779790	9780588	1635	2433	798	RIGHT	A441.EDF	A44	1
67	9780609	9783568	2454	5413	2959	RIGHT	A441.EDF	A44	1
68	9785507	9791103	58	5654	5596	RIGHT	A441.EDF	A44	1
69	9793088	9797807	58	4777	4719	RIGHT	A441.EDF	A44	1
70	9799783	9805201	58	5476	5418	RIGHT	A441.EDF	A44	1
71	9807140	9810093	58	3011	2953	RIGHT	A441.EDF	A44	1
71	9810114	9810119	3032	3037	5	RIGHT	A441.EDF	A44	1
71	9810160	9811915	3078	4833	1755	RIGHT	A441.EDF	A44	1
72	9814026	9820481	57	6512	6455	RIGHT	A441.EDF	A44	1
73	9823358	9828646	57	5345	5288	RIGHT	A441.EDF	A44	1
74	9830575	9836321	58	5804	5746	RIGHT	A441.EDF	A44	1
75	9838391	9844566	57	6232	6175	RIGHT	A441.EDF	A44	1
76	9846522	9849839	57	3374	3317	RIGHT	A441.EDF	A44	1
76	9849890	9849913	3425	3448	23	RIGHT	A441.EDF	A44	1
76	9849947	9849968	3482	3503	21	RIGHT	A441.EDF	A44	1
76	9850005	9850006	3540	3541	1	RIGHT	A441.EDF	A44	1
76	9850049	9850054	3584	3589	5	RIGHT	A441.EDF	A44	1
76	9850085	9850087	3620	3622	2	RIGHT	A441.EDF	A44	1
76	9850109	9850110	3644	3645	1	RIGHT	A441.EDF	A44	1
76	9850158	9850797	3693	4332	639	RIGHT	A441.EDF	A44	1
76	9851069	9851087	4604	4622	18	RIGHT	A441.EDF	A44	1
76	9851174	9851174	4709	4709	0	RIGHT	A441.EDF	A44	1
76	9851259	9851263	4794	4798	4	RIGHT	A441.EDF	A44	1
76	9851346	9851348	4881	4883	2	RIGHT	A441.EDF	A44	1
76	9851405	9851407	4940	4942	2	RIGHT	A441.EDF	A44	1
76	9851462	9851462	4997	4997	0	RIGHT	A441.EDF	A44	1
76	9851535	9851656	5070	5191	121	RIGHT	A441.EDF	A44	1
76	9851705	9851707	5240	5242	2	RIGHT	A441.EDF	A44	1
76	9851741	9851788	5276	5323	47	RIGHT	A441.EDF	A44	1
76	9851833	9851834	5368	5369	1	RIGHT	A441.EDF	A44	1
76	9851858	9851859	5393	5394	1	RIGHT	A441.EDF	A44	1
76	9851891	9851892	5426	5427	1	RIGHT	A441.EDF	A44	1
76	9851927	9851928	5462	5463	1	RIGHT	A441.EDF	A44	1
76	9851971	9852021	5506	5556	50	RIGHT	A441.EDF	A44	1
76	9852073	9852204	5608	5739	131	RIGHT	A441.EDF	A44	1
76	9852255	9852257	5790	5792	2	RIGHT	A441.EDF	A44	1
76	9852281	9852298	5816	5833	17	RIGHT	A441.EDF	A44	1
76	9852331	9852331	5866	5866	0	RIGHT	A441.EDF	A44	1
77	9854409	9854530	58	179	121	RIGHT	A441.EDF	A44	1
77	9854587	9854900	236	549	313	RIGHT	A441.EDF	A44	1
77	9854944	9854945	593	594	1	RIGHT	A441.EDF	A44	1
77	9854975	9854991	624	640	16	RIGHT	A441.EDF	A44	1
77	9855044	9855051	693	700	7	RIGHT	A441.EDF	A44	1
77	9855076	9855122	725	771	46	RIGHT	A441.EDF	A44	1
77	9855144	9855195	793	844	51	RIGHT	A441.EDF	A44	1
77	9855217	9855222	866	871	5	RIGHT	A441.EDF	A44	1
77	9855248	9855301	897	950	53	RIGHT	A441.EDF	A44	1
77	9855323	9855401	972	1050	78	RIGHT	A441.EDF	A44	1
77	9855424	9855460	1073	1109	36	RIGHT	A441.EDF	A44	1
77	9855508	9855685	1157	1334	177	RIGHT	A441.EDF	A44	1
77	9855717	9855762	1366	1411	45	RIGHT	A441.EDF	A44	1
77	9855791	9855800	1440	1449	9	RIGHT	A441.EDF	A44	1
77	9855835	9856047	1484	1696	212	RIGHT	A441.EDF	A44	1
77	9856069	9858413	1718	4062	2344	RIGHT	A441.EDF	A44	1
77	9858452	9858480	4101	4129	28	RIGHT	A441.EDF	A44	1
77	9858505	9858618	4154	4267	113	RIGHT	A441.EDF	A44	1
77	9858639	9860215	4288	5864	1576	RIGHT	A441.EDF	A44	1
77	9860254	9860366	5903	6015	112	RIGHT	A441.EDF	A44	1
77	9860403	9860665	6052	6314	262	RIGHT	A441.EDF	A44	1
78	9862553	9862617	85	149	64	RIGHT	A441.EDF	A44	1
78	9862649	9863393	181	925	744	RIGHT	A441.EDF	A44	1
78	9863427	9865518	959	3050	2091	RIGHT	A441.EDF	A44	1
78	9865565	9865565	3097	3097	0	RIGHT	A441.EDF	A44	1
78	9865610	9865611	3142	3143	1	RIGHT	A441.EDF	A44	1
78	9865646	9865646	3178	3178	0	RIGHT	A441.EDF	A44	1
78	9865680	9865699	3212	3231	19	RIGHT	A441.EDF	A44	1
78	9865758	9865758	3290	3290	0	RIGHT	A441.EDF	A44	1
78	9865787	9865787	3319	3319	0	RIGHT	A441.EDF	A44	1
78	9865845	9865845	3377	3377	0	RIGHT	A441.EDF	A44	1
78	9865874	9865884	3406	3416	10	RIGHT	A441.EDF	A44	1
78	9865905	9865936	3437	3468	31	RIGHT	A441.EDF	A44	1
78	9866013	9866013	3545	3545	0	RIGHT	A441.EDF	A44	1
78	9866045	9867403	3577	4935	1358	RIGHT	A441.EDF	A44	1
78	9867424	9868540	4956	6072	1116	RIGHT	A441.EDF	A44	1
79	9870878	9870879	126	127	1	RIGHT	A441.EDF	A44	1
79	9870966	9870967	214	215	1	RIGHT	A441.EDF	A44	1
79	9871005	9871006	253	254	1	RIGHT	A441.EDF	A44	1
79	9871035	9871052	283	300	17	RIGHT	A441.EDF	A44	1
79	9871075	9871087	323	335	12	RIGHT	A441.EDF	A44	1
79	9871286	9871704	534	952	418	RIGHT	A441.EDF	A44	1
79	9871740	9871754	988	1002	14	RIGHT	A441.EDF	A44	1
79	9871797	9871797	1045	1045	0	RIGHT	A441.EDF	A44	1
79	9871819	9871820	1067	1068	1	RIGHT	A441.EDF	A44	1
79	9871893	9871893	1141	1141	0	RIGHT	A441.EDF	A44	1
79	9871985	9871985	1233	1233	0	RIGHT	A441.EDF	A44	1
79	9872014	9872014	1262	1262	0	RIGHT	A441.EDF	A44	1
79	9872111	9874258	1359	3506	2147	RIGHT	A441.EDF	A44	1
79	9874279	9874296	3527	3544	17	RIGHT	A441.EDF	A44	1
79	9874326	9874408	3574	3656	82	RIGHT	A441.EDF	A44	1
79	9874435	9874500	3683	3748	65	RIGHT	A441.EDF	A44	1
79	9874530	9875235	3778	4483	705	RIGHT	A441.EDF	A44	1
79	9875293	9875293	4541	4541	0	RIGHT	A441.EDF	A44	1
79	9875333	9875333	4581	4581	0	RIGHT	A441.EDF	A44	1
79	9875364	9875364	4612	4612	0	RIGHT	A441.EDF	A44	1
79	9875407	9875428	4655	4676	21	RIGHT	A441.EDF	A44	1
79	9875452	9875523	4700	4771	71	RIGHT	A441.EDF	A44	1
79	9875572	9875919	4820	5167	347	RIGHT	A441.EDF	A44	1
79	9875944	9875950	5192	5198	6	RIGHT	A441.EDF	A44	1
79	9876033	9876460	5281	5708	427	RIGHT	A441.EDF	A44	1
79	9876483	9876845	5731	6093	362	RIGHT	A441.EDF	A44	1
80	9879972	9887322	58	7408	7350	RIGHT	A441.EDF	A44	1
81	9889579	9894846	57	5324	5267	RIGHT	A441.EDF	A44	1
82	9897142	9903952	57	6867	6810	RIGHT	A441.EDF	A44	1
83	9905749	9911597	57	5905	5848	RIGHT	A441.EDF	A44	1
84	9913740	9921183	58	7501	7443	RIGHT	A441.EDF	A44	1
85	9923470	9929868	57	6455	6398	RIGHT	A441.EDF	A44	1
86	9931788	9937703	57	5972	5915	RIGHT	A441.EDF	A44	1
87	9939901	9945678	58	5835	5777	RIGHT	A441.EDF	A44	1
88	9947544	9954373	57	6886	6829	RIGHT	A441.EDF	A44	1
89	9956193	9956651	57	515	458	RIGHT	A441.EDF	A44	1
89	9956674	9956721	538	585	47	RIGHT	A441.EDF	A44	1
89	9956752	9962239	616	6103	5487	RIGHT	A441.EDF	A44	1
89	9962262	9962768	6126	6632	506	RIGHT	A441.EDF	A44	1
90	9964548	9970883	58	6393	6335	RIGHT	A441.EDF	A44	1
91	9972630	9978769	58	6197	6139	RIGHT	A441.EDF	A44	1
92	9980756	9983375	58	2677	2619	RIGHT	A441.EDF	A44	1
92	9983518	9983519	2820	2821	1	RIGHT	A441.EDF	A44	1
92	9983570	9983607	2872	2909	37	RIGHT	A441.EDF	A44	1
92	9983763	9983777	3065	3079	14	RIGHT	A441.EDF	A44	1
92	9983806	9983806	3108	3108	0	RIGHT	A441.EDF	A44	1
92	9983852	9983852	3154	3154	0	RIGHT	A441.EDF	A44	1
92	9983877	9983900	3179	3202	23	RIGHT	A441.EDF	A44	1
92	9983933	9983936	3235	3238	3	RIGHT	A441.EDF	A44	1
92	9983959	9983988	3261	3290	29	RIGHT	A441.EDF	A44	1
92	9984178	9984521	3480	3823	343	RIGHT	A441.EDF	A44	1
92	9984689	9984691	3991	3993	2	RIGHT	A441.EDF	A44	1
92	9984745	9984745	4047	4047	0	RIGHT	A441.EDF	A44	1
92	9984795	9984795	4097	4097	0	RIGHT	A441.EDF	A44	1
92	9984853	9984853	4155	4155	0	RIGHT	A441.EDF	A44	1
92	9984929	9984929	4231	4231	0	RIGHT	A441.EDF	A44	1
92	9984980	9984984	4282	4286	4	RIGHT	A441.EDF	A44	1
92	9985010	9985060	4312	4362	50	RIGHT	A441.EDF	A44	1
92	9985110	9985127	4412	4429	17	RIGHT	A441.EDF	A44	1
92	9985252	9985252	4554	4554	0	RIGHT	A441.EDF	A44	1
92	9985364	9985377	4666	4679	13	RIGHT	A441.EDF	A44	1
92	9985430	9985431	4732	4733	1	RIGHT	A441.EDF	A44	1
92	9985455	9985455	4757	4757	0	RIGHT	A441.EDF	A44	1
92	9985547	9985548	4849	4850	1	RIGHT	A441.EDF	A44	1
92	9985643	9985646	4945	4948	3	RIGHT	A441.EDF	A44	1
92	9985707	9985721	5009	5023	14	RIGHT	A441.EDF	A44	1
92	9985750	9985750	5052	5052	0	RIGHT	A441.EDF	A44	1
92	9985780	9985781	5082	5083	1	RIGHT	A441.EDF	A44	1
92	9985829	9985868	5131	5170	39	RIGHT	A441.EDF	A44	1
92	9985890	9985963	5192	5265	73	RIGHT	A441.EDF	A44	1
92	9985990	9985990	5292	5292	0	RIGHT	A441.EDF	A44	1
92	9986013	9986287	5315	5589	274	RIGHT	A441.EDF	A44	1
92	9986309	9986315	5611	5617	6	RIGHT	A441.EDF	A44	1
92	9986410	9986410	5712	5712	0	RIGHT	A441.EDF	A44	1
92	9986447	9986456	5749	5758	9	RIGHT	A441.EDF	A44	1
92	9986619	9986633	5921	5935	14	RIGHT	A441.EDF	A44	1
93	9988442	9988785	57	400	343	RIGHT	A441.EDF	A44	1
93	9988811	9988838	426	453	27	RIGHT	A441.EDF	A44	1
93	9988861	9989429	476	1044	568	RIGHT	A441.EDF	A44	1
93	9989458	9990285	1073	1900	827	RIGHT	A441.EDF	A44	1
93	9990310	9990406	1925	2021	96	RIGHT	A441.EDF	A44	1
93	9990444	9990465	2059	2080	21	RIGHT	A441.EDF	A44	1
93	9990488	9990568	2103	2183	80	RIGHT	A441.EDF	A44	1
93	9990592	9990615	2207	2230	23	RIGHT	A441.EDF	A44	1
93	9990637	9992909	2252	4524	2272	RIGHT	A441.EDF	A44	1
93	9992935	9993049	4550	4664	114	RIGHT	A441.EDF	A44	1
93	9993070	9993070	4685	4685	0	RIGHT	A441.EDF	A44	1
93	9993091	9993118	4706	4733	27	RIGHT	A441.EDF	A44	1
93	9993146	9993163	4761	4778	17	RIGHT	A441.EDF	A44	1
93	9993191	9993192	4806	4807	1	RIGHT	A441.EDF	A44	1
93	9993215	9993632	4830	5247	417	RIGHT	A441.EDF	A44	1
93	9993665	9993665	5280	5280	0	RIGHT	A441.EDF	A44	1
93	9993704	9993741	5319	5356	37	RIGHT	A441.EDF	A44	1
93	9993763	9993772	5378	5387	9	RIGHT	A441.EDF	A44	1
93	9993798	9993827	5413	5442	29	RIGHT	A441.EDF	A44	1
93	9993865	9993922	5480	5537	57	RIGHT	A441.EDF	A44	1
93	9993949	9993983	5564	5598	34	RIGHT	A441.EDF	A44	1
93	9994018	9994117	5633	5732	99	RIGHT	A441.EDF	A44	1
93	9994139	9994158	5754	5773	19	RIGHT	A441.EDF	A44	1
93	9994184	9994235	5799	5850	51	RIGHT	A441.EDF	A44	1
93	9994271	9994279	5886	5894	8	RIGHT	A441.EDF	A44	1
93	9994300	9994395	5915	6010	95	RIGHT	A441.EDF	A44	1
93	9994427	9995088	6042	6703	661	RIGHT	A441.EDF	A44	1
94	9996887	9996936	58	107	49	RIGHT	A441.EDF	A44	1
94	9996974	9996977	145	148	3	RIGHT	A441.EDF	A44	1
94	9997013	9997039	184	210	26	RIGHT	A441.EDF	A44	1
94	9997068	9997932	239	1103	864	RIGHT	A441.EDF	A44	1
94	9997969	9998003	1140	1174	34	RIGHT	A441.EDF	A44	1
94	9998024	9998067	1195	1238	43	RIGHT	A441.EDF	A44	1
94	9998093	9998095	1264	1266	2	RIGHT	A441.EDF	A44	1
94	9998126	9998610	1297	1781	484	RIGHT	A441.EDF	A44	1
94	9998640	9999177	1811	2348	537	RIGHT	A441.EDF	A44	1
94	9999204	10001943	2375	5114	2739	RIGHT	A441.EDF	A44	1
95	10003569	10007415	57	3903	3846	RIGHT	A441.EDF	A44	1
95	10007443	10009117	3931	5605	1674	RIGHT	A441.EDF	A44	1
96	10010577	10016711	57	6191	6134	RIGHT	A441.EDF	A44	1
97	10019077	10020098	58	1079	1021	RIGHT	A441.EDF	A44	1
97	10020132	10020132	1113	1113	0	RIGHT	A441.EDF	A44	1
97	10020162	10020204	1143	1185	42	RIGHT	A441.EDF	A44	1
97	10020371	10020371	1352	1352	0	RIGHT	A441.EDF	A44	1
97	10020409	10020409	1390	1390	0	RIGHT	A441.EDF	A44	1
97	10020436	10020436	1417	1417	0	RIGHT	A441.EDF	A44	1
97	10020555	10020555	1536	1536	0	RIGHT	A441.EDF	A44	1
97	10020610	10020611	1591	1592	1	RIGHT	A441.EDF	A44	1
97	10020644	10020644	1625	1625	0	RIGHT	A441.EDF	A44	1
97	10020736	10020747	1717	1728	11	RIGHT	A441.EDF	A44	1
97	10020883	10020883	1864	1864	0	RIGHT	A441.EDF	A44	1
97	10020910	10020910	1891	1891	0	RIGHT	A441.EDF	A44	1
97	10021065	10021065	2046	2046	0	RIGHT	A441.EDF	A44	1
97	10021163	10021169	2144	2150	6	RIGHT	A441.EDF	A44	1
97	10021323	10021341	2304	2322	18	RIGHT	A441.EDF	A44	1
97	10021374	10021374	2355	2355	0	RIGHT	A441.EDF	A44	1
97	10021417	10021439	2398	2420	22	RIGHT	A441.EDF	A44	1
97	10021464	10021491	2445	2472	27	RIGHT	A441.EDF	A44	1
97	10021518	10022008	2499	2989	490	RIGHT	A441.EDF	A44	1
97	10022033	10022132	3014	3113	99	RIGHT	A441.EDF	A44	1
97	10022161	10022220	3142	3201	59	RIGHT	A441.EDF	A44	1
97	10022244	10022261	3225	3242	17	RIGHT	A441.EDF	A44	1
97	10022283	10022287	3264	3268	4	RIGHT	A441.EDF	A44	1
97	10022344	10022357	3325	3338	13	RIGHT	A441.EDF	A44	1
97	10022381	10022381	3362	3362	0	RIGHT	A441.EDF	A44	1
97	10022404	10022404	3385	3385	0	RIGHT	A441.EDF	A44	1
97	10022465	10022465	3446	3446	0	RIGHT	A441.EDF	A44	1
97	10022543	10022567	3524	3548	24	RIGHT	A441.EDF	A44	1
97	10022640	10022640	3621	3621	0	RIGHT	A441.EDF	A44	1
97	10022665	10022673	3646	3654	8	RIGHT	A441.EDF	A44	1
97	10022753	10022754	3734	3735	1	RIGHT	A441.EDF	A44	1
97	10022782	10026428	3763	7409	3646	RIGHT	A441.EDF	A44	1
98	10028037	10033253	57	5273	5216	RIGHT	A441.EDF	A44	1
99	10035538	10040826	57	5345	5288	RIGHT	A441.EDF	A44	1
100	10043262	10048331	57	5126	5069	RIGHT	A441.EDF	A44	1
101	10050190	10056687	57	6554	6497	RIGHT	A441.EDF	A44	1
102	10058576	10065502	58	6984	6926	RIGHT	A441.EDF	A44	1
103	10067360	10072836	57	5533	5476	RIGHT	A441.EDF	A44	1
104	10074686	10081041	57	6412	6355	RIGHT	A441.EDF	A44	1
105	10082760	10089056	57	6353	6296	RIGHT	A441.EDF	A44	1
106	10090726	10095510	58	4842	4784	RIGHT	A441.EDF	A44	1
107	10097468	10103455	58	6045	5987	RIGHT	A441.EDF	A44	1
108	10105551	10110669	57	5175	5118	RIGHT	A441.EDF	A44	1
109	10112656	10117724	58	5126	5068	RIGHT	A441.EDF	A44	1
110	10119960	10126559	58	6657	6599	RIGHT	A441.EDF	A44	1
111	10128410	10133754	58	5402	5344	RIGHT	A441.EDF	A44	1
112	10135791	10140798	57	5064	5007	RIGHT	A441.EDF	A44	1
113	10143098	10148703	58	5663	5605	RIGHT	A441.EDF	A44	1
114	10151082	10152117	58	1093	1035	RIGHT	A441.EDF	A44	1
114	10152145	10152199	1121	1175	54	RIGHT	A441.EDF	A44	1
114	10152232	10152232	1208	1208	0	RIGHT	A441.EDF	A44	1
114	10152315	10152614	1291	1590	299	RIGHT	A441.EDF	A44	1
114	10152701	10153036	1677	2012	335	RIGHT	A441.EDF	A44	1
114	10153100	10153116	2076	2092	16	RIGHT	A441.EDF	A44	1
114	10153191	10153193	2167	2169	2	RIGHT	A441.EDF	A44	1
114	10153245	10153245	2221	2221	0	RIGHT	A441.EDF	A44	1
114	10153281	10153336	2257	2312	55	RIGHT	A441.EDF	A44	1
114	10153371	10153425	2347	2401	54	RIGHT	A441.EDF	A44	1
114	10153458	10153458	2434	2434	0	RIGHT	A441.EDF	A44	1
114	10153502	10153521	2478	2497	19	RIGHT	A441.EDF	A44	1
114	10153726	10153726	2702	2702	0	RIGHT	A441.EDF	A44	1
114	10153764	10153764	2740	2740	0	RIGHT	A441.EDF	A44	1
114	10153877	10153905	2853	2881	28	RIGHT	A441.EDF	A44	1
114	10153979	10153988	2955	2964	9	RIGHT	A441.EDF	A44	1
114	10154010	10154043	2986	3019	33	RIGHT	A441.EDF	A44	1
114	10154088	10154102	3064	3078	14	RIGHT	A441.EDF	A44	1
114	10154137	10154137	3113	3113	0	RIGHT	A441.EDF	A44	1
114	10154158	10154158	3134	3134	0	RIGHT	A441.EDF	A44	1
114	10154217	10154218	3193	3194	1	RIGHT	A441.EDF	A44	1
114	10154316	10154435	3292	3411	119	RIGHT	A441.EDF	A44	1
114	10154468	10154849	3444	3825	381	RIGHT	A441.EDF	A44	1
114	10155026	10155026	4002	4002	0	RIGHT	A441.EDF	A44	1
114	10155215	10155215	4191	4191	0	RIGHT	A441.EDF	A44	1
114	10155350	10155350	4326	4326	0	RIGHT	A441.EDF	A44	1
114	10155428	10155453	4404	4429	25	RIGHT	A441.EDF	A44	1
114	10155637	10155689	4613	4665	52	RIGHT	A441.EDF	A44	1
114	10155752	10155791	4728	4767	39	RIGHT	A441.EDF	A44	1
114	10155826	10155826	4802	4802	0	RIGHT	A441.EDF	A44	1
114	10155871	10155871	4847	4847	0	RIGHT	A441.EDF	A44	1
114	10156079	10156090	5055	5066	11	RIGHT	A441.EDF	A44	1
114	10156154	10156480	5130	5456	326	RIGHT	A441.EDF	A44	1
114	10156531	10156534	5507	5510	3	RIGHT	A441.EDF	A44	1
114	10156655	10156657	5631	5633	2	RIGHT	A441.EDF	A44	1
114	10156865	10156867	5841	5843	2	RIGHT	A441.EDF	A44	1
114	10156996	10157012	5972	5988	16	RIGHT	A441.EDF	A44	1
114	10157112	10157112	6088	6088	0	RIGHT	A441.EDF	A44	1
114	10157163	10157182	6139	6158	19	RIGHT	A441.EDF	A44	1
114	10157277	10157283	6253	6259	6	RIGHT	A441.EDF	A44	1
114	10157310	10157315	6286	6291	5	RIGHT	A441.EDF	A44	1
114	10157354	10157354	6330	6330	0	RIGHT	A441.EDF	A44	1
114	10157452	10157476	6428	6452	24	RIGHT	A441.EDF	A44	1
114	10157561	10157562	6537	6538	1	RIGHT	A441.EDF	A44	1
114	10157615	10157625	6591	6601	10	RIGHT	A441.EDF	A44	1
114	10157663	10157663	6639	6639	0	RIGHT	A441.EDF	A44	1
114	10157722	10157722	6698	6698	0	RIGHT	A441.EDF	A44	1
114	10157765	10157765	6741	6741	0	RIGHT	A441.EDF	A44	1
114	10157847	10157862	6823	6838	15	RIGHT	A441.EDF	A44	1
114	10157890	10157918	6866	6894	28	RIGHT	A441.EDF	A44	1
115	10160153	10165414	112	5373	5261	RIGHT	A441.EDF	A44	1
116	10168372	10173548	58	5234	5176	RIGHT	A441.EDF	A44	1
117	10175276	10180262	57	5043	4986	RIGHT	A441.EDF	A44	1
118	10182678	10187767	58	5147	5089	RIGHT	A441.EDF	A44	1
119	10190002	10196643	57	6698	6641	RIGHT	A441.EDF	A44	1
120	10198722	10204977	58	6313	6255	RIGHT	A441.EDF	A44	1
1	10374757	10374760	96	99	3	RIGHT	A442.EDF	A44	2
1	10374786	10374821	125	160	35	RIGHT	A442.EDF	A44	2
1	10374875	10374875	214	214	0	RIGHT	A442.EDF	A44	2
1	10374915	10374915	254	254	0	RIGHT	A442.EDF	A44	2
1	10374977	10375128	316	467	151	RIGHT	A442.EDF	A44	2
1	10375706	10375945	1045	1284	239	RIGHT	A442.EDF	A44	2
1	10376068	10376272	1407	1611	204	RIGHT	A442.EDF	A44	2
1	10376302	10376303	1641	1642	1	RIGHT	A442.EDF	A44	2
1	10376349	10376377	1688	1716	28	RIGHT	A442.EDF	A44	2
1	10376398	10376503	1737	1842	105	RIGHT	A442.EDF	A44	2
1	10376528	10376562	1867	1901	34	RIGHT	A442.EDF	A44	2
1	10376597	10376613	1936	1952	16	RIGHT	A442.EDF	A44	2
1	10376650	10376651	1989	1990	1	RIGHT	A442.EDF	A44	2
1	10377219	10377220	2558	2559	1	RIGHT	A442.EDF	A44	2
1	10377243	10379765	2582	5104	2522	RIGHT	A442.EDF	A44	2
2	10381370	10386529	57	5216	5159	RIGHT	A442.EDF	A44	2
3	10388456	10388462	90	96	6	RIGHT	A442.EDF	A44	2
3	10388483	10388484	117	118	1	RIGHT	A442.EDF	A44	2
3	10388507	10388523	141	157	16	RIGHT	A442.EDF	A44	2
3	10388561	10388569	195	203	8	RIGHT	A442.EDF	A44	2
3	10388604	10388827	238	461	223	RIGHT	A442.EDF	A44	2
3	10388876	10393454	510	5088	4578	RIGHT	A442.EDF	A44	2
4	10395828	10400298	220	4690	4470	RIGHT	A442.EDF	A44	2
5	10402485	10403341	57	913	856	RIGHT	A442.EDF	A44	2
5	10403388	10403388	960	960	0	RIGHT	A442.EDF	A44	2
5	10403524	10403559	1096	1131	35	RIGHT	A442.EDF	A44	2
5	10403637	10403637	1209	1209	0	RIGHT	A442.EDF	A44	2
5	10403676	10403683	1248	1255	7	RIGHT	A442.EDF	A44	2
5	10403714	10403714	1286	1286	0	RIGHT	A442.EDF	A44	2
5	10403744	10403744	1316	1316	0	RIGHT	A442.EDF	A44	2
5	10403787	10403787	1359	1359	0	RIGHT	A442.EDF	A44	2
5	10403815	10403839	1387	1411	24	RIGHT	A442.EDF	A44	2
5	10403862	10403904	1434	1476	42	RIGHT	A442.EDF	A44	2
5	10403925	10409083	1497	6655	5158	RIGHT	A442.EDF	A44	2
6	10411037	10411091	100	154	54	RIGHT	A442.EDF	A44	2
6	10411125	10411191	188	254	66	RIGHT	A442.EDF	A44	2
6	10411224	10417328	287	6391	6104	RIGHT	A442.EDF	A44	2
7	10420048	10426014	57	6023	5966	RIGHT	A442.EDF	A44	2
8	10428472	10428473	139	140	1	RIGHT	A442.EDF	A44	2
8	10428632	10434639	299	6306	6007	RIGHT	A442.EDF	A44	2
9	10437699	10444715	58	7074	7016	RIGHT	A442.EDF	A44	2
10	10447023	10448486	66	1529	1463	RIGHT	A442.EDF	A44	2
10	10448553	10449023	1596	2066	470	RIGHT	A442.EDF	A44	2
10	10449103	10450505	2146	3548	1402	RIGHT	A442.EDF	A44	2
10	10450528	10452071	3571	5114	1543	RIGHT	A442.EDF	A44	2
10	10452092	10452217	5135	5260	125	RIGHT	A442.EDF	A44	2
10	10452242	10453000	5285	6043	758	RIGHT	A442.EDF	A44	2
11	10455167	10455771	57	661	604	RIGHT	A442.EDF	A44	2
11	10455793	10456133	683	1023	340	RIGHT	A442.EDF	A44	2
11	10456154	10456173	1044	1063	19	RIGHT	A442.EDF	A44	2
11	10456203	10456212	1093	1102	9	RIGHT	A442.EDF	A44	2
11	10456234	10456243	1124	1133	9	RIGHT	A442.EDF	A44	2
11	10456289	10456289	1179	1179	0	RIGHT	A442.EDF	A44	2
11	10456314	10456314	1204	1204	0	RIGHT	A442.EDF	A44	2
11	10456370	10456391	1260	1281	21	RIGHT	A442.EDF	A44	2
11	10456468	10456470	1358	1360	2	RIGHT	A442.EDF	A44	2
11	10456523	10456829	1413	1719	306	RIGHT	A442.EDF	A44	2
11	10456856	10456972	1746	1862	116	RIGHT	A442.EDF	A44	2
11	10457003	10457013	1893	1903	10	RIGHT	A442.EDF	A44	2
11	10457035	10457036	1925	1926	1	RIGHT	A442.EDF	A44	2
11	10457118	10457119	2008	2009	1	RIGHT	A442.EDF	A44	2
11	10457191	10457210	2081	2100	19	RIGHT	A442.EDF	A44	2
11	10457278	10457281	2168	2171	3	RIGHT	A442.EDF	A44	2
11	10457310	10457372	2200	2262	62	RIGHT	A442.EDF	A44	2
11	10457421	10457447	2311	2337	26	RIGHT	A442.EDF	A44	2
11	10457476	10457528	2366	2418	52	RIGHT	A442.EDF	A44	2
11	10457556	10457576	2446	2466	20	RIGHT	A442.EDF	A44	2
11	10457610	10457727	2500	2617	117	RIGHT	A442.EDF	A44	2
11	10457756	10457756	2646	2646	0	RIGHT	A442.EDF	A44	2
11	10457789	10457791	2679	2681	2	RIGHT	A442.EDF	A44	2
11	10457823	10457825	2713	2715	2	RIGHT	A442.EDF	A44	2
11	10457922	10457946	2812	2836	24	RIGHT	A442.EDF	A44	2
11	10457981	10457982	2871	2872	1	RIGHT	A442.EDF	A44	2
11	10458024	10458029	2914	2919	5	RIGHT	A442.EDF	A44	2
11	10458050	10458477	2940	3367	427	RIGHT	A442.EDF	A44	2
11	10458525	10458526	3415	3416	1	RIGHT	A442.EDF	A44	2
11	10458599	10458599	3489	3489	0	RIGHT	A442.EDF	A44	2
11	10458643	10458655	3533	3545	12	RIGHT	A442.EDF	A44	2
11	10458724	10458749	3614	3639	25	RIGHT	A442.EDF	A44	2
11	10458777	10458792	3667	3682	15	RIGHT	A442.EDF	A44	2
11	10458817	10458818	3707	3708	1	RIGHT	A442.EDF	A44	2
11	10458840	10459108	3730	3998	268	RIGHT	A442.EDF	A44	2
11	10459140	10459144	4030	4034	4	RIGHT	A442.EDF	A44	2
11	10459268	10459269	4158	4159	1	RIGHT	A442.EDF	A44	2
11	10459307	10459308	4197	4198	1	RIGHT	A442.EDF	A44	2
11	10459333	10459494	4223	4384	161	RIGHT	A442.EDF	A44	2
11	10459526	10459573	4416	4463	47	RIGHT	A442.EDF	A44	2
11	10459603	10459606	4493	4496	3	RIGHT	A442.EDF	A44	2
11	10459644	10459661	4534	4551	17	RIGHT	A442.EDF	A44	2
11	10459728	10459821	4618	4711	93	RIGHT	A442.EDF	A44	2
11	10459845	10460097	4735	4987	252	RIGHT	A442.EDF	A44	2
11	10460190	10460226	5080	5116	36	RIGHT	A442.EDF	A44	2
11	10460250	10460261	5140	5151	11	RIGHT	A442.EDF	A44	2
11	10460288	10460288	5178	5178	0	RIGHT	A442.EDF	A44	2
11	10460327	10460328	5217	5218	1	RIGHT	A442.EDF	A44	2
11	10460396	10460396	5286	5286	0	RIGHT	A442.EDF	A44	2
11	10460442	10460442	5332	5332	0	RIGHT	A442.EDF	A44	2
11	10460471	10460510	5361	5400	39	RIGHT	A442.EDF	A44	2
11	10460533	10460534	5423	5424	1	RIGHT	A442.EDF	A44	2
11	10460577	10460577	5467	5467	0	RIGHT	A442.EDF	A44	2
11	10460599	10460600	5489	5490	1	RIGHT	A442.EDF	A44	2
11	10460757	10461604	5647	6494	847	RIGHT	A442.EDF	A44	2
11	10461672	10461680	6562	6570	8	RIGHT	A442.EDF	A44	2
11	10461709	10461711	6599	6601	2	RIGHT	A442.EDF	A44	2
11	10461844	10461849	6734	6739	5	RIGHT	A442.EDF	A44	2
11	10461887	10461908	6777	6798	21	RIGHT	A442.EDF	A44	2
11	10461930	10461930	6820	6820	0	RIGHT	A442.EDF	A44	2
11	10461963	10462070	6853	6960	107	RIGHT	A442.EDF	A44	2
11	10462097	10462133	6987	7023	36	RIGHT	A442.EDF	A44	2
11	10462156	10462167	7046	7057	11	RIGHT	A442.EDF	A44	2
11	10462189	10462190	7079	7080	1	RIGHT	A442.EDF	A44	2
11	10462273	10462336	7163	7226	63	RIGHT	A442.EDF	A44	2
12	10464311	10464311	164	164	0	RIGHT	A442.EDF	A44	2
12	10464579	10464642	432	495	63	RIGHT	A442.EDF	A44	2
12	10464673	10464734	526	587	61	RIGHT	A442.EDF	A44	2
12	10464757	10464757	610	610	0	RIGHT	A442.EDF	A44	2
12	10464799	10465432	652	1285	633	RIGHT	A442.EDF	A44	2
12	10465469	10465515	1322	1368	46	RIGHT	A442.EDF	A44	2
12	10465568	10465570	1421	1423	2	RIGHT	A442.EDF	A44	2
12	10465594	10465606	1447	1459	12	RIGHT	A442.EDF	A44	2
12	10465635	10465756	1488	1609	121	RIGHT	A442.EDF	A44	2
12	10465789	10465790	1642	1643	1	RIGHT	A442.EDF	A44	2
12	10465811	10465908	1664	1761	97	RIGHT	A442.EDF	A44	2
12	10465929	10467128	1782	2981	1199	RIGHT	A442.EDF	A44	2
12	10467163	10467199	3016	3052	36	RIGHT	A442.EDF	A44	2
12	10467223	10467279	3076	3132	56	RIGHT	A442.EDF	A44	2
12	10467338	10467373	3191	3226	35	RIGHT	A442.EDF	A44	2
12	10467397	10467497	3250	3350	100	RIGHT	A442.EDF	A44	2
12	10467561	10467570	3414	3423	9	RIGHT	A442.EDF	A44	2
12	10467609	10467609	3462	3462	0	RIGHT	A442.EDF	A44	2
12	10467636	10467656	3489	3509	20	RIGHT	A442.EDF	A44	2
12	10467685	10467695	3538	3548	10	RIGHT	A442.EDF	A44	2
12	10467789	10467790	3642	3643	1	RIGHT	A442.EDF	A44	2
12	10467822	10467847	3675	3700	25	RIGHT	A442.EDF	A44	2
12	10467879	10467885	3732	3738	6	RIGHT	A442.EDF	A44	2
12	10467960	10467962	3813	3815	2	RIGHT	A442.EDF	A44	2
12	10468017	10468018	3870	3871	1	RIGHT	A442.EDF	A44	2
12	10468075	10468084	3928	3937	9	RIGHT	A442.EDF	A44	2
12	10468152	10468223	4005	4076	71	RIGHT	A442.EDF	A44	2
12	10468312	10468316	4165	4169	4	RIGHT	A442.EDF	A44	2
12	10468356	10468356	4209	4209	0	RIGHT	A442.EDF	A44	2
12	10468407	10468409	4260	4262	2	RIGHT	A442.EDF	A44	2
12	10468431	10468610	4284	4463	179	RIGHT	A442.EDF	A44	2
12	10468633	10468717	4486	4570	84	RIGHT	A442.EDF	A44	2
12	10468745	10468797	4598	4650	52	RIGHT	A442.EDF	A44	2
12	10468843	10468843	4696	4696	0	RIGHT	A442.EDF	A44	2
12	10468865	10468911	4718	4764	46	RIGHT	A442.EDF	A44	2
12	10468942	10469256	4795	5109	314	RIGHT	A442.EDF	A44	2
12	10469281	10469337	5134	5190	56	RIGHT	A442.EDF	A44	2
12	10469373	10469374	5226	5227	1	RIGHT	A442.EDF	A44	2
12	10469409	10469410	5262	5263	1	RIGHT	A442.EDF	A44	2
13	10471840	10472318	57	535	478	RIGHT	A442.EDF	A44	2
13	10472344	10473011	561	1228	667	RIGHT	A442.EDF	A44	2
13	10473032	10474979	1249	3196	1947	RIGHT	A442.EDF	A44	2
13	10475003	10476301	3220	4518	1298	RIGHT	A442.EDF	A44	2
13	10476325	10476483	4542	4700	158	RIGHT	A442.EDF	A44	2
13	10476533	10476585	4750	4802	52	RIGHT	A442.EDF	A44	2
13	10476620	10476732	4837	4949	112	RIGHT	A442.EDF	A44	2
13	10476759	10476759	4976	4976	0	RIGHT	A442.EDF	A44	2
13	10476789	10476890	5006	5107	101	RIGHT	A442.EDF	A44	2
13	10476911	10476961	5128	5178	50	RIGHT	A442.EDF	A44	2
13	10477001	10477805	5218	6022	804	RIGHT	A442.EDF	A44	2
14	10479587	10479595	100	108	8	RIGHT	A442.EDF	A44	2
14	10479642	10479702	155	215	60	RIGHT	A442.EDF	A44	2
14	10479731	10479731	244	244	0	RIGHT	A442.EDF	A44	2
14	10479760	10479761	273	274	1	RIGHT	A442.EDF	A44	2
14	10479803	10479816	316	329	13	RIGHT	A442.EDF	A44	2
14	10479856	10479857	369	370	1	RIGHT	A442.EDF	A44	2
14	10479882	10479882	395	395	0	RIGHT	A442.EDF	A44	2
14	10479912	10479930	425	443	18	RIGHT	A442.EDF	A44	2
14	10480049	10480049	562	562	0	RIGHT	A442.EDF	A44	2
14	10480087	10480114	600	627	27	RIGHT	A442.EDF	A44	2
14	10480156	10480164	669	677	8	RIGHT	A442.EDF	A44	2
14	10480196	10480200	709	713	4	RIGHT	A442.EDF	A44	2
14	10480222	10480701	735	1214	479	RIGHT	A442.EDF	A44	2
14	10480722	10481671	1235	2184	949	RIGHT	A442.EDF	A44	2
14	10481699	10481720	2212	2233	21	RIGHT	A442.EDF	A44	2
14	10481742	10481867	2255	2380	125	RIGHT	A442.EDF	A44	2
14	10481888	10482027	2401	2540	139	RIGHT	A442.EDF	A44	2
14	10482059	10482060	2572	2573	1	RIGHT	A442.EDF	A44	2
14	10482117	10483257	2630	3770	1140	RIGHT	A442.EDF	A44	2
14	10483288	10483344	3801	3857	56	RIGHT	A442.EDF	A44	2
14	10483370	10483937	3883	4450	567	RIGHT	A442.EDF	A44	2
14	10483958	10484063	4471	4576	105	RIGHT	A442.EDF	A44	2
14	10484093	10484125	4606	4638	32	RIGHT	A442.EDF	A44	2
14	10484150	10484213	4663	4726	63	RIGHT	A442.EDF	A44	2
14	10484249	10484253	4762	4766	4	RIGHT	A442.EDF	A44	2
14	10484281	10484377	4794	4890	96	RIGHT	A442.EDF	A44	2
14	10484400	10485008	4913	5521	608	RIGHT	A442.EDF	A44	2
14	10485029	10485029	5542	5542	0	RIGHT	A442.EDF	A44	2
14	10485059	10486331	5572	6844	1272	RIGHT	A442.EDF	A44	2
15	10488381	10488671	57	347	290	RIGHT	A442.EDF	A44	2
15	10488693	10488695	369	371	2	RIGHT	A442.EDF	A44	2
15	10488719	10488720	395	396	1	RIGHT	A442.EDF	A44	2
15	10488760	10488761	436	437	1	RIGHT	A442.EDF	A44	2
15	10488782	10488783	458	459	1	RIGHT	A442.EDF	A44	2
15	10488823	10488895	499	571	72	RIGHT	A442.EDF	A44	2
15	10488962	10488962	638	638	0	RIGHT	A442.EDF	A44	2
15	10488988	10489038	664	714	50	RIGHT	A442.EDF	A44	2
15	10489073	10489617	749	1293	544	RIGHT	A442.EDF	A44	2
15	10489655	10489736	1331	1412	81	RIGHT	A442.EDF	A44	2
15	10489899	10489899	1575	1575	0	RIGHT	A442.EDF	A44	2
15	10489923	10489936	1599	1612	13	RIGHT	A442.EDF	A44	2
15	10489961	10489989	1637	1665	28	RIGHT	A442.EDF	A44	2
15	10490021	10493905	1697	5581	3884	RIGHT	A442.EDF	A44	2
16	10496091	10496460	57	426	369	RIGHT	A442.EDF	A44	2
16	10496488	10496488	454	454	0	RIGHT	A442.EDF	A44	2
16	10496541	10496555	507	521	14	RIGHT	A442.EDF	A44	2
16	10496589	10498262	555	2228	1673	RIGHT	A442.EDF	A44	2
16	10498289	10498296	2255	2262	7	RIGHT	A442.EDF	A44	2
16	10498323	10498460	2289	2426	137	RIGHT	A442.EDF	A44	2
16	10498490	10502611	2456	6577	4121	RIGHT	A442.EDF	A44	2
17	10505012	10505743	58	789	731	RIGHT	A442.EDF	A44	2
17	10505786	10507110	832	2156	1324	RIGHT	A442.EDF	A44	2
17	10507134	10507606	2180	2652	472	RIGHT	A442.EDF	A44	2
17	10507628	10507841	2674	2887	213	RIGHT	A442.EDF	A44	2
17	10507866	10511727	2912	6773	3861	RIGHT	A442.EDF	A44	2
17	10511754	10511766	6800	6812	12	RIGHT	A442.EDF	A44	2
17	10511820	10511820	6866	6866	0	RIGHT	A442.EDF	A44	2
17	10511849	10511866	6895	6912	17	RIGHT	A442.EDF	A44	2
18	10513682	10514696	58	1072	1014	RIGHT	A442.EDF	A44	2
18	10514739	10514840	1115	1216	101	RIGHT	A442.EDF	A44	2
18	10514863	10514914	1239	1290	51	RIGHT	A442.EDF	A44	2
18	10514938	10514962	1314	1338	24	RIGHT	A442.EDF	A44	2
18	10514987	10514987	1363	1363	0	RIGHT	A442.EDF	A44	2
18	10515038	10515040	1414	1416	2	RIGHT	A442.EDF	A44	2
18	10515072	10515087	1448	1463	15	RIGHT	A442.EDF	A44	2
18	10515112	10515200	1488	1576	88	RIGHT	A442.EDF	A44	2
18	10515248	10515270	1624	1646	22	RIGHT	A442.EDF	A44	2
18	10515302	10515316	1678	1692	14	RIGHT	A442.EDF	A44	2
18	10515338	10515902	1714	2278	564	RIGHT	A442.EDF	A44	2
18	10515923	10518761	2299	5137	2838	RIGHT	A442.EDF	A44	2
19	10520760	10523284	58	2582	2524	RIGHT	A442.EDF	A44	2
19	10523310	10527776	2608	7074	4466	RIGHT	A442.EDF	A44	2
20	10529780	10529815	57	92	35	RIGHT	A442.EDF	A44	2
20	10529837	10529837	114	114	0	RIGHT	A442.EDF	A44	2
20	10529871	10529871	148	148	0	RIGHT	A442.EDF	A44	2
20	10529892	10529895	169	172	3	RIGHT	A442.EDF	A44	2
20	10529919	10529921	196	198	2	RIGHT	A442.EDF	A44	2
20	10529943	10529969	220	246	26	RIGHT	A442.EDF	A44	2
20	10530010	10530010	287	287	0	RIGHT	A442.EDF	A44	2
20	10530036	10530083	313	360	47	RIGHT	A442.EDF	A44	2
20	10530107	10530145	384	422	38	RIGHT	A442.EDF	A44	2
20	10530185	10530278	462	555	93	RIGHT	A442.EDF	A44	2
20	10530303	10530648	580	925	345	RIGHT	A442.EDF	A44	2
20	10530679	10530680	956	957	1	RIGHT	A442.EDF	A44	2
20	10530706	10531158	983	1435	452	RIGHT	A442.EDF	A44	2
20	10531179	10531201	1456	1478	22	RIGHT	A442.EDF	A44	2
20	10531222	10532511	1499	2788	1289	RIGHT	A442.EDF	A44	2
20	10532544	10532547	2821	2824	3	RIGHT	A442.EDF	A44	2
20	10532569	10533310	2846	3587	741	RIGHT	A442.EDF	A44	2
20	10533334	10533361	3611	3638	27	RIGHT	A442.EDF	A44	2
20	10533383	10533411	3660	3688	28	RIGHT	A442.EDF	A44	2
20	10533436	10535038	3713	5315	1602	RIGHT	A442.EDF	A44	2
20	10535060	10535285	5337	5562	225	RIGHT	A442.EDF	A44	2
20	10535410	10535410	5687	5687	0	RIGHT	A442.EDF	A44	2
20	10535434	10535543	5711	5820	109	RIGHT	A442.EDF	A44	2
20	10535566	10535794	5843	6071	228	RIGHT	A442.EDF	A44	2
20	10535823	10536201	6100	6478	378	RIGHT	A442.EDF	A44	2
21	10538320	10539069	58	807	749	RIGHT	A442.EDF	A44	2
21	10539095	10539096	833	834	1	RIGHT	A442.EDF	A44	2
21	10539157	10539157	895	895	0	RIGHT	A442.EDF	A44	2
21	10539178	10539178	916	916	0	RIGHT	A442.EDF	A44	2
21	10539200	10539202	938	940	2	RIGHT	A442.EDF	A44	2
21	10539251	10539297	989	1035	46	RIGHT	A442.EDF	A44	2
21	10539319	10539437	1057	1175	118	RIGHT	A442.EDF	A44	2
21	10539493	10539493	1231	1231	0	RIGHT	A442.EDF	A44	2
21	10539535	10539549	1273	1287	14	RIGHT	A442.EDF	A44	2
21	10539604	10539620	1342	1358	16	RIGHT	A442.EDF	A44	2
21	10539652	10539663	1390	1401	11	RIGHT	A442.EDF	A44	2
21	10539714	10539791	1452	1529	77	RIGHT	A442.EDF	A44	2
21	10539813	10539831	1551	1569	18	RIGHT	A442.EDF	A44	2
21	10539878	10539878	1616	1616	0	RIGHT	A442.EDF	A44	2
21	10539905	10540314	1643	2052	409	RIGHT	A442.EDF	A44	2
21	10540353	10540379	2091	2117	26	RIGHT	A442.EDF	A44	2
21	10540408	10540424	2146	2162	16	RIGHT	A442.EDF	A44	2
21	10540483	10540502	2221	2240	19	RIGHT	A442.EDF	A44	2
21	10540543	10540549	2281	2287	6	RIGHT	A442.EDF	A44	2
21	10540578	10540579	2316	2317	1	RIGHT	A442.EDF	A44	2
21	10540625	10540665	2363	2403	40	RIGHT	A442.EDF	A44	2
21	10540693	10540723	2431	2461	30	RIGHT	A442.EDF	A44	2
21	10540748	10540889	2486	2627	141	RIGHT	A442.EDF	A44	2
21	10540924	10542426	2662	4164	1502	RIGHT	A442.EDF	A44	2
21	10542452	10542471	4190	4209	19	RIGHT	A442.EDF	A44	2
21	10542505	10542521	4243	4259	16	RIGHT	A442.EDF	A44	2
21	10542545	10542940	4283	4678	395	RIGHT	A442.EDF	A44	2
21	10542964	10543049	4702	4787	85	RIGHT	A442.EDF	A44	2
21	10543073	10543109	4811	4847	36	RIGHT	A442.EDF	A44	2
21	10543150	10543173	4888	4911	23	RIGHT	A442.EDF	A44	2
21	10543206	10543262	4944	5000	56	RIGHT	A442.EDF	A44	2
21	10543295	10543384	5033	5122	89	RIGHT	A442.EDF	A44	2
21	10543412	10543447	5150	5185	35	RIGHT	A442.EDF	A44	2
21	10543514	10544746	5252	6484	1232	RIGHT	A442.EDF	A44	2
22	10546265	10548342	57	2134	2077	RIGHT	A442.EDF	A44	2
22	10548364	10548366	2156	2158	2	RIGHT	A442.EDF	A44	2
22	10548387	10548414	2179	2206	27	RIGHT	A442.EDF	A44	2
22	10548440	10548489	2232	2281	49	RIGHT	A442.EDF	A44	2
22	10548535	10548913	2327	2705	378	RIGHT	A442.EDF	A44	2
22	10548938	10548940	2730	2732	2	RIGHT	A442.EDF	A44	2
22	10548967	10549621	2759	3413	654	RIGHT	A442.EDF	A44	2
22	10549643	10552902	3435	6694	3259	RIGHT	A442.EDF	A44	2
22	10552925	10552982	6717	6774	57	RIGHT	A442.EDF	A44	2
23	10554768	10555244	57	533	476	RIGHT	A442.EDF	A44	2
23	10555265	10555277	554	566	12	RIGHT	A442.EDF	A44	2
23	10555320	10555320	609	609	0	RIGHT	A442.EDF	A44	2
23	10555641	10555641	930	930	0	RIGHT	A442.EDF	A44	2
23	10555921	10555925	1210	1214	4	RIGHT	A442.EDF	A44	2
23	10556089	10556089	1378	1378	0	RIGHT	A442.EDF	A44	2
23	10556156	10556156	1445	1445	0	RIGHT	A442.EDF	A44	2
23	10556191	10556196	1480	1485	5	RIGHT	A442.EDF	A44	2
23	10556226	10556248	1515	1537	22	RIGHT	A442.EDF	A44	2
23	10556294	10556318	1583	1607	24	RIGHT	A442.EDF	A44	2
23	10556461	10556851	1750	2140	390	RIGHT	A442.EDF	A44	2
23	10556957	10557367	2246	2656	410	RIGHT	A442.EDF	A44	2
23	10557494	10557538	2783	2827	44	RIGHT	A442.EDF	A44	2
23	10557631	10557631	2920	2920	0	RIGHT	A442.EDF	A44	2
23	10557701	10557701	2990	2990	0	RIGHT	A442.EDF	A44	2
23	10557744	10558163	3033	3452	419	RIGHT	A442.EDF	A44	2
23	10558185	10558204	3474	3493	19	RIGHT	A442.EDF	A44	2
23	10558275	10558275	3564	3564	0	RIGHT	A442.EDF	A44	2
23	10558299	10558324	3588	3613	25	RIGHT	A442.EDF	A44	2
23	10558358	10558359	3647	3648	1	RIGHT	A442.EDF	A44	2
23	10558439	10558439	3728	3728	0	RIGHT	A442.EDF	A44	2
23	10558487	10558487	3776	3776	0	RIGHT	A442.EDF	A44	2
23	10558557	10560386	3846	5675	1829	RIGHT	A442.EDF	A44	2
24	10562380	10562408	283	311	28	RIGHT	A442.EDF	A44	2
24	10562450	10562461	353	364	11	RIGHT	A442.EDF	A44	2
24	10562492	10562492	395	395	0	RIGHT	A442.EDF	A44	2
24	10562539	10562556	442	459	17	RIGHT	A442.EDF	A44	2
24	10562577	10562621	480	524	44	RIGHT	A442.EDF	A44	2
24	10562675	10562686	578	589	11	RIGHT	A442.EDF	A44	2
24	10562744	10564669	647	2572	1925	RIGHT	A442.EDF	A44	2
24	10564691	10566355	2594	4258	1664	RIGHT	A442.EDF	A44	2
24	10566398	10566398	4301	4301	0	RIGHT	A442.EDF	A44	2
24	10566434	10566434	4337	4337	0	RIGHT	A442.EDF	A44	2
24	10566471	10566474	4374	4377	3	RIGHT	A442.EDF	A44	2
24	10566554	10566572	4457	4475	18	RIGHT	A442.EDF	A44	2
24	10566642	10566694	4545	4597	52	RIGHT	A442.EDF	A44	2
24	10566717	10566774	4620	4677	57	RIGHT	A442.EDF	A44	2
24	10566813	10566873	4716	4776	60	RIGHT	A442.EDF	A44	2
24	10566900	10566906	4803	4809	6	RIGHT	A442.EDF	A44	2
24	10566951	10566951	4854	4854	0	RIGHT	A442.EDF	A44	2
24	10566982	10566989	4885	4892	7	RIGHT	A442.EDF	A44	2
24	10567011	10567032	4914	4935	21	RIGHT	A442.EDF	A44	2
24	10567053	10567364	4956	5267	311	RIGHT	A442.EDF	A44	2
24	10567389	10567484	5292	5387	95	RIGHT	A442.EDF	A44	2
24	10567515	10567517	5418	5420	2	RIGHT	A442.EDF	A44	2
24	10567538	10567538	5441	5441	0	RIGHT	A442.EDF	A44	2
24	10567573	10567609	5476	5512	36	RIGHT	A442.EDF	A44	2
24	10567630	10567721	5533	5624	91	RIGHT	A442.EDF	A44	2
25	10569921	10575185	57	5321	5264	RIGHT	A442.EDF	A44	2
26	10577508	10580126	57	2675	2618	RIGHT	A442.EDF	A44	2
26	10580149	10580211	2698	2760	62	RIGHT	A442.EDF	A44	2
26	10580250	10580258	2799	2807	8	RIGHT	A442.EDF	A44	2
26	10580293	10581529	2842	4078	1236	RIGHT	A442.EDF	A44	2
26	10581558	10581568	4107	4117	10	RIGHT	A442.EDF	A44	2
26	10581591	10582900	4140	5449	1309	RIGHT	A442.EDF	A44	2
27	10585105	10585154	57	106	49	RIGHT	A442.EDF	A44	2
27	10585187	10585315	139	267	128	RIGHT	A442.EDF	A44	2
27	10585343	10585495	295	447	152	RIGHT	A442.EDF	A44	2
27	10585520	10585579	472	531	59	RIGHT	A442.EDF	A44	2
27	10585612	10585955	564	907	343	RIGHT	A442.EDF	A44	2
27	10585983	10585984	935	936	1	RIGHT	A442.EDF	A44	2
27	10586096	10586096	1048	1048	0	RIGHT	A442.EDF	A44	2
27	10586205	10586219	1157	1171	14	RIGHT	A442.EDF	A44	2
27	10586244	10586945	1196	1897	701	RIGHT	A442.EDF	A44	2
27	10586977	10586977	1929	1929	0	RIGHT	A442.EDF	A44	2
27	10587004	10587005	1956	1957	1	RIGHT	A442.EDF	A44	2
27	10587036	10587036	1988	1988	0	RIGHT	A442.EDF	A44	2
27	10587084	10587102	2036	2054	18	RIGHT	A442.EDF	A44	2
27	10587133	10587141	2085	2093	8	RIGHT	A442.EDF	A44	2
27	10587162	10587195	2114	2147	33	RIGHT	A442.EDF	A44	2
27	10587297	10587297	2249	2249	0	RIGHT	A442.EDF	A44	2
27	10587352	10587364	2304	2316	12	RIGHT	A442.EDF	A44	2
27	10587394	10587467	2346	2419	73	RIGHT	A442.EDF	A44	2
27	10587509	10587705	2461	2657	196	RIGHT	A442.EDF	A44	2
27	10587729	10587801	2681	2753	72	RIGHT	A442.EDF	A44	2
27	10587822	10587822	2774	2774	0	RIGHT	A442.EDF	A44	2
27	10587846	10587979	2798	2931	133	RIGHT	A442.EDF	A44	2
27	10588023	10588529	2975	3481	506	RIGHT	A442.EDF	A44	2
27	10588551	10589629	3503	4581	1078	RIGHT	A442.EDF	A44	2
27	10589657	10589658	4609	4610	1	RIGHT	A442.EDF	A44	2
27	10589696	10589697	4648	4649	1	RIGHT	A442.EDF	A44	2
27	10589718	10589721	4670	4673	3	RIGHT	A442.EDF	A44	2
27	10589751	10589758	4703	4710	7	RIGHT	A442.EDF	A44	2
27	10589783	10589790	4735	4742	7	RIGHT	A442.EDF	A44	2
27	10589813	10589824	4765	4776	11	RIGHT	A442.EDF	A44	2
27	10589861	10589866	4813	4818	5	RIGHT	A442.EDF	A44	2
27	10589898	10590182	4850	5134	284	RIGHT	A442.EDF	A44	2
27	10590204	10590995	5156	5947	791	RIGHT	A442.EDF	A44	2
28	10592958	10593083	83	208	125	RIGHT	A442.EDF	A44	2
28	10593107	10593755	232	880	648	RIGHT	A442.EDF	A44	2
28	10593793	10593795	918	920	2	RIGHT	A442.EDF	A44	2
28	10593819	10593824	944	949	5	RIGHT	A442.EDF	A44	2
28	10593845	10594139	970	1264	294	RIGHT	A442.EDF	A44	2
28	10594160	10594184	1285	1309	24	RIGHT	A442.EDF	A44	2
28	10594236	10594270	1361	1395	34	RIGHT	A442.EDF	A44	2
28	10594295	10594305	1420	1430	10	RIGHT	A442.EDF	A44	2
28	10594338	10594338	1463	1463	0	RIGHT	A442.EDF	A44	2
28	10594367	10594388	1492	1513	21	RIGHT	A442.EDF	A44	2
28	10594415	10594737	1540	1862	322	RIGHT	A442.EDF	A44	2
28	10594759	10594760	1884	1885	1	RIGHT	A442.EDF	A44	2
28	10594802	10594818	1927	1943	16	RIGHT	A442.EDF	A44	2
28	10594893	10595206	2018	2331	313	RIGHT	A442.EDF	A44	2
28	10595255	10595288	2380	2413	33	RIGHT	A442.EDF	A44	2
28	10595309	10595650	2434	2775	341	RIGHT	A442.EDF	A44	2
28	10595693	10596096	2818	3221	403	RIGHT	A442.EDF	A44	2
28	10596130	10596137	3255	3262	7	RIGHT	A442.EDF	A44	2
28	10596164	10596230	3289	3355	66	RIGHT	A442.EDF	A44	2
28	10596273	10596275	3398	3400	2	RIGHT	A442.EDF	A44	2
28	10596322	10596322	3447	3447	0	RIGHT	A442.EDF	A44	2
28	10596361	10596364	3486	3489	3	RIGHT	A442.EDF	A44	2
28	10596403	10596403	3528	3528	0	RIGHT	A442.EDF	A44	2
28	10596448	10596481	3573	3606	33	RIGHT	A442.EDF	A44	2
28	10596631	10596632	3756	3757	1	RIGHT	A442.EDF	A44	2
28	10596655	10596675	3780	3800	20	RIGHT	A442.EDF	A44	2
28	10596710	10596730	3835	3855	20	RIGHT	A442.EDF	A44	2
28	10596776	10596816	3901	3941	40	RIGHT	A442.EDF	A44	2
28	10596847	10596848	3972	3973	1	RIGHT	A442.EDF	A44	2
28	10596936	10596936	4061	4061	0	RIGHT	A442.EDF	A44	2
28	10597023	10597199	4148	4324	176	RIGHT	A442.EDF	A44	2
28	10597267	10597280	4392	4405	13	RIGHT	A442.EDF	A44	2
28	10597357	10597357	4482	4482	0	RIGHT	A442.EDF	A44	2
28	10597417	10597417	4542	4542	0	RIGHT	A442.EDF	A44	2
28	10597469	10597487	4594	4612	18	RIGHT	A442.EDF	A44	2
28	10597531	10597531	4656	4656	0	RIGHT	A442.EDF	A44	2
28	10597556	10597575	4681	4700	19	RIGHT	A442.EDF	A44	2
28	10597617	10597640	4742	4765	23	RIGHT	A442.EDF	A44	2
28	10597726	10597726	4851	4851	0	RIGHT	A442.EDF	A44	2
28	10597768	10597769	4893	4894	1	RIGHT	A442.EDF	A44	2
28	10597801	10597807	4926	4932	6	RIGHT	A442.EDF	A44	2
28	10597896	10597896	5021	5021	0	RIGHT	A442.EDF	A44	2
28	10597998	10598313	5123	5438	315	RIGHT	A442.EDF	A44	2
28	10598414	10598424	5539	5549	10	RIGHT	A442.EDF	A44	2
29	10600349	10600425	93	169	76	RIGHT	A442.EDF	A44	2
29	10600459	10600504	203	248	45	RIGHT	A442.EDF	A44	2
29	10600564	10600564	308	308	0	RIGHT	A442.EDF	A44	2
29	10600591	10600605	335	349	14	RIGHT	A442.EDF	A44	2
29	10600637	10600638	381	382	1	RIGHT	A442.EDF	A44	2
29	10600715	10600770	459	514	55	RIGHT	A442.EDF	A44	2
29	10600796	10600806	540	550	10	RIGHT	A442.EDF	A44	2
29	10600851	10600851	595	595	0	RIGHT	A442.EDF	A44	2
29	10600877	10600877	621	621	0	RIGHT	A442.EDF	A44	2
29	10600937	10600938	681	682	1	RIGHT	A442.EDF	A44	2
29	10601075	10601076	819	820	1	RIGHT	A442.EDF	A44	2
29	10601386	10601386	1130	1130	0	RIGHT	A442.EDF	A44	2
29	10601418	10601419	1162	1163	1	RIGHT	A442.EDF	A44	2
29	10601565	10601566	1309	1310	1	RIGHT	A442.EDF	A44	2
29	10601603	10601613	1347	1357	10	RIGHT	A442.EDF	A44	2
29	10601781	10601784	1525	1528	3	RIGHT	A442.EDF	A44	2
29	10601808	10601830	1552	1574	22	RIGHT	A442.EDF	A44	2
29	10601925	10601926	1669	1670	1	RIGHT	A442.EDF	A44	2
29	10601959	10601961	1703	1705	2	RIGHT	A442.EDF	A44	2
29	10601982	10601982	1726	1726	0	RIGHT	A442.EDF	A44	2
29	10602042	10602064	1786	1808	22	RIGHT	A442.EDF	A44	2
29	10602127	10602145	1871	1889	18	RIGHT	A442.EDF	A44	2
29	10602306	10602306	2050	2050	0	RIGHT	A442.EDF	A44	2
29	10602367	10602384	2111	2128	17	RIGHT	A442.EDF	A44	2
29	10602421	10602421	2165	2165	0	RIGHT	A442.EDF	A44	2
29	10602449	10602449	2193	2193	0	RIGHT	A442.EDF	A44	2
29	10602476	10602508	2220	2252	32	RIGHT	A442.EDF	A44	2
29	10602548	10602596	2292	2340	48	RIGHT	A442.EDF	A44	2
29	10602621	10602640	2365	2384	19	RIGHT	A442.EDF	A44	2
29	10602670	10602959	2414	2703	289	RIGHT	A442.EDF	A44	2
29	10602981	10603020	2725	2764	39	RIGHT	A442.EDF	A44	2
29	10603078	10604163	2822	3907	1085	RIGHT	A442.EDF	A44	2
29	10604192	10604217	3936	3961	25	RIGHT	A442.EDF	A44	2
29	10604317	10604317	4061	4061	0	RIGHT	A442.EDF	A44	2
29	10604425	10604430	4169	4174	5	RIGHT	A442.EDF	A44	2
29	10604586	10604588	4330	4332	2	RIGHT	A442.EDF	A44	2
29	10604691	10604692	4435	4436	1	RIGHT	A442.EDF	A44	2
29	10604751	10604765	4495	4509	14	RIGHT	A442.EDF	A44	2
29	10604826	10604836	4570	4580	10	RIGHT	A442.EDF	A44	2
29	10604879	10605162	4623	4906	283	RIGHT	A442.EDF	A44	2
29	10605190	10605234	4934	4978	44	RIGHT	A442.EDF	A44	2
29	10605275	10605277	5019	5021	2	RIGHT	A442.EDF	A44	2
29	10605315	10605340	5059	5084	25	RIGHT	A442.EDF	A44	2
29	10605364	10605381	5108	5125	17	RIGHT	A442.EDF	A44	2
29	10605404	10605405	5148	5149	1	RIGHT	A442.EDF	A44	2
29	10605440	10605441	5184	5185	1	RIGHT	A442.EDF	A44	2
29	10605467	10605477	5211	5221	10	RIGHT	A442.EDF	A44	2
29	10605498	10605557	5242	5301	59	RIGHT	A442.EDF	A44	2
29	10605580	10605585	5324	5329	5	RIGHT	A442.EDF	A44	2
29	10605625	10605659	5369	5403	34	RIGHT	A442.EDF	A44	2
29	10605688	10605689	5432	5433	1	RIGHT	A442.EDF	A44	2
29	10605721	10605929	5465	5673	208	RIGHT	A442.EDF	A44	2
29	10605951	10605953	5695	5697	2	RIGHT	A442.EDF	A44	2
29	10605993	10606124	5737	5868	131	RIGHT	A442.EDF	A44	2
30	10609129	10609886	57	814	757	RIGHT	A442.EDF	A44	2
30	10609912	10610263	840	1191	351	RIGHT	A442.EDF	A44	2
30	10610295	10610296	1223	1224	1	RIGHT	A442.EDF	A44	2
30	10610330	10610334	1258	1262	4	RIGHT	A442.EDF	A44	2
30	10610367	10610367	1295	1295	0	RIGHT	A442.EDF	A44	2
30	10610393	10610397	1321	1325	4	RIGHT	A442.EDF	A44	2
30	10610419	10610435	1347	1363	16	RIGHT	A442.EDF	A44	2
30	10610577	10610577	1505	1505	0	RIGHT	A442.EDF	A44	2
30	10610687	10610689	1615	1617	2	RIGHT	A442.EDF	A44	2
30	10610725	10610730	1653	1658	5	RIGHT	A442.EDF	A44	2
30	10610808	10610808	1736	1736	0	RIGHT	A442.EDF	A44	2
30	10610898	10610921	1826	1849	23	RIGHT	A442.EDF	A44	2
30	10611008	10611050	1936	1978	42	RIGHT	A442.EDF	A44	2
30	10611080	10611080	2008	2008	0	RIGHT	A442.EDF	A44	2
30	10612286	10612760	3214	3688	474	RIGHT	A442.EDF	A44	2
30	10612784	10612784	3712	3712	0	RIGHT	A442.EDF	A44	2
30	10612806	10612808	3734	3736	2	RIGHT	A442.EDF	A44	2
30	10612838	10613100	3766	4028	262	RIGHT	A442.EDF	A44	2
30	10613158	10613169	4086	4097	11	RIGHT	A442.EDF	A44	2
30	10613217	10613217	4145	4145	0	RIGHT	A442.EDF	A44	2
30	10613272	10613304	4200	4232	32	RIGHT	A442.EDF	A44	2
30	10613325	10613325	4253	4253	0	RIGHT	A442.EDF	A44	2
30	10613383	10614016	4311	4944	633	RIGHT	A442.EDF	A44	2
30	10614088	10614088	5016	5016	0	RIGHT	A442.EDF	A44	2
30	10614210	10614259	5138	5187	49	RIGHT	A442.EDF	A44	2
30	10614295	10614295	5223	5223	0	RIGHT	A442.EDF	A44	2
30	10614357	10614520	5285	5448	163	RIGHT	A442.EDF	A44	2
30	10614557	10614565	5485	5493	8	RIGHT	A442.EDF	A44	2
30	10614589	10615435	5517	6363	846	RIGHT	A442.EDF	A44	2
30	10615478	10615498	6406	6426	20	RIGHT	A442.EDF	A44	2
30	10615636	10615636	6564	6564	0	RIGHT	A442.EDF	A44	2
30	10615832	10615832	6760	6760	0	RIGHT	A442.EDF	A44	2
30	10615953	10616421	6881	7349	468	RIGHT	A442.EDF	A44	2
31	10618636	10619045	100	509	409	RIGHT	A442.EDF	A44	2
31	10619072	10619073	536	537	1	RIGHT	A442.EDF	A44	2
31	10619101	10619129	565	593	28	RIGHT	A442.EDF	A44	2
31	10619151	10619174	615	638	23	RIGHT	A442.EDF	A44	2
31	10619228	10619557	692	1021	329	RIGHT	A442.EDF	A44	2
31	10619610	10619616	1074	1080	6	RIGHT	A442.EDF	A44	2
31	10619653	10619653	1117	1117	0	RIGHT	A442.EDF	A44	2
31	10619728	10619747	1192	1211	19	RIGHT	A442.EDF	A44	2
31	10619807	10619807	1271	1271	0	RIGHT	A442.EDF	A44	2
31	10619875	10619882	1339	1346	7	RIGHT	A442.EDF	A44	2
31	10619907	10619957	1371	1421	50	RIGHT	A442.EDF	A44	2
31	10619982	10619982	1446	1446	0	RIGHT	A442.EDF	A44	2
31	10620006	10620033	1470	1497	27	RIGHT	A442.EDF	A44	2
31	10620061	10620073	1525	1537	12	RIGHT	A442.EDF	A44	2
31	10620192	10620193	1656	1657	1	RIGHT	A442.EDF	A44	2
31	10620289	10620326	1753	1790	37	RIGHT	A442.EDF	A44	2
31	10620355	10620372	1819	1836	17	RIGHT	A442.EDF	A44	2
31	10620428	10620429	1892	1893	1	RIGHT	A442.EDF	A44	2
31	10620452	10620467	1916	1931	15	RIGHT	A442.EDF	A44	2
31	10620490	10620548	1954	2012	58	RIGHT	A442.EDF	A44	2
31	10620580	10620690	2044	2154	110	RIGHT	A442.EDF	A44	2
31	10620727	10620764	2191	2228	37	RIGHT	A442.EDF	A44	2
31	10620785	10620979	2249	2443	194	RIGHT	A442.EDF	A44	2
31	10621000	10621240	2464	2704	240	RIGHT	A442.EDF	A44	2
31	10621302	10621304	2766	2768	2	RIGHT	A442.EDF	A44	2
31	10621332	10621332	2796	2796	0	RIGHT	A442.EDF	A44	2
31	10621371	10621371	2835	2835	0	RIGHT	A442.EDF	A44	2
31	10621412	10621756	2876	3220	344	RIGHT	A442.EDF	A44	2
31	10621777	10621854	3241	3318	77	RIGHT	A442.EDF	A44	2
31	10621902	10621995	3366	3459	93	RIGHT	A442.EDF	A44	2
31	10622046	10622076	3510	3540	30	RIGHT	A442.EDF	A44	2
31	10622113	10622168	3577	3632	55	RIGHT	A442.EDF	A44	2
31	10622232	10622248	3696	3712	16	RIGHT	A442.EDF	A44	2
31	10622288	10622335	3752	3799	47	RIGHT	A442.EDF	A44	2
31	10622363	10622536	3827	4000	173	RIGHT	A442.EDF	A44	2
31	10622558	10622578	4022	4042	20	RIGHT	A442.EDF	A44	2
31	10622603	10622640	4067	4104	37	RIGHT	A442.EDF	A44	2
31	10622663	10622769	4127	4233	106	RIGHT	A442.EDF	A44	2
31	10622793	10622852	4257	4316	59	RIGHT	A442.EDF	A44	2
31	10622917	10622917	4381	4381	0	RIGHT	A442.EDF	A44	2
31	10622938	10622938	4402	4402	0	RIGHT	A442.EDF	A44	2
31	10622970	10623042	4434	4506	72	RIGHT	A442.EDF	A44	2
31	10623079	10623094	4543	4558	15	RIGHT	A442.EDF	A44	2
31	10623120	10623137	4584	4601	17	RIGHT	A442.EDF	A44	2
31	10623160	10623201	4624	4665	41	RIGHT	A442.EDF	A44	2
31	10623227	10623298	4691	4762	71	RIGHT	A442.EDF	A44	2
31	10623340	10623340	4804	4804	0	RIGHT	A442.EDF	A44	2
31	10623361	10623367	4825	4831	6	RIGHT	A442.EDF	A44	2
31	10623389	10623391	4853	4855	2	RIGHT	A442.EDF	A44	2
31	10623440	10623487	4904	4951	47	RIGHT	A442.EDF	A44	2
31	10623522	10623684	4986	5148	162	RIGHT	A442.EDF	A44	2
31	10623721	10623897	5185	5361	176	RIGHT	A442.EDF	A44	2
31	10623920	10623920	5384	5384	0	RIGHT	A442.EDF	A44	2
31	10623949	10623995	5413	5459	46	RIGHT	A442.EDF	A44	2
31	10624018	10624019	5482	5483	1	RIGHT	A442.EDF	A44	2
31	10624054	10624367	5518	5831	313	RIGHT	A442.EDF	A44	2
32	10626244	10627162	58	976	918	RIGHT	A442.EDF	A44	2
32	10627198	10627198	1012	1012	0	RIGHT	A442.EDF	A44	2
32	10627230	10627230	1044	1044	0	RIGHT	A442.EDF	A44	2
32	10627436	10627436	1250	1250	0	RIGHT	A442.EDF	A44	2
32	10627598	10627610	1412	1424	12	RIGHT	A442.EDF	A44	2
32	10627763	10627763	1577	1577	0	RIGHT	A442.EDF	A44	2
32	10627957	10627957	1771	1771	0	RIGHT	A442.EDF	A44	2
32	10627985	10627985	1799	1799	0	RIGHT	A442.EDF	A44	2
32	10628007	10628007	1821	1821	0	RIGHT	A442.EDF	A44	2
32	10628050	10628055	1864	1869	5	RIGHT	A442.EDF	A44	2
32	10628080	10628099	1894	1913	19	RIGHT	A442.EDF	A44	2
32	10628130	10628161	1944	1975	31	RIGHT	A442.EDF	A44	2
32	10628224	10628225	2038	2039	1	RIGHT	A442.EDF	A44	2
32	10628248	10628261	2062	2075	13	RIGHT	A442.EDF	A44	2
32	10628292	10628336	2106	2150	44	RIGHT	A442.EDF	A44	2
32	10628377	10628377	2191	2191	0	RIGHT	A442.EDF	A44	2
32	10628468	10628487	2282	2301	19	RIGHT	A442.EDF	A44	2
32	10628539	10628573	2353	2387	34	RIGHT	A442.EDF	A44	2
32	10628609	10628624	2423	2438	15	RIGHT	A442.EDF	A44	2
32	10628651	10628684	2465	2498	33	RIGHT	A442.EDF	A44	2
32	10628707	10628716	2521	2530	9	RIGHT	A442.EDF	A44	2
32	10628741	10628743	2555	2557	2	RIGHT	A442.EDF	A44	2
32	10628788	10628984	2602	2798	196	RIGHT	A442.EDF	A44	2
32	10629016	10629017	2830	2831	1	RIGHT	A442.EDF	A44	2
32	10629067	10629067	2881	2881	0	RIGHT	A442.EDF	A44	2
32	10629216	10629216	3030	3030	0	RIGHT	A442.EDF	A44	2
32	10629315	10629320	3129	3134	5	RIGHT	A442.EDF	A44	2
32	10629362	10629362	3176	3176	0	RIGHT	A442.EDF	A44	2
32	10629414	10629414	3228	3228	0	RIGHT	A442.EDF	A44	2
32	10629458	10629547	3272	3361	89	RIGHT	A442.EDF	A44	2
32	10629568	10629602	3382	3416	34	RIGHT	A442.EDF	A44	2
32	10629641	10630025	3455	3839	384	RIGHT	A442.EDF	A44	2
32	10630056	10630169	3870	3983	113	RIGHT	A442.EDF	A44	2
32	10630191	10630490	4005	4304	299	RIGHT	A442.EDF	A44	2
32	10630512	10630646	4326	4460	134	RIGHT	A442.EDF	A44	2
32	10630680	10630897	4494	4711	217	RIGHT	A442.EDF	A44	2
32	10630926	10630990	4740	4804	64	RIGHT	A442.EDF	A44	2
33	10633108	10633961	58	911	853	RIGHT	A442.EDF	A44	2
33	10633984	10633985	934	935	1	RIGHT	A442.EDF	A44	2
33	10634018	10634018	968	968	0	RIGHT	A442.EDF	A44	2
33	10634051	10634089	1001	1039	38	RIGHT	A442.EDF	A44	2
33	10634116	10634143	1066	1093	27	RIGHT	A442.EDF	A44	2
33	10634170	10634189	1120	1139	19	RIGHT	A442.EDF	A44	2
33	10634261	10634294	1211	1244	33	RIGHT	A442.EDF	A44	2
33	10634330	10634332	1280	1282	2	RIGHT	A442.EDF	A44	2
33	10634388	10634419	1338	1369	31	RIGHT	A442.EDF	A44	2
33	10634452	10634462	1402	1412	10	RIGHT	A442.EDF	A44	2
33	10634506	10634508	1456	1458	2	RIGHT	A442.EDF	A44	2
33	10634535	10634566	1485	1516	31	RIGHT	A442.EDF	A44	2
33	10634587	10634619	1537	1569	32	RIGHT	A442.EDF	A44	2
33	10634642	10634648	1592	1598	6	RIGHT	A442.EDF	A44	2
33	10634677	10634677	1627	1627	0	RIGHT	A442.EDF	A44	2
33	10634747	10634747	1697	1697	0	RIGHT	A442.EDF	A44	2
33	10634768	10634768	1718	1718	0	RIGHT	A442.EDF	A44	2
33	10634820	10634822	1770	1772	2	RIGHT	A442.EDF	A44	2
33	10634872	10634888	1822	1838	16	RIGHT	A442.EDF	A44	2
33	10634919	10634942	1869	1892	23	RIGHT	A442.EDF	A44	2
33	10634987	10634987	1937	1937	0	RIGHT	A442.EDF	A44	2
33	10635015	10635015	1965	1965	0	RIGHT	A442.EDF	A44	2
33	10635039	10635433	1989	2383	394	RIGHT	A442.EDF	A44	2
33	10635494	10635494	2444	2444	0	RIGHT	A442.EDF	A44	2
33	10635583	10635584	2533	2534	1	RIGHT	A442.EDF	A44	2
33	10635620	10635620	2570	2570	0	RIGHT	A442.EDF	A44	2
33	10635764	10636069	2714	3019	305	RIGHT	A442.EDF	A44	2
33	10636092	10636100	3042	3050	8	RIGHT	A442.EDF	A44	2
33	10636127	10636314	3077	3264	187	RIGHT	A442.EDF	A44	2
33	10636336	10636552	3286	3502	216	RIGHT	A442.EDF	A44	2
33	10636573	10637540	3523	4490	967	RIGHT	A442.EDF	A44	2
33	10637567	10637823	4517	4773	256	RIGHT	A442.EDF	A44	2
33	10637846	10637874	4796	4824	28	RIGHT	A442.EDF	A44	2
33	10637916	10637988	4866	4938	72	RIGHT	A442.EDF	A44	2
33	10638022	10638023	4972	4973	1	RIGHT	A442.EDF	A44	2
33	10638049	10638159	4999	5109	110	RIGHT	A442.EDF	A44	2
33	10638188	10638234	5138	5184	46	RIGHT	A442.EDF	A44	2
33	10638258	10638289	5208	5239	31	RIGHT	A442.EDF	A44	2
33	10638311	10638313	5261	5263	2	RIGHT	A442.EDF	A44	2
33	10638334	10638374	5284	5324	40	RIGHT	A442.EDF	A44	2
33	10638404	10638474	5354	5424	70	RIGHT	A442.EDF	A44	2
34	10640404	10640429	57	82	25	RIGHT	A442.EDF	A44	2
34	10640451	10640458	104	111	7	RIGHT	A442.EDF	A44	2
34	10640479	10640844	132	497	365	RIGHT	A442.EDF	A44	2
34	10640888	10640891	541	544	3	RIGHT	A442.EDF	A44	2
34	10640918	10643468	571	3121	2550	RIGHT	A442.EDF	A44	2
34	10643498	10643498	3151	3151	0	RIGHT	A442.EDF	A44	2
34	10643537	10643537	3190	3190	0	RIGHT	A442.EDF	A44	2
34	10643559	10643559	3212	3212	0	RIGHT	A442.EDF	A44	2
34	10643634	10643665	3287	3318	31	RIGHT	A442.EDF	A44	2
34	10643695	10643726	3348	3379	31	RIGHT	A442.EDF	A44	2
34	10643762	10644580	3415	4233	818	RIGHT	A442.EDF	A44	2
34	10644607	10644805	4260	4458	198	RIGHT	A442.EDF	A44	2
34	10644833	10644846	4486	4499	13	RIGHT	A442.EDF	A44	2
34	10644873	10644874	4526	4527	1	RIGHT	A442.EDF	A44	2
34	10644898	10644931	4551	4584	33	RIGHT	A442.EDF	A44	2
34	10644962	10644962	4615	4615	0	RIGHT	A442.EDF	A44	2
34	10645028	10645034	4681	4687	6	RIGHT	A442.EDF	A44	2
34	10645081	10645087	4734	4740	6	RIGHT	A442.EDF	A44	2
34	10645117	10645117	4770	4770	0	RIGHT	A442.EDF	A44	2
34	10645150	10645231	4803	4884	81	RIGHT	A442.EDF	A44	2
34	10645316	10646727	4969	6380	1411	RIGHT	A442.EDF	A44	2
34	10646752	10646808	6405	6461	56	RIGHT	A442.EDF	A44	2
34	10646831	10646960	6484	6613	129	RIGHT	A442.EDF	A44	2
35	10648863	10650063	66	1266	1200	RIGHT	A442.EDF	A44	2
35	10650089	10650103	1292	1306	14	RIGHT	A442.EDF	A44	2
35	10650187	10650187	1390	1390	0	RIGHT	A442.EDF	A44	2
35	10650247	10650248	1450	1451	1	RIGHT	A442.EDF	A44	2
35	10650289	10650336	1492	1539	47	RIGHT	A442.EDF	A44	2
35	10650362	10650393	1565	1596	31	RIGHT	A442.EDF	A44	2
35	10650417	10650443	1620	1646	26	RIGHT	A442.EDF	A44	2
35	10650464	10650465	1667	1668	1	RIGHT	A442.EDF	A44	2
35	10650496	10650511	1699	1714	15	RIGHT	A442.EDF	A44	2
35	10650533	10650610	1736	1813	77	RIGHT	A442.EDF	A44	2
35	10650631	10650771	1834	1974	140	RIGHT	A442.EDF	A44	2
35	10650827	10650894	2030	2097	67	RIGHT	A442.EDF	A44	2
35	10650915	10650915	2118	2118	0	RIGHT	A442.EDF	A44	2
35	10650960	10650962	2163	2165	2	RIGHT	A442.EDF	A44	2
35	10651028	10651029	2231	2232	1	RIGHT	A442.EDF	A44	2
35	10651064	10651166	2267	2369	102	RIGHT	A442.EDF	A44	2
35	10651202	10651228	2405	2431	26	RIGHT	A442.EDF	A44	2
35	10651274	10651303	2477	2506	29	RIGHT	A442.EDF	A44	2
35	10651326	10651885	2529	3088	559	RIGHT	A442.EDF	A44	2
35	10651907	10651961	3110	3164	54	RIGHT	A442.EDF	A44	2
35	10652015	10652057	3218	3260	42	RIGHT	A442.EDF	A44	2
35	10652088	10652102	3291	3305	14	RIGHT	A442.EDF	A44	2
35	10652129	10652137	3332	3340	8	RIGHT	A442.EDF	A44	2
35	10652178	10652225	3381	3428	47	RIGHT	A442.EDF	A44	2
35	10652248	10652363	3451	3566	115	RIGHT	A442.EDF	A44	2
35	10652390	10652419	3593	3622	29	RIGHT	A442.EDF	A44	2
35	10652443	10652563	3646	3766	120	RIGHT	A442.EDF	A44	2
35	10652595	10652643	3798	3846	48	RIGHT	A442.EDF	A44	2
35	10652665	10652706	3868	3909	41	RIGHT	A442.EDF	A44	2
35	10652728	10652744	3931	3947	16	RIGHT	A442.EDF	A44	2
35	10652781	10652782	3984	3985	1	RIGHT	A442.EDF	A44	2
35	10652832	10652832	4035	4035	0	RIGHT	A442.EDF	A44	2
35	10652870	10652876	4073	4079	6	RIGHT	A442.EDF	A44	2
35	10652924	10652939	4127	4142	15	RIGHT	A442.EDF	A44	2
35	10652995	10652999	4198	4202	4	RIGHT	A442.EDF	A44	2
35	10653071	10653455	4274	4658	384	RIGHT	A442.EDF	A44	2
35	10653477	10654358	4680	5561	881	RIGHT	A442.EDF	A44	2
35	10654379	10654404	5582	5607	25	RIGHT	A442.EDF	A44	2
36	10656997	10657900	75	978	903	RIGHT	A442.EDF	A44	2
36	10657930	10657998	1008	1076	68	RIGHT	A442.EDF	A44	2
36	10658036	10658074	1114	1152	38	RIGHT	A442.EDF	A44	2
36	10658121	10658148	1199	1226	27	RIGHT	A442.EDF	A44	2
36	10658171	10658201	1249	1279	30	RIGHT	A442.EDF	A44	2
36	10658224	10658252	1302	1330	28	RIGHT	A442.EDF	A44	2
36	10658277	10658300	1355	1378	23	RIGHT	A442.EDF	A44	2
36	10658363	10658466	1441	1544	103	RIGHT	A442.EDF	A44	2
36	10658493	10658535	1571	1613	42	RIGHT	A442.EDF	A44	2
36	10658628	10658628	1706	1706	0	RIGHT	A442.EDF	A44	2
36	10658886	10658915	1964	1993	29	RIGHT	A442.EDF	A44	2
36	10658944	10658956	2022	2034	12	RIGHT	A442.EDF	A44	2
36	10658986	10659097	2064	2175	111	RIGHT	A442.EDF	A44	2
36	10659132	10659138	2210	2216	6	RIGHT	A442.EDF	A44	2
36	10659238	10659250	2316	2328	12	RIGHT	A442.EDF	A44	2
36	10659312	10659314	2390	2392	2	RIGHT	A442.EDF	A44	2
36	10659345	10659783	2423	2861	438	RIGHT	A442.EDF	A44	2
36	10659804	10661149	2882	4227	1345	RIGHT	A442.EDF	A44	2
36	10661173	10661536	4251	4614	363	RIGHT	A442.EDF	A44	2
36	10661562	10662510	4640	5588	948	RIGHT	A442.EDF	A44	2
37	10664218	10665260	57	1099	1042	RIGHT	A442.EDF	A44	2
37	10665304	10665349	1143	1188	45	RIGHT	A442.EDF	A44	2
37	10665372	10666848	1211	2687	1476	RIGHT	A442.EDF	A44	2
37	10666877	10669804	2716	5643	2927	RIGHT	A442.EDF	A44	2
38	10671929	10674154	58	2283	2225	RIGHT	A442.EDF	A44	2
38	10674196	10678669	2325	6798	4473	RIGHT	A442.EDF	A44	2
39	10680287	10681710	58	1481	1423	RIGHT	A442.EDF	A44	2
39	10681747	10681747	1518	1518	0	RIGHT	A442.EDF	A44	2
39	10681818	10681842	1589	1613	24	RIGHT	A442.EDF	A44	2
39	10681902	10681922	1673	1693	20	RIGHT	A442.EDF	A44	2
39	10681944	10683333	1715	3104	1389	RIGHT	A442.EDF	A44	2
39	10683358	10683463	3129	3234	105	RIGHT	A442.EDF	A44	2
39	10683512	10685123	3283	4894	1611	RIGHT	A442.EDF	A44	2
40	10686717	10686717	93	93	0	RIGHT	A442.EDF	A44	2
40	10686741	10686759	117	135	18	RIGHT	A442.EDF	A44	2
40	10686785	10686802	161	178	17	RIGHT	A442.EDF	A44	2
40	10686823	10688814	199	2190	1991	RIGHT	A442.EDF	A44	2
40	10689087	10689112	2463	2488	25	RIGHT	A442.EDF	A44	2
40	10689217	10690109	2593	3485	892	RIGHT	A442.EDF	A44	2
40	10690143	10691567	3519	4943	1424	RIGHT	A442.EDF	A44	2
41	10694186	10696172	69	2055	1986	RIGHT	A442.EDF	A44	2
41	10696204	10696218	2087	2101	14	RIGHT	A442.EDF	A44	2
41	10696651	10696651	2534	2534	0	RIGHT	A442.EDF	A44	2
41	10696758	10696802	2641	2685	44	RIGHT	A442.EDF	A44	2
41	10696825	10700332	2708	6215	3507	RIGHT	A442.EDF	A44	2
42	10701841	10704012	57	2228	2171	RIGHT	A442.EDF	A44	2
42	10704033	10704033	2249	2249	0	RIGHT	A442.EDF	A44	2
42	10704070	10704070	2286	2286	0	RIGHT	A442.EDF	A44	2
42	10704170	10704197	2386	2413	27	RIGHT	A442.EDF	A44	2
42	10704225	10704228	2441	2444	3	RIGHT	A442.EDF	A44	2
42	10704255	10704330	2471	2546	75	RIGHT	A442.EDF	A44	2
42	10704365	10704365	2581	2581	0	RIGHT	A442.EDF	A44	2
42	10704390	10708678	2606	6894	4288	RIGHT	A442.EDF	A44	2
43	10710866	10711291	58	483	425	RIGHT	A442.EDF	A44	2
43	10711317	10711324	509	516	7	RIGHT	A442.EDF	A44	2
43	10711358	10711359	550	551	1	RIGHT	A442.EDF	A44	2
43	10711386	10712967	578	2159	1581	RIGHT	A442.EDF	A44	2
43	10713020	10713021	2212	2213	1	RIGHT	A442.EDF	A44	2
43	10713093	10713110	2285	2302	17	RIGHT	A442.EDF	A44	2
43	10713144	10713144	2336	2336	0	RIGHT	A442.EDF	A44	2
43	10713177	10713193	2369	2385	16	RIGHT	A442.EDF	A44	2
43	10713215	10713221	2407	2413	6	RIGHT	A442.EDF	A44	2
43	10713251	10713255	2443	2447	4	RIGHT	A442.EDF	A44	2
43	10713312	10713325	2504	2517	13	RIGHT	A442.EDF	A44	2
43	10713346	10713352	2538	2544	6	RIGHT	A442.EDF	A44	2
43	10713377	10713377	2569	2569	0	RIGHT	A442.EDF	A44	2
43	10713398	10713416	2590	2608	18	RIGHT	A442.EDF	A44	2
43	10713441	10713441	2633	2633	0	RIGHT	A442.EDF	A44	2
43	10713474	10713512	2666	2704	38	RIGHT	A442.EDF	A44	2
43	10713534	10713955	2726	3147	421	RIGHT	A442.EDF	A44	2
43	10713980	10714022	3172	3214	42	RIGHT	A442.EDF	A44	2
43	10714086	10714090	3278	3282	4	RIGHT	A442.EDF	A44	2
43	10714143	10714143	3335	3335	0	RIGHT	A442.EDF	A44	2
43	10714182	10714182	3374	3374	0	RIGHT	A442.EDF	A44	2
43	10714325	10714342	3517	3534	17	RIGHT	A442.EDF	A44	2
43	10714370	10714370	3562	3562	0	RIGHT	A442.EDF	A44	2
43	10714407	10714407	3599	3599	0	RIGHT	A442.EDF	A44	2
43	10714452	10714452	3644	3644	0	RIGHT	A442.EDF	A44	2
43	10714526	10714526	3718	3718	0	RIGHT	A442.EDF	A44	2
43	10714606	10714606	3798	3798	0	RIGHT	A442.EDF	A44	2
43	10714627	10714628	3819	3820	1	RIGHT	A442.EDF	A44	2
43	10714748	10714774	3940	3966	26	RIGHT	A442.EDF	A44	2
43	10714875	10714894	4067	4086	19	RIGHT	A442.EDF	A44	2
43	10714962	10715769	4154	4961	807	RIGHT	A442.EDF	A44	2
43	10715790	10715868	4982	5060	78	RIGHT	A442.EDF	A44	2
43	10715889	10715913	5081	5105	24	RIGHT	A442.EDF	A44	2
43	10715948	10716021	5140	5213	73	RIGHT	A442.EDF	A44	2
43	10716057	10716076	5249	5268	19	RIGHT	A442.EDF	A44	2
43	10716100	10716190	5292	5382	90	RIGHT	A442.EDF	A44	2
43	10716218	10716232	5410	5424	14	RIGHT	A442.EDF	A44	2
43	10716253	10716268	5445	5460	15	RIGHT	A442.EDF	A44	2
43	10716318	10716328	5510	5520	10	RIGHT	A442.EDF	A44	2
43	10716391	10716393	5583	5585	2	RIGHT	A442.EDF	A44	2
43	10716427	10716438	5619	5630	11	RIGHT	A442.EDF	A44	2
43	10716498	10716526	5690	5718	28	RIGHT	A442.EDF	A44	2
43	10716549	10716743	5741	5935	194	RIGHT	A442.EDF	A44	2
44	10718542	10725038	57	6553	6496	RIGHT	A442.EDF	A44	2
45	10726846	10728021	58	1233	1175	RIGHT	A442.EDF	A44	2
45	10728046	10728066	1258	1278	20	RIGHT	A442.EDF	A44	2
45	10728087	10728999	1299	2211	912	RIGHT	A442.EDF	A44	2
45	10729026	10729026	2238	2238	0	RIGHT	A442.EDF	A44	2
45	10729063	10729101	2275	2313	38	RIGHT	A442.EDF	A44	2
45	10729129	10732262	2341	5474	3133	RIGHT	A442.EDF	A44	2
46	10734542	10739837	57	5352	5295	RIGHT	A442.EDF	A44	2
47	10741722	10744228	57	2563	2506	RIGHT	A442.EDF	A44	2
47	10744250	10744265	2585	2600	15	RIGHT	A442.EDF	A44	2
47	10744303	10748222	2638	6557	3919	RIGHT	A442.EDF	A44	2
48	10750131	10755136	58	5063	5005	RIGHT	A442.EDF	A44	2
49	10757583	10763882	58	6357	6299	RIGHT	A442.EDF	A44	2
50	10765840	10772617	57	6834	6777	RIGHT	A442.EDF	A44	2
51	10774556	10775002	58	504	446	RIGHT	A442.EDF	A44	2
51	10775134	10775151	636	653	17	RIGHT	A442.EDF	A44	2
51	10775279	10777872	781	3374	2593	RIGHT	A442.EDF	A44	2
51	10777912	10777929	3414	3431	17	RIGHT	A442.EDF	A44	2
51	10777953	10777953	3455	3455	0	RIGHT	A442.EDF	A44	2
51	10777998	10778379	3500	3881	381	RIGHT	A442.EDF	A44	2
51	10778401	10778405	3903	3907	4	RIGHT	A442.EDF	A44	2
51	10778434	10778437	3936	3939	3	RIGHT	A442.EDF	A44	2
51	10778469	10778469	3971	3971	0	RIGHT	A442.EDF	A44	2
51	10778528	10778729	4030	4231	201	RIGHT	A442.EDF	A44	2
51	10778772	10779921	4274	5423	1149	RIGHT	A442.EDF	A44	2
51	10779960	10781212	5462	6714	1252	RIGHT	A442.EDF	A44	2
52	10783272	10789658	57	6443	6386	RIGHT	A442.EDF	A44	2
53	10791346	10791346	98	98	0	RIGHT	A442.EDF	A44	2
53	10791411	10791412	163	164	1	RIGHT	A442.EDF	A44	2
53	10791832	10797532	584	6284	5700	RIGHT	A442.EDF	A44	2
54	10798940	10805177	58	6295	6237	RIGHT	A442.EDF	A44	2
55	10806702	10807011	75	384	309	RIGHT	A442.EDF	A44	2
55	10807035	10813092	408	6465	6057	RIGHT	A442.EDF	A44	2
56	10814672	10817065	58	2451	2393	RIGHT	A442.EDF	A44	2
56	10817089	10817152	2475	2538	63	RIGHT	A442.EDF	A44	2
56	10817198	10817230	2584	2616	32	RIGHT	A442.EDF	A44	2
56	10817265	10821267	2651	6653	4002	RIGHT	A442.EDF	A44	2
57	10822935	10827581	57	4703	4646	RIGHT	A442.EDF	A44	2
58	10829399	10835446	57	6104	6047	RIGHT	A442.EDF	A44	2
59	10837481	10842331	57	4907	4850	RIGHT	A442.EDF	A44	2
60	10843738	10846160	57	2479	2422	RIGHT	A442.EDF	A44	2
60	10846184	10846196	2503	2515	12	RIGHT	A442.EDF	A44	2
60	10846241	10846241	2560	2560	0	RIGHT	A442.EDF	A44	2
60	10846267	10846314	2586	2633	47	RIGHT	A442.EDF	A44	2
60	10846350	10846352	2669	2671	2	RIGHT	A442.EDF	A44	2
60	10846441	10846443	2760	2762	2	RIGHT	A442.EDF	A44	2
60	10846501	10850615	2820	6934	4114	RIGHT	A442.EDF	A44	2
61	10852193	10852962	77	846	769	RIGHT	A442.EDF	A44	2
61	10852999	10853023	883	907	24	RIGHT	A442.EDF	A44	2
61	10853046	10855625	930	3509	2579	RIGHT	A442.EDF	A44	2
61	10855663	10855977	3547	3861	314	RIGHT	A442.EDF	A44	2
61	10856002	10858350	3886	6234	2348	RIGHT	A442.EDF	A44	2
61	10858376	10858930	6260	6814	554	RIGHT	A442.EDF	A44	2
62	10861116	10861543	58	485	427	RIGHT	A442.EDF	A44	2
62	10861572	10861573	514	515	1	RIGHT	A442.EDF	A44	2
62	10861620	10861624	562	566	4	RIGHT	A442.EDF	A44	2
62	10861703	10861747	645	689	44	RIGHT	A442.EDF	A44	2
62	10861770	10861770	712	712	0	RIGHT	A442.EDF	A44	2
62	10861810	10862129	752	1071	319	RIGHT	A442.EDF	A44	2
62	10862179	10862179	1121	1121	0	RIGHT	A442.EDF	A44	2
62	10862235	10862312	1177	1254	77	RIGHT	A442.EDF	A44	2
62	10862367	10862408	1309	1350	41	RIGHT	A442.EDF	A44	2
62	10862449	10862486	1391	1428	37	RIGHT	A442.EDF	A44	2
62	10862544	10862596	1486	1538	52	RIGHT	A442.EDF	A44	2
62	10862634	10862636	1576	1578	2	RIGHT	A442.EDF	A44	2
62	10862669	10862679	1611	1621	10	RIGHT	A442.EDF	A44	2
62	10862712	10862740	1654	1682	28	RIGHT	A442.EDF	A44	2
62	10862777	10862785	1719	1727	8	RIGHT	A442.EDF	A44	2
62	10862809	10862915	1751	1857	106	RIGHT	A442.EDF	A44	2
62	10862948	10862948	1890	1890	0	RIGHT	A442.EDF	A44	2
62	10862990	10862995	1932	1937	5	RIGHT	A442.EDF	A44	2
62	10863019	10863484	1961	2426	465	RIGHT	A442.EDF	A44	2
62	10863505	10864011	2447	2953	506	RIGHT	A442.EDF	A44	2
62	10864053	10864054	2995	2996	1	RIGHT	A442.EDF	A44	2
62	10864113	10864123	3055	3065	10	RIGHT	A442.EDF	A44	2
62	10864247	10864434	3189	3376	187	RIGHT	A442.EDF	A44	2
62	10864458	10864527	3400	3469	69	RIGHT	A442.EDF	A44	2
62	10864552	10865014	3494	3956	462	RIGHT	A442.EDF	A44	2
62	10865037	10865074	3979	4016	37	RIGHT	A442.EDF	A44	2
62	10865142	10865142	4084	4084	0	RIGHT	A442.EDF	A44	2
62	10865167	10865167	4109	4109	0	RIGHT	A442.EDF	A44	2
62	10865188	10865189	4130	4131	1	RIGHT	A442.EDF	A44	2
62	10865211	10866047	4153	4989	836	RIGHT	A442.EDF	A44	2
62	10866098	10866141	5040	5083	43	RIGHT	A442.EDF	A44	2
62	10866170	10866190	5112	5132	20	RIGHT	A442.EDF	A44	2
62	10866212	10866446	5154	5388	234	RIGHT	A442.EDF	A44	2
62	10866475	10866595	5417	5537	120	RIGHT	A442.EDF	A44	2
63	10869445	10869494	57	106	49	RIGHT	A442.EDF	A44	2
63	10869519	10869520	131	132	1	RIGHT	A442.EDF	A44	2
63	10869555	10876671	167	7283	7116	RIGHT	A442.EDF	A44	2
64	10878165	10878194	77	106	29	RIGHT	A442.EDF	A44	2
64	10878222	10878231	134	143	9	RIGHT	A442.EDF	A44	2
64	10878266	10879141	178	1053	875	RIGHT	A442.EDF	A44	2
64	10879180	10879751	1092	1663	571	RIGHT	A442.EDF	A44	2
64	10879772	10884746	1684	6658	4974	RIGHT	A442.EDF	A44	2
65	10886644	10892271	57	5684	5627	RIGHT	A442.EDF	A44	2
66	10893741	10900096	60	6415	6355	RIGHT	A442.EDF	A44	2
67	10902164	10909321	58	7215	7157	RIGHT	A442.EDF	A44	2
68	10911372	10912538	449	1615	1166	RIGHT	A442.EDF	A44	2
68	10912658	10916496	1735	5573	3838	RIGHT	A442.EDF	A44	2
69	10918210	10923260	58	5108	5050	RIGHT	A442.EDF	A44	2
70	10925624	10925643	84	103	19	RIGHT	A442.EDF	A44	2
70	10925691	10932555	151	7015	6864	RIGHT	A442.EDF	A44	2
71	10934562	10941201	57	6696	6639	RIGHT	A442.EDF	A44	2
72	10943801	10949516	58	5773	5715	RIGHT	A442.EDF	A44	2
73	10952005	10957081	58	5134	5076	RIGHT	A442.EDF	A44	2
74	10959288	10959400	58	170	112	RIGHT	A442.EDF	A44	2
74	10959423	10959509	193	279	86	RIGHT	A442.EDF	A44	2
74	10959533	10959632	303	402	99	RIGHT	A442.EDF	A44	2
74	10959672	10959689	442	459	17	RIGHT	A442.EDF	A44	2
74	10959714	10959714	484	484	0	RIGHT	A442.EDF	A44	2
74	10959742	10964785	512	5555	5043	RIGHT	A442.EDF	A44	2
75	10966883	10972350	57	5524	5467	RIGHT	A442.EDF	A44	2
76	10974025	10980375	58	6408	6350	RIGHT	A442.EDF	A44	2
77	10982825	10983044	57	276	219	RIGHT	A442.EDF	A44	2
77	10983089	10983089	321	321	0	RIGHT	A442.EDF	A44	2
77	10983112	10983143	344	375	31	RIGHT	A442.EDF	A44	2
77	10983217	10983219	449	451	2	RIGHT	A442.EDF	A44	2
77	10983249	10988610	481	5842	5361	RIGHT	A442.EDF	A44	2
78	10990859	10996725	58	5924	5866	RIGHT	A442.EDF	A44	2
79	10998424	11004860	57	6493	6436	RIGHT	A442.EDF	A44	2
80	11007207	11013515	58	6366	6308	RIGHT	A442.EDF	A44	2
81	11015495	11018721	57	3283	3226	RIGHT	A442.EDF	A44	2
81	11018916	11019589	3478	4151	673	RIGHT	A442.EDF	A44	2
81	11019614	11019614	4176	4176	0	RIGHT	A442.EDF	A44	2
81	11019644	11019656	4206	4218	12	RIGHT	A442.EDF	A44	2
81	11019704	11019704	4266	4266	0	RIGHT	A442.EDF	A44	2
81	11019794	11019821	4356	4383	27	RIGHT	A442.EDF	A44	2
81	11019896	11019924	4458	4486	28	RIGHT	A442.EDF	A44	2
81	11019947	11019953	4509	4515	6	RIGHT	A442.EDF	A44	2
81	11019981	11021110	4543	5672	1129	RIGHT	A442.EDF	A44	2
82	11022549	11022653	57	161	104	RIGHT	A442.EDF	A44	2
82	11022677	11023276	185	784	599	RIGHT	A442.EDF	A44	2
82	11023326	11023377	834	885	51	RIGHT	A442.EDF	A44	2
82	11023409	11023443	917	951	34	RIGHT	A442.EDF	A44	2
82	11023475	11023477	983	985	2	RIGHT	A442.EDF	A44	2
82	11023502	11023512	1010	1020	10	RIGHT	A442.EDF	A44	2
82	11023566	11023580	1074	1088	14	RIGHT	A442.EDF	A44	2
82	11023622	11023639	1130	1147	17	RIGHT	A442.EDF	A44	2
82	11023662	11023663	1170	1171	1	RIGHT	A442.EDF	A44	2
82	11023692	11023714	1200	1222	22	RIGHT	A442.EDF	A44	2
82	11023741	11023747	1249	1255	6	RIGHT	A442.EDF	A44	2
82	11023772	11023907	1280	1415	135	RIGHT	A442.EDF	A44	2
82	11023940	11024286	1448	1794	346	RIGHT	A442.EDF	A44	2
82	11024318	11024816	1826	2324	498	RIGHT	A442.EDF	A44	2
82	11024847	11027714	2355	5222	2867	RIGHT	A442.EDF	A44	2
83	11029563	11029564	89	90	1	RIGHT	A442.EDF	A44	2
83	11029630	11030062	156	588	432	RIGHT	A442.EDF	A44	2
83	11030093	11030220	619	746	127	RIGHT	A442.EDF	A44	2
83	11030244	11030250	770	776	6	RIGHT	A442.EDF	A44	2
83	11030291	11030291	817	817	0	RIGHT	A442.EDF	A44	2
83	11030351	11030352	877	878	1	RIGHT	A442.EDF	A44	2
83	11030382	11030382	908	908	0	RIGHT	A442.EDF	A44	2
83	11030449	11030449	975	975	0	RIGHT	A442.EDF	A44	2
83	11030474	11030474	1000	1000	0	RIGHT	A442.EDF	A44	2
83	11030500	11030500	1026	1026	0	RIGHT	A442.EDF	A44	2
83	11030544	11030625	1070	1151	81	RIGHT	A442.EDF	A44	2
83	11030647	11030662	1173	1188	15	RIGHT	A442.EDF	A44	2
83	11030690	11031375	1216	1901	685	RIGHT	A442.EDF	A44	2
83	11031404	11031857	1930	2383	453	RIGHT	A442.EDF	A44	2
83	11032119	11032160	2645	2686	41	RIGHT	A442.EDF	A44	2
83	11032186	11032238	2712	2764	52	RIGHT	A442.EDF	A44	2
83	11032274	11032279	2800	2805	5	RIGHT	A442.EDF	A44	2
83	11032302	11032665	2828	3191	363	RIGHT	A442.EDF	A44	2
83	11032687	11032707	3213	3233	20	RIGHT	A442.EDF	A44	2
83	11032729	11032735	3255	3261	6	RIGHT	A442.EDF	A44	2
83	11032797	11033133	3323	3659	336	RIGHT	A442.EDF	A44	2
83	11033157	11033171	3683	3697	14	RIGHT	A442.EDF	A44	2
83	11033231	11033231	3757	3757	0	RIGHT	A442.EDF	A44	2
83	11033256	11033343	3782	3869	87	RIGHT	A442.EDF	A44	2
83	11033374	11033430	3900	3956	56	RIGHT	A442.EDF	A44	2
83	11033462	11033573	3988	4099	111	RIGHT	A442.EDF	A44	2
83	11033603	11033631	4129	4157	28	RIGHT	A442.EDF	A44	2
83	11033680	11033709	4206	4235	29	RIGHT	A442.EDF	A44	2
83	11033740	11033742	4266	4268	2	RIGHT	A442.EDF	A44	2
83	11033811	11033811	4337	4337	0	RIGHT	A442.EDF	A44	2
83	11033850	11033850	4376	4376	0	RIGHT	A442.EDF	A44	2
83	11033873	11033873	4399	4399	0	RIGHT	A442.EDF	A44	2
83	11033895	11033963	4421	4489	68	RIGHT	A442.EDF	A44	2
83	11034032	11034032	4558	4558	0	RIGHT	A442.EDF	A44	2
83	11034091	11034107	4617	4633	16	RIGHT	A442.EDF	A44	2
83	11034132	11034135	4658	4661	3	RIGHT	A442.EDF	A44	2
83	11034215	11034215	4741	4741	0	RIGHT	A442.EDF	A44	2
83	11034240	11034240	4766	4766	0	RIGHT	A442.EDF	A44	2
83	11034266	11034266	4792	4792	0	RIGHT	A442.EDF	A44	2
83	11034288	11034288	4814	4814	0	RIGHT	A442.EDF	A44	2
83	11034331	11034350	4857	4876	19	RIGHT	A442.EDF	A44	2
83	11034381	11034501	4907	5027	120	RIGHT	A442.EDF	A44	2
83	11034528	11034556	5054	5082	28	RIGHT	A442.EDF	A44	2
83	11034581	11034623	5107	5149	42	RIGHT	A442.EDF	A44	2
83	11034654	11034654	5180	5180	0	RIGHT	A442.EDF	A44	2
83	11034681	11034725	5207	5251	44	RIGHT	A442.EDF	A44	2
83	11034747	11034857	5273	5383	110	RIGHT	A442.EDF	A44	2
83	11034886	11035117	5412	5643	231	RIGHT	A442.EDF	A44	2
83	11035145	11035248	5671	5774	103	RIGHT	A442.EDF	A44	2
83	11035297	11035310	5823	5836	13	RIGHT	A442.EDF	A44	2
83	11035372	11035536	5898	6062	164	RIGHT	A442.EDF	A44	2
83	11035558	11035755	6084	6281	197	RIGHT	A442.EDF	A44	2
83	11035780	11035968	6306	6494	188	RIGHT	A442.EDF	A44	2
83	11036001	11036680	6527	7206	679	RIGHT	A442.EDF	A44	2
84	11038376	11038656	75	355	280	RIGHT	A442.EDF	A44	2
84	11038683	11038687	382	386	4	RIGHT	A442.EDF	A44	2
84	11038743	11038743	442	442	0	RIGHT	A442.EDF	A44	2
84	11038895	11038897	594	596	2	RIGHT	A442.EDF	A44	2
84	11039112	11039112	811	811	0	RIGHT	A442.EDF	A44	2
84	11039135	11039135	834	834	0	RIGHT	A442.EDF	A44	2
84	11039275	11039276	974	975	1	RIGHT	A442.EDF	A44	2
84	11039383	11039383	1082	1082	0	RIGHT	A442.EDF	A44	2
84	11039443	11039443	1142	1142	0	RIGHT	A442.EDF	A44	2
84	11039464	11039737	1163	1436	273	RIGHT	A442.EDF	A44	2
84	11039781	11039781	1480	1480	0	RIGHT	A442.EDF	A44	2
84	11039854	11039854	1553	1553	0	RIGHT	A442.EDF	A44	2
84	11039899	11039939	1598	1638	40	RIGHT	A442.EDF	A44	2
84	11039973	11039985	1672	1684	12	RIGHT	A442.EDF	A44	2
84	11040153	11040153	1852	1852	0	RIGHT	A442.EDF	A44	2
84	11040224	11040539	1923	2238	315	RIGHT	A442.EDF	A44	2
84	11040584	11040593	2283	2292	9	RIGHT	A442.EDF	A44	2
84	11040622	11040622	2321	2321	0	RIGHT	A442.EDF	A44	2
84	11040656	11040703	2355	2402	47	RIGHT	A442.EDF	A44	2
84	11040734	11040744	2433	2443	10	RIGHT	A442.EDF	A44	2
84	11040772	11040773	2471	2472	1	RIGHT	A442.EDF	A44	2
84	11040794	11041431	2493	3130	637	RIGHT	A442.EDF	A44	2
84	11041459	11041469	3158	3168	10	RIGHT	A442.EDF	A44	2
84	11041507	11041842	3206	3541	335	RIGHT	A442.EDF	A44	2
84	11041873	11041894	3572	3593	21	RIGHT	A442.EDF	A44	2
84	11041917	11041972	3616	3671	55	RIGHT	A442.EDF	A44	2
84	11041997	11041998	3696	3697	1	RIGHT	A442.EDF	A44	2
84	11042021	11042155	3720	3854	134	RIGHT	A442.EDF	A44	2
84	11042185	11042208	3884	3907	23	RIGHT	A442.EDF	A44	2
84	11042229	11042230	3928	3929	1	RIGHT	A442.EDF	A44	2
84	11042277	11042300	3976	3999	23	RIGHT	A442.EDF	A44	2
84	11042322	11042340	4021	4039	18	RIGHT	A442.EDF	A44	2
84	11042361	11042392	4060	4091	31	RIGHT	A442.EDF	A44	2
84	11042430	11042440	4129	4139	10	RIGHT	A442.EDF	A44	2
84	11042463	11042476	4162	4175	13	RIGHT	A442.EDF	A44	2
84	11042498	11042500	4197	4199	2	RIGHT	A442.EDF	A44	2
84	11042580	11042582	4279	4281	2	RIGHT	A442.EDF	A44	2
84	11042622	11042622	4321	4321	0	RIGHT	A442.EDF	A44	2
84	11042654	11042677	4353	4376	23	RIGHT	A442.EDF	A44	2
84	11042698	11042699	4397	4398	1	RIGHT	A442.EDF	A44	2
84	11042758	11042758	4457	4457	0	RIGHT	A442.EDF	A44	2
84	11042792	11042822	4491	4521	30	RIGHT	A442.EDF	A44	2
84	11042872	11042962	4571	4661	90	RIGHT	A442.EDF	A44	2
84	11043007	11043011	4706	4710	4	RIGHT	A442.EDF	A44	2
84	11043032	11043449	4731	5148	417	RIGHT	A442.EDF	A44	2
84	11043483	11043501	5182	5200	18	RIGHT	A442.EDF	A44	2
84	11043573	11043580	5272	5279	7	RIGHT	A442.EDF	A44	2
84	11043601	11043601	5300	5300	0	RIGHT	A442.EDF	A44	2
84	11043635	11043636	5334	5335	1	RIGHT	A442.EDF	A44	2
84	11043677	11043677	5376	5376	0	RIGHT	A442.EDF	A44	2
84	11043701	11044064	5400	5763	363	RIGHT	A442.EDF	A44	2
85	11045833	11045861	57	85	28	RIGHT	A442.EDF	A44	2
85	11045886	11046611	110	835	725	RIGHT	A442.EDF	A44	2
85	11046635	11046635	859	859	0	RIGHT	A442.EDF	A44	2
85	11046702	11046742	926	966	40	RIGHT	A442.EDF	A44	2
85	11046785	11046785	1009	1009	0	RIGHT	A442.EDF	A44	2
85	11046812	11047623	1036	1847	811	RIGHT	A442.EDF	A44	2
85	11047657	11048487	1881	2711	830	RIGHT	A442.EDF	A44	2
85	11048508	11049457	2732	3681	949	RIGHT	A442.EDF	A44	2
85	11049482	11050856	3706	5080	1374	RIGHT	A442.EDF	A44	2
85	11050891	11051061	5115	5285	170	RIGHT	A442.EDF	A44	2
85	11051082	11051086	5306	5310	4	RIGHT	A442.EDF	A44	2
85	11051119	11051128	5343	5352	9	RIGHT	A442.EDF	A44	2
86	11053206	11054591	66	1451	1385	RIGHT	A442.EDF	A44	2
86	11054620	11054671	1480	1531	51	RIGHT	A442.EDF	A44	2
86	11054697	11054835	1557	1695	138	RIGHT	A442.EDF	A44	2
86	11054858	11055377	1718	2237	519	RIGHT	A442.EDF	A44	2
86	11055399	11058549	2259	5409	3150	RIGHT	A442.EDF	A44	2
86	11058639	11058654	5499	5514	15	RIGHT	A442.EDF	A44	2
86	11058703	11058703	5563	5563	0	RIGHT	A442.EDF	A44	2
86	11058755	11059254	5615	6114	499	RIGHT	A442.EDF	A44	2
87	11061059	11063331	74	2346	2272	RIGHT	A442.EDF	A44	2
87	11063684	11063684	2699	2699	0	RIGHT	A442.EDF	A44	2
87	11063754	11064154	2769	3169	400	RIGHT	A442.EDF	A44	2
87	11064176	11064271	3191	3286	95	RIGHT	A442.EDF	A44	2
87	11064293	11064517	3308	3532	224	RIGHT	A442.EDF	A44	2
87	11064546	11064614	3561	3629	68	RIGHT	A442.EDF	A44	2
87	11064638	11064668	3653	3683	30	RIGHT	A442.EDF	A44	2
87	11064689	11065240	3704	4255	551	RIGHT	A442.EDF	A44	2
87	11065268	11065285	4283	4300	17	RIGHT	A442.EDF	A44	2
87	11065307	11065307	4322	4322	0	RIGHT	A442.EDF	A44	2
87	11065345	11067126	4360	6141	1781	RIGHT	A442.EDF	A44	2
87	11067158	11067158	6173	6173	0	RIGHT	A442.EDF	A44	2
87	11067231	11067231	6246	6246	0	RIGHT	A442.EDF	A44	2
87	11067261	11067275	6276	6290	14	RIGHT	A442.EDF	A44	2
87	11067304	11067609	6319	6624	305	RIGHT	A442.EDF	A44	2
88	11069264	11070020	57	813	756	RIGHT	A442.EDF	A44	2
88	11070052	11070053	845	846	1	RIGHT	A442.EDF	A44	2
88	11070074	11070935	867	1728	861	RIGHT	A442.EDF	A44	2
88	11070957	11070957	1750	1750	0	RIGHT	A442.EDF	A44	2
88	11070987	11070998	1780	1791	11	RIGHT	A442.EDF	A44	2
88	11071024	11071024	1817	1817	0	RIGHT	A442.EDF	A44	2
88	11071062	11071159	1855	1952	97	RIGHT	A442.EDF	A44	2
88	11071183	11072665	1976	3458	1482	RIGHT	A442.EDF	A44	2
88	11072686	11073992	3479	4785	1306	RIGHT	A442.EDF	A44	2
89	11075945	11076044	71	170	99	RIGHT	A442.EDF	A44	2
89	11076067	11076069	193	195	2	RIGHT	A442.EDF	A44	2
89	11076092	11076092	218	218	0	RIGHT	A442.EDF	A44	2
89	11076137	11076142	263	268	5	RIGHT	A442.EDF	A44	2
89	11076168	11076194	294	320	26	RIGHT	A442.EDF	A44	2
89	11076239	11076631	365	757	392	RIGHT	A442.EDF	A44	2
89	11076665	11076665	791	791	0	RIGHT	A442.EDF	A44	2
89	11076686	11076769	812	895	83	RIGHT	A442.EDF	A44	2
89	11076817	11076893	943	1019	76	RIGHT	A442.EDF	A44	2
89	11076919	11076920	1045	1046	1	RIGHT	A442.EDF	A44	2
89	11076943	11077354	1069	1480	411	RIGHT	A442.EDF	A44	2
89	11077477	11077489	1603	1615	12	RIGHT	A442.EDF	A44	2
89	11077520	11077534	1646	1660	14	RIGHT	A442.EDF	A44	2
89	11077582	11077593	1708	1719	11	RIGHT	A442.EDF	A44	2
89	11077646	11077647	1772	1773	1	RIGHT	A442.EDF	A44	2
89	11077728	11077728	1854	1854	0	RIGHT	A442.EDF	A44	2
89	11077754	11077755	1880	1881	1	RIGHT	A442.EDF	A44	2
89	11077857	11077860	1983	1986	3	RIGHT	A442.EDF	A44	2
89	11077946	11077946	2072	2072	0	RIGHT	A442.EDF	A44	2
89	11077974	11077976	2100	2102	2	RIGHT	A442.EDF	A44	2
89	11077998	11078032	2124	2158	34	RIGHT	A442.EDF	A44	2
89	11078053	11078086	2179	2212	33	RIGHT	A442.EDF	A44	2
89	11078112	11078159	2238	2285	47	RIGHT	A442.EDF	A44	2
89	11078181	11078206	2307	2332	25	RIGHT	A442.EDF	A44	2
89	11078228	11078267	2354	2393	39	RIGHT	A442.EDF	A44	2
89	11078768	11078959	2894	3085	191	RIGHT	A442.EDF	A44	2
89	11079395	11079402	3521	3528	7	RIGHT	A442.EDF	A44	2
89	11079529	11079529	3655	3655	0	RIGHT	A442.EDF	A44	2
89	11079564	11079564	3690	3690	0	RIGHT	A442.EDF	A44	2
89	11079605	11079641	3731	3767	36	RIGHT	A442.EDF	A44	2
89	11079688	11079702	3814	3828	14	RIGHT	A442.EDF	A44	2
89	11079764	11079783	3890	3909	19	RIGHT	A442.EDF	A44	2
89	11079852	11079872	3978	3998	20	RIGHT	A442.EDF	A44	2
89	11079904	11079904	4030	4030	0	RIGHT	A442.EDF	A44	2
89	11079940	11079947	4066	4073	7	RIGHT	A442.EDF	A44	2
89	11080023	11080065	4149	4191	42	RIGHT	A442.EDF	A44	2
89	11080087	11080099	4213	4225	12	RIGHT	A442.EDF	A44	2
89	11080144	11080144	4270	4270	0	RIGHT	A442.EDF	A44	2
89	11080174	11080219	4300	4345	45	RIGHT	A442.EDF	A44	2
89	11080240	11080240	4366	4366	0	RIGHT	A442.EDF	A44	2
89	11080296	11080296	4422	4422	0	RIGHT	A442.EDF	A44	2
89	11080323	11080323	4449	4449	0	RIGHT	A442.EDF	A44	2
89	11080349	11080371	4475	4497	22	RIGHT	A442.EDF	A44	2
89	11080402	11080507	4528	4633	105	RIGHT	A442.EDF	A44	2
89	11080533	11080537	4659	4663	4	RIGHT	A442.EDF	A44	2
89	11080560	11081058	4686	5184	498	RIGHT	A442.EDF	A44	2
89	11081096	11081096	5222	5222	0	RIGHT	A442.EDF	A44	2
89	11081131	11081221	5257	5347	90	RIGHT	A442.EDF	A44	2
89	11081245	11081245	5371	5371	0	RIGHT	A442.EDF	A44	2
89	11081283	11081296	5409	5422	13	RIGHT	A442.EDF	A44	2
89	11081340	11081428	5466	5554	88	RIGHT	A442.EDF	A44	2
89	11081452	11081452	5578	5578	0	RIGHT	A442.EDF	A44	2
89	11081477	11081477	5603	5603	0	RIGHT	A442.EDF	A44	2
90	11083216	11083641	57	482	425	RIGHT	A442.EDF	A44	2
90	11083683	11083695	524	536	12	RIGHT	A442.EDF	A44	2
90	11083733	11083745	574	586	12	RIGHT	A442.EDF	A44	2
90	11083768	11083769	609	610	1	RIGHT	A442.EDF	A44	2
90	11083819	11083820	660	661	1	RIGHT	A442.EDF	A44	2
90	11083843	11083869	684	710	26	RIGHT	A442.EDF	A44	2
90	11083992	11083993	833	834	1	RIGHT	A442.EDF	A44	2
90	11084029	11084031	870	872	2	RIGHT	A442.EDF	A44	2
90	11084064	11084064	905	905	0	RIGHT	A442.EDF	A44	2
90	11084136	11084136	977	977	0	RIGHT	A442.EDF	A44	2
90	11084228	11084230	1069	1071	2	RIGHT	A442.EDF	A44	2
90	11084285	11084285	1126	1126	0	RIGHT	A442.EDF	A44	2
90	11084395	11084395	1236	1236	0	RIGHT	A442.EDF	A44	2
90	11084453	11084453	1294	1294	0	RIGHT	A442.EDF	A44	2
90	11084485	11084485	1326	1326	0	RIGHT	A442.EDF	A44	2
90	11084606	11084606	1447	1447	0	RIGHT	A442.EDF	A44	2
90	11084707	11084707	1548	1548	0	RIGHT	A442.EDF	A44	2
90	11084732	11084734	1573	1575	2	RIGHT	A442.EDF	A44	2
90	11084855	11084855	1696	1696	0	RIGHT	A442.EDF	A44	2
90	11084921	11084922	1762	1763	1	RIGHT	A442.EDF	A44	2
90	11085037	11085047	1878	1888	10	RIGHT	A442.EDF	A44	2
90	11085101	11085102	1942	1943	1	RIGHT	A442.EDF	A44	2
90	11085210	11085217	2051	2058	7	RIGHT	A442.EDF	A44	2
90	11085272	11085285	2113	2126	13	RIGHT	A442.EDF	A44	2
90	11085325	11085374	2166	2215	49	RIGHT	A442.EDF	A44	2
90	11085490	11085712	2331	2553	222	RIGHT	A442.EDF	A44	2
90	11086373	11086746	3214	3587	373	RIGHT	A442.EDF	A44	2
90	11088334	11088471	5175	5312	137	RIGHT	A442.EDF	A44	2
91	11090864	11091121	882	1139	257	RIGHT	A442.EDF	A44	2
91	11091778	11091778	1796	1796	0	RIGHT	A442.EDF	A44	2
91	11093320	11093320	3338	3338	0	RIGHT	A442.EDF	A44	2
91	11093368	11093371	3386	3389	3	RIGHT	A442.EDF	A44	2
91	11093404	11093411	3422	3429	7	RIGHT	A442.EDF	A44	2
91	11093443	11093452	3461	3470	9	RIGHT	A442.EDF	A44	2
91	11093493	11093498	3511	3516	5	RIGHT	A442.EDF	A44	2
91	11093531	11093615	3549	3633	84	RIGHT	A442.EDF	A44	2
91	11093674	11093674	3692	3692	0	RIGHT	A442.EDF	A44	2
91	11093707	11093707	3725	3725	0	RIGHT	A442.EDF	A44	2
91	11093734	11093748	3752	3766	14	RIGHT	A442.EDF	A44	2
91	11093788	11093788	3806	3806	0	RIGHT	A442.EDF	A44	2
91	11093820	11094168	3838	4186	348	RIGHT	A442.EDF	A44	2
91	11094197	11094715	4215	4733	518	RIGHT	A442.EDF	A44	2
91	11094740	11094795	4758	4813	55	RIGHT	A442.EDF	A44	2
91	11094866	11094866	4884	4884	0	RIGHT	A442.EDF	A44	2
91	11094897	11094897	4915	4915	0	RIGHT	A442.EDF	A44	2
91	11094920	11094921	4938	4939	1	RIGHT	A442.EDF	A44	2
91	11094968	11094968	4986	4986	0	RIGHT	A442.EDF	A44	2
91	11094996	11094996	5014	5014	0	RIGHT	A442.EDF	A44	2
91	11095022	11095023	5040	5041	1	RIGHT	A442.EDF	A44	2
91	11095046	11095136	5064	5154	90	RIGHT	A442.EDF	A44	2
91	11095198	11095202	5216	5220	4	RIGHT	A442.EDF	A44	2
91	11095249	11095273	5267	5291	24	RIGHT	A442.EDF	A44	2
91	11095320	11095320	5338	5338	0	RIGHT	A442.EDF	A44	2
91	11095380	11095412	5398	5430	32	RIGHT	A442.EDF	A44	2
91	11095448	11095487	5466	5505	39	RIGHT	A442.EDF	A44	2
91	11095516	11095516	5534	5534	0	RIGHT	A442.EDF	A44	2
91	11095556	11095556	5574	5574	0	RIGHT	A442.EDF	A44	2
91	11095590	11095610	5608	5628	20	RIGHT	A442.EDF	A44	2
91	11095640	11095667	5658	5685	27	RIGHT	A442.EDF	A44	2
91	11095688	11095839	5706	5857	151	RIGHT	A442.EDF	A44	2
91	11095867	11096113	5885	6131	246	RIGHT	A442.EDF	A44	2
91	11096160	11096237	6178	6255	77	RIGHT	A442.EDF	A44	2
91	11096280	11096285	6298	6303	5	RIGHT	A442.EDF	A44	2
91	11096315	11096617	6333	6635	302	RIGHT	A442.EDF	A44	2
92	11098095	11098096	128	129	1	RIGHT	A442.EDF	A44	2
92	11098127	11098707	160	740	580	RIGHT	A442.EDF	A44	2
92	11098739	11098739	772	772	0	RIGHT	A442.EDF	A44	2
92	11098786	11098786	819	819	0	RIGHT	A442.EDF	A44	2
92	11098927	11098953	960	986	26	RIGHT	A442.EDF	A44	2
92	11099029	11099029	1062	1062	0	RIGHT	A442.EDF	A44	2
92	11099061	11099090	1094	1123	29	RIGHT	A442.EDF	A44	2
92	11099128	11099474	1161	1507	346	RIGHT	A442.EDF	A44	2
92	11099541	11099541	1574	1574	0	RIGHT	A442.EDF	A44	2
92	11099592	11099593	1625	1626	1	RIGHT	A442.EDF	A44	2
92	11099620	11099638	1653	1671	18	RIGHT	A442.EDF	A44	2
92	11099745	11099747	1778	1780	2	RIGHT	A442.EDF	A44	2
92	11099784	11099792	1817	1825	8	RIGHT	A442.EDF	A44	2
92	11099840	11099863	1873	1896	23	RIGHT	A442.EDF	A44	2
92	11099934	11100023	1967	2056	89	RIGHT	A442.EDF	A44	2
92	11100050	11100050	2083	2083	0	RIGHT	A442.EDF	A44	2
92	11100075	11100112	2108	2145	37	RIGHT	A442.EDF	A44	2
92	11100574	11100574	2607	2607	0	RIGHT	A442.EDF	A44	2
92	11100639	11100639	2672	2672	0	RIGHT	A442.EDF	A44	2
92	11100696	11100697	2729	2730	1	RIGHT	A442.EDF	A44	2
92	11100722	11100739	2755	2772	17	RIGHT	A442.EDF	A44	2
92	11100763	11100763	2796	2796	0	RIGHT	A442.EDF	A44	2
92	11100788	11101152	2821	3185	364	RIGHT	A442.EDF	A44	2
92	11101189	11101189	3222	3222	0	RIGHT	A442.EDF	A44	2
92	11101217	11101680	3250	3713	463	RIGHT	A442.EDF	A44	2
92	11101704	11101833	3737	3866	129	RIGHT	A442.EDF	A44	2
92	11101858	11101890	3891	3923	32	RIGHT	A442.EDF	A44	2
92	11101914	11101931	3947	3964	17	RIGHT	A442.EDF	A44	2
92	11101960	11101962	3993	3995	2	RIGHT	A442.EDF	A44	2
92	11102030	11102050	4063	4083	20	RIGHT	A442.EDF	A44	2
92	11102081	11102099	4114	4132	18	RIGHT	A442.EDF	A44	2
92	11102124	11102125	4157	4158	1	RIGHT	A442.EDF	A44	2
92	11102196	11102197	4229	4230	1	RIGHT	A442.EDF	A44	2
92	11102252	11102256	4285	4289	4	RIGHT	A442.EDF	A44	2
92	11102287	11102296	4320	4329	9	RIGHT	A442.EDF	A44	2
92	11102330	11102349	4363	4382	19	RIGHT	A442.EDF	A44	2
92	11102397	11102406	4430	4439	9	RIGHT	A442.EDF	A44	2
92	11102471	11102488	4504	4521	17	RIGHT	A442.EDF	A44	2
92	11102514	11102514	4547	4547	0	RIGHT	A442.EDF	A44	2
92	11102549	11102549	4582	4582	0	RIGHT	A442.EDF	A44	2
92	11102577	11102944	4610	4977	367	RIGHT	A442.EDF	A44	2
92	11103047	11103047	5080	5080	0	RIGHT	A442.EDF	A44	2
92	11103094	11103100	5127	5133	6	RIGHT	A442.EDF	A44	2
92	11103131	11103161	5164	5194	30	RIGHT	A442.EDF	A44	2
92	11103204	11103506	5237	5539	302	RIGHT	A442.EDF	A44	2
92	11103543	11103589	5576	5622	46	RIGHT	A442.EDF	A44	2
92	11103629	11103685	5662	5718	56	RIGHT	A442.EDF	A44	2
92	11103708	11103712	5741	5745	4	RIGHT	A442.EDF	A44	2
92	11103742	11103742	5775	5775	0	RIGHT	A442.EDF	A44	2
92	11103784	11103785	5817	5818	1	RIGHT	A442.EDF	A44	2
92	11103819	11103822	5852	5855	3	RIGHT	A442.EDF	A44	2
92	11103906	11103906	5939	5939	0	RIGHT	A442.EDF	A44	2
92	11103928	11103928	5961	5961	0	RIGHT	A442.EDF	A44	2
92	11103960	11104181	5993	6214	221	RIGHT	A442.EDF	A44	2
93	11106241	11106295	58	112	54	RIGHT	A442.EDF	A44	2
93	11106323	11106486	140	303	163	RIGHT	A442.EDF	A44	2
93	11106676	11107023	493	840	347	RIGHT	A442.EDF	A44	2
93	11107049	11107049	866	866	0	RIGHT	A442.EDF	A44	2
93	11107198	11107210	1015	1027	12	RIGHT	A442.EDF	A44	2
93	11107235	11108661	1052	2478	1426	RIGHT	A442.EDF	A44	2
93	11109088	11109336	2905	3153	248	RIGHT	A442.EDF	A44	2
93	11109533	11109576	3350	3393	43	RIGHT	A442.EDF	A44	2
93	11109605	11109708	3422	3525	103	RIGHT	A442.EDF	A44	2
93	11109743	11109795	3560	3612	52	RIGHT	A442.EDF	A44	2
93	11110540	11110540	4357	4357	0	RIGHT	A442.EDF	A44	2
93	11110587	11110601	4404	4418	14	RIGHT	A442.EDF	A44	2
93	11110753	11110754	4570	4571	1	RIGHT	A442.EDF	A44	2
93	11110793	11110793	4610	4610	0	RIGHT	A442.EDF	A44	2
93	11110828	11110828	4645	4645	0	RIGHT	A442.EDF	A44	2
93	11111090	11111090	4907	4907	0	RIGHT	A442.EDF	A44	2
93	11111249	11111269	5066	5086	20	RIGHT	A442.EDF	A44	2
93	11111387	11111387	5204	5204	0	RIGHT	A442.EDF	A44	2
93	11111455	11111455	5272	5272	0	RIGHT	A442.EDF	A44	2
94	11113270	11113297	57	84	27	RIGHT	A442.EDF	A44	2
94	11113350	11113373	137	160	23	RIGHT	A442.EDF	A44	2
94	11113409	11115935	196	2722	2526	RIGHT	A442.EDF	A44	2
94	11115956	11115997	2743	2784	41	RIGHT	A442.EDF	A44	2
94	11116045	11116045	2832	2832	0	RIGHT	A442.EDF	A44	2
94	11116068	11116160	2855	2947	92	RIGHT	A442.EDF	A44	2
94	11116184	11116184	2971	2971	0	RIGHT	A442.EDF	A44	2
94	11116211	11117349	2998	4136	1138	RIGHT	A442.EDF	A44	2
94	11117380	11117856	4167	4643	476	RIGHT	A442.EDF	A44	2
94	11117887	11118154	4674	4941	267	RIGHT	A442.EDF	A44	2
94	11118175	11118370	4962	5157	195	RIGHT	A442.EDF	A44	2
94	11118391	11118504	5178	5291	113	RIGHT	A442.EDF	A44	2
94	11118528	11118551	5315	5338	23	RIGHT	A442.EDF	A44	2
94	11118581	11118597	5368	5384	16	RIGHT	A442.EDF	A44	2
94	11118618	11119801	5405	6588	1183	RIGHT	A442.EDF	A44	2
95	11121580	11122273	57	750	693	RIGHT	A442.EDF	A44	2
95	11122366	11122366	843	843	0	RIGHT	A442.EDF	A44	2
95	11122461	11122461	938	938	0	RIGHT	A442.EDF	A44	2
95	11122488	11122488	965	965	0	RIGHT	A442.EDF	A44	2
95	11122531	11122541	1008	1018	10	RIGHT	A442.EDF	A44	2
95	11122564	11122589	1041	1066	25	RIGHT	A442.EDF	A44	2
95	11122645	11122645	1122	1122	0	RIGHT	A442.EDF	A44	2
95	11122736	11122746	1213	1223	10	RIGHT	A442.EDF	A44	2
95	11122809	11122826	1286	1303	17	RIGHT	A442.EDF	A44	2
95	11122907	11122907	1384	1384	0	RIGHT	A442.EDF	A44	2
95	11122934	11122934	1411	1411	0	RIGHT	A442.EDF	A44	2
95	11122962	11122962	1439	1439	0	RIGHT	A442.EDF	A44	2
95	11123042	11123043	1519	1520	1	RIGHT	A442.EDF	A44	2
95	11123074	11123075	1551	1552	1	RIGHT	A442.EDF	A44	2
95	11123158	11123159	1635	1636	1	RIGHT	A442.EDF	A44	2
95	11123338	11123338	1815	1815	0	RIGHT	A442.EDF	A44	2
95	11123415	11123430	1892	1907	15	RIGHT	A442.EDF	A44	2
95	11123472	11123474	1949	1951	2	RIGHT	A442.EDF	A44	2
95	11124183	11124184	2660	2661	1	RIGHT	A442.EDF	A44	2
95	11124222	11124414	2699	2891	192	RIGHT	A442.EDF	A44	2
95	11124436	11125192	2913	3669	756	RIGHT	A442.EDF	A44	2
95	11125255	11125255	3732	3732	0	RIGHT	A442.EDF	A44	2
95	11125297	11125298	3774	3775	1	RIGHT	A442.EDF	A44	2
95	11125330	11126159	3807	4636	829	RIGHT	A442.EDF	A44	2
95	11126230	11126349	4707	4826	119	RIGHT	A442.EDF	A44	2
95	11126419	11126440	4896	4917	21	RIGHT	A442.EDF	A44	2
95	11126467	11126895	4944	5372	428	RIGHT	A442.EDF	A44	2
95	11126923	11126923	5400	5400	0	RIGHT	A442.EDF	A44	2
95	11126947	11127212	5424	5689	265	RIGHT	A442.EDF	A44	2
95	11127244	11127574	5721	6051	330	RIGHT	A442.EDF	A44	2
95	11127598	11127696	6075	6173	98	RIGHT	A442.EDF	A44	2
95	11127729	11127830	6206	6307	101	RIGHT	A442.EDF	A44	2
95	11127851	11127952	6328	6429	101	RIGHT	A442.EDF	A44	2
95	11127974	11128036	6451	6513	62	RIGHT	A442.EDF	A44	2
95	11128060	11128297	6537	6774	237	RIGHT	A442.EDF	A44	2
96	11130350	11130750	75	475	400	RIGHT	A442.EDF	A44	2
96	11130812	11130849	537	574	37	RIGHT	A442.EDF	A44	2
96	11130874	11131579	599	1304	705	RIGHT	A442.EDF	A44	2
96	11131612	11131689	1337	1414	77	RIGHT	A442.EDF	A44	2
96	11131733	11131841	1458	1566	108	RIGHT	A442.EDF	A44	2
96	11131907	11131919	1632	1644	12	RIGHT	A442.EDF	A44	2
96	11131965	11131976	1690	1701	11	RIGHT	A442.EDF	A44	2
96	11132015	11132015	1740	1740	0	RIGHT	A442.EDF	A44	2
96	11132067	11132077	1792	1802	10	RIGHT	A442.EDF	A44	2
96	11132099	11132099	1824	1824	0	RIGHT	A442.EDF	A44	2
96	11132142	11132143	1867	1868	1	RIGHT	A442.EDF	A44	2
96	11132189	11132492	1914	2217	303	RIGHT	A442.EDF	A44	2
96	11133053	11133458	2778	3183	405	RIGHT	A442.EDF	A44	2
96	11133922	11133922	3647	3647	0	RIGHT	A442.EDF	A44	2
96	11134071	11134071	3796	3796	0	RIGHT	A442.EDF	A44	2
96	11134094	11134118	3819	3843	24	RIGHT	A442.EDF	A44	2
96	11134147	11134149	3872	3874	2	RIGHT	A442.EDF	A44	2
96	11134180	11134206	3905	3931	26	RIGHT	A442.EDF	A44	2
96	11134235	11134356	3960	4081	121	RIGHT	A442.EDF	A44	2
96	11134397	11134531	4122	4256	134	RIGHT	A442.EDF	A44	2
96	11134553	11135861	4278	5586	1308	RIGHT	A442.EDF	A44	2
97	11137428	11138015	66	653	587	RIGHT	A442.EDF	A44	2
97	11138039	11138376	677	1014	337	RIGHT	A442.EDF	A44	2
97	11138400	11138401	1038	1039	1	RIGHT	A442.EDF	A44	2
97	11138446	11138446	1084	1084	0	RIGHT	A442.EDF	A44	2
97	11138502	11138533	1140	1171	31	RIGHT	A442.EDF	A44	2
97	11138575	11138576	1213	1214	1	RIGHT	A442.EDF	A44	2
97	11138605	11138605	1243	1243	0	RIGHT	A442.EDF	A44	2
97	11138665	11139025	1303	1663	360	RIGHT	A442.EDF	A44	2
97	11139046	11139568	1684	2206	522	RIGHT	A442.EDF	A44	2
97	11140895	11142153	3533	4791	1258	RIGHT	A442.EDF	A44	2
97	11142552	11142562	5190	5200	10	RIGHT	A442.EDF	A44	2
97	11142753	11142755	5391	5393	2	RIGHT	A442.EDF	A44	2
97	11142879	11142879	5517	5517	0	RIGHT	A442.EDF	A44	2
97	11142972	11142973	5610	5611	1	RIGHT	A442.EDF	A44	2
98	11145124	11145705	57	638	581	RIGHT	A442.EDF	A44	2
98	11145726	11145732	659	665	6	RIGHT	A442.EDF	A44	2
98	11145785	11145788	718	721	3	RIGHT	A442.EDF	A44	2
98	11145828	11145828	761	761	0	RIGHT	A442.EDF	A44	2
98	11145869	11147938	802	2871	2069	RIGHT	A442.EDF	A44	2
98	11148228	11148246	3161	3179	18	RIGHT	A442.EDF	A44	2
98	11148301	11148418	3234	3351	117	RIGHT	A442.EDF	A44	2
98	11148448	11150199	3381	5132	1751	RIGHT	A442.EDF	A44	2
99	11151359	11151360	120	121	1	RIGHT	A442.EDF	A44	2
99	11151449	11151478	210	239	29	RIGHT	A442.EDF	A44	2
99	11151501	11152374	262	1135	873	RIGHT	A442.EDF	A44	2
99	11152400	11152450	1161	1211	50	RIGHT	A442.EDF	A44	2
99	11152481	11152906	1242	1667	425	RIGHT	A442.EDF	A44	2
99	11152928	11153053	1689	1814	125	RIGHT	A442.EDF	A44	2
99	11154323	11154323	3084	3084	0	RIGHT	A442.EDF	A44	2
99	11154354	11154354	3115	3115	0	RIGHT	A442.EDF	A44	2
99	11154392	11154402	3153	3163	10	RIGHT	A442.EDF	A44	2
99	11154442	11154443	3203	3204	1	RIGHT	A442.EDF	A44	2
99	11154491	11154506	3252	3267	15	RIGHT	A442.EDF	A44	2
99	11154528	11154528	3289	3289	0	RIGHT	A442.EDF	A44	2
99	11154617	11154617	3378	3378	0	RIGHT	A442.EDF	A44	2
99	11154644	11154654	3405	3415	10	RIGHT	A442.EDF	A44	2
99	11154718	11154747	3479	3508	29	RIGHT	A442.EDF	A44	2
99	11154802	11154842	3563	3603	40	RIGHT	A442.EDF	A44	2
99	11154863	11154864	3624	3625	1	RIGHT	A442.EDF	A44	2
99	11154888	11154943	3649	3704	55	RIGHT	A442.EDF	A44	2
99	11154982	11154983	3743	3744	1	RIGHT	A442.EDF	A44	2
99	11155030	11155030	3791	3791	0	RIGHT	A442.EDF	A44	2
99	11155053	11155055	3814	3816	2	RIGHT	A442.EDF	A44	2
99	11155082	11155098	3843	3859	16	RIGHT	A442.EDF	A44	2
99	11155173	11155174	3934	3935	1	RIGHT	A442.EDF	A44	2
99	11155237	11155238	3998	3999	1	RIGHT	A442.EDF	A44	2
99	11155265	11156683	4026	5444	1418	RIGHT	A442.EDF	A44	2
100	11158159	11158560	57	458	401	RIGHT	A442.EDF	A44	2
100	11158696	11158780	594	678	84	RIGHT	A442.EDF	A44	2
100	11158812	11159504	710	1402	692	RIGHT	A442.EDF	A44	2
100	11159550	11159799	1448	1697	249	RIGHT	A442.EDF	A44	2
100	11159863	11159863	1761	1761	0	RIGHT	A442.EDF	A44	2
100	11159904	11159904	1802	1802	0	RIGHT	A442.EDF	A44	2
100	11159933	11159933	1831	1831	0	RIGHT	A442.EDF	A44	2
100	11160018	11160018	1916	1916	0	RIGHT	A442.EDF	A44	2
100	11160041	11160041	1939	1939	0	RIGHT	A442.EDF	A44	2
100	11160079	11160079	1977	1977	0	RIGHT	A442.EDF	A44	2
100	11160110	11160115	2008	2013	5	RIGHT	A442.EDF	A44	2
100	11160173	11160189	2071	2087	16	RIGHT	A442.EDF	A44	2
100	11160239	11160239	2137	2137	0	RIGHT	A442.EDF	A44	2
100	11160304	11160304	2202	2202	0	RIGHT	A442.EDF	A44	2
100	11160354	11160363	2252	2261	9	RIGHT	A442.EDF	A44	2
100	11160424	11160445	2322	2343	21	RIGHT	A442.EDF	A44	2
100	11160468	11160534	2366	2432	66	RIGHT	A442.EDF	A44	2
100	11160567	11160567	2465	2465	0	RIGHT	A442.EDF	A44	2
100	11160600	11160601	2498	2499	1	RIGHT	A442.EDF	A44	2
100	11160634	11160635	2532	2533	1	RIGHT	A442.EDF	A44	2
100	11160667	11160667	2565	2565	0	RIGHT	A442.EDF	A44	2
100	11160697	11160739	2595	2637	42	RIGHT	A442.EDF	A44	2
100	11160761	11160814	2659	2712	53	RIGHT	A442.EDF	A44	2
100	11160905	11161222	2803	3120	317	RIGHT	A442.EDF	A44	2
100	11161272	11161344	3170	3242	72	RIGHT	A442.EDF	A44	2
100	11161372	11161865	3270	3763	493	RIGHT	A442.EDF	A44	2
100	11161890	11161897	3788	3795	7	RIGHT	A442.EDF	A44	2
100	11161953	11162075	3851	3973	122	RIGHT	A442.EDF	A44	2
100	11162130	11162175	4028	4073	45	RIGHT	A442.EDF	A44	2
100	11162219	11163211	4117	5109	992	RIGHT	A442.EDF	A44	2
100	11163236	11163331	5134	5229	95	RIGHT	A442.EDF	A44	2
100	11163365	11163373	5263	5271	8	RIGHT	A442.EDF	A44	2
100	11163419	11163440	5317	5338	21	RIGHT	A442.EDF	A44	2
100	11163471	11163471	5369	5369	0	RIGHT	A442.EDF	A44	2
100	11163500	11163500	5398	5398	0	RIGHT	A442.EDF	A44	2
100	11163553	11163584	5451	5482	31	RIGHT	A442.EDF	A44	2
100	11163607	11163669	5505	5567	62	RIGHT	A442.EDF	A44	2
100	11163720	11163763	5618	5661	43	RIGHT	A442.EDF	A44	2
100	11163785	11165309	5683	7207	1524	RIGHT	A442.EDF	A44	2
101	11167274	11167575	57	358	301	RIGHT	A442.EDF	A44	2
101	11167604	11167738	387	521	134	RIGHT	A442.EDF	A44	2
101	11167783	11167804	566	587	21	RIGHT	A442.EDF	A44	2
101	11167826	11167827	609	610	1	RIGHT	A442.EDF	A44	2
101	11167850	11167852	633	635	2	RIGHT	A442.EDF	A44	2
101	11167914	11167914	697	697	0	RIGHT	A442.EDF	A44	2
101	11167996	11168012	779	795	16	RIGHT	A442.EDF	A44	2
101	11168036	11168036	819	819	0	RIGHT	A442.EDF	A44	2
101	11168058	11168058	841	841	0	RIGHT	A442.EDF	A44	2
101	11168079	11168131	862	914	52	RIGHT	A442.EDF	A44	2
101	11168163	11168604	946	1387	441	RIGHT	A442.EDF	A44	2
101	11168656	11169009	1439	1792	353	RIGHT	A442.EDF	A44	2
101	11169082	11169083	1865	1866	1	RIGHT	A442.EDF	A44	2
101	11169157	11169160	1940	1943	3	RIGHT	A442.EDF	A44	2
101	11169181	11169219	1964	2002	38	RIGHT	A442.EDF	A44	2
101	11169278	11169280	2061	2063	2	RIGHT	A442.EDF	A44	2
101	11169312	11169455	2095	2238	143	RIGHT	A442.EDF	A44	2
101	11169476	11169523	2259	2306	47	RIGHT	A442.EDF	A44	2
101	11169907	11169907	2690	2690	0	RIGHT	A442.EDF	A44	2
101	11169931	11170294	2714	3077	363	RIGHT	A442.EDF	A44	2
101	11170486	11170514	3269	3297	28	RIGHT	A442.EDF	A44	2
101	11170540	11170541	3323	3324	1	RIGHT	A442.EDF	A44	2
101	11170572	11170572	3355	3355	0	RIGHT	A442.EDF	A44	2
101	11170663	11174034	3446	6817	3371	RIGHT	A442.EDF	A44	2
102	11176089	11176629	58	598	540	RIGHT	A442.EDF	A44	2
102	11176692	11176696	661	665	4	RIGHT	A442.EDF	A44	2
102	11176723	11176765	692	734	42	RIGHT	A442.EDF	A44	2
102	11176788	11176976	757	945	188	RIGHT	A442.EDF	A44	2
102	11176998	11177013	967	982	15	RIGHT	A442.EDF	A44	2
102	11177042	11177087	1011	1056	45	RIGHT	A442.EDF	A44	2
102	11177108	11177161	1077	1130	53	RIGHT	A442.EDF	A44	2
102	11177196	11177202	1165	1171	6	RIGHT	A442.EDF	A44	2
102	11177236	11177423	1205	1392	187	RIGHT	A442.EDF	A44	2
102	11177450	11177471	1419	1440	21	RIGHT	A442.EDF	A44	2
102	11177508	11177508	1477	1477	0	RIGHT	A442.EDF	A44	2
102	11177536	11178456	1505	2425	920	RIGHT	A442.EDF	A44	2
102	11178489	11178490	2458	2459	1	RIGHT	A442.EDF	A44	2
102	11178527	11178527	2496	2496	0	RIGHT	A442.EDF	A44	2
102	11178572	11178572	2541	2541	0	RIGHT	A442.EDF	A44	2
102	11178665	11179038	2634	3007	373	RIGHT	A442.EDF	A44	2
102	11179317	11179317	3286	3286	0	RIGHT	A442.EDF	A44	2
102	11179444	11179444	3413	3413	0	RIGHT	A442.EDF	A44	2
102	11179585	11179585	3554	3554	0	RIGHT	A442.EDF	A44	2
102	11179608	11179676	3577	3645	68	RIGHT	A442.EDF	A44	2
102	11179723	11179772	3692	3741	49	RIGHT	A442.EDF	A44	2
102	11179793	11179793	3762	3762	0	RIGHT	A442.EDF	A44	2
102	11179837	11179838	3806	3807	1	RIGHT	A442.EDF	A44	2
102	11179872	11179872	3841	3841	0	RIGHT	A442.EDF	A44	2
102	11179918	11179920	3887	3889	2	RIGHT	A442.EDF	A44	2
102	11180025	11180025	3994	3994	0	RIGHT	A442.EDF	A44	2
102	11180422	11181315	4391	5284	893	RIGHT	A442.EDF	A44	2
102	11181343	11181343	5312	5312	0	RIGHT	A442.EDF	A44	2
102	11181417	11181432	5386	5401	15	RIGHT	A442.EDF	A44	2
102	11181470	11181471	5439	5440	1	RIGHT	A442.EDF	A44	2
102	11181512	11181572	5481	5541	60	RIGHT	A442.EDF	A44	2
102	11181607	11181607	5576	5576	0	RIGHT	A442.EDF	A44	2
102	11182014	11182492	5983	6461	478	RIGHT	A442.EDF	A44	2
102	11182913	11182915	6882	6884	2	RIGHT	A442.EDF	A44	2
103	11184867	11185967	57	1157	1100	RIGHT	A442.EDF	A44	2
103	11186196	11186417	1386	1607	221	RIGHT	A442.EDF	A44	2
103	11186995	11187207	2185	2397	212	RIGHT	A442.EDF	A44	2
103	11187736	11188066	2926	3256	330	RIGHT	A442.EDF	A44	2
103	11188512	11188512	3702	3702	0	RIGHT	A442.EDF	A44	2
103	11188559	11188559	3749	3749	0	RIGHT	A442.EDF	A44	2
103	11188620	11188620	3810	3810	0	RIGHT	A442.EDF	A44	2
103	11188725	11188733	3915	3923	8	RIGHT	A442.EDF	A44	2
103	11188797	11188798	3987	3988	1	RIGHT	A442.EDF	A44	2
103	11188822	11188834	4012	4024	12	RIGHT	A442.EDF	A44	2
103	11188900	11188902	4090	4092	2	RIGHT	A442.EDF	A44	2
103	11188924	11188972	4114	4162	48	RIGHT	A442.EDF	A44	2
103	11189005	11189039	4195	4229	34	RIGHT	A442.EDF	A44	2
103	11189074	11189076	4264	4266	2	RIGHT	A442.EDF	A44	2
103	11189102	11189137	4292	4327	35	RIGHT	A442.EDF	A44	2
103	11189173	11189173	4363	4363	0	RIGHT	A442.EDF	A44	2
103	11189201	11189201	4391	4391	0	RIGHT	A442.EDF	A44	2
103	11189222	11189222	4412	4412	0	RIGHT	A442.EDF	A44	2
103	11189243	11189263	4433	4453	20	RIGHT	A442.EDF	A44	2
103	11189298	11189448	4488	4638	150	RIGHT	A442.EDF	A44	2
103	11189475	11189477	4665	4667	2	RIGHT	A442.EDF	A44	2
103	11189498	11189781	4688	4971	283	RIGHT	A442.EDF	A44	2
103	11189802	11189974	4992	5164	172	RIGHT	A442.EDF	A44	2
104	11191843	11192017	66	240	174	RIGHT	A442.EDF	A44	2
104	11192050	11192134	273	357	84	RIGHT	A442.EDF	A44	2
104	11192158	11193314	381	1537	1156	RIGHT	A442.EDF	A44	2
104	11193409	11193409	1632	1632	0	RIGHT	A442.EDF	A44	2
104	11193439	11193442	1662	1665	3	RIGHT	A442.EDF	A44	2
104	11193495	11193506	1718	1729	11	RIGHT	A442.EDF	A44	2
104	11193692	11193692	1915	1915	0	RIGHT	A442.EDF	A44	2
104	11193755	11193827	1978	2050	72	RIGHT	A442.EDF	A44	2
104	11193863	11193904	2086	2127	41	RIGHT	A442.EDF	A44	2
104	11193934	11193946	2157	2169	12	RIGHT	A442.EDF	A44	2
104	11194007	11194022	2230	2245	15	RIGHT	A442.EDF	A44	2
104	11194281	11194281	2504	2504	0	RIGHT	A442.EDF	A44	2
104	11194324	11194324	2547	2547	0	RIGHT	A442.EDF	A44	2
104	11194521	11194528	2744	2751	7	RIGHT	A442.EDF	A44	2
104	11194557	11194580	2780	2803	23	RIGHT	A442.EDF	A44	2
104	11194606	11194629	2829	2852	23	RIGHT	A442.EDF	A44	2
104	11194653	11194687	2876	2910	34	RIGHT	A442.EDF	A44	2
104	11194708	11194718	2931	2941	10	RIGHT	A442.EDF	A44	2
104	11194764	11194764	2987	2987	0	RIGHT	A442.EDF	A44	2
104	11194848	11194898	3071	3121	50	RIGHT	A442.EDF	A44	2
104	11194927	11194941	3150	3164	14	RIGHT	A442.EDF	A44	2
104	11194993	11194993	3216	3216	0	RIGHT	A442.EDF	A44	2
104	11195029	11195094	3252	3317	65	RIGHT	A442.EDF	A44	2
104	11195117	11195124	3340	3347	7	RIGHT	A442.EDF	A44	2
104	11195183	11195683	3406	3906	500	RIGHT	A442.EDF	A44	2
104	11195707	11196668	3930	4891	961	RIGHT	A442.EDF	A44	2
104	11196712	11196712	4935	4935	0	RIGHT	A442.EDF	A44	2
104	11196765	11196778	4988	5001	13	RIGHT	A442.EDF	A44	2
104	11196828	11196828	5051	5051	0	RIGHT	A442.EDF	A44	2
104	11196854	11196854	5077	5077	0	RIGHT	A442.EDF	A44	2
104	11196900	11196900	5123	5123	0	RIGHT	A442.EDF	A44	2
104	11196932	11197402	5155	5625	470	RIGHT	A442.EDF	A44	2
104	11197424	11197424	5647	5647	0	RIGHT	A442.EDF	A44	2
104	11197446	11197554	5669	5777	108	RIGHT	A442.EDF	A44	2
104	11197595	11197610	5818	5833	15	RIGHT	A442.EDF	A44	2
104	11197636	11197864	5859	6087	228	RIGHT	A442.EDF	A44	2
104	11198088	11198691	6311	6914	603	RIGHT	A442.EDF	A44	2
105	11200317	11202685	57	2425	2368	RIGHT	A442.EDF	A44	2
105	11202732	11202786	2472	2526	54	RIGHT	A442.EDF	A44	2
105	11202819	11202832	2559	2572	13	RIGHT	A442.EDF	A44	2
105	11202854	11202906	2594	2646	52	RIGHT	A442.EDF	A44	2
105	11202930	11203070	2670	2810	140	RIGHT	A442.EDF	A44	2
105	11203436	11203671	3176	3411	235	RIGHT	A442.EDF	A44	2
105	11203692	11206631	3432	6371	2939	RIGHT	A442.EDF	A44	2
105	11206774	11206926	6514	6666	152	RIGHT	A442.EDF	A44	2
105	11206960	11207029	6700	6769	69	RIGHT	A442.EDF	A44	2
105	11207050	11207060	6790	6800	10	RIGHT	A442.EDF	A44	2
105	11207092	11207455	6832	7195	363	RIGHT	A442.EDF	A44	2
106	11209448	11209459	76	87	11	RIGHT	A442.EDF	A44	2
106	11209481	11209503	109	131	22	RIGHT	A442.EDF	A44	2
106	11209541	11209560	169	188	19	RIGHT	A442.EDF	A44	2
106	11209589	11209621	217	249	32	RIGHT	A442.EDF	A44	2
106	11209656	11210405	284	1033	749	RIGHT	A442.EDF	A44	2
106	11210428	11210534	1056	1162	106	RIGHT	A442.EDF	A44	2
106	11210560	11211174	1188	1802	614	RIGHT	A442.EDF	A44	2
106	11211198	11211198	1826	1826	0	RIGHT	A442.EDF	A44	2
106	11211227	11211234	1855	1862	7	RIGHT	A442.EDF	A44	2
106	11211287	11211635	1915	2263	348	RIGHT	A442.EDF	A44	2
106	11211915	11211915	2543	2543	0	RIGHT	A442.EDF	A44	2
106	11212021	11212021	2649	2649	0	RIGHT	A442.EDF	A44	2
106	11212051	11215920	2679	6548	3869	RIGHT	A442.EDF	A44	2
107	11217685	11220296	58	2669	2611	RIGHT	A442.EDF	A44	2
107	11220335	11220357	2708	2730	22	RIGHT	A442.EDF	A44	2
107	11220409	11220409	2782	2782	0	RIGHT	A442.EDF	A44	2
107	11220436	11220449	2809	2822	13	RIGHT	A442.EDF	A44	2
107	11220492	11222894	2865	5267	2402	RIGHT	A442.EDF	A44	2
108	11225074	11225142	228	296	68	RIGHT	A442.EDF	A44	2
108	11225179	11227126	333	2280	1947	RIGHT	A442.EDF	A44	2
108	11227228	11227457	2382	2611	229	RIGHT	A442.EDF	A44	2
108	11227743	11227744	2897	2898	1	RIGHT	A442.EDF	A44	2
108	11227797	11227798	2951	2952	1	RIGHT	A442.EDF	A44	2
108	11227819	11230489	2973	5643	2670	RIGHT	A442.EDF	A44	2
109	11232223	11237263	71	5111	5040	RIGHT	A442.EDF	A44	2
110	11239193	11239193	85	85	0	RIGHT	A442.EDF	A44	2
110	11239308	11239319	200	211	11	RIGHT	A442.EDF	A44	2
110	11239347	11240115	239	1007	768	RIGHT	A442.EDF	A44	2
110	11240145	11240359	1037	1251	214	RIGHT	A442.EDF	A44	2
110	11240393	11240405	1285	1297	12	RIGHT	A442.EDF	A44	2
110	11240448	11240448	1340	1340	0	RIGHT	A442.EDF	A44	2
110	11240530	11240530	1422	1422	0	RIGHT	A442.EDF	A44	2
110	11240551	11240584	1443	1476	33	RIGHT	A442.EDF	A44	2
110	11240607	11240607	1499	1499	0	RIGHT	A442.EDF	A44	2
110	11240657	11241180	1549	2072	523	RIGHT	A442.EDF	A44	2
110	11241201	11241257	2093	2149	56	RIGHT	A442.EDF	A44	2
110	11241296	11241296	2188	2188	0	RIGHT	A442.EDF	A44	2
110	11241324	11241324	2216	2216	0	RIGHT	A442.EDF	A44	2
110	11241361	11241361	2253	2253	0	RIGHT	A442.EDF	A44	2
110	11241730	11241730	2622	2622	0	RIGHT	A442.EDF	A44	2
110	11241767	11241773	2659	2665	6	RIGHT	A442.EDF	A44	2
110	11241810	11241810	2702	2702	0	RIGHT	A442.EDF	A44	2
110	11241833	11244287	2725	5179	2454	RIGHT	A442.EDF	A44	2
111	11245825	11245950	57	182	125	RIGHT	A442.EDF	A44	2
111	11245976	11246257	208	489	281	RIGHT	A442.EDF	A44	2
111	11246295	11248306	527	2538	2011	RIGHT	A442.EDF	A44	2
111	11248363	11248363	2595	2595	0	RIGHT	A442.EDF	A44	2
111	11248536	11248552	2768	2784	16	RIGHT	A442.EDF	A44	2
111	11248631	11248666	2863	2898	35	RIGHT	A442.EDF	A44	2
111	11248694	11249523	2926	3755	829	RIGHT	A442.EDF	A44	2
111	11249550	11252523	3782	6755	2973	RIGHT	A442.EDF	A44	2
112	11254249	11254958	76	785	709	RIGHT	A442.EDF	A44	2
112	11254993	11254993	820	820	0	RIGHT	A442.EDF	A44	2
112	11255046	11255046	873	873	0	RIGHT	A442.EDF	A44	2
112	11255094	11255094	921	921	0	RIGHT	A442.EDF	A44	2
112	11255116	11255870	943	1697	754	RIGHT	A442.EDF	A44	2
112	11255908	11255908	1735	1735	0	RIGHT	A442.EDF	A44	2
112	11255963	11255963	1790	1790	0	RIGHT	A442.EDF	A44	2
112	11255994	11256359	1821	2186	365	RIGHT	A442.EDF	A44	2
112	11256455	11256455	2282	2282	0	RIGHT	A442.EDF	A44	2
112	11256477	11256486	2304	2313	9	RIGHT	A442.EDF	A44	2
112	11256520	11256777	2347	2604	257	RIGHT	A442.EDF	A44	2
112	11256821	11257146	2648	2973	325	RIGHT	A442.EDF	A44	2
112	11257178	11257178	3005	3005	0	RIGHT	A442.EDF	A44	2
112	11257298	11257303	3125	3130	5	RIGHT	A442.EDF	A44	2
112	11257343	11257896	3170	3723	553	RIGHT	A442.EDF	A44	2
112	11257919	11257929	3746	3756	10	RIGHT	A442.EDF	A44	2
112	11257953	11257954	3780	3781	1	RIGHT	A442.EDF	A44	2
112	11258001	11258031	3828	3858	30	RIGHT	A442.EDF	A44	2
112	11258061	11258061	3888	3888	0	RIGHT	A442.EDF	A44	2
112	11258091	11258091	3918	3918	0	RIGHT	A442.EDF	A44	2
112	11258119	11258120	3946	3947	1	RIGHT	A442.EDF	A44	2
112	11258147	11259150	3974	4977	1003	RIGHT	A442.EDF	A44	2
112	11259302	11259593	5129	5420	291	RIGHT	A442.EDF	A44	2
112	11259619	11259641	5446	5468	22	RIGHT	A442.EDF	A44	2
112	11259702	11259702	5529	5529	0	RIGHT	A442.EDF	A44	2
112	11259729	11259748	5556	5575	19	RIGHT	A442.EDF	A44	2
112	11259853	11259853	5680	5680	0	RIGHT	A442.EDF	A44	2
112	11259874	11260168	5701	5995	294	RIGHT	A442.EDF	A44	2
113	11261948	11263022	58	1132	1074	RIGHT	A442.EDF	A44	2
113	11263096	11263129	1206	1239	33	RIGHT	A442.EDF	A44	2
113	11263156	11263159	1266	1269	3	RIGHT	A442.EDF	A44	2
113	11263190	11263209	1300	1319	19	RIGHT	A442.EDF	A44	2
113	11263232	11263921	1342	2031	689	RIGHT	A442.EDF	A44	2
113	11263944	11264217	2054	2327	273	RIGHT	A442.EDF	A44	2
113	11264241	11264260	2351	2370	19	RIGHT	A442.EDF	A44	2
113	11264300	11264338	2410	2448	38	RIGHT	A442.EDF	A44	2
113	11264366	11264366	2476	2476	0	RIGHT	A442.EDF	A44	2
113	11264392	11264392	2502	2502	0	RIGHT	A442.EDF	A44	2
113	11264431	11264501	2541	2611	70	RIGHT	A442.EDF	A44	2
113	11264561	11264562	2671	2672	1	RIGHT	A442.EDF	A44	2
113	11264587	11264587	2697	2697	0	RIGHT	A442.EDF	A44	2
113	11264706	11264724	2816	2834	18	RIGHT	A442.EDF	A44	2
113	11264851	11264859	2961	2969	8	RIGHT	A442.EDF	A44	2
113	11264885	11264886	2995	2996	1	RIGHT	A442.EDF	A44	2
113	11264952	11264952	3062	3062	0	RIGHT	A442.EDF	A44	2
113	11265055	11265327	3165	3437	272	RIGHT	A442.EDF	A44	2
113	11265428	11265478	3538	3588	50	RIGHT	A442.EDF	A44	2
113	11265500	11265500	3610	3610	0	RIGHT	A442.EDF	A44	2
113	11265549	11265549	3659	3659	0	RIGHT	A442.EDF	A44	2
113	11265623	11265668	3733	3778	45	RIGHT	A442.EDF	A44	2
113	11265703	11265719	3813	3829	16	RIGHT	A442.EDF	A44	2
113	11265748	11266412	3858	4522	664	RIGHT	A442.EDF	A44	2
113	11266434	11266465	4544	4575	31	RIGHT	A442.EDF	A44	2
113	11266500	11266552	4610	4662	52	RIGHT	A442.EDF	A44	2
113	11266587	11266600	4697	4710	13	RIGHT	A442.EDF	A44	2
113	11266679	11266680	4789	4790	1	RIGHT	A442.EDF	A44	2
113	11266703	11266709	4813	4819	6	RIGHT	A442.EDF	A44	2
113	11266760	11266760	4870	4870	0	RIGHT	A442.EDF	A44	2
113	11266784	11266818	4894	4928	34	RIGHT	A442.EDF	A44	2
113	11266862	11266881	4972	4991	19	RIGHT	A442.EDF	A44	2
113	11267024	11267038	5134	5148	14	RIGHT	A442.EDF	A44	2
113	11267090	11267090	5200	5200	0	RIGHT	A442.EDF	A44	2
113	11267114	11267114	5224	5224	0	RIGHT	A442.EDF	A44	2
113	11267154	11267154	5264	5264	0	RIGHT	A442.EDF	A44	2
113	11267236	11267236	5346	5346	0	RIGHT	A442.EDF	A44	2
113	11267446	11267446	5556	5556	0	RIGHT	A442.EDF	A44	2
113	11267496	11267496	5606	5606	0	RIGHT	A442.EDF	A44	2
113	11267545	11267545	5655	5655	0	RIGHT	A442.EDF	A44	2
113	11267572	11267572	5682	5682	0	RIGHT	A442.EDF	A44	2
113	11267596	11267684	5706	5794	88	RIGHT	A442.EDF	A44	2
113	11267719	11267724	5829	5834	5	RIGHT	A442.EDF	A44	2
113	11267751	11267752	5861	5862	1	RIGHT	A442.EDF	A44	2
113	11267791	11267850	5901	5960	59	RIGHT	A442.EDF	A44	2
113	11267911	11267966	6021	6076	55	RIGHT	A442.EDF	A44	2
113	11267992	11268002	6102	6112	10	RIGHT	A442.EDF	A44	2
114	11270607	11270818	57	268	211	RIGHT	A442.EDF	A44	2
114	11270903	11270984	353	434	81	RIGHT	A442.EDF	A44	2
114	11271019	11271020	469	470	1	RIGHT	A442.EDF	A44	2
114	11271044	11271044	494	494	0	RIGHT	A442.EDF	A44	2
114	11271141	11271144	591	594	3	RIGHT	A442.EDF	A44	2
114	11271177	11271216	627	666	39	RIGHT	A442.EDF	A44	2
114	11271261	11271290	711	740	29	RIGHT	A442.EDF	A44	2
114	11271379	11271393	829	843	14	RIGHT	A442.EDF	A44	2
114	11271419	11271471	869	921	52	RIGHT	A442.EDF	A44	2
114	11271597	11271597	1047	1047	0	RIGHT	A442.EDF	A44	2
114	11271624	11271660	1074	1110	36	RIGHT	A442.EDF	A44	2
114	11271707	11271743	1157	1193	36	RIGHT	A442.EDF	A44	2
114	11271778	11272080	1228	1530	302	RIGHT	A442.EDF	A44	2
114	11272103	11272149	1553	1599	46	RIGHT	A442.EDF	A44	2
114	11272178	11272199	1628	1649	21	RIGHT	A442.EDF	A44	2
114	11272233	11272305	1683	1755	72	RIGHT	A442.EDF	A44	2
114	11272397	11272397	1847	1847	0	RIGHT	A442.EDF	A44	2
114	11272441	11272442	1891	1892	1	RIGHT	A442.EDF	A44	2
114	11272559	11272559	2009	2009	0	RIGHT	A442.EDF	A44	2
114	11272637	11272638	2087	2088	1	RIGHT	A442.EDF	A44	2
114	11272674	11272674	2124	2124	0	RIGHT	A442.EDF	A44	2
114	11272841	11272878	2291	2328	37	RIGHT	A442.EDF	A44	2
114	11272899	11272957	2349	2407	58	RIGHT	A442.EDF	A44	2
114	11272980	11273014	2430	2464	34	RIGHT	A442.EDF	A44	2
114	11273108	11273109	2558	2559	1	RIGHT	A442.EDF	A44	2
114	11273150	11273157	2600	2607	7	RIGHT	A442.EDF	A44	2
114	11273190	11273190	2640	2640	0	RIGHT	A442.EDF	A44	2
114	11273247	11273247	2697	2697	0	RIGHT	A442.EDF	A44	2
114	11273274	11273274	2724	2724	0	RIGHT	A442.EDF	A44	2
114	11273297	11273299	2747	2749	2	RIGHT	A442.EDF	A44	2
114	11273346	11273367	2796	2817	21	RIGHT	A442.EDF	A44	2
114	11273398	11273736	2848	3186	338	RIGHT	A442.EDF	A44	2
114	11273760	11273790	3210	3240	30	RIGHT	A442.EDF	A44	2
114	11273831	11273842	3281	3292	11	RIGHT	A442.EDF	A44	2
114	11273873	11273873	3323	3323	0	RIGHT	A442.EDF	A44	2
114	11273908	11273935	3358	3385	27	RIGHT	A442.EDF	A44	2
114	11274059	11274066	3509	3516	7	RIGHT	A442.EDF	A44	2
114	11274189	11274205	3639	3655	16	RIGHT	A442.EDF	A44	2
114	11274249	11274249	3699	3699	0	RIGHT	A442.EDF	A44	2
114	11274286	11274297	3736	3747	11	RIGHT	A442.EDF	A44	2
114	11274325	11274334	3775	3784	9	RIGHT	A442.EDF	A44	2
114	11274458	11274458	3908	3908	0	RIGHT	A442.EDF	A44	2
114	11274496	11274496	3946	3946	0	RIGHT	A442.EDF	A44	2
114	11274527	11274546	3977	3996	19	RIGHT	A442.EDF	A44	2
114	11274604	11274604	4054	4054	0	RIGHT	A442.EDF	A44	2
114	11274685	11275213	4135	4663	528	RIGHT	A442.EDF	A44	2
114	11275244	11275437	4694	4887	193	RIGHT	A442.EDF	A44	2
114	11275473	11275854	4923	5304	381	RIGHT	A442.EDF	A44	2
114	11275927	11275957	5377	5407	30	RIGHT	A442.EDF	A44	2
115	11277696	11277714	86	104	18	RIGHT	A442.EDF	A44	2
115	11277738	11277739	128	129	1	RIGHT	A442.EDF	A44	2
115	11277768	11277796	158	186	28	RIGHT	A442.EDF	A44	2
115	11277856	11277858	246	248	2	RIGHT	A442.EDF	A44	2
115	11277985	11277985	375	375	0	RIGHT	A442.EDF	A44	2
115	11278068	11278928	458	1318	860	RIGHT	A442.EDF	A44	2
115	11278953	11278953	1343	1343	0	RIGHT	A442.EDF	A44	2
115	11278983	11279039	1373	1429	56	RIGHT	A442.EDF	A44	2
115	11279079	11279264	1469	1654	185	RIGHT	A442.EDF	A44	2
115	11279287	11279375	1677	1765	88	RIGHT	A442.EDF	A44	2
115	11279418	11279466	1808	1856	48	RIGHT	A442.EDF	A44	2
115	11279543	11279545	1933	1935	2	RIGHT	A442.EDF	A44	2
115	11279581	11279602	1971	1992	21	RIGHT	A442.EDF	A44	2
115	11279686	11279686	2076	2076	0	RIGHT	A442.EDF	A44	2
115	11279717	11279772	2107	2162	55	RIGHT	A442.EDF	A44	2
115	11280077	11280435	2467	2825	358	RIGHT	A442.EDF	A44	2
115	11280543	11281559	2933	3949	1016	RIGHT	A442.EDF	A44	2
115	11281766	11282724	4156	5114	958	RIGHT	A442.EDF	A44	2
116	11284558	11284801	76	319	243	RIGHT	A442.EDF	A44	2
116	11284822	11284822	340	340	0	RIGHT	A442.EDF	A44	2
116	11285025	11285096	543	614	71	RIGHT	A442.EDF	A44	2
116	11285134	11290556	652	6074	5422	RIGHT	A442.EDF	A44	2
117	11291734	11294023	58	2347	2289	RIGHT	A442.EDF	A44	2
117	11294263	11296590	2587	4914	2327	RIGHT	A442.EDF	A44	2
118	11298518	11301368	57	2907	2850	RIGHT	A442.EDF	A44	2
118	11301397	11301397	2936	2936	0	RIGHT	A442.EDF	A44	2
118	11301422	11301422	2961	2961	0	RIGHT	A442.EDF	A44	2
118	11301496	11302052	3035	3591	556	RIGHT	A442.EDF	A44	2
118	11302074	11302384	3613	3923	310	RIGHT	A442.EDF	A44	2
118	11302407	11302434	3946	3973	27	RIGHT	A442.EDF	A44	2
118	11302456	11304333	3995	5872	1877	RIGHT	A442.EDF	A44	2
118	11304365	11304447	5904	5986	82	RIGHT	A442.EDF	A44	2
118	11304470	11304472	6009	6011	2	RIGHT	A442.EDF	A44	2
118	11304631	11304905	6170	6444	274	RIGHT	A442.EDF	A44	2
118	11304949	11304962	6488	6501	13	RIGHT	A442.EDF	A44	2
118	11304985	11305015	6524	6554	30	RIGHT	A442.EDF	A44	2
118	11305048	11305048	6587	6587	0	RIGHT	A442.EDF	A44	2
118	11305082	11305090	6621	6629	8	RIGHT	A442.EDF	A44	2
118	11305115	11305136	6654	6675	21	RIGHT	A442.EDF	A44	2
118	11305166	11305172	6705	6711	6	RIGHT	A442.EDF	A44	2
118	11305217	11305233	6756	6772	16	RIGHT	A442.EDF	A44	2
119	11306590	11306790	57	257	200	RIGHT	A442.EDF	A44	2
119	11306819	11306841	286	308	22	RIGHT	A442.EDF	A44	2
119	11306862	11306871	329	338	9	RIGHT	A442.EDF	A44	2
119	11306950	11311789	417	5256	4839	RIGHT	A442.EDF	A44	2
120	11313656	11315692	57	2093	2036	RIGHT	A442.EDF	A44	2
120	11316426	11316426	2827	2827	0	RIGHT	A442.EDF	A44	2
120	11317153	11317556	3554	3957	403	RIGHT	A442.EDF	A44	2
120	11318621	11319398	5022	5799	777	RIGHT	A442.EDF	A44	2
120	11320309	11320512	6710	6913	203	RIGHT	A442.EDF	A44	2
1	11900640	11900694	58	112	54	RIGHT	A443.EDF	A44	3
1	11900726	11900743	144	161	17	RIGHT	A443.EDF	A44	3
1	11900764	11900826	182	244	62	RIGHT	A443.EDF	A44	3
1	11900847	11900847	265	265	0	RIGHT	A443.EDF	A44	3
1	11900870	11901060	288	478	190	RIGHT	A443.EDF	A44	3
1	11901418	11901591	836	1009	173	RIGHT	A443.EDF	A44	3
1	11901625	11901625	1043	1043	0	RIGHT	A443.EDF	A44	3
1	11901676	11901734	1094	1152	58	RIGHT	A443.EDF	A44	3
1	11901759	11901827	1177	1245	68	RIGHT	A443.EDF	A44	3
1	11901879	11902045	1297	1463	166	RIGHT	A443.EDF	A44	3
1	11902149	11902408	1567	1826	259	RIGHT	A443.EDF	A44	3
1	11902434	11907365	1852	6783	4931	RIGHT	A443.EDF	A44	3
2	11909507	11910076	57	626	569	RIGHT	A443.EDF	A44	3
2	11910098	11913394	648	3944	3296	RIGHT	A443.EDF	A44	3
2	11913459	11913459	4009	4009	0	RIGHT	A443.EDF	A44	3
2	11913502	11913502	4052	4052	0	RIGHT	A443.EDF	A44	3
2	11913620	11913620	4170	4170	0	RIGHT	A443.EDF	A44	3
2	11913982	11913983	4532	4533	1	RIGHT	A443.EDF	A44	3
2	11914008	11914008	4558	4558	0	RIGHT	A443.EDF	A44	3
2	11914029	11914034	4579	4584	5	RIGHT	A443.EDF	A44	3
2	11914062	11914079	4612	4629	17	RIGHT	A443.EDF	A44	3
2	11914102	11914142	4652	4692	40	RIGHT	A443.EDF	A44	3
2	11914168	11914169	4718	4719	1	RIGHT	A443.EDF	A44	3
2	11914225	11914226	4775	4776	1	RIGHT	A443.EDF	A44	3
2	11914257	11915640	4807	6190	1383	RIGHT	A443.EDF	A44	3
3	11917554	11918178	58	682	624	RIGHT	A443.EDF	A44	3
3	11918249	11919194	753	1698	945	RIGHT	A443.EDF	A44	3
3	11919222	11920132	1726	2636	910	RIGHT	A443.EDF	A44	3
3	11920193	11920193	2697	2697	0	RIGHT	A443.EDF	A44	3
3	11920281	11920315	2785	2819	34	RIGHT	A443.EDF	A44	3
3	11920388	11920389	2892	2893	1	RIGHT	A443.EDF	A44	3
3	11920445	11920445	2949	2949	0	RIGHT	A443.EDF	A44	3
3	11920496	11921154	3000	3658	658	RIGHT	A443.EDF	A44	3
3	11921285	11921289	3789	3793	4	RIGHT	A443.EDF	A44	3
3	11921336	11921352	3840	3856	16	RIGHT	A443.EDF	A44	3
3	11921419	11922008	3923	4512	589	RIGHT	A443.EDF	A44	3
3	11922040	11922081	4544	4585	41	RIGHT	A443.EDF	A44	3
3	11922119	11922119	4623	4623	0	RIGHT	A443.EDF	A44	3
3	11922167	11922167	4671	4671	0	RIGHT	A443.EDF	A44	3
3	11922339	11922339	4843	4843	0	RIGHT	A443.EDF	A44	3
3	11922395	11922405	4899	4909	10	RIGHT	A443.EDF	A44	3
3	11922458	11922463	4962	4967	5	RIGHT	A443.EDF	A44	3
3	11922502	11922502	5006	5006	0	RIGHT	A443.EDF	A44	3
3	11922565	11922565	5069	5069	0	RIGHT	A443.EDF	A44	3
3	11922589	11922601	5093	5105	12	RIGHT	A443.EDF	A44	3
3	11922636	11922685	5140	5189	49	RIGHT	A443.EDF	A44	3
3	11922775	11922777	5279	5281	2	RIGHT	A443.EDF	A44	3
3	11922844	11923795	5348	6299	951	RIGHT	A443.EDF	A44	3
4	11927098	11927322	57	281	224	RIGHT	A443.EDF	A44	3
4	11927344	11932641	303	5600	5297	RIGHT	A443.EDF	A44	3
5	11934814	11940906	57	6149	6092	RIGHT	A443.EDF	A44	3
6	11942495	11944114	58	1677	1619	RIGHT	A443.EDF	A44	3
6	11944139	11944139	1702	1702	0	RIGHT	A443.EDF	A44	3
6	11944213	11944228	1776	1791	15	RIGHT	A443.EDF	A44	3
6	11944332	11944348	1895	1911	16	RIGHT	A443.EDF	A44	3
6	11944372	11944987	1935	2550	615	RIGHT	A443.EDF	A44	3
6	11945018	11945019	2581	2582	1	RIGHT	A443.EDF	A44	3
6	11945078	11945082	2641	2645	4	RIGHT	A443.EDF	A44	3
6	11945134	11945134	2697	2697	0	RIGHT	A443.EDF	A44	3
6	11945200	11945208	2763	2771	8	RIGHT	A443.EDF	A44	3
6	11945235	11945235	2798	2798	0	RIGHT	A443.EDF	A44	3
6	11945300	11945300	2863	2863	0	RIGHT	A443.EDF	A44	3
6	11945462	11945462	3025	3025	0	RIGHT	A443.EDF	A44	3
6	11945488	11945505	3051	3068	17	RIGHT	A443.EDF	A44	3
6	11945827	11945840	3390	3403	13	RIGHT	A443.EDF	A44	3
6	11945930	11945932	3493	3495	2	RIGHT	A443.EDF	A44	3
6	11945970	11945970	3533	3533	0	RIGHT	A443.EDF	A44	3
6	11945993	11946000	3556	3563	7	RIGHT	A443.EDF	A44	3
6	11946021	11946022	3584	3585	1	RIGHT	A443.EDF	A44	3
6	11946130	11946170	3693	3733	40	RIGHT	A443.EDF	A44	3
6	11946211	11946222	3774	3785	11	RIGHT	A443.EDF	A44	3
6	11946248	11946254	3811	3817	6	RIGHT	A443.EDF	A44	3
6	11946521	11946521	4084	4084	0	RIGHT	A443.EDF	A44	3
6	11946548	11946548	4111	4111	0	RIGHT	A443.EDF	A44	3
6	11946592	11946592	4155	4155	0	RIGHT	A443.EDF	A44	3
6	11946672	11946685	4235	4248	13	RIGHT	A443.EDF	A44	3
6	11946755	11946758	4318	4321	3	RIGHT	A443.EDF	A44	3
6	11946795	11946796	4358	4359	1	RIGHT	A443.EDF	A44	3
6	11946826	11946841	4389	4404	15	RIGHT	A443.EDF	A44	3
6	11946868	11946879	4431	4442	11	RIGHT	A443.EDF	A44	3
6	11946959	11946959	4522	4522	0	RIGHT	A443.EDF	A44	3
6	11947009	11947026	4572	4589	17	RIGHT	A443.EDF	A44	3
6	11947096	11947406	4659	4969	310	RIGHT	A443.EDF	A44	3
6	11947427	11947429	4990	4992	2	RIGHT	A443.EDF	A44	3
6	11947456	11947457	5019	5020	1	RIGHT	A443.EDF	A44	3
6	11947490	11947497	5053	5060	7	RIGHT	A443.EDF	A44	3
6	11947625	11947904	5188	5467	279	RIGHT	A443.EDF	A44	3
6	11947927	11947973	5490	5536	46	RIGHT	A443.EDF	A44	3
6	11948000	11948001	5563	5564	1	RIGHT	A443.EDF	A44	3
6	11948069	11948097	5632	5660	28	RIGHT	A443.EDF	A44	3
6	11948134	11948134	5697	5697	0	RIGHT	A443.EDF	A44	3
6	11948159	11948187	5722	5750	28	RIGHT	A443.EDF	A44	3
6	11948219	11948219	5782	5782	0	RIGHT	A443.EDF	A44	3
6	11948292	11948346	5855	5909	54	RIGHT	A443.EDF	A44	3
6	11948370	11948394	5933	5957	24	RIGHT	A443.EDF	A44	3
6	11948484	11948484	6047	6047	0	RIGHT	A443.EDF	A44	3
6	11948516	11948517	6079	6080	1	RIGHT	A443.EDF	A44	3
6	11948594	11948594	6157	6157	0	RIGHT	A443.EDF	A44	3
6	11948637	11948638	6200	6201	1	RIGHT	A443.EDF	A44	3
6	11948826	11948827	6389	6390	1	RIGHT	A443.EDF	A44	3
6	11949537	11949601	7100	7164	64	RIGHT	A443.EDF	A44	3
7	11951663	11952001	57	395	338	RIGHT	A443.EDF	A44	3
7	11952081	11952082	475	476	1	RIGHT	A443.EDF	A44	3
7	11952279	11952279	673	673	0	RIGHT	A443.EDF	A44	3
7	11952396	11952396	790	790	0	RIGHT	A443.EDF	A44	3
7	11952431	11952431	825	825	0	RIGHT	A443.EDF	A44	3
7	11952531	11952532	925	926	1	RIGHT	A443.EDF	A44	3
7	11952745	11952745	1139	1139	0	RIGHT	A443.EDF	A44	3
7	11952797	11952799	1191	1193	2	RIGHT	A443.EDF	A44	3
7	11952834	11952852	1228	1246	18	RIGHT	A443.EDF	A44	3
7	11952927	11952929	1321	1323	2	RIGHT	A443.EDF	A44	3
7	11953222	11953222	1616	1616	0	RIGHT	A443.EDF	A44	3
7	11953257	11953328	1651	1722	71	RIGHT	A443.EDF	A44	3
7	11953411	11953444	1805	1838	33	RIGHT	A443.EDF	A44	3
7	11953476	11953492	1870	1886	16	RIGHT	A443.EDF	A44	3
7	11953513	11953577	1907	1971	64	RIGHT	A443.EDF	A44	3
7	11953620	11953620	2014	2014	0	RIGHT	A443.EDF	A44	3
7	11953641	11953642	2035	2036	1	RIGHT	A443.EDF	A44	3
7	11953663	11953679	2057	2073	16	RIGHT	A443.EDF	A44	3
7	11953706	11953706	2100	2100	0	RIGHT	A443.EDF	A44	3
7	11953734	11953743	2128	2137	9	RIGHT	A443.EDF	A44	3
7	11953764	11953764	2158	2158	0	RIGHT	A443.EDF	A44	3
7	11953799	11953814	2193	2208	15	RIGHT	A443.EDF	A44	3
7	11953844	11953853	2238	2247	9	RIGHT	A443.EDF	A44	3
7	11953894	11953894	2288	2288	0	RIGHT	A443.EDF	A44	3
7	11953922	11953922	2316	2316	0	RIGHT	A443.EDF	A44	3
7	11953993	11953993	2387	2387	0	RIGHT	A443.EDF	A44	3
7	11954099	11954111	2493	2505	12	RIGHT	A443.EDF	A44	3
7	11954182	11954733	2576	3127	551	RIGHT	A443.EDF	A44	3
7	11954819	11954819	3213	3213	0	RIGHT	A443.EDF	A44	3
7	11954932	11954932	3326	3326	0	RIGHT	A443.EDF	A44	3
7	11954986	11954986	3380	3380	0	RIGHT	A443.EDF	A44	3
7	11955031	11956126	3425	4520	1095	RIGHT	A443.EDF	A44	3
7	11956167	11956168	4561	4562	1	RIGHT	A443.EDF	A44	3
7	11956221	11956221	4615	4615	0	RIGHT	A443.EDF	A44	3
8	11957861	11958552	57	748	691	RIGHT	A443.EDF	A44	3
8	11958582	11958653	778	849	71	RIGHT	A443.EDF	A44	3
8	11958687	11958715	883	911	28	RIGHT	A443.EDF	A44	3
8	11958747	11958759	943	955	12	RIGHT	A443.EDF	A44	3
8	11958797	11959148	993	1344	351	RIGHT	A443.EDF	A44	3
8	11959195	11959195	1391	1391	0	RIGHT	A443.EDF	A44	3
8	11959271	11959291	1467	1487	20	RIGHT	A443.EDF	A44	3
8	11959333	11959335	1529	1531	2	RIGHT	A443.EDF	A44	3
8	11959403	11959743	1599	1939	340	RIGHT	A443.EDF	A44	3
8	11959800	11960428	1996	2624	628	RIGHT	A443.EDF	A44	3
8	11960460	11960471	2656	2667	11	RIGHT	A443.EDF	A44	3
8	11960626	11960629	2822	2825	3	RIGHT	A443.EDF	A44	3
8	11960737	11960758	2933	2954	21	RIGHT	A443.EDF	A44	3
8	11960805	11960805	3001	3001	0	RIGHT	A443.EDF	A44	3
8	11960914	11960932	3110	3128	18	RIGHT	A443.EDF	A44	3
8	11961008	11961019	3204	3215	11	RIGHT	A443.EDF	A44	3
8	11961103	11961103	3299	3299	0	RIGHT	A443.EDF	A44	3
8	11961392	11961392	3588	3588	0	RIGHT	A443.EDF	A44	3
8	11961801	11961801	3997	3997	0	RIGHT	A443.EDF	A44	3
8	11962016	11962016	4212	4212	0	RIGHT	A443.EDF	A44	3
8	11962254	11962628	4450	4824	374	RIGHT	A443.EDF	A44	3
8	11962709	11962709	4905	4905	0	RIGHT	A443.EDF	A44	3
9	11964652	11964653	92	93	1	RIGHT	A443.EDF	A44	3
9	11964708	11964708	148	148	0	RIGHT	A443.EDF	A44	3
9	11964730	11964746	170	186	16	RIGHT	A443.EDF	A44	3
9	11964818	11964828	258	268	10	RIGHT	A443.EDF	A44	3
9	11964853	11964853	293	293	0	RIGHT	A443.EDF	A44	3
9	11964882	11964916	322	356	34	RIGHT	A443.EDF	A44	3
9	11965047	11965047	487	487	0	RIGHT	A443.EDF	A44	3
9	11965139	11965534	579	974	395	RIGHT	A443.EDF	A44	3
9	11965559	11966219	999	1659	660	RIGHT	A443.EDF	A44	3
9	11966257	11966257	1697	1697	0	RIGHT	A443.EDF	A44	3
9	11966345	11966383	1785	1823	38	RIGHT	A443.EDF	A44	3
9	11966429	11966472	1869	1912	43	RIGHT	A443.EDF	A44	3
9	11966497	11966497	1937	1937	0	RIGHT	A443.EDF	A44	3
9	11966550	11966556	1990	1996	6	RIGHT	A443.EDF	A44	3
9	11966599	11966603	2039	2043	4	RIGHT	A443.EDF	A44	3
9	11966625	11966651	2065	2091	26	RIGHT	A443.EDF	A44	3
9	11966673	11966750	2113	2190	77	RIGHT	A443.EDF	A44	3
9	11966772	11966777	2212	2217	5	RIGHT	A443.EDF	A44	3
9	11966799	11966800	2239	2240	1	RIGHT	A443.EDF	A44	3
9	11966827	11966846	2267	2286	19	RIGHT	A443.EDF	A44	3
9	11966877	11966890	2317	2330	13	RIGHT	A443.EDF	A44	3
9	11966915	11967348	2355	2788	433	RIGHT	A443.EDF	A44	3
9	11967411	11967411	2851	2851	0	RIGHT	A443.EDF	A44	3
9	11967438	11967444	2878	2884	6	RIGHT	A443.EDF	A44	3
9	11967475	11967477	2915	2917	2	RIGHT	A443.EDF	A44	3
9	11967515	11967525	2955	2965	10	RIGHT	A443.EDF	A44	3
9	11967555	11967555	2995	2995	0	RIGHT	A443.EDF	A44	3
9	11967576	11967585	3016	3025	9	RIGHT	A443.EDF	A44	3
9	11967639	11967644	3079	3084	5	RIGHT	A443.EDF	A44	3
9	11967826	11967849	3266	3289	23	RIGHT	A443.EDF	A44	3
9	11967927	11967927	3367	3367	0	RIGHT	A443.EDF	A44	3
9	11967955	11967955	3395	3395	0	RIGHT	A443.EDF	A44	3
9	11968019	11968056	3459	3496	37	RIGHT	A443.EDF	A44	3
9	11968113	11968113	3553	3553	0	RIGHT	A443.EDF	A44	3
9	11968140	11968491	3580	3931	351	RIGHT	A443.EDF	A44	3
9	11968586	11968586	4026	4026	0	RIGHT	A443.EDF	A44	3
9	11968608	11968618	4048	4058	10	RIGHT	A443.EDF	A44	3
9	11968669	11968669	4109	4109	0	RIGHT	A443.EDF	A44	3
9	11968777	11969095	4217	4535	318	RIGHT	A443.EDF	A44	3
9	11969117	11969448	4557	4888	331	RIGHT	A443.EDF	A44	3
9	11969533	11969533	4973	4973	0	RIGHT	A443.EDF	A44	3
9	11969589	11969589	5029	5029	0	RIGHT	A443.EDF	A44	3
9	11969646	11969659	5086	5099	13	RIGHT	A443.EDF	A44	3
9	11969689	11969690	5129	5130	1	RIGHT	A443.EDF	A44	3
9	11969873	11970223	5313	5663	350	RIGHT	A443.EDF	A44	3
9	11970253	11970434	5693	5874	181	RIGHT	A443.EDF	A44	3
10	11972268	11972562	58	352	294	RIGHT	A443.EDF	A44	3
10	11972585	11972585	375	375	0	RIGHT	A443.EDF	A44	3
10	11972669	11972670	459	460	1	RIGHT	A443.EDF	A44	3
10	11972709	11972709	499	499	0	RIGHT	A443.EDF	A44	3
10	11972743	11972744	533	534	1	RIGHT	A443.EDF	A44	3
10	11972811	11972823	601	613	12	RIGHT	A443.EDF	A44	3
10	11972882	11972895	672	685	13	RIGHT	A443.EDF	A44	3
10	11973016	11973016	806	806	0	RIGHT	A443.EDF	A44	3
10	11973042	11973053	832	843	11	RIGHT	A443.EDF	A44	3
10	11973464	11973470	1254	1260	6	RIGHT	A443.EDF	A44	3
10	11973526	11973526	1316	1316	0	RIGHT	A443.EDF	A44	3
10	11973550	11973582	1340	1372	32	RIGHT	A443.EDF	A44	3
10	11973724	11973732	1514	1522	8	RIGHT	A443.EDF	A44	3
10	11973981	11973981	1771	1771	0	RIGHT	A443.EDF	A44	3
10	11974002	11974002	1792	1792	0	RIGHT	A443.EDF	A44	3
10	11974051	11974052	1841	1842	1	RIGHT	A443.EDF	A44	3
10	11974303	11974371	2093	2161	68	RIGHT	A443.EDF	A44	3
10	11974402	11974405	2192	2195	3	RIGHT	A443.EDF	A44	3
10	11974457	11974518	2247	2308	61	RIGHT	A443.EDF	A44	3
10	11974551	11974580	2341	2370	29	RIGHT	A443.EDF	A44	3
10	11974601	11974760	2391	2550	159	RIGHT	A443.EDF	A44	3
10	11974814	11974825	2604	2615	11	RIGHT	A443.EDF	A44	3
10	11974864	11974864	2654	2654	0	RIGHT	A443.EDF	A44	3
10	11974940	11974959	2730	2749	19	RIGHT	A443.EDF	A44	3
10	11974987	11975180	2777	2970	193	RIGHT	A443.EDF	A44	3
10	11975201	11975559	2991	3349	358	RIGHT	A443.EDF	A44	3
10	11975625	11975628	3415	3418	3	RIGHT	A443.EDF	A44	3
10	11975736	11975736	3526	3526	0	RIGHT	A443.EDF	A44	3
10	11976049	11976590	3839	4380	541	RIGHT	A443.EDF	A44	3
10	11976613	11976652	4403	4442	39	RIGHT	A443.EDF	A44	3
10	11976710	11976745	4500	4535	35	RIGHT	A443.EDF	A44	3
10	11976767	11976767	4557	4557	0	RIGHT	A443.EDF	A44	3
10	11976798	11976798	4588	4588	0	RIGHT	A443.EDF	A44	3
10	11976820	11976849	4610	4639	29	RIGHT	A443.EDF	A44	3
10	11976885	11976889	4675	4679	4	RIGHT	A443.EDF	A44	3
10	11976937	11977284	4727	5074	347	RIGHT	A443.EDF	A44	3
10	11977305	11977322	5095	5112	17	RIGHT	A443.EDF	A44	3
10	11977344	11977345	5134	5135	1	RIGHT	A443.EDF	A44	3
10	11977379	11977692	5169	5482	313	RIGHT	A443.EDF	A44	3
10	11977754	11977755	5544	5545	1	RIGHT	A443.EDF	A44	3
10	11977787	11977793	5577	5583	6	RIGHT	A443.EDF	A44	3
10	11977855	11978078	5645	5868	223	RIGHT	A443.EDF	A44	3
10	11978100	11978161	5890	5951	61	RIGHT	A443.EDF	A44	3
10	11978213	11978233	6003	6023	20	RIGHT	A443.EDF	A44	3
10	11978254	11978256	6044	6046	2	RIGHT	A443.EDF	A44	3
10	11978279	11978619	6069	6409	340	RIGHT	A443.EDF	A44	3
11	11981346	11981653	57	364	307	RIGHT	A443.EDF	A44	3
11	11981676	11982193	387	904	517	RIGHT	A443.EDF	A44	3
11	11982474	11982766	1185	1477	292	RIGHT	A443.EDF	A44	3
11	11982794	11983906	1505	2617	1112	RIGHT	A443.EDF	A44	3
11	11983931	11983949	2642	2660	18	RIGHT	A443.EDF	A44	3
11	11983978	11984012	2689	2723	34	RIGHT	A443.EDF	A44	3
11	11984055	11984055	2766	2766	0	RIGHT	A443.EDF	A44	3
11	11984127	11984129	2838	2840	2	RIGHT	A443.EDF	A44	3
11	11984234	11984239	2945	2950	5	RIGHT	A443.EDF	A44	3
11	11984379	11984380	3090	3091	1	RIGHT	A443.EDF	A44	3
11	11984418	11984418	3129	3129	0	RIGHT	A443.EDF	A44	3
11	11984714	11984753	3425	3464	39	RIGHT	A443.EDF	A44	3
11	11984788	11984819	3499	3530	31	RIGHT	A443.EDF	A44	3
11	11984845	11984869	3556	3580	24	RIGHT	A443.EDF	A44	3
11	11984971	11984971	3682	3682	0	RIGHT	A443.EDF	A44	3
11	11985004	11985005	3715	3716	1	RIGHT	A443.EDF	A44	3
11	11985158	11985169	3869	3880	11	RIGHT	A443.EDF	A44	3
11	11985207	11985534	3918	4245	327	RIGHT	A443.EDF	A44	3
11	11985581	11985595	4292	4306	14	RIGHT	A443.EDF	A44	3
11	11985768	11985776	4479	4487	8	RIGHT	A443.EDF	A44	3
11	11985815	11985815	4526	4526	0	RIGHT	A443.EDF	A44	3
11	11985915	11986339	4626	5050	424	RIGHT	A443.EDF	A44	3
11	11986369	11986379	5080	5090	10	RIGHT	A443.EDF	A44	3
11	11986540	11986541	5251	5252	1	RIGHT	A443.EDF	A44	3
11	11986806	11986807	5517	5518	1	RIGHT	A443.EDF	A44	3
11	11986873	11987610	5584	6321	737	RIGHT	A443.EDF	A44	3
11	11987638	11987707	6349	6418	69	RIGHT	A443.EDF	A44	3
11	11987733	11987776	6444	6487	43	RIGHT	A443.EDF	A44	3
11	11987800	11987809	6511	6520	9	RIGHT	A443.EDF	A44	3
11	11987852	11987909	6563	6620	57	RIGHT	A443.EDF	A44	3
11	11987938	11987998	6649	6709	60	RIGHT	A443.EDF	A44	3
11	11988025	11988036	6736	6747	11	RIGHT	A443.EDF	A44	3
11	11988065	11988084	6776	6795	19	RIGHT	A443.EDF	A44	3
11	11988111	11988455	6822	7166	344	RIGHT	A443.EDF	A44	3
12	11990699	11990987	57	345	288	RIGHT	A443.EDF	A44	3
12	11991009	11991010	367	368	1	RIGHT	A443.EDF	A44	3
12	11991035	11991036	393	394	1	RIGHT	A443.EDF	A44	3
12	11991074	11991516	432	874	442	RIGHT	A443.EDF	A44	3
12	11991548	11992026	906	1384	478	RIGHT	A443.EDF	A44	3
12	11992056	11992073	1414	1431	17	RIGHT	A443.EDF	A44	3
12	11992121	11992283	1479	1641	162	RIGHT	A443.EDF	A44	3
12	11992334	11992408	1692	1766	74	RIGHT	A443.EDF	A44	3
12	11992430	11992909	1788	2267	479	RIGHT	A443.EDF	A44	3
12	11992931	11992938	2289	2296	7	RIGHT	A443.EDF	A44	3
12	11992968	11993031	2326	2389	63	RIGHT	A443.EDF	A44	3
12	11993071	11993092	2429	2450	21	RIGHT	A443.EDF	A44	3
12	11993124	11993370	2482	2728	246	RIGHT	A443.EDF	A44	3
12	11993391	11993391	2749	2749	0	RIGHT	A443.EDF	A44	3
12	11993415	11993881	2773	3239	466	RIGHT	A443.EDF	A44	3
12	11993925	11993928	3283	3286	3	RIGHT	A443.EDF	A44	3
12	11993978	11993978	3336	3336	0	RIGHT	A443.EDF	A44	3
12	11994061	11994066	3419	3424	5	RIGHT	A443.EDF	A44	3
12	11994131	11994165	3489	3523	34	RIGHT	A443.EDF	A44	3
12	11994202	11994202	3560	3560	0	RIGHT	A443.EDF	A44	3
12	11994237	11994246	3595	3604	9	RIGHT	A443.EDF	A44	3
12	11994315	11994315	3673	3673	0	RIGHT	A443.EDF	A44	3
12	11994344	11994349	3702	3707	5	RIGHT	A443.EDF	A44	3
12	11994372	11994375	3730	3733	3	RIGHT	A443.EDF	A44	3
12	11994405	11994411	3763	3769	6	RIGHT	A443.EDF	A44	3
12	11994464	11994465	3822	3823	1	RIGHT	A443.EDF	A44	3
12	11994513	11994521	3871	3879	8	RIGHT	A443.EDF	A44	3
12	11994552	11994553	3910	3911	1	RIGHT	A443.EDF	A44	3
12	11994581	11994894	3939	4252	313	RIGHT	A443.EDF	A44	3
12	11994954	11994958	4312	4316	4	RIGHT	A443.EDF	A44	3
12	11994999	11995035	4357	4393	36	RIGHT	A443.EDF	A44	3
12	11995138	11995138	4496	4496	0	RIGHT	A443.EDF	A44	3
12	11995163	11995983	4521	5341	820	RIGHT	A443.EDF	A44	3
12	11996062	11996097	5420	5455	35	RIGHT	A443.EDF	A44	3
12	11996119	11996119	5477	5477	0	RIGHT	A443.EDF	A44	3
12	11996160	11996160	5518	5518	0	RIGHT	A443.EDF	A44	3
12	11996276	11996276	5634	5634	0	RIGHT	A443.EDF	A44	3
12	11996306	11996830	5664	6188	524	RIGHT	A443.EDF	A44	3
13	11998814	11999545	57	788	731	RIGHT	A443.EDF	A44	3
13	11999599	11999599	842	842	0	RIGHT	A443.EDF	A44	3
13	11999657	11999682	900	925	25	RIGHT	A443.EDF	A44	3
13	11999848	11999849	1091	1092	1	RIGHT	A443.EDF	A44	3
13	11999896	11999896	1139	1139	0	RIGHT	A443.EDF	A44	3
13	11999933	11999970	1176	1213	37	RIGHT	A443.EDF	A44	3
13	11999999	12000013	1242	1256	14	RIGHT	A443.EDF	A44	3
13	12000045	12000154	1288	1397	109	RIGHT	A443.EDF	A44	3
13	12000183	12002389	1426	3632	2206	RIGHT	A443.EDF	A44	3
13	12002413	12002456	3656	3699	43	RIGHT	A443.EDF	A44	3
13	12002490	12003191	3733	4434	701	RIGHT	A443.EDF	A44	3
13	12003222	12003313	4465	4556	91	RIGHT	A443.EDF	A44	3
13	12003415	12003424	4658	4667	9	RIGHT	A443.EDF	A44	3
13	12003456	12003483	4699	4726	27	RIGHT	A443.EDF	A44	3
13	12003510	12003524	4753	4767	14	RIGHT	A443.EDF	A44	3
13	12003551	12003564	4794	4807	13	RIGHT	A443.EDF	A44	3
13	12003594	12003666	4837	4909	72	RIGHT	A443.EDF	A44	3
13	12003704	12003705	4947	4948	1	RIGHT	A443.EDF	A44	3
13	12003737	12003880	4980	5123	143	RIGHT	A443.EDF	A44	3
13	12003902	12003937	5145	5180	35	RIGHT	A443.EDF	A44	3
13	12003964	12003968	5207	5211	4	RIGHT	A443.EDF	A44	3
13	12004008	12004010	5251	5253	2	RIGHT	A443.EDF	A44	3
13	12004050	12004050	5293	5293	0	RIGHT	A443.EDF	A44	3
13	12004074	12004088	5317	5331	14	RIGHT	A443.EDF	A44	3
13	12004120	12004492	5363	5735	372	RIGHT	A443.EDF	A44	3
13	12004520	12004536	5763	5779	16	RIGHT	A443.EDF	A44	3
13	12004565	12004565	5808	5808	0	RIGHT	A443.EDF	A44	3
13	12004636	12004636	5879	5879	0	RIGHT	A443.EDF	A44	3
13	12004682	12004682	5925	5925	0	RIGHT	A443.EDF	A44	3
13	12004719	12004719	5962	5962	0	RIGHT	A443.EDF	A44	3
13	12004753	12004775	5996	6018	22	RIGHT	A443.EDF	A44	3
13	12004810	12004823	6053	6066	13	RIGHT	A443.EDF	A44	3
13	12004854	12004898	6097	6141	44	RIGHT	A443.EDF	A44	3
13	12004921	12004940	6164	6183	19	RIGHT	A443.EDF	A44	3
13	12004988	12005015	6231	6258	27	RIGHT	A443.EDF	A44	3
13	12005053	12005053	6296	6296	0	RIGHT	A443.EDF	A44	3
13	12005100	12005100	6343	6343	0	RIGHT	A443.EDF	A44	3
13	12005152	12005192	6395	6435	40	RIGHT	A443.EDF	A44	3
13	12005216	12005240	6459	6483	24	RIGHT	A443.EDF	A44	3
13	12005276	12005295	6519	6538	19	RIGHT	A443.EDF	A44	3
13	12005329	12006107	6572	7350	778	RIGHT	A443.EDF	A44	3
14	12007990	12007990	121	121	0	RIGHT	A443.EDF	A44	3
14	12008030	12008274	161	405	244	RIGHT	A443.EDF	A44	3
14	12008345	12008688	476	819	343	RIGHT	A443.EDF	A44	3
14	12008748	12008748	879	879	0	RIGHT	A443.EDF	A44	3
14	12008954	12008970	1085	1101	16	RIGHT	A443.EDF	A44	3
14	12009017	12009019	1148	1150	2	RIGHT	A443.EDF	A44	3
14	12009194	12009194	1325	1325	0	RIGHT	A443.EDF	A44	3
14	12009222	12009242	1353	1373	20	RIGHT	A443.EDF	A44	3
14	12009292	12009293	1423	1424	1	RIGHT	A443.EDF	A44	3
14	12009326	12009326	1457	1457	0	RIGHT	A443.EDF	A44	3
14	12009355	12009363	1486	1494	8	RIGHT	A443.EDF	A44	3
14	12009394	12009553	1525	1684	159	RIGHT	A443.EDF	A44	3
14	12009580	12010010	1711	2141	430	RIGHT	A443.EDF	A44	3
14	12010052	12010053	2183	2184	1	RIGHT	A443.EDF	A44	3
14	12010103	12010105	2234	2236	2	RIGHT	A443.EDF	A44	3
14	12010156	12010163	2287	2294	7	RIGHT	A443.EDF	A44	3
14	12010210	12010227	2341	2358	17	RIGHT	A443.EDF	A44	3
14	12010318	12010318	2449	2449	0	RIGHT	A443.EDF	A44	3
14	12010347	12010367	2478	2498	20	RIGHT	A443.EDF	A44	3
14	12010397	12010397	2528	2528	0	RIGHT	A443.EDF	A44	3
14	12010428	12010428	2559	2559	0	RIGHT	A443.EDF	A44	3
14	12010467	12010524	2598	2655	57	RIGHT	A443.EDF	A44	3
14	12010563	12010582	2694	2713	19	RIGHT	A443.EDF	A44	3
14	12010631	12010915	2762	3046	284	RIGHT	A443.EDF	A44	3
14	12010941	12010942	3072	3073	1	RIGHT	A443.EDF	A44	3
14	12010974	12011006	3105	3137	32	RIGHT	A443.EDF	A44	3
14	12011067	12011070	3198	3201	3	RIGHT	A443.EDF	A44	3
14	12011120	12011120	3251	3251	0	RIGHT	A443.EDF	A44	3
14	12011213	12011274	3344	3405	61	RIGHT	A443.EDF	A44	3
14	12011407	12011408	3538	3539	1	RIGHT	A443.EDF	A44	3
14	12011445	12011446	3576	3577	1	RIGHT	A443.EDF	A44	3
14	12011600	12011607	3731	3738	7	RIGHT	A443.EDF	A44	3
14	12011656	12011703	3787	3834	47	RIGHT	A443.EDF	A44	3
14	12011746	12011788	3877	3919	42	RIGHT	A443.EDF	A44	3
14	12011809	12011867	3940	3998	58	RIGHT	A443.EDF	A44	3
14	12011888	12011911	4019	4042	23	RIGHT	A443.EDF	A44	3
14	12011944	12012301	4075	4432	357	RIGHT	A443.EDF	A44	3
14	12012323	12014093	4454	6224	1770	RIGHT	A443.EDF	A44	3
14	12014137	12014138	6268	6269	1	RIGHT	A443.EDF	A44	3
14	12014229	12014229	6360	6360	0	RIGHT	A443.EDF	A44	3
14	12014274	12014274	6405	6405	0	RIGHT	A443.EDF	A44	3
14	12014398	12014572	6529	6703	174	RIGHT	A443.EDF	A44	3
14	12014594	12014964	6725	7095	370	RIGHT	A443.EDF	A44	3
14	12015007	12015007	7138	7138	0	RIGHT	A443.EDF	A44	3
14	12015107	12015112	7238	7243	5	RIGHT	A443.EDF	A44	3
15	12016820	12018278	57	1515	1458	RIGHT	A443.EDF	A44	3
15	12018340	12018374	1577	1611	34	RIGHT	A443.EDF	A44	3
15	12018442	12018442	1679	1679	0	RIGHT	A443.EDF	A44	3
15	12018525	12018526	1762	1763	1	RIGHT	A443.EDF	A44	3
15	12018604	12018604	1841	1841	0	RIGHT	A443.EDF	A44	3
15	12018654	12019571	1891	2808	917	RIGHT	A443.EDF	A44	3
15	12019601	12020232	2838	3469	631	RIGHT	A443.EDF	A44	3
15	12020257	12020275	3494	3512	18	RIGHT	A443.EDF	A44	3
15	12020329	12020330	3566	3567	1	RIGHT	A443.EDF	A44	3
15	12020363	12020363	3600	3600	0	RIGHT	A443.EDF	A44	3
15	12020384	12020386	3621	3623	2	RIGHT	A443.EDF	A44	3
15	12020480	12020485	3717	3722	5	RIGHT	A443.EDF	A44	3
15	12020622	12020624	3859	3861	2	RIGHT	A443.EDF	A44	3
15	12021222	12021222	4459	4459	0	RIGHT	A443.EDF	A44	3
15	12021263	12021653	4500	4890	390	RIGHT	A443.EDF	A44	3
15	12021704	12021704	4941	4941	0	RIGHT	A443.EDF	A44	3
15	12021935	12021935	5172	5172	0	RIGHT	A443.EDF	A44	3
15	12021999	12021999	5236	5236	0	RIGHT	A443.EDF	A44	3
15	12022029	12022047	5266	5284	18	RIGHT	A443.EDF	A44	3
15	12022068	12022073	5305	5310	5	RIGHT	A443.EDF	A44	3
15	12022095	12022495	5332	5732	400	RIGHT	A443.EDF	A44	3
15	12022534	12022536	5771	5773	2	RIGHT	A443.EDF	A44	3
15	12022557	12022577	5794	5814	20	RIGHT	A443.EDF	A44	3
15	12022598	12023266	5835	6503	668	RIGHT	A443.EDF	A44	3
16	12025253	12026746	74	1567	1493	RIGHT	A443.EDF	A44	3
16	12026768	12026770	1589	1591	2	RIGHT	A443.EDF	A44	3
16	12026799	12026799	1620	1620	0	RIGHT	A443.EDF	A44	3
16	12026831	12026831	1652	1652	0	RIGHT	A443.EDF	A44	3
16	12026855	12026855	1676	1676	0	RIGHT	A443.EDF	A44	3
16	12026932	12026932	1753	1753	0	RIGHT	A443.EDF	A44	3
16	12026993	12026994	1814	1815	1	RIGHT	A443.EDF	A44	3
16	12027035	12027036	1856	1857	1	RIGHT	A443.EDF	A44	3
16	12027062	12027109	1883	1930	47	RIGHT	A443.EDF	A44	3
16	12027189	12027196	2010	2017	7	RIGHT	A443.EDF	A44	3
16	12027218	12027227	2039	2048	9	RIGHT	A443.EDF	A44	3
16	12027261	12027535	2082	2356	274	RIGHT	A443.EDF	A44	3
16	12027796	12028081	2617	2902	285	RIGHT	A443.EDF	A44	3
16	12028165	12028322	2986	3143	157	RIGHT	A443.EDF	A44	3
16	12028483	12028644	3304	3465	161	RIGHT	A443.EDF	A44	3
16	12028785	12028856	3606	3677	71	RIGHT	A443.EDF	A44	3
16	12028887	12028903	3708	3724	16	RIGHT	A443.EDF	A44	3
16	12028929	12028930	3750	3751	1	RIGHT	A443.EDF	A44	3
16	12029002	12029028	3823	3849	26	RIGHT	A443.EDF	A44	3
16	12029110	12029611	3931	4432	501	RIGHT	A443.EDF	A44	3
16	12030146	12030247	4967	5068	101	RIGHT	A443.EDF	A44	3
16	12030389	12030456	5210	5277	67	RIGHT	A443.EDF	A44	3
16	12030646	12030647	5467	5468	1	RIGHT	A443.EDF	A44	3
16	12030673	12030698	5494	5519	25	RIGHT	A443.EDF	A44	3
17	12032390	12032564	58	232	174	RIGHT	A443.EDF	A44	3
17	12032816	12032843	484	511	27	RIGHT	A443.EDF	A44	3
17	12032908	12033145	576	813	237	RIGHT	A443.EDF	A44	3
17	12033228	12034853	896	2521	1625	RIGHT	A443.EDF	A44	3
17	12035472	12035472	3140	3140	0	RIGHT	A443.EDF	A44	3
17	12035653	12035654	3321	3322	1	RIGHT	A443.EDF	A44	3
17	12035704	12035725	3372	3393	21	RIGHT	A443.EDF	A44	3
17	12035761	12035767	3429	3435	6	RIGHT	A443.EDF	A44	3
17	12035821	12035844	3489	3512	23	RIGHT	A443.EDF	A44	3
17	12035894	12035978	3562	3646	84	RIGHT	A443.EDF	A44	3
17	12036001	12036033	3669	3701	32	RIGHT	A443.EDF	A44	3
17	12036060	12036270	3728	3938	210	RIGHT	A443.EDF	A44	3
17	12036303	12036368	3971	4036	65	RIGHT	A443.EDF	A44	3
17	12036391	12036741	4059	4409	350	RIGHT	A443.EDF	A44	3
17	12036768	12036768	4436	4436	0	RIGHT	A443.EDF	A44	3
17	12036791	12036808	4459	4476	17	RIGHT	A443.EDF	A44	3
17	12036836	12036840	4504	4508	4	RIGHT	A443.EDF	A44	3
17	12036867	12036888	4535	4556	21	RIGHT	A443.EDF	A44	3
17	12036935	12036935	4603	4603	0	RIGHT	A443.EDF	A44	3
17	12037002	12037013	4670	4681	11	RIGHT	A443.EDF	A44	3
17	12037046	12037047	4714	4715	1	RIGHT	A443.EDF	A44	3
17	12037076	12037097	4744	4765	21	RIGHT	A443.EDF	A44	3
17	12037136	12037187	4804	4855	51	RIGHT	A443.EDF	A44	3
17	12037251	12037617	4919	5285	366	RIGHT	A443.EDF	A44	3
17	12037656	12037701	5324	5369	45	RIGHT	A443.EDF	A44	3
17	12037737	12037753	5405	5421	16	RIGHT	A443.EDF	A44	3
17	12037779	12037880	5447	5548	101	RIGHT	A443.EDF	A44	3
17	12037909	12037911	5577	5579	2	RIGHT	A443.EDF	A44	3
17	12037933	12038055	5601	5723	122	RIGHT	A443.EDF	A44	3
18	12041119	12041301	71	253	182	RIGHT	A443.EDF	A44	3
18	12041329	12041331	281	283	2	RIGHT	A443.EDF	A44	3
18	12041373	12041419	325	371	46	RIGHT	A443.EDF	A44	3
18	12041442	12042652	394	1604	1210	RIGHT	A443.EDF	A44	3
18	12042691	12042714	1643	1666	23	RIGHT	A443.EDF	A44	3
18	12042741	12042769	1693	1721	28	RIGHT	A443.EDF	A44	3
18	12042796	12042976	1748	1928	180	RIGHT	A443.EDF	A44	3
18	12043038	12043438	1990	2390	400	RIGHT	A443.EDF	A44	3
18	12043459	12043460	2411	2412	1	RIGHT	A443.EDF	A44	3
18	12043519	12043520	2471	2472	1	RIGHT	A443.EDF	A44	3
18	12044153	12044207	3105	3159	54	RIGHT	A443.EDF	A44	3
18	12044238	12044296	3190	3248	58	RIGHT	A443.EDF	A44	3
18	12044319	12045110	3271	4062	791	RIGHT	A443.EDF	A44	3
18	12045135	12045191	4087	4143	56	RIGHT	A443.EDF	A44	3
18	12045246	12045365	4198	4317	119	RIGHT	A443.EDF	A44	3
18	12045398	12045415	4350	4367	17	RIGHT	A443.EDF	A44	3
18	12045436	12045486	4388	4438	50	RIGHT	A443.EDF	A44	3
18	12045509	12045512	4461	4464	3	RIGHT	A443.EDF	A44	3
18	12045535	12045555	4487	4507	20	RIGHT	A443.EDF	A44	3
18	12045578	12045644	4530	4596	66	RIGHT	A443.EDF	A44	3
18	12045676	12045705	4628	4657	29	RIGHT	A443.EDF	A44	3
18	12045755	12045756	4707	4708	1	RIGHT	A443.EDF	A44	3
18	12045777	12045778	4729	4730	1	RIGHT	A443.EDF	A44	3
18	12045803	12045804	4755	4756	1	RIGHT	A443.EDF	A44	3
18	12045946	12046029	4898	4981	83	RIGHT	A443.EDF	A44	3
18	12046053	12046511	5005	5463	458	RIGHT	A443.EDF	A44	3
18	12046537	12046612	5489	5564	75	RIGHT	A443.EDF	A44	3
18	12046635	12046647	5587	5599	12	RIGHT	A443.EDF	A44	3
18	12046673	12047004	5625	5956	331	RIGHT	A443.EDF	A44	3
18	12047025	12047531	5977	6483	506	RIGHT	A443.EDF	A44	3
19	12049440	12049630	57	247	190	RIGHT	A443.EDF	A44	3
19	12049833	12049833	450	450	0	RIGHT	A443.EDF	A44	3
19	12049860	12050703	477	1320	843	RIGHT	A443.EDF	A44	3
19	12050724	12050724	1341	1341	0	RIGHT	A443.EDF	A44	3
19	12050748	12050749	1365	1366	1	RIGHT	A443.EDF	A44	3
19	12050802	12050802	1419	1419	0	RIGHT	A443.EDF	A44	3
19	12050977	12050977	1594	1594	0	RIGHT	A443.EDF	A44	3
19	12051157	12051171	1774	1788	14	RIGHT	A443.EDF	A44	3
19	12051202	12051202	1819	1819	0	RIGHT	A443.EDF	A44	3
19	12051255	12051255	1872	1872	0	RIGHT	A443.EDF	A44	3
19	12051900	12051901	2517	2518	1	RIGHT	A443.EDF	A44	3
19	12051987	12051988	2604	2605	1	RIGHT	A443.EDF	A44	3
19	12052121	12052129	2738	2746	8	RIGHT	A443.EDF	A44	3
19	12052161	12052162	2778	2779	1	RIGHT	A443.EDF	A44	3
19	12052183	12052205	2800	2822	22	RIGHT	A443.EDF	A44	3
19	12052229	12052263	2846	2880	34	RIGHT	A443.EDF	A44	3
19	12052305	12052315	2922	2932	10	RIGHT	A443.EDF	A44	3
19	12052337	12052393	2954	3010	56	RIGHT	A443.EDF	A44	3
19	12052414	12053285	3031	3902	871	RIGHT	A443.EDF	A44	3
19	12053424	12053938	4041	4555	514	RIGHT	A443.EDF	A44	3
19	12053981	12054066	4598	4683	85	RIGHT	A443.EDF	A44	3
19	12054094	12054228	4711	4845	134	RIGHT	A443.EDF	A44	3
19	12054250	12054294	4867	4911	44	RIGHT	A443.EDF	A44	3
19	12054317	12054341	4934	4958	24	RIGHT	A443.EDF	A44	3
19	12054375	12054395	4992	5012	20	RIGHT	A443.EDF	A44	3
19	12054582	12054582	5199	5199	0	RIGHT	A443.EDF	A44	3
19	12054662	12055227	5279	5844	565	RIGHT	A443.EDF	A44	3
20	12056936	12057129	59	252	193	RIGHT	A443.EDF	A44	3
20	12057156	12057192	279	315	36	RIGHT	A443.EDF	A44	3
20	12057241	12057728	364	851	487	RIGHT	A443.EDF	A44	3
20	12057761	12058176	884	1299	415	RIGHT	A443.EDF	A44	3
20	12058201	12058205	1324	1328	4	RIGHT	A443.EDF	A44	3
20	12058301	12058317	1424	1440	16	RIGHT	A443.EDF	A44	3
20	12058371	12058372	1494	1495	1	RIGHT	A443.EDF	A44	3
20	12058400	12058400	1523	1523	0	RIGHT	A443.EDF	A44	3
20	12058450	12058484	1573	1607	34	RIGHT	A443.EDF	A44	3
20	12058524	12058524	1647	1647	0	RIGHT	A443.EDF	A44	3
20	12058567	12058578	1690	1701	11	RIGHT	A443.EDF	A44	3
20	12058601	12058650	1724	1773	49	RIGHT	A443.EDF	A44	3
20	12059599	12059600	2722	2723	1	RIGHT	A443.EDF	A44	3
20	12060095	12060098	3218	3221	3	RIGHT	A443.EDF	A44	3
20	12060408	12060408	3531	3531	0	RIGHT	A443.EDF	A44	3
20	12060656	12060656	3779	3779	0	RIGHT	A443.EDF	A44	3
20	12060698	12060698	3821	3821	0	RIGHT	A443.EDF	A44	3
20	12060856	12060911	3979	4034	55	RIGHT	A443.EDF	A44	3
20	12060943	12060943	4066	4066	0	RIGHT	A443.EDF	A44	3
20	12060965	12060965	4088	4088	0	RIGHT	A443.EDF	A44	3
20	12061011	12061016	4134	4139	5	RIGHT	A443.EDF	A44	3
20	12061049	12061086	4172	4209	37	RIGHT	A443.EDF	A44	3
20	12061119	12061156	4242	4279	37	RIGHT	A443.EDF	A44	3
20	12061184	12061209	4307	4332	25	RIGHT	A443.EDF	A44	3
20	12061237	12061276	4360	4399	39	RIGHT	A443.EDF	A44	3
20	12061303	12061312	4426	4435	9	RIGHT	A443.EDF	A44	3
20	12061342	12061344	4465	4467	2	RIGHT	A443.EDF	A44	3
20	12061399	12061417	4522	4540	18	RIGHT	A443.EDF	A44	3
20	12061450	12061469	4573	4592	19	RIGHT	A443.EDF	A44	3
20	12061493	12061503	4616	4626	10	RIGHT	A443.EDF	A44	3
20	12061553	12061553	4676	4676	0	RIGHT	A443.EDF	A44	3
20	12061591	12061831	4714	4954	240	RIGHT	A443.EDF	A44	3
21	12063650	12064073	57	480	423	RIGHT	A443.EDF	A44	3
21	12064100	12064503	507	910	403	RIGHT	A443.EDF	A44	3
21	12064526	12064527	933	934	1	RIGHT	A443.EDF	A44	3
21	12064580	12064580	987	987	0	RIGHT	A443.EDF	A44	3
21	12064659	12064659	1066	1066	0	RIGHT	A443.EDF	A44	3
21	12064700	12064730	1107	1137	30	RIGHT	A443.EDF	A44	3
21	12064783	12064789	1190	1196	6	RIGHT	A443.EDF	A44	3
21	12064832	12064832	1239	1239	0	RIGHT	A443.EDF	A44	3
21	12064858	12064860	1265	1267	2	RIGHT	A443.EDF	A44	3
21	12064884	12064908	1291	1315	24	RIGHT	A443.EDF	A44	3
21	12064933	12064986	1340	1393	53	RIGHT	A443.EDF	A44	3
21	12065194	12065350	1601	1757	156	RIGHT	A443.EDF	A44	3
21	12065385	12065386	1792	1793	1	RIGHT	A443.EDF	A44	3
21	12065435	12065882	1842	2289	447	RIGHT	A443.EDF	A44	3
21	12065911	12065914	2318	2321	3	RIGHT	A443.EDF	A44	3
21	12065938	12065966	2345	2373	28	RIGHT	A443.EDF	A44	3
21	12065991	12066051	2398	2458	60	RIGHT	A443.EDF	A44	3
21	12066119	12066134	2526	2541	15	RIGHT	A443.EDF	A44	3
21	12066179	12066185	2586	2592	6	RIGHT	A443.EDF	A44	3
21	12066223	12066234	2630	2641	11	RIGHT	A443.EDF	A44	3
21	12066359	12066368	2766	2775	9	RIGHT	A443.EDF	A44	3
21	12066411	12066457	2818	2864	46	RIGHT	A443.EDF	A44	3
21	12066478	12066533	2885	2940	55	RIGHT	A443.EDF	A44	3
21	12066563	12066606	2970	3013	43	RIGHT	A443.EDF	A44	3
21	12066631	12066711	3038	3118	80	RIGHT	A443.EDF	A44	3
21	12066737	12066753	3144	3160	16	RIGHT	A443.EDF	A44	3
21	12066783	12066784	3190	3191	1	RIGHT	A443.EDF	A44	3
21	12066810	12066824	3217	3231	14	RIGHT	A443.EDF	A44	3
21	12066852	12066899	3259	3306	47	RIGHT	A443.EDF	A44	3
21	12067191	12067191	3598	3598	0	RIGHT	A443.EDF	A44	3
21	12067291	12067291	3698	3698	0	RIGHT	A443.EDF	A44	3
21	12067386	12067387	3793	3794	1	RIGHT	A443.EDF	A44	3
21	12067430	12067443	3837	3850	13	RIGHT	A443.EDF	A44	3
21	12067500	12067501	3907	3908	1	RIGHT	A443.EDF	A44	3
21	12067599	12067662	4006	4069	63	RIGHT	A443.EDF	A44	3
21	12067683	12067807	4090	4214	124	RIGHT	A443.EDF	A44	3
21	12067830	12067859	4237	4266	29	RIGHT	A443.EDF	A44	3
21	12067880	12067922	4287	4329	42	RIGHT	A443.EDF	A44	3
21	12067951	12068022	4358	4429	71	RIGHT	A443.EDF	A44	3
21	12068048	12068230	4455	4637	182	RIGHT	A443.EDF	A44	3
21	12068265	12068577	4672	4984	312	RIGHT	A443.EDF	A44	3
21	12068612	12068709	5019	5116	97	RIGHT	A443.EDF	A44	3
21	12068753	12068814	5160	5221	61	RIGHT	A443.EDF	A44	3
22	12070619	12071234	58	673	615	RIGHT	A443.EDF	A44	3
22	12071260	12071313	699	752	53	RIGHT	A443.EDF	A44	3
22	12071341	12071400	780	839	59	RIGHT	A443.EDF	A44	3
22	12071424	12071481	863	920	57	RIGHT	A443.EDF	A44	3
22	12071503	12071507	942	946	4	RIGHT	A443.EDF	A44	3
22	12071531	12071551	970	990	20	RIGHT	A443.EDF	A44	3
22	12071600	12071669	1039	1108	69	RIGHT	A443.EDF	A44	3
22	12071697	12071744	1136	1183	47	RIGHT	A443.EDF	A44	3
22	12071777	12071863	1216	1302	86	RIGHT	A443.EDF	A44	3
22	12071906	12071938	1345	1377	32	RIGHT	A443.EDF	A44	3
22	12071959	12071976	1398	1415	17	RIGHT	A443.EDF	A44	3
22	12072004	12072019	1443	1458	15	RIGHT	A443.EDF	A44	3
22	12072040	12072043	1479	1482	3	RIGHT	A443.EDF	A44	3
22	12072079	12072088	1518	1527	9	RIGHT	A443.EDF	A44	3
22	12072111	12072133	1550	1572	22	RIGHT	A443.EDF	A44	3
22	12072160	12072162	1599	1601	2	RIGHT	A443.EDF	A44	3
22	12072183	12072183	1622	1622	0	RIGHT	A443.EDF	A44	3
22	12072228	12072231	1667	1670	3	RIGHT	A443.EDF	A44	3
22	12072271	12072272	1710	1711	1	RIGHT	A443.EDF	A44	3
22	12072293	12072293	1732	1732	0	RIGHT	A443.EDF	A44	3
22	12072328	12072329	1767	1768	1	RIGHT	A443.EDF	A44	3
22	12072385	12072481	1824	1920	96	RIGHT	A443.EDF	A44	3
22	12073240	12073492	2679	2931	252	RIGHT	A443.EDF	A44	3
22	12074727	12074727	4166	4166	0	RIGHT	A443.EDF	A44	3
22	12074781	12074808	4220	4247	27	RIGHT	A443.EDF	A44	3
22	12074829	12074848	4268	4287	19	RIGHT	A443.EDF	A44	3
22	12074874	12074877	4313	4316	3	RIGHT	A443.EDF	A44	3
22	12074906	12075033	4345	4472	127	RIGHT	A443.EDF	A44	3
22	12075061	12075065	4500	4504	4	RIGHT	A443.EDF	A44	3
22	12075090	12075193	4529	4632	103	RIGHT	A443.EDF	A44	3
22	12075226	12075260	4665	4699	34	RIGHT	A443.EDF	A44	3
22	12075282	12075289	4721	4728	7	RIGHT	A443.EDF	A44	3
22	12075310	12075310	4749	4749	0	RIGHT	A443.EDF	A44	3
22	12075339	12075387	4778	4826	48	RIGHT	A443.EDF	A44	3
22	12075408	12075412	4847	4851	4	RIGHT	A443.EDF	A44	3
22	12075437	12075631	4876	5070	194	RIGHT	A443.EDF	A44	3
22	12075657	12075916	5096	5355	259	RIGHT	A443.EDF	A44	3
22	12075962	12076036	5401	5475	74	RIGHT	A443.EDF	A44	3
22	12076075	12076124	5514	5563	49	RIGHT	A443.EDF	A44	3
22	12076168	12076184	5607	5623	16	RIGHT	A443.EDF	A44	3
22	12076219	12076639	5658	6078	420	RIGHT	A443.EDF	A44	3
23	12078330	12078330	82	82	0	RIGHT	A443.EDF	A44	3
23	12078728	12079002	480	754	274	RIGHT	A443.EDF	A44	3
23	12079068	12079068	820	820	0	RIGHT	A443.EDF	A44	3
23	12079094	12079101	846	853	7	RIGHT	A443.EDF	A44	3
23	12079123	12079156	875	908	33	RIGHT	A443.EDF	A44	3
23	12079183	12079251	935	1003	68	RIGHT	A443.EDF	A44	3
23	12079285	12079285	1037	1037	0	RIGHT	A443.EDF	A44	3
23	12079321	12079334	1073	1086	13	RIGHT	A443.EDF	A44	3
23	12079355	12079356	1107	1108	1	RIGHT	A443.EDF	A44	3
23	12079421	12079441	1173	1193	20	RIGHT	A443.EDF	A44	3
23	12079467	12079625	1219	1377	158	RIGHT	A443.EDF	A44	3
23	12079656	12079776	1408	1528	120	RIGHT	A443.EDF	A44	3
23	12079800	12079821	1552	1573	21	RIGHT	A443.EDF	A44	3
23	12079842	12080130	1594	1882	288	RIGHT	A443.EDF	A44	3
23	12080156	12080161	1908	1913	5	RIGHT	A443.EDF	A44	3
23	12080199	12080314	1951	2066	115	RIGHT	A443.EDF	A44	3
23	12080346	12080355	2098	2107	9	RIGHT	A443.EDF	A44	3
23	12080391	12080393	2143	2145	2	RIGHT	A443.EDF	A44	3
23	12081023	12081024	2775	2776	1	RIGHT	A443.EDF	A44	3
23	12081063	12081198	2815	2950	135	RIGHT	A443.EDF	A44	3
23	12081231	12081233	2983	2985	2	RIGHT	A443.EDF	A44	3
23	12081273	12081311	3025	3063	38	RIGHT	A443.EDF	A44	3
23	12081333	12081346	3085	3098	13	RIGHT	A443.EDF	A44	3
23	12081380	12081383	3132	3135	3	RIGHT	A443.EDF	A44	3
23	12081419	12081429	3171	3181	10	RIGHT	A443.EDF	A44	3
23	12081498	12081499	3250	3251	1	RIGHT	A443.EDF	A44	3
23	12081549	12081569	3301	3321	20	RIGHT	A443.EDF	A44	3
23	12081603	12081639	3355	3391	36	RIGHT	A443.EDF	A44	3
23	12081663	12081674	3415	3426	11	RIGHT	A443.EDF	A44	3
23	12081713	12081715	3465	3467	2	RIGHT	A443.EDF	A44	3
23	12081748	12081749	3500	3501	1	RIGHT	A443.EDF	A44	3
23	12081777	12081777	3529	3529	0	RIGHT	A443.EDF	A44	3
23	12081810	12081980	3562	3732	170	RIGHT	A443.EDF	A44	3
23	12082246	12082273	3998	4025	27	RIGHT	A443.EDF	A44	3
23	12082301	12082311	4053	4063	10	RIGHT	A443.EDF	A44	3
23	12082343	12082374	4095	4126	31	RIGHT	A443.EDF	A44	3
23	12082443	12082446	4195	4198	3	RIGHT	A443.EDF	A44	3
23	12082486	12084644	4238	6396	2158	RIGHT	A443.EDF	A44	3
24	12086264	12086307	58	101	43	RIGHT	A443.EDF	A44	3
24	12086419	12091980	213	5774	5561	RIGHT	A443.EDF	A44	3
25	12093758	12094122	57	421	364	RIGHT	A443.EDF	A44	3
25	12094167	12094168	466	467	1	RIGHT	A443.EDF	A44	3
25	12094199	12099643	498	5942	5444	RIGHT	A443.EDF	A44	3
26	12101624	12108549	57	6982	6925	RIGHT	A443.EDF	A44	3
27	12110979	12116934	58	6013	5955	RIGHT	A443.EDF	A44	3
28	12118625	12118808	58	241	183	RIGHT	A443.EDF	A44	3
28	12118837	12118935	270	368	98	RIGHT	A443.EDF	A44	3
28	12118980	12119006	413	439	26	RIGHT	A443.EDF	A44	3
28	12119028	12119095	461	528	67	RIGHT	A443.EDF	A44	3
28	12119140	12119140	573	573	0	RIGHT	A443.EDF	A44	3
28	12119173	12124459	606	5892	5286	RIGHT	A443.EDF	A44	3
29	12125887	12131313	57	5483	5426	RIGHT	A443.EDF	A44	3
30	12133263	12139368	58	6163	6105	RIGHT	A443.EDF	A44	3
31	12141686	12147483	57	5854	5797	RIGHT	A443.EDF	A44	3
32	12149391	12155308	58	5975	5917	RIGHT	A443.EDF	A44	3
33	12157610	12163183	58	5631	5573	RIGHT	A443.EDF	A44	3
34	12164700	12169376	57	4733	4676	RIGHT	A443.EDF	A44	3
35	12172254	12173183	57	986	929	RIGHT	A443.EDF	A44	3
35	12173212	12173225	1015	1028	13	RIGHT	A443.EDF	A44	3
35	12173250	12173271	1053	1074	21	RIGHT	A443.EDF	A44	3
35	12173305	12174595	1108	2398	1290	RIGHT	A443.EDF	A44	3
35	12174709	12176652	2512	4455	1943	RIGHT	A443.EDF	A44	3
35	12176684	12176745	4487	4548	61	RIGHT	A443.EDF	A44	3
35	12176802	12176819	4605	4622	17	RIGHT	A443.EDF	A44	3
35	12176888	12176899	4691	4702	11	RIGHT	A443.EDF	A44	3
35	12176948	12176949	4751	4752	1	RIGHT	A443.EDF	A44	3
35	12176985	12176985	4788	4788	0	RIGHT	A443.EDF	A44	3
35	12177023	12177024	4826	4827	1	RIGHT	A443.EDF	A44	3
35	12177103	12177109	4906	4912	6	RIGHT	A443.EDF	A44	3
35	12177238	12177238	5041	5041	0	RIGHT	A443.EDF	A44	3
35	12177325	12177325	5128	5128	0	RIGHT	A443.EDF	A44	3
35	12177423	12177789	5226	5592	366	RIGHT	A443.EDF	A44	3
35	12177816	12178211	5619	6014	395	RIGHT	A443.EDF	A44	3
35	12178259	12178278	6062	6081	19	RIGHT	A443.EDF	A44	3
35	12178625	12178682	6428	6485	57	RIGHT	A443.EDF	A44	3
36	12180233	12180882	60	709	649	RIGHT	A443.EDF	A44	3
36	12180903	12181339	730	1166	436	RIGHT	A443.EDF	A44	3
36	12181365	12181365	1192	1192	0	RIGHT	A443.EDF	A44	3
36	12181409	12181467	1236	1294	58	RIGHT	A443.EDF	A44	3
36	12181508	12182433	1335	2260	925	RIGHT	A443.EDF	A44	3
36	12182541	12183770	2368	3597	1229	RIGHT	A443.EDF	A44	3
36	12183791	12183798	3618	3625	7	RIGHT	A443.EDF	A44	3
36	12183840	12183840	3667	3667	0	RIGHT	A443.EDF	A44	3
36	12183930	12183937	3757	3764	7	RIGHT	A443.EDF	A44	3
36	12183990	12186057	3817	5884	2067	RIGHT	A443.EDF	A44	3
37	12188389	12188390	121	122	1	RIGHT	A443.EDF	A44	3
37	12188561	12188562	293	294	1	RIGHT	A443.EDF	A44	3
37	12188589	12188590	321	322	1	RIGHT	A443.EDF	A44	3
37	12188638	12188645	370	377	7	RIGHT	A443.EDF	A44	3
37	12188680	12188681	412	413	1	RIGHT	A443.EDF	A44	3
37	12188720	12190843	452	2575	2123	RIGHT	A443.EDF	A44	3
37	12190868	12194032	2600	5764	3164	RIGHT	A443.EDF	A44	3
38	12196043	12201586	57	5600	5543	RIGHT	A443.EDF	A44	3
39	12203126	12207679	68	4621	4553	RIGHT	A443.EDF	A44	3
39	12207708	12207728	4650	4670	20	RIGHT	A443.EDF	A44	3
39	12207756	12208110	4698	5052	354	RIGHT	A443.EDF	A44	3
40	12210010	12215134	57	5181	5124	RIGHT	A443.EDF	A44	3
41	12216763	12222099	57	5393	5336	RIGHT	A443.EDF	A44	3
42	12223609	12225042	59	1492	1433	RIGHT	A443.EDF	A44	3
42	12225096	12226977	1546	3427	1881	RIGHT	A443.EDF	A44	3
42	12227311	12228693	3761	5143	1382	RIGHT	A443.EDF	A44	3
42	12228720	12228720	5170	5170	0	RIGHT	A443.EDF	A44	3
42	12228745	12228776	5195	5226	31	RIGHT	A443.EDF	A44	3
42	12228803	12229953	5253	6403	1150	RIGHT	A443.EDF	A44	3
43	12231603	12238479	58	6934	6876	RIGHT	A443.EDF	A44	3
44	12240008	12242352	57	2401	2344	RIGHT	A443.EDF	A44	3
44	12242387	12242401	2436	2450	14	RIGHT	A443.EDF	A44	3
44	12242426	12245373	2475	5422	2947	RIGHT	A443.EDF	A44	3
45	12247023	12247155	58	190	132	RIGHT	A443.EDF	A44	3
45	12247179	12247183	214	218	4	RIGHT	A443.EDF	A44	3
45	12247216	12247232	251	267	16	RIGHT	A443.EDF	A44	3
45	12247253	12247318	288	353	65	RIGHT	A443.EDF	A44	3
45	12247341	12253968	376	7003	6627	RIGHT	A443.EDF	A44	3
46	12255639	12261643	69	6073	6004	RIGHT	A443.EDF	A44	3
47	12263390	12265577	57	2244	2187	RIGHT	A443.EDF	A44	3
47	12265604	12265617	2271	2284	13	RIGHT	A443.EDF	A44	3
47	12265776	12265777	2443	2444	1	RIGHT	A443.EDF	A44	3
47	12265901	12265901	2568	2568	0	RIGHT	A443.EDF	A44	3
47	12265933	12265942	2600	2609	9	RIGHT	A443.EDF	A44	3
47	12265965	12265966	2632	2633	1	RIGHT	A443.EDF	A44	3
47	12266000	12266035	2667	2702	35	RIGHT	A443.EDF	A44	3
47	12266066	12269498	2733	6165	3432	RIGHT	A443.EDF	A44	3
48	12271813	12276199	57	4443	4386	RIGHT	A443.EDF	A44	3
48	12276225	12276225	4469	4469	0	RIGHT	A443.EDF	A44	3
48	12276258	12278283	4502	6527	2025	RIGHT	A443.EDF	A44	3
49	12280277	12284342	57	4122	4065	RIGHT	A443.EDF	A44	3
49	12284391	12285239	4171	5019	848	RIGHT	A443.EDF	A44	3
49	12285265	12285336	5045	5116	71	RIGHT	A443.EDF	A44	3
49	12285366	12285378	5146	5158	12	RIGHT	A443.EDF	A44	3
50	12288090	12288090	92	92	0	RIGHT	A443.EDF	A44	3
50	12288122	12294964	124	6966	6842	RIGHT	A443.EDF	A44	3
51	12297361	12298495	57	1191	1134	RIGHT	A443.EDF	A44	3
51	12298517	12298532	1213	1228	15	RIGHT	A443.EDF	A44	3
51	12298553	12299992	1249	2688	1439	RIGHT	A443.EDF	A44	3
51	12300065	12300134	2761	2830	69	RIGHT	A443.EDF	A44	3
51	12300160	12300905	2856	3601	745	RIGHT	A443.EDF	A44	3
51	12300926	12301004	3622	3700	78	RIGHT	A443.EDF	A44	3
51	12301036	12301988	3732	4684	952	RIGHT	A443.EDF	A44	3
51	12302019	12302027	4715	4723	8	RIGHT	A443.EDF	A44	3
51	12302078	12302078	4774	4774	0	RIGHT	A443.EDF	A44	3
51	12302109	12302115	4805	4811	6	RIGHT	A443.EDF	A44	3
51	12302151	12302193	4847	4889	42	RIGHT	A443.EDF	A44	3
51	12302223	12302223	4919	4919	0	RIGHT	A443.EDF	A44	3
51	12302259	12302259	4955	4955	0	RIGHT	A443.EDF	A44	3
51	12302286	12302303	4982	4999	17	RIGHT	A443.EDF	A44	3
51	12302342	12302342	5038	5038	0	RIGHT	A443.EDF	A44	3
51	12302378	12302401	5074	5097	23	RIGHT	A443.EDF	A44	3
51	12302428	12304199	5124	6895	1771	RIGHT	A443.EDF	A44	3
52	12305946	12306336	57	447	390	RIGHT	A443.EDF	A44	3
52	12306395	12306698	506	809	303	RIGHT	A443.EDF	A44	3
52	12306749	12306805	860	916	56	RIGHT	A443.EDF	A44	3
52	12306840	12306917	951	1028	77	RIGHT	A443.EDF	A44	3
52	12306941	12306945	1052	1056	4	RIGHT	A443.EDF	A44	3
52	12306996	12306996	1107	1107	0	RIGHT	A443.EDF	A44	3
52	12307041	12307157	1152	1268	116	RIGHT	A443.EDF	A44	3
52	12307188	12307309	1299	1420	121	RIGHT	A443.EDF	A44	3
52	12307337	12307680	1448	1791	343	RIGHT	A443.EDF	A44	3
52	12307724	12308061	1835	2172	337	RIGHT	A443.EDF	A44	3
52	12308097	12308554	2208	2665	457	RIGHT	A443.EDF	A44	3
52	12308577	12309623	2688	3734	1046	RIGHT	A443.EDF	A44	3
52	12309649	12309667	3760	3778	18	RIGHT	A443.EDF	A44	3
52	12309691	12309763	3802	3874	72	RIGHT	A443.EDF	A44	3
52	12309784	12311254	3895	5365	1470	RIGHT	A443.EDF	A44	3
53	12312993	12313184	57	248	191	RIGHT	A443.EDF	A44	3
53	12313210	12313648	274	712	438	RIGHT	A443.EDF	A44	3
53	12313679	12313751	743	815	72	RIGHT	A443.EDF	A44	3
53	12313789	12313936	853	1000	147	RIGHT	A443.EDF	A44	3
53	12313978	12314050	1042	1114	72	RIGHT	A443.EDF	A44	3
53	12314092	12314214	1156	1278	122	RIGHT	A443.EDF	A44	3
53	12314264	12314349	1328	1413	85	RIGHT	A443.EDF	A44	3
53	12314404	12316021	1468	3085	1617	RIGHT	A443.EDF	A44	3
53	12316064	12316088	3128	3152	24	RIGHT	A443.EDF	A44	3
53	12316109	12316182	3173	3246	73	RIGHT	A443.EDF	A44	3
53	12316206	12316292	3270	3356	86	RIGHT	A443.EDF	A44	3
53	12316317	12316342	3381	3406	25	RIGHT	A443.EDF	A44	3
53	12316378	12316378	3442	3442	0	RIGHT	A443.EDF	A44	3
53	12316410	12316924	3474	3988	514	RIGHT	A443.EDF	A44	3
53	12316947	12317999	4011	5063	1052	RIGHT	A443.EDF	A44	3
53	12318020	12319329	5084	6393	1309	RIGHT	A443.EDF	A44	3
54	12320788	12325713	69	4994	4925	RIGHT	A443.EDF	A44	3
55	12327493	12329977	58	2542	2484	RIGHT	A443.EDF	A44	3
55	12329999	12330015	2564	2580	16	RIGHT	A443.EDF	A44	3
55	12330041	12330079	2606	2644	38	RIGHT	A443.EDF	A44	3
55	12330129	12330348	2694	2913	219	RIGHT	A443.EDF	A44	3
55	12330472	12330477	3037	3042	5	RIGHT	A443.EDF	A44	3
55	12330504	12332687	3069	5252	2183	RIGHT	A443.EDF	A44	3
56	12334366	12336621	57	2312	2255	RIGHT	A443.EDF	A44	3
56	12336654	12336677	2345	2368	23	RIGHT	A443.EDF	A44	3
56	12336706	12339821	2397	5512	3115	RIGHT	A443.EDF	A44	3
57	12342507	12348036	58	5587	5529	RIGHT	A443.EDF	A44	3
58	12350105	12352240	58	2193	2135	RIGHT	A443.EDF	A44	3
58	12352280	12352292	2233	2245	12	RIGHT	A443.EDF	A44	3
58	12352328	12352329	2281	2282	1	RIGHT	A443.EDF	A44	3
58	12352481	12356501	2434	6454	4020	RIGHT	A443.EDF	A44	3
59	12358680	12363666	57	5043	4986	RIGHT	A443.EDF	A44	3
60	12365519	12365555	92	128	36	RIGHT	A443.EDF	A44	3
60	12365589	12365648	162	221	59	RIGHT	A443.EDF	A44	3
60	12365687	12365690	260	263	3	RIGHT	A443.EDF	A44	3
60	12365742	12365742	315	315	0	RIGHT	A443.EDF	A44	3
60	12365798	12365817	371	390	19	RIGHT	A443.EDF	A44	3
60	12365873	12366493	446	1066	620	RIGHT	A443.EDF	A44	3
60	12366515	12367654	1088	2227	1139	RIGHT	A443.EDF	A44	3
60	12367767	12370750	2340	5323	2983	RIGHT	A443.EDF	A44	3
61	12372863	12375618	57	2812	2755	RIGHT	A443.EDF	A44	3
61	12375641	12375654	2835	2848	13	RIGHT	A443.EDF	A44	3
61	12375692	12378385	2886	5579	2693	RIGHT	A443.EDF	A44	3
62	12380034	12381837	57	1860	1803	RIGHT	A443.EDF	A44	3
62	12381861	12382161	1884	2184	300	RIGHT	A443.EDF	A44	3
62	12382194	12382197	2217	2220	3	RIGHT	A443.EDF	A44	3
62	12382229	12385820	2252	5843	3591	RIGHT	A443.EDF	A44	3
63	12387894	12393654	71	5831	5760	RIGHT	A443.EDF	A44	3
64	12395550	12398823	58	3331	3273	RIGHT	A443.EDF	A44	3
64	12398848	12398932	3356	3440	84	RIGHT	A443.EDF	A44	3
64	12398956	12398957	3464	3465	1	RIGHT	A443.EDF	A44	3
64	12399309	12399337	3817	3845	28	RIGHT	A443.EDF	A44	3
64	12399362	12399903	3870	4411	541	RIGHT	A443.EDF	A44	3
64	12400034	12400035	4542	4543	1	RIGHT	A443.EDF	A44	3
64	12400144	12400150	4652	4658	6	RIGHT	A443.EDF	A44	3
64	12400175	12400183	4683	4691	8	RIGHT	A443.EDF	A44	3
64	12400223	12400224	4731	4732	1	RIGHT	A443.EDF	A44	3
64	12400256	12400285	4764	4793	29	RIGHT	A443.EDF	A44	3
64	12400310	12400310	4818	4818	0	RIGHT	A443.EDF	A44	3
64	12400344	12400344	4852	4852	0	RIGHT	A443.EDF	A44	3
64	12400371	12400521	4879	5029	150	RIGHT	A443.EDF	A44	3
65	12402597	12408483	58	5944	5886	RIGHT	A443.EDF	A44	3
66	12410103	12417549	58	7504	7446	RIGHT	A443.EDF	A44	3
67	12419931	12425724	57	5850	5793	RIGHT	A443.EDF	A44	3
68	12427514	12430066	58	2610	2552	RIGHT	A443.EDF	A44	3
68	12430087	12430089	2631	2633	2	RIGHT	A443.EDF	A44	3
68	12430115	12434209	2659	6753	4094	RIGHT	A443.EDF	A44	3
69	12436018	12441674	57	5713	5656	RIGHT	A443.EDF	A44	3
70	12444383	12450139	57	5813	5756	RIGHT	A443.EDF	A44	3
71	12451938	12456014	57	4133	4076	RIGHT	A443.EDF	A44	3
71	12456038	12458405	4157	6524	2367	RIGHT	A443.EDF	A44	3
72	12460234	12462466	58	2290	2232	RIGHT	A443.EDF	A44	3
72	12462495	12462495	2319	2319	0	RIGHT	A443.EDF	A44	3
72	12462761	12462803	2585	2627	42	RIGHT	A443.EDF	A44	3
72	12462826	12462865	2650	2689	39	RIGHT	A443.EDF	A44	3
72	12462893	12466079	2717	5903	3186	RIGHT	A443.EDF	A44	3
73	12467940	12468235	57	352	295	RIGHT	A443.EDF	A44	3
73	12468259	12473754	376	5871	5495	RIGHT	A443.EDF	A44	3
74	12475522	12478242	58	2778	2720	RIGHT	A443.EDF	A44	3
74	12478270	12478712	2806	3248	442	RIGHT	A443.EDF	A44	3
74	12478733	12478974	3269	3510	241	RIGHT	A443.EDF	A44	3
74	12478995	12479687	3531	4223	692	RIGHT	A443.EDF	A44	3
74	12479713	12479804	4249	4340	91	RIGHT	A443.EDF	A44	3
74	12479832	12480169	4368	4705	337	RIGHT	A443.EDF	A44	3
74	12480534	12480776	5070	5312	242	RIGHT	A443.EDF	A44	3
74	12481783	12482219	6319	6755	436	RIGHT	A443.EDF	A44	3
75	12484139	12484421	149	431	282	RIGHT	A443.EDF	A44	3
75	12485440	12485441	1450	1451	1	RIGHT	A443.EDF	A44	3
75	12485507	12485507	1517	1517	0	RIGHT	A443.EDF	A44	3
75	12485578	12485579	1588	1589	1	RIGHT	A443.EDF	A44	3
75	12485610	12485620	1620	1630	10	RIGHT	A443.EDF	A44	3
75	12486214	12486872	2224	2882	658	RIGHT	A443.EDF	A44	3
75	12488487	12488830	4497	4840	343	RIGHT	A443.EDF	A44	3
75	12490838	12490924	6848	6934	86	RIGHT	A443.EDF	A44	3
76	12492754	12493000	57	303	246	RIGHT	A443.EDF	A44	3
76	12493196	12497498	499	4801	4302	RIGHT	A443.EDF	A44	3
77	12499368	12500411	58	1101	1043	RIGHT	A443.EDF	A44	3
77	12500434	12501964	1124	2654	1530	RIGHT	A443.EDF	A44	3
77	12502002	12502149	2692	2839	147	RIGHT	A443.EDF	A44	3
77	12502175	12502669	2865	3359	494	RIGHT	A443.EDF	A44	3
77	12502696	12506204	3386	6894	3508	RIGHT	A443.EDF	A44	3
77	12506225	12506281	6915	6971	56	RIGHT	A443.EDF	A44	3
77	12506305	12506305	6995	6995	0	RIGHT	A443.EDF	A44	3
77	12506363	12506363	7053	7053	0	RIGHT	A443.EDF	A44	3
77	12506427	12506496	7117	7186	69	RIGHT	A443.EDF	A44	3
77	12506530	12506530	7220	7220	0	RIGHT	A443.EDF	A44	3
77	12506551	12506557	7241	7247	6	RIGHT	A443.EDF	A44	3
77	12506596	12506634	7286	7324	38	RIGHT	A443.EDF	A44	3
78	12508447	12509315	58	926	868	RIGHT	A443.EDF	A44	3
78	12509341	12511299	952	2910	1958	RIGHT	A443.EDF	A44	3
78	12511338	12511338	2949	2949	0	RIGHT	A443.EDF	A44	3
78	12511367	12511566	2978	3177	199	RIGHT	A443.EDF	A44	3
78	12511595	12512163	3206	3774	568	RIGHT	A443.EDF	A44	3
78	12512191	12512194	3802	3805	3	RIGHT	A443.EDF	A44	3
78	12512220	12512222	3831	3833	2	RIGHT	A443.EDF	A44	3
78	12512244	12512244	3855	3855	0	RIGHT	A443.EDF	A44	3
78	12512278	12512284	3889	3895	6	RIGHT	A443.EDF	A44	3
78	12512309	12512309	3920	3920	0	RIGHT	A443.EDF	A44	3
78	12512394	12513334	4005	4945	940	RIGHT	A443.EDF	A44	3
78	12513362	12513425	4973	5036	63	RIGHT	A443.EDF	A44	3
78	12513468	12513481	5079	5092	13	RIGHT	A443.EDF	A44	3
78	12513531	12513531	5142	5142	0	RIGHT	A443.EDF	A44	3
78	12513555	12513579	5166	5190	24	RIGHT	A443.EDF	A44	3
78	12513612	12513612	5223	5223	0	RIGHT	A443.EDF	A44	3
78	12513671	12513692	5282	5303	21	RIGHT	A443.EDF	A44	3
78	12513729	12513729	5340	5340	0	RIGHT	A443.EDF	A44	3
78	12513755	12513759	5366	5370	4	RIGHT	A443.EDF	A44	3
78	12513796	12513800	5407	5411	4	RIGHT	A443.EDF	A44	3
78	12513823	12513825	5434	5436	2	RIGHT	A443.EDF	A44	3
78	12513848	12515159	5459	6770	1311	RIGHT	A443.EDF	A44	3
79	12517098	12519296	57	2255	2198	RIGHT	A443.EDF	A44	3
79	12519336	12519703	2295	2662	367	RIGHT	A443.EDF	A44	3
79	12519755	12519782	2714	2741	27	RIGHT	A443.EDF	A44	3
79	12519818	12522332	2777	5291	2514	RIGHT	A443.EDF	A44	3
79	12522357	12522406	5316	5365	49	RIGHT	A443.EDF	A44	3
79	12522428	12522429	5387	5388	1	RIGHT	A443.EDF	A44	3
79	12522450	12522488	5409	5447	38	RIGHT	A443.EDF	A44	3
79	12522509	12523795	5468	6754	1286	RIGHT	A443.EDF	A44	3
80	12525813	12526475	57	719	662	RIGHT	A443.EDF	A44	3
80	12526499	12529514	743	3758	3015	RIGHT	A443.EDF	A44	3
80	12529545	12529545	3789	3789	0	RIGHT	A443.EDF	A44	3
80	12529568	12530499	3812	4743	931	RIGHT	A443.EDF	A44	3
81	12532285	12532616	57	388	331	RIGHT	A443.EDF	A44	3
81	12532641	12534455	413	2227	1814	RIGHT	A443.EDF	A44	3
81	12534937	12534937	2709	2709	0	RIGHT	A443.EDF	A44	3
81	12534972	12535158	2744	2930	186	RIGHT	A443.EDF	A44	3
81	12535184	12539074	2956	6846	3890	RIGHT	A443.EDF	A44	3
82	12540561	12547119	58	6616	6558	RIGHT	A443.EDF	A44	3
83	12549212	12549248	123	159	36	RIGHT	A443.EDF	A44	3
83	12549278	12549279	189	190	1	RIGHT	A443.EDF	A44	3
83	12549363	12549375	274	286	12	RIGHT	A443.EDF	A44	3
83	12549400	12549400	311	311	0	RIGHT	A443.EDF	A44	3
83	12549425	12549477	336	388	52	RIGHT	A443.EDF	A44	3
83	12549519	12549519	430	430	0	RIGHT	A443.EDF	A44	3
83	12549583	12551238	494	2149	1655	RIGHT	A443.EDF	A44	3
83	12551268	12551945	2179	2856	677	RIGHT	A443.EDF	A44	3
83	12552313	12552464	3224	3375	151	RIGHT	A443.EDF	A44	3
83	12552496	12552524	3407	3435	28	RIGHT	A443.EDF	A44	3
83	12552547	12552615	3458	3526	68	RIGHT	A443.EDF	A44	3
83	12552642	12552643	3553	3554	1	RIGHT	A443.EDF	A44	3
83	12552671	12552671	3582	3582	0	RIGHT	A443.EDF	A44	3
83	12552716	12552716	3627	3627	0	RIGHT	A443.EDF	A44	3
83	12552776	12552776	3687	3687	0	RIGHT	A443.EDF	A44	3
83	12553190	12553195	4101	4106	5	RIGHT	A443.EDF	A44	3
83	12553217	12553410	4128	4321	193	RIGHT	A443.EDF	A44	3
83	12553442	12553473	4353	4384	31	RIGHT	A443.EDF	A44	3
83	12553504	12553529	4415	4440	25	RIGHT	A443.EDF	A44	3
83	12553552	12553559	4463	4470	7	RIGHT	A443.EDF	A44	3
83	12553586	12553605	4497	4516	19	RIGHT	A443.EDF	A44	3
83	12553649	12553670	4560	4581	21	RIGHT	A443.EDF	A44	3
83	12553739	12553740	4650	4651	1	RIGHT	A443.EDF	A44	3
83	12553803	12553805	4714	4716	2	RIGHT	A443.EDF	A44	3
83	12553828	12553842	4739	4753	14	RIGHT	A443.EDF	A44	3
83	12553864	12553990	4775	4901	126	RIGHT	A443.EDF	A44	3
83	12554018	12554062	4929	4973	44	RIGHT	A443.EDF	A44	3
83	12554719	12554719	5630	5630	0	RIGHT	A443.EDF	A44	3
83	12555240	12555240	6151	6151	0	RIGHT	A443.EDF	A44	3
83	12555266	12555266	6177	6177	0	RIGHT	A443.EDF	A44	3
83	12555306	12555306	6217	6217	0	RIGHT	A443.EDF	A44	3
83	12555365	12555854	6276	6765	489	RIGHT	A443.EDF	A44	3
84	12557505	12559746	57	2298	2241	RIGHT	A443.EDF	A44	3
84	12559826	12559847	2378	2399	21	RIGHT	A443.EDF	A44	3
84	12559876	12559904	2428	2456	28	RIGHT	A443.EDF	A44	3
84	12559927	12559942	2479	2494	15	RIGHT	A443.EDF	A44	3
84	12559967	12559979	2519	2531	12	RIGHT	A443.EDF	A44	3
84	12560058	12560065	2610	2617	7	RIGHT	A443.EDF	A44	3
84	12560720	12561292	3272	3844	572	RIGHT	A443.EDF	A44	3
84	12561407	12561407	3959	3959	0	RIGHT	A443.EDF	A44	3
84	12561455	12561460	4007	4012	5	RIGHT	A443.EDF	A44	3
84	12561734	12561734	4286	4286	0	RIGHT	A443.EDF	A44	3
84	12562434	12562539	4986	5091	105	RIGHT	A443.EDF	A44	3
84	12562924	12563120	5476	5672	196	RIGHT	A443.EDF	A44	3
85	12565006	12565090	57	141	84	RIGHT	A443.EDF	A44	3
85	12565252	12565274	303	325	22	RIGHT	A443.EDF	A44	3
85	12565376	12565376	427	427	0	RIGHT	A443.EDF	A44	3
85	12565400	12565440	451	491	40	RIGHT	A443.EDF	A44	3
85	12565479	12565494	530	545	15	RIGHT	A443.EDF	A44	3
85	12565516	12565517	567	568	1	RIGHT	A443.EDF	A44	3
85	12565543	12565544	594	595	1	RIGHT	A443.EDF	A44	3
85	12565703	12565703	754	754	0	RIGHT	A443.EDF	A44	3
85	12565726	12565726	777	777	0	RIGHT	A443.EDF	A44	3
85	12565805	12565805	856	856	0	RIGHT	A443.EDF	A44	3
85	12565839	12567088	890	2139	1249	RIGHT	A443.EDF	A44	3
85	12568012	12568012	3063	3063	0	RIGHT	A443.EDF	A44	3
85	12568216	12568216	3267	3267	0	RIGHT	A443.EDF	A44	3
85	12568320	12568320	3371	3371	0	RIGHT	A443.EDF	A44	3
85	12568366	12568366	3417	3417	0	RIGHT	A443.EDF	A44	3
85	12568389	12568407	3440	3458	18	RIGHT	A443.EDF	A44	3
85	12568497	12568499	3548	3550	2	RIGHT	A443.EDF	A44	3
85	12568545	12568560	3596	3611	15	RIGHT	A443.EDF	A44	3
85	12568604	12569696	3655	4747	1092	RIGHT	A443.EDF	A44	3
85	12569720	12569831	4771	4882	111	RIGHT	A443.EDF	A44	3
85	12569858	12570171	4909	5222	313	RIGHT	A443.EDF	A44	3
85	12570209	12570324	5260	5375	115	RIGHT	A443.EDF	A44	3
85	12570353	12570370	5404	5421	17	RIGHT	A443.EDF	A44	3
85	12570393	12570404	5444	5455	11	RIGHT	A443.EDF	A44	3
85	12570432	12570613	5483	5664	181	RIGHT	A443.EDF	A44	3
85	12570731	12570772	5782	5823	41	RIGHT	A443.EDF	A44	3
85	12570811	12571112	5862	6163	301	RIGHT	A443.EDF	A44	3
85	12571139	12571167	6190	6218	28	RIGHT	A443.EDF	A44	3
85	12571188	12571724	6239	6775	536	RIGHT	A443.EDF	A44	3
86	12573566	12573580	92	106	14	RIGHT	A443.EDF	A44	3
86	12573670	12573671	196	197	1	RIGHT	A443.EDF	A44	3
86	12573732	12573732	258	258	0	RIGHT	A443.EDF	A44	3
86	12573762	12575403	288	1929	1641	RIGHT	A443.EDF	A44	3
86	12575429	12575460	1955	1986	31	RIGHT	A443.EDF	A44	3
87	12581546	12581580	58	92	34	RIGHT	A443.EDF	A44	3
87	12581609	12581609	121	121	0	RIGHT	A443.EDF	A44	3
87	12581966	12583372	478	1884	1406	RIGHT	A443.EDF	A44	3
87	12585730	12585750	4242	4262	20	RIGHT	A443.EDF	A44	3
87	12585838	12586577	4350	5089	739	RIGHT	A443.EDF	A44	3
87	12586625	12586626	5137	5138	1	RIGHT	A443.EDF	A44	3
87	12586654	12586654	5166	5166	0	RIGHT	A443.EDF	A44	3
87	12586756	12586766	5268	5278	10	RIGHT	A443.EDF	A44	3
87	12586955	12586956	5467	5468	1	RIGHT	A443.EDF	A44	3
87	12586978	12586978	5490	5490	0	RIGHT	A443.EDF	A44	3
87	12587063	12587069	5575	5581	6	RIGHT	A443.EDF	A44	3
87	12587111	12587111	5623	5623	0	RIGHT	A443.EDF	A44	3
87	12587183	12587228	5695	5740	45	RIGHT	A443.EDF	A44	3
87	12587252	12587320	5764	5832	68	RIGHT	A443.EDF	A44	3
87	12587386	12587387	5898	5899	1	RIGHT	A443.EDF	A44	3
87	12587421	12587440	5933	5952	19	RIGHT	A443.EDF	A44	3
87	12587480	12587480	5992	5992	0	RIGHT	A443.EDF	A44	3
87	12587519	12587594	6031	6106	75	RIGHT	A443.EDF	A44	3
88	12589069	12590645	57	1633	1576	RIGHT	A443.EDF	A44	3
88	12590670	12590672	1658	1660	2	RIGHT	A443.EDF	A44	3
88	12590753	12590754	1741	1742	1	RIGHT	A443.EDF	A44	3
88	12590908	12590917	1896	1905	9	RIGHT	A443.EDF	A44	3
88	12590979	12590979	1967	1967	0	RIGHT	A443.EDF	A44	3
88	12591831	12591831	2819	2819	0	RIGHT	A443.EDF	A44	3
88	12591881	12591892	2869	2880	11	RIGHT	A443.EDF	A44	3
88	12592003	12592003	2991	2991	0	RIGHT	A443.EDF	A44	3
88	12592239	12592240	3227	3228	1	RIGHT	A443.EDF	A44	3
88	12592656	12592657	3644	3645	1	RIGHT	A443.EDF	A44	3
88	12592747	12592762	3735	3750	15	RIGHT	A443.EDF	A44	3
88	12592784	12592901	3772	3889	117	RIGHT	A443.EDF	A44	3
88	12592926	12595629	3914	6617	2703	RIGHT	A443.EDF	A44	3
89	12597428	12599642	58	2272	2214	RIGHT	A443.EDF	A44	3
89	12600263	12603093	2893	5723	2830	RIGHT	A443.EDF	A44	3
90	12604734	12605709	57	1032	975	RIGHT	A443.EDF	A44	3
90	12605736	12605745	1059	1068	9	RIGHT	A443.EDF	A44	3
90	12605791	12605802	1114	1125	11	RIGHT	A443.EDF	A44	3
90	12605833	12605833	1156	1156	0	RIGHT	A443.EDF	A44	3
90	12605884	12605901	1207	1224	17	RIGHT	A443.EDF	A44	3
90	12605940	12605940	1263	1263	0	RIGHT	A443.EDF	A44	3
90	12605978	12605994	1301	1317	16	RIGHT	A443.EDF	A44	3
90	12606026	12606045	1349	1368	19	RIGHT	A443.EDF	A44	3
90	12606079	12606091	1402	1414	12	RIGHT	A443.EDF	A44	3
90	12606231	12606232	1554	1555	1	RIGHT	A443.EDF	A44	3
90	12606255	12606280	1578	1603	25	RIGHT	A443.EDF	A44	3
90	12606400	12606408	1723	1731	8	RIGHT	A443.EDF	A44	3
90	12606444	12606520	1767	1843	76	RIGHT	A443.EDF	A44	3
90	12606554	12606554	1877	1877	0	RIGHT	A443.EDF	A44	3
90	12606591	12606609	1914	1932	18	RIGHT	A443.EDF	A44	3
90	12606643	12610999	1966	6322	4356	RIGHT	A443.EDF	A44	3
91	12612637	12618012	58	5433	5375	RIGHT	A443.EDF	A44	3
92	12619919	12625448	57	5586	5529	RIGHT	A443.EDF	A44	3
93	12627357	12632882	57	5582	5525	RIGHT	A443.EDF	A44	3
94	12635404	12641167	57	5820	5763	RIGHT	A443.EDF	A44	3
95	12643014	12643407	57	450	393	RIGHT	A443.EDF	A44	3
95	12643433	12644347	476	1390	914	RIGHT	A443.EDF	A44	3
95	12644384	12644384	1427	1427	0	RIGHT	A443.EDF	A44	3
95	12644420	12649932	1463	6975	5512	RIGHT	A443.EDF	A44	3
96	12651989	12653155	57	1223	1166	RIGHT	A443.EDF	A44	3
96	12653192	12657437	1260	5505	4245	RIGHT	A443.EDF	A44	3
97	12659275	12659470	57	252	195	RIGHT	A443.EDF	A44	3
97	12659507	12659573	289	355	66	RIGHT	A443.EDF	A44	3
97	12659599	12665773	381	6555	6174	RIGHT	A443.EDF	A44	3
98	12667738	12673957	57	6276	6219	RIGHT	A443.EDF	A44	3
99	12675675	12680711	57	5093	5036	RIGHT	A443.EDF	A44	3
100	12683330	12688296	57	5023	4966	RIGHT	A443.EDF	A44	3
101	12690562	12697762	57	7257	7200	RIGHT	A443.EDF	A44	3
102	12699521	12701618	58	2155	2097	RIGHT	A443.EDF	A44	3
102	12701649	12701661	2186	2198	12	RIGHT	A443.EDF	A44	3
102	12701706	12701711	2243	2248	5	RIGHT	A443.EDF	A44	3
102	12701741	12701741	2278	2278	0	RIGHT	A443.EDF	A44	3
102	12701771	12701773	2308	2310	2	RIGHT	A443.EDF	A44	3
102	12701797	12701810	2334	2347	13	RIGHT	A443.EDF	A44	3
102	12701839	12701861	2376	2398	22	RIGHT	A443.EDF	A44	3
102	12701882	12702974	2419	3511	1092	RIGHT	A443.EDF	A44	3
102	12703035	12703036	3572	3573	1	RIGHT	A443.EDF	A44	3
102	12703089	12703102	3626	3639	13	RIGHT	A443.EDF	A44	3
102	12703157	12705186	3694	5723	2029	RIGHT	A443.EDF	A44	3
103	12706877	12709015	58	2196	2138	RIGHT	A443.EDF	A44	3
103	12709072	12709073	2253	2254	1	RIGHT	A443.EDF	A44	3
103	12709118	12709118	2299	2299	0	RIGHT	A443.EDF	A44	3
103	12709204	12709205	2385	2386	1	RIGHT	A443.EDF	A44	3
103	12709236	12709252	2417	2433	16	RIGHT	A443.EDF	A44	3
103	12709281	12709316	2462	2497	35	RIGHT	A443.EDF	A44	3
103	12709367	12709368	2548	2549	1	RIGHT	A443.EDF	A44	3
103	12709397	12713111	2578	6292	3714	RIGHT	A443.EDF	A44	3
104	12715866	12716030	57	221	164	RIGHT	A443.EDF	A44	3
104	12716124	12716140	315	331	16	RIGHT	A443.EDF	A44	3
104	12716168	12716188	359	379	20	RIGHT	A443.EDF	A44	3
104	12716209	12716209	400	400	0	RIGHT	A443.EDF	A44	3
104	12716230	12716236	421	427	6	RIGHT	A443.EDF	A44	3
104	12716375	12716773	566	964	398	RIGHT	A443.EDF	A44	3
104	12716794	12716873	985	1064	79	RIGHT	A443.EDF	A44	3
104	12716912	12719042	1103	3233	2130	RIGHT	A443.EDF	A44	3
104	12719086	12719092	3277	3283	6	RIGHT	A443.EDF	A44	3
104	12719120	12719121	3311	3312	1	RIGHT	A443.EDF	A44	3
104	12719170	12719174	3361	3365	4	RIGHT	A443.EDF	A44	3
104	12719207	12719245	3398	3436	38	RIGHT	A443.EDF	A44	3
104	12719329	12719350	3520	3541	21	RIGHT	A443.EDF	A44	3
104	12719388	12719439	3579	3630	51	RIGHT	A443.EDF	A44	3
104	12719470	12719481	3661	3672	11	RIGHT	A443.EDF	A44	3
104	12719507	12719856	3698	4047	349	RIGHT	A443.EDF	A44	3
104	12719878	12719975	4069	4166	97	RIGHT	A443.EDF	A44	3
104	12719997	12720047	4188	4238	50	RIGHT	A443.EDF	A44	3
104	12720070	12720418	4261	4609	348	RIGHT	A443.EDF	A44	3
104	12720444	12720444	4635	4635	0	RIGHT	A443.EDF	A44	3
104	12720484	12720498	4675	4689	14	RIGHT	A443.EDF	A44	3
104	12720539	12720590	4730	4781	51	RIGHT	A443.EDF	A44	3
104	12720644	12720644	4835	4835	0	RIGHT	A443.EDF	A44	3
104	12720687	12720687	4878	4878	0	RIGHT	A443.EDF	A44	3
104	12720728	12720759	4919	4950	31	RIGHT	A443.EDF	A44	3
104	12720797	12721155	4988	5346	358	RIGHT	A443.EDF	A44	3
104	12721177	12721925	5368	6116	748	RIGHT	A443.EDF	A44	3
104	12721947	12722087	6138	6278	140	RIGHT	A443.EDF	A44	3
105	12724107	12726220	57	2170	2113	RIGHT	A443.EDF	A44	3
105	12726241	12726241	2191	2191	0	RIGHT	A443.EDF	A44	3
105	12726272	12727068	2222	3018	796	RIGHT	A443.EDF	A44	3
105	12727140	12727162	3090	3112	22	RIGHT	A443.EDF	A44	3
105	12727247	12727251	3197	3201	4	RIGHT	A443.EDF	A44	3
105	12727321	12728330	3271	4280	1009	RIGHT	A443.EDF	A44	3
105	12728361	12728374	4311	4324	13	RIGHT	A443.EDF	A44	3
105	12728419	12729708	4369	5658	1289	RIGHT	A443.EDF	A44	3
105	12729732	12729763	5682	5713	31	RIGHT	A443.EDF	A44	3
105	12729791	12730143	5741	6093	352	RIGHT	A443.EDF	A44	3
106	12732001	12734580	57	2636	2579	RIGHT	A443.EDF	A44	3
106	12734609	12734650	2665	2706	41	RIGHT	A443.EDF	A44	3
106	12734683	12735061	2739	3117	378	RIGHT	A443.EDF	A44	3
106	12735105	12735107	3161	3163	2	RIGHT	A443.EDF	A44	3
106	12735410	12735425	3466	3481	15	RIGHT	A443.EDF	A44	3
106	12735486	12735486	3542	3542	0	RIGHT	A443.EDF	A44	3
106	12735515	12735530	3571	3586	15	RIGHT	A443.EDF	A44	3
106	12735551	12735565	3607	3621	14	RIGHT	A443.EDF	A44	3
106	12735606	12735668	3662	3724	62	RIGHT	A443.EDF	A44	3
106	12735739	12735776	3795	3832	37	RIGHT	A443.EDF	A44	3
106	12735808	12735821	3864	3877	13	RIGHT	A443.EDF	A44	3
106	12735843	12735868	3899	3924	25	RIGHT	A443.EDF	A44	3
106	12735896	12735896	3952	3952	0	RIGHT	A443.EDF	A44	3
106	12735919	12735919	3975	3975	0	RIGHT	A443.EDF	A44	3
106	12735995	12735996	4051	4052	1	RIGHT	A443.EDF	A44	3
106	12736172	12736172	4228	4228	0	RIGHT	A443.EDF	A44	3
106	12736194	12737039	4250	5095	845	RIGHT	A443.EDF	A44	3
106	12737081	12737161	5137	5217	80	RIGHT	A443.EDF	A44	3
106	12737185	12737326	5241	5382	141	RIGHT	A443.EDF	A44	3
107	12739283	12740125	58	900	842	RIGHT	A443.EDF	A44	3
107	12740161	12740213	936	988	52	RIGHT	A443.EDF	A44	3
107	12740240	12744682	1015	5457	4442	RIGHT	A443.EDF	A44	3
108	12746430	12748617	57	2244	2187	RIGHT	A443.EDF	A44	3
108	12748642	12748712	2269	2339	70	RIGHT	A443.EDF	A44	3
108	12748813	12748833	2440	2460	20	RIGHT	A443.EDF	A44	3
108	12748867	12748867	2494	2494	0	RIGHT	A443.EDF	A44	3
108	12748889	12748889	2516	2516	0	RIGHT	A443.EDF	A44	3
108	12748928	12748928	2555	2555	0	RIGHT	A443.EDF	A44	3
108	12748955	12748967	2582	2594	12	RIGHT	A443.EDF	A44	3
108	12748990	12749554	2617	3181	564	RIGHT	A443.EDF	A44	3
108	12749590	12749608	3217	3235	18	RIGHT	A443.EDF	A44	3
108	12749633	12749633	3260	3260	0	RIGHT	A443.EDF	A44	3
108	12749657	12749661	3284	3288	4	RIGHT	A443.EDF	A44	3
108	12749704	12749786	3331	3413	82	RIGHT	A443.EDF	A44	3
108	12749809	12749810	3436	3437	1	RIGHT	A443.EDF	A44	3
108	12749833	12749862	3460	3489	29	RIGHT	A443.EDF	A44	3
108	12749894	12749964	3521	3591	70	RIGHT	A443.EDF	A44	3
108	12749988	12749993	3615	3620	5	RIGHT	A443.EDF	A44	3
108	12750015	12751515	3642	5142	1500	RIGHT	A443.EDF	A44	3
109	12753524	12756880	58	3414	3356	RIGHT	A443.EDF	A44	3
109	12756903	12756920	3437	3454	17	RIGHT	A443.EDF	A44	3
109	12756961	12757024	3495	3558	63	RIGHT	A443.EDF	A44	3
109	12757045	12760410	3579	6944	3365	RIGHT	A443.EDF	A44	3
110	12762037	12768475	57	6495	6438	RIGHT	A443.EDF	A44	3
111	12770364	12775649	58	5343	5285	RIGHT	A443.EDF	A44	3
112	12777165	12783505	57	6397	6340	RIGHT	A443.EDF	A44	3
113	12785275	12790639	58	5422	5364	RIGHT	A443.EDF	A44	3
114	12793188	12797893	57	4762	4705	RIGHT	A443.EDF	A44	3
115	12799692	12805448	57	5813	5756	RIGHT	A443.EDF	A44	3
116	12807428	12814714	58	7344	7286	RIGHT	A443.EDF	A44	3
117	12816202	12821428	58	5284	5226	RIGHT	A443.EDF	A44	3
118	12823668	12830063	58	6453	6395	RIGHT	A443.EDF	A44	3
119	12831919	12836998	57	5136	5079	RIGHT	A443.EDF	A44	3
120	12838637	12845423	58	6844	6786	RIGHT	A443.EDF	A44	3
2	14449373	14449509	146	282	136	RIGHT	C361.EDF	C36	1
3	14458888	14459060	115	287	172	RIGHT	C361.EDF	C36	1
3	14459637	14459732	864	959	95	RIGHT	C361.EDF	C36	1
4	14468706	14468766	1227	1287	60	RIGHT	C361.EDF	C36	1
4	14473119	14473198	5640	5719	79	RIGHT	C361.EDF	C36	1
5	14477186	14477235	57	106	49	RIGHT	C361.EDF	C36	1
5	14478422	14478451	1293	1322	29	RIGHT	C361.EDF	C36	1
5	14484029	14484133	6900	7004	104	RIGHT	C361.EDF	C36	1
6	14486452	14486508	57	113	56	RIGHT	C361.EDF	C36	1
6	14487684	14487720	1289	1325	36	RIGHT	C361.EDF	C36	1
6	14487912	14487986	1517	1591	74	RIGHT	C361.EDF	C36	1
6	14490421	14490485	4026	4090	64	RIGHT	C361.EDF	C36	1
7	14494916	14495203	57	344	287	RIGHT	C361.EDF	C36	1
7	14495595	14495713	736	854	118	RIGHT	C361.EDF	C36	1
8	14502852	14502913	330	391	61	RIGHT	C361.EDF	C36	1
8	14507707	14507793	5185	5271	86	RIGHT	C361.EDF	C36	1
9	14512486	14512676	58	248	190	RIGHT	C361.EDF	C36	1
9	14512813	14512907	385	479	94	RIGHT	C361.EDF	C36	1
9	14513081	14513199	653	771	118	RIGHT	C361.EDF	C36	1
9	14515220	14515315	2792	2887	95	RIGHT	C361.EDF	C36	1
9	14516874	14516992	4446	4564	118	RIGHT	C361.EDF	C36	1
10	14522972	14523035	948	1011	63	RIGHT	C361.EDF	C36	1
11	14530989	14531089	57	157	100	RIGHT	C361.EDF	C36	1
11	14531299	14531349	367	417	50	RIGHT	C361.EDF	C36	1
11	14531859	14531954	927	1022	95	RIGHT	C361.EDF	C36	1
11	14534549	14534630	3617	3698	81	RIGHT	C361.EDF	C36	1
12	14540203	14540280	57	134	77	RIGHT	C361.EDF	C36	1
12	14540626	14540683	480	537	57	RIGHT	C361.EDF	C36	1
12	14541201	14541319	1055	1173	118	RIGHT	C361.EDF	C36	1
12	14544816	14544931	4670	4785	115	RIGHT	C361.EDF	C36	1
13	14549166	14549221	112	167	55	RIGHT	C361.EDF	C36	1
13	14549439	14549449	385	395	10	RIGHT	C361.EDF	C36	1
13	14549498	14549537	444	483	39	RIGHT	C361.EDF	C36	1
13	14549766	14549837	712	783	71	RIGHT	C361.EDF	C36	1
13	14552290	14552362	3236	3308	72	RIGHT	C361.EDF	C36	1
13	14553040	14553139	3986	4085	99	RIGHT	C361.EDF	C36	1
13	14553491	14553586	4437	4532	95	RIGHT	C361.EDF	C36	1
13	14554188	14554285	5134	5231	97	RIGHT	C361.EDF	C36	1
14	14557986	14558074	223	311	88	RIGHT	C361.EDF	C36	1
14	14558549	14558659	786	896	110	RIGHT	C361.EDF	C36	1
15	14568656	14568878	72	294	222	RIGHT	C361.EDF	C36	1
15	14569411	14569500	827	916	89	RIGHT	C361.EDF	C36	1
15	14569840	14569936	1256	1352	96	RIGHT	C361.EDF	C36	1
15	14570215	14570327	1631	1743	112	RIGHT	C361.EDF	C36	1
16	14576850	14576991	153	294	141	RIGHT	C361.EDF	C36	1
16	14577957	14578034	1260	1337	77	RIGHT	C361.EDF	C36	1
16	14578240	14578342	1543	1645	102	RIGHT	C361.EDF	C36	1
17	14587393	14587446	57	110	53	RIGHT	C361.EDF	C36	1
17	14587570	14588018	234	682	448	RIGHT	C361.EDF	C36	1
17	14588625	14588744	1289	1408	119	RIGHT	C361.EDF	C36	1
18	14597693	14597733	118	158	40	RIGHT	C361.EDF	C36	1
18	14597774	14597826	199	251	52	RIGHT	C361.EDF	C36	1
18	14597941	14598053	366	478	112	RIGHT	C361.EDF	C36	1
18	14598201	14598299	626	724	98	RIGHT	C361.EDF	C36	1
18	14598574	14598700	999	1125	126	RIGHT	C361.EDF	C36	1
19	14605988	14606101	57	170	113	RIGHT	C361.EDF	C36	1
19	14606625	14606700	694	769	75	RIGHT	C361.EDF	C36	1
20	14615967	14616065	57	155	98	RIGHT	C361.EDF	C36	1
20	14616162	14616276	252	366	114	RIGHT	C361.EDF	C36	1
21	14625723	14625883	272	432	160	RIGHT	C361.EDF	C36	1
22	14634567	14634731	192	356	164	RIGHT	C361.EDF	C36	1
22	14640106	14640171	5731	5796	65	RIGHT	C361.EDF	C36	1
23	14644665	14644768	242	345	103	RIGHT	C361.EDF	C36	1
23	14645356	14645482	933	1059	126	RIGHT	C361.EDF	C36	1
23	14651046	14651121	6623	6698	75	RIGHT	C361.EDF	C36	1
24	14654543	14654724	84	265	181	RIGHT	C361.EDF	C36	1
25	14664589	14664761	106	278	172	RIGHT	C361.EDF	C36	1
25	14665344	14665467	861	984	123	RIGHT	C361.EDF	C36	1
26	14672845	14672931	331	417	86	RIGHT	C361.EDF	C36	1
27	14681469	14681564	89	184	95	RIGHT	C361.EDF	C36	1
27	14681911	14681994	531	614	83	RIGHT	C361.EDF	C36	1
27	14682156	14682289	776	909	133	RIGHT	C361.EDF	C36	1
27	14682481	14682567	1101	1187	86	RIGHT	C361.EDF	C36	1
27	14682758	14682853	1378	1473	95	RIGHT	C361.EDF	C36	1
27	14684955	14685004	3575	3624	49	RIGHT	C361.EDF	C36	1
27	14686113	14686146	4733	4766	33	RIGHT	C361.EDF	C36	1
27	14686717	14686871	5337	5491	154	RIGHT	C361.EDF	C36	1
28	14693872	14693949	107	184	77	RIGHT	C361.EDF	C36	1
28	14694026	14694099	261	334	73	RIGHT	C361.EDF	C36	1
28	14694231	14694240	466	475	9	RIGHT	C361.EDF	C36	1
28	14694478	14694540	713	775	62	RIGHT	C361.EDF	C36	1
28	14694678	14694889	913	1124	211	RIGHT	C361.EDF	C36	1
28	14695087	14695670	1322	1905	583	RIGHT	C361.EDF	C36	1
28	14695813	14696561	2048	2796	748	RIGHT	C361.EDF	C36	1
28	14696773	14696918	3008	3153	145	RIGHT	C361.EDF	C36	1
28	14697208	14697716	3443	3951	508	RIGHT	C361.EDF	C36	1
28	14697994	14698077	4229	4312	83	RIGHT	C361.EDF	C36	1
28	14698498	14698841	4733	5076	343	RIGHT	C361.EDF	C36	1
28	14698955	14699040	5190	5275	85	RIGHT	C361.EDF	C36	1
28	14699562	14699663	5797	5898	101	RIGHT	C361.EDF	C36	1
28	14699749	14699911	5984	6146	162	RIGHT	C361.EDF	C36	1
28	14700180	14700277	6415	6512	97	RIGHT	C361.EDF	C36	1
29	14702932	14703006	57	131	74	RIGHT	C361.EDF	C36	1
29	14703138	14703224	263	349	86	RIGHT	C361.EDF	C36	1
29	14703554	14703627	679	752	73	RIGHT	C361.EDF	C36	1
29	14703947	14704048	1072	1173	101	RIGHT	C361.EDF	C36	1
29	14704392	14704465	1517	1590	73	RIGHT	C361.EDF	C36	1
29	14704729	14704820	1854	1945	91	RIGHT	C361.EDF	C36	1
29	14705088	14705167	2213	2292	79	RIGHT	C361.EDF	C36	1
29	14706458	14706543	3583	3668	85	RIGHT	C361.EDF	C36	1
29	14708340	14708447	5465	5572	107	RIGHT	C361.EDF	C36	1
30	14712717	14712790	57	130	73	RIGHT	C361.EDF	C36	1
30	14712903	14713174	243	514	271	RIGHT	C361.EDF	C36	1
30	14713325	14713415	665	755	90	RIGHT	C361.EDF	C36	1
30	14713622	14713710	962	1050	88	RIGHT	C361.EDF	C36	1
30	14714948	14714970	2288	2310	22	RIGHT	C361.EDF	C36	1
30	14715146	14715248	2486	2588	102	RIGHT	C361.EDF	C36	1
30	14716475	14716607	3815	3947	132	RIGHT	C361.EDF	C36	1
30	14716948	14717037	4288	4377	89	RIGHT	C361.EDF	C36	1
30	14717293	14717386	4633	4726	93	RIGHT	C361.EDF	C36	1
30	14717527	14717630	4867	4970	103	RIGHT	C361.EDF	C36	1
30	14718338	14718387	5678	5727	49	RIGHT	C361.EDF	C36	1
30	14718574	14718703	5914	6043	129	RIGHT	C361.EDF	C36	1
31	14722245	14722335	137	227	90	RIGHT	C361.EDF	C36	1
31	14722448	14722526	340	418	78	RIGHT	C361.EDF	C36	1
31	14722687	14722775	579	667	88	RIGHT	C361.EDF	C36	1
31	14723045	14723137	937	1029	92	RIGHT	C361.EDF	C36	1
31	14723375	14723388	1267	1280	13	RIGHT	C361.EDF	C36	1
31	14723421	14723646	1313	1538	225	RIGHT	C361.EDF	C36	1
31	14727492	14727578	5384	5470	86	RIGHT	C361.EDF	C36	1
31	14728099	14728204	5991	6096	105	RIGHT	C361.EDF	C36	1
31	14728594	14728677	6486	6569	83	RIGHT	C361.EDF	C36	1
31	14729025	14729067	6917	6959	42	RIGHT	C361.EDF	C36	1
32	14731573	14731718	93	238	145	RIGHT	C361.EDF	C36	1
32	14732198	14732281	718	801	83	RIGHT	C361.EDF	C36	1
32	14732458	14732555	978	1075	97	RIGHT	C361.EDF	C36	1
32	14734522	14734624	3042	3144	102	RIGHT	C361.EDF	C36	1
32	14735575	14735668	4095	4188	93	RIGHT	C361.EDF	C36	1
33	14741216	14741320	157	261	104	RIGHT	C361.EDF	C36	1
33	14741471	14741574	412	515	103	RIGHT	C361.EDF	C36	1
33	14741783	14741864	724	805	81	RIGHT	C361.EDF	C36	1
33	14742055	14742124	996	1065	69	RIGHT	C361.EDF	C36	1
33	14742306	14742368	1247	1309	62	RIGHT	C361.EDF	C36	1
34	14749490	14749559	57	126	69	RIGHT	C361.EDF	C36	1
34	14750307	14750337	874	904	30	RIGHT	C361.EDF	C36	1
34	14750588	14750719	1155	1286	131	RIGHT	C361.EDF	C36	1
34	14750941	14751025	1508	1592	84	RIGHT	C361.EDF	C36	1
34	14751217	14751316	1784	1883	99	RIGHT	C361.EDF	C36	1
34	14754216	14754301	4783	4868	85	RIGHT	C361.EDF	C36	1
35	14758285	14758402	283	400	117	RIGHT	C361.EDF	C36	1
35	14759222	14759336	1220	1334	114	RIGHT	C361.EDF	C36	1
35	14759468	14759604	1466	1602	136	RIGHT	C361.EDF	C36	1
36	14766847	14767022	58	233	175	RIGHT	C361.EDF	C36	1
36	14767181	14767291	392	502	110	RIGHT	C361.EDF	C36	1
36	14767534	14767664	745	875	130	RIGHT	C361.EDF	C36	1
36	14768381	14768480	1592	1691	99	RIGHT	C361.EDF	C36	1
36	14771469	14771567	4680	4778	98	RIGHT	C361.EDF	C36	1
37	14775256	14775283	57	84	27	RIGHT	C361.EDF	C36	1
37	14775431	14775565	232	366	134	RIGHT	C361.EDF	C36	1
37	14776060	14776166	861	967	106	RIGHT	C361.EDF	C36	1
37	14778708	14778818	3509	3619	110	RIGHT	C361.EDF	C36	1
38	14784051	14784246	57	252	195	RIGHT	C361.EDF	C36	1
38	14784523	14784610	529	616	87	RIGHT	C361.EDF	C36	1
38	14784782	14784895	788	901	113	RIGHT	C361.EDF	C36	1
38	14785467	14785497	1473	1503	30	RIGHT	C361.EDF	C36	1
38	14785718	14785836	1724	1842	118	RIGHT	C361.EDF	C36	1
38	14790648	14790735	6654	6741	87	RIGHT	C361.EDF	C36	1
39	14795486	14795529	285	328	43	RIGHT	C361.EDF	C36	1
39	14795969	14796060	768	859	91	RIGHT	C361.EDF	C36	1
39	14796257	14796358	1056	1157	101	RIGHT	C361.EDF	C36	1
40	14805530	14806594	57	1121	1064	RIGHT	C361.EDF	C36	1
40	14806765	14806987	1292	1514	222	RIGHT	C361.EDF	C36	1
40	14807098	14807366	1625	1893	268	RIGHT	C361.EDF	C36	1
40	14807556	14807648	2083	2175	92	RIGHT	C361.EDF	C36	1
40	14807913	14808055	2440	2582	142	RIGHT	C361.EDF	C36	1
40	14808228	14808325	2755	2852	97	RIGHT	C361.EDF	C36	1
40	14808616	14808665	3143	3192	49	RIGHT	C361.EDF	C36	1
40	14809105	14809315	3632	3842	210	RIGHT	C361.EDF	C36	1
40	14809493	14809576	4020	4103	83	RIGHT	C361.EDF	C36	1
40	14809965	14810058	4492	4585	93	RIGHT	C361.EDF	C36	1
40	14810362	14810445	4889	4972	83	RIGHT	C361.EDF	C36	1
40	14810695	14810773	5222	5300	78	RIGHT	C361.EDF	C36	1
40	14811310	14811434	5837	5961	124	RIGHT	C361.EDF	C36	1
40	14812362	14812479	6889	7006	117	RIGHT	C361.EDF	C36	1
41	14815720	14815855	396	531	135	RIGHT	C361.EDF	C36	1
41	14815919	14816277	595	953	358	RIGHT	C361.EDF	C36	1
41	14816308	14816377	984	1053	69	RIGHT	C361.EDF	C36	1
41	14816482	14816568	1158	1244	86	RIGHT	C361.EDF	C36	1
41	14816685	14816794	1361	1470	109	RIGHT	C361.EDF	C36	1
41	14816981	14817092	1657	1768	111	RIGHT	C361.EDF	C36	1
41	14817512	14817620	2188	2296	108	RIGHT	C361.EDF	C36	1
41	14818566	14818685	3242	3361	119	RIGHT	C361.EDF	C36	1
41	14819663	14819777	4339	4453	114	RIGHT	C361.EDF	C36	1
41	14820194	14820305	4870	4981	111	RIGHT	C361.EDF	C36	1
41	14821184	14821312	5860	5988	128	RIGHT	C361.EDF	C36	1
42	14824591	14824679	193	281	88	RIGHT	C361.EDF	C36	1
42	14825111	14825208	713	810	97	RIGHT	C361.EDF	C36	1
42	14825475	14825590	1077	1192	115	RIGHT	C361.EDF	C36	1
42	14825688	14825899	1290	1501	211	RIGHT	C361.EDF	C36	1
42	14825977	14826087	1579	1689	110	RIGHT	C361.EDF	C36	1
42	14826275	14826370	1877	1972	95	RIGHT	C361.EDF	C36	1
42	14827298	14827410	2900	3012	112	RIGHT	C361.EDF	C36	1
43	14834973	14835093	161	281	120	RIGHT	C361.EDF	C36	1
43	14835522	14835651	710	839	129	RIGHT	C361.EDF	C36	1
43	14835864	14836015	1052	1203	151	RIGHT	C361.EDF	C36	1
43	14836162	14836326	1350	1514	164	RIGHT	C361.EDF	C36	1
43	14836542	14836568	1730	1756	26	RIGHT	C361.EDF	C36	1
43	14836672	14836774	1860	1962	102	RIGHT	C361.EDF	C36	1
44	14842785	14842878	86	179	93	RIGHT	C361.EDF	C36	1
44	14843020	14843115	321	416	95	RIGHT	C361.EDF	C36	1
44	14843616	14843735	917	1036	119	RIGHT	C361.EDF	C36	1
44	14846841	14846936	4142	4237	95	RIGHT	C361.EDF	C36	1
45	14851734	14851855	57	178	121	RIGHT	C361.EDF	C36	1
45	14852010	14852103	333	426	93	RIGHT	C361.EDF	C36	1
45	14855995	14856101	4318	4424	106	RIGHT	C361.EDF	C36	1
46	14859661	14859780	212	331	119	RIGHT	C361.EDF	C36	1
46	14860295	14860421	846	972	126	RIGHT	C361.EDF	C36	1
46	14860663	14860775	1214	1326	112	RIGHT	C361.EDF	C36	1
46	14861486	14861610	2037	2161	124	RIGHT	C361.EDF	C36	1
46	14861827	14861967	2378	2518	140	RIGHT	C361.EDF	C36	1
46	14864657	14864732	5208	5283	75	RIGHT	C361.EDF	C36	1
47	14867363	14867486	121	244	123	RIGHT	C361.EDF	C36	1
47	14867702	14867895	460	653	193	RIGHT	C361.EDF	C36	1
47	14868129	14868240	887	998	111	RIGHT	C361.EDF	C36	1
47	14868598	14868684	1356	1442	86	RIGHT	C361.EDF	C36	1
48	14875534	14875626	246	338	92	RIGHT	C361.EDF	C36	1
48	14876526	14876609	1238	1321	83	RIGHT	C361.EDF	C36	1
48	14877089	14877213	1801	1925	124	RIGHT	C361.EDF	C36	1
49	14884406	14884459	57	110	53	RIGHT	C361.EDF	C36	1
49	14884601	14884740	252	391	139	RIGHT	C361.EDF	C36	1
49	14885479	14885561	1130	1212	82	RIGHT	C361.EDF	C36	1
50	14893072	14893201	91	220	129	RIGHT	C361.EDF	C36	1
50	14899235	14899359	6254	6378	124	RIGHT	C361.EDF	C36	1
51	14901762	14901872	101	211	110	RIGHT	C361.EDF	C36	1
51	14902218	14902315	557	654	97	RIGHT	C361.EDF	C36	1
52	14910262	14910321	57	116	59	RIGHT	C361.EDF	C36	1
52	14911095	14911201	890	996	106	RIGHT	C361.EDF	C36	1
52	14911430	14911556	1225	1351	126	RIGHT	C361.EDF	C36	1
53	14918835	14918973	68	206	138	RIGHT	C361.EDF	C36	1
53	14919326	14919416	559	649	90	RIGHT	C361.EDF	C36	1
53	14919567	14919708	800	941	141	RIGHT	C361.EDF	C36	1
53	14919959	14920062	1192	1295	103	RIGHT	C361.EDF	C36	1
53	14921767	14921863	3000	3096	96	RIGHT	C361.EDF	C36	1
54	14928774	14928859	57	142	85	RIGHT	C361.EDF	C36	1
54	14928969	14929119	252	402	150	RIGHT	C361.EDF	C36	1
54	14929148	14929531	431	814	383	RIGHT	C361.EDF	C36	1
54	14929870	14929956	1153	1239	86	RIGHT	C361.EDF	C36	1
54	14931169	14931260	2452	2543	91	RIGHT	C361.EDF	C36	1
54	14932643	14932695	3926	3978	52	RIGHT	C361.EDF	C36	1
55	14937129	14938804	57	1732	1675	RIGHT	C361.EDF	C36	1
55	14938876	14938949	1804	1877	73	RIGHT	C361.EDF	C36	1
55	14939235	14939329	2163	2257	94	RIGHT	C361.EDF	C36	1
55	14939464	14939718	2392	2646	254	RIGHT	C361.EDF	C36	1
55	14939764	14939857	2692	2785	93	RIGHT	C361.EDF	C36	1
55	14940010	14940112	2938	3040	102	RIGHT	C361.EDF	C36	1
55	14940183	14940391	3111	3319	208	RIGHT	C361.EDF	C36	1
55	14940536	14940625	3464	3553	89	RIGHT	C361.EDF	C36	1
55	14941456	14941534	4384	4462	78	RIGHT	C361.EDF	C36	1
56	14945370	14945441	57	128	71	RIGHT	C361.EDF	C36	1
56	14945532	14945618	219	305	86	RIGHT	C361.EDF	C36	1
56	14945914	14946008	601	695	94	RIGHT	C361.EDF	C36	1
56	14946372	14946474	1059	1161	102	RIGHT	C361.EDF	C36	1
56	14946789	14946896	1476	1583	107	RIGHT	C361.EDF	C36	1
56	14947108	14947220	1795	1907	112	RIGHT	C361.EDF	C36	1
56	14947736	14947847	2423	2534	111	RIGHT	C361.EDF	C36	1
56	14948142	14948269	2829	2956	127	RIGHT	C361.EDF	C36	1
56	14948726	14948838	3413	3525	112	RIGHT	C361.EDF	C36	1
56	14950934	14951038	5621	5725	104	RIGHT	C361.EDF	C36	1
57	14954475	14954500	58	83	25	RIGHT	C361.EDF	C36	1
57	14954634	14954736	217	319	102	RIGHT	C361.EDF	C36	1
57	14955116	14955220	699	803	104	RIGHT	C361.EDF	C36	1
57	14955797	14955908	1380	1491	111	RIGHT	C361.EDF	C36	1
57	14958437	14958566	4020	4149	129	RIGHT	C361.EDF	C36	1
58	14962431	14962564	104	237	133	RIGHT	C361.EDF	C36	1
58	14965717	14965827	3390	3500	110	RIGHT	C361.EDF	C36	1
59	14971919	14971993	57	131	74	RIGHT	C361.EDF	C36	1
59	14972112	14972325	250	463	213	RIGHT	C361.EDF	C36	1
59	14972534	14972660	672	798	126	RIGHT	C361.EDF	C36	1
59	14972966	14973102	1104	1240	136	RIGHT	C361.EDF	C36	1
59	14976349	14976494	4487	4632	145	RIGHT	C361.EDF	C36	1
60	14982482	14982644	57	219	162	RIGHT	C361.EDF	C36	1
60	14982785	14982874	360	449	89	RIGHT	C361.EDF	C36	1
60	14983242	14983365	817	940	123	RIGHT	C361.EDF	C36	1
60	14983741	14983850	1316	1425	109	RIGHT	C361.EDF	C36	1
60	14986513	14986616	4088	4191	103	RIGHT	C361.EDF	C36	1
60	14988616	14988708	6191	6283	92	RIGHT	C361.EDF	C36	1
61	14993675	14993772	850	947	97	RIGHT	C361.EDF	C36	1
61	14993863	14993872	1038	1047	9	RIGHT	C361.EDF	C36	1
61	14994007	14994156	1182	1331	149	RIGHT	C361.EDF	C36	1
61	14997303	14997424	4478	4599	121	RIGHT	C361.EDF	C36	1
62	15000337	15000583	57	303	246	RIGHT	C361.EDF	C36	1
62	15000826	15000957	546	677	131	RIGHT	C361.EDF	C36	1
62	15001319	15001407	1039	1127	88	RIGHT	C361.EDF	C36	1
62	15007008	15007045	6728	6765	37	RIGHT	C361.EDF	C36	1
63	15009654	15009784	122	252	130	RIGHT	C361.EDF	C36	1
63	15010052	15010178	520	646	126	RIGHT	C361.EDF	C36	1
63	15010417	15010527	885	995	110	RIGHT	C361.EDF	C36	1
63	15013682	15013789	4150	4257	107	RIGHT	C361.EDF	C36	1
64	15017841	15018031	62	252	190	RIGHT	C361.EDF	C36	1
64	15018182	15018293	403	514	111	RIGHT	C361.EDF	C36	1
64	15018748	15018879	969	1100	131	RIGHT	C361.EDF	C36	1
64	15019507	15019654	1728	1875	147	RIGHT	C361.EDF	C36	1
64	15021450	15021593	3671	3814	143	RIGHT	C361.EDF	C36	1
64	15024172	15024292	6393	6513	120	RIGHT	C361.EDF	C36	1
65	15027983	15028122	131	270	139	RIGHT	C361.EDF	C36	1
65	15028530	15028643	678	791	113	RIGHT	C361.EDF	C36	1
66	15035825	15036037	113	325	212	RIGHT	C361.EDF	C36	1
66	15036257	15036305	545	593	48	RIGHT	C361.EDF	C36	1
66	15036518	15036652	806	940	134	RIGHT	C361.EDF	C36	1
66	15037406	15037477	1694	1765	71	RIGHT	C361.EDF	C36	1
67	15043680	15043809	78	207	129	RIGHT	C361.EDF	C36	1
67	15043939	15044052	337	450	113	RIGHT	C361.EDF	C36	1
67	15044384	15044521	782	919	137	RIGHT	C361.EDF	C36	1
67	15047550	15047652	3948	4050	102	RIGHT	C361.EDF	C36	1
68	15052522	15052647	82	207	125	RIGHT	C361.EDF	C36	1
68	15053592	15053700	1152	1260	108	RIGHT	C361.EDF	C36	1
68	15057439	15057559	4999	5119	120	RIGHT	C361.EDF	C36	1
69	15061671	15061735	57	121	64	RIGHT	C361.EDF	C36	1
69	15061925	15062046	311	432	121	RIGHT	C361.EDF	C36	1
69	15062341	15062481	727	867	140	RIGHT	C361.EDF	C36	1
70	15070449	15070509	57	117	60	RIGHT	C361.EDF	C36	1
70	15070652	15070775	260	383	123	RIGHT	C361.EDF	C36	1
70	15071386	15071516	994	1124	130	RIGHT	C361.EDF	C36	1
70	15071728	15071813	1336	1421	85	RIGHT	C361.EDF	C36	1
70	15071985	15072071	1593	1679	86	RIGHT	C361.EDF	C36	1
70	15072290	15072348	1898	1956	58	RIGHT	C361.EDF	C36	1
70	15072822	15072940	2430	2548	118	RIGHT	C361.EDF	C36	1
70	15074788	15074934	4396	4542	146	RIGHT	C361.EDF	C36	1
71	15078596	15078762	218	384	166	RIGHT	C361.EDF	C36	1
71	15079724	15079820	1346	1442	96	RIGHT	C361.EDF	C36	1
71	15083328	15083445	4950	5067	117	RIGHT	C361.EDF	C36	1
71	15084785	15084922	6407	6544	137	RIGHT	C361.EDF	C36	1
72	15087989	15088017	58	86	28	RIGHT	C361.EDF	C36	1
72	15088196	15088354	265	423	158	RIGHT	C361.EDF	C36	1
73	15097006	15097205	57	256	199	RIGHT	C361.EDF	C36	1
73	15097712	15097818	763	869	106	RIGHT	C361.EDF	C36	1
74	15106069	15106170	57	158	101	RIGHT	C361.EDF	C36	1
74	15106301	15106436	289	424	135	RIGHT	C361.EDF	C36	1
74	15107180	15107276	1168	1264	96	RIGHT	C361.EDF	C36	1
74	15107484	15107535	1472	1523	51	RIGHT	C361.EDF	C36	1
75	15113954	15114092	65	203	138	RIGHT	C361.EDF	C36	1
75	15114218	15114359	329	470	141	RIGHT	C361.EDF	C36	1
75	15114544	15114686	655	797	142	RIGHT	C361.EDF	C36	1
75	15114886	15114974	997	1085	88	RIGHT	C361.EDF	C36	1
75	15115527	15115600	1638	1711	73	RIGHT	C361.EDF	C36	1
75	15115771	15115909	1882	2020	138	RIGHT	C361.EDF	C36	1
75	15119195	15119309	5306	5420	114	RIGHT	C361.EDF	C36	1
75	15120236	15120344	6347	6455	108	RIGHT	C361.EDF	C36	1
76	15124630	15124755	313	438	125	RIGHT	C361.EDF	C36	1
76	15124943	15125015	626	698	72	RIGHT	C361.EDF	C36	1
76	15125090	15125195	773	878	105	RIGHT	C361.EDF	C36	1
76	15125417	15125548	1100	1231	131	RIGHT	C361.EDF	C36	1
76	15128138	15128250	3821	3933	112	RIGHT	C361.EDF	C36	1
76	15129628	15129680	5311	5363	52	RIGHT	C361.EDF	C36	1
77	15132885	15132951	57	123	66	RIGHT	C361.EDF	C36	1
77	15133048	15133144	220	316	96	RIGHT	C361.EDF	C36	1
77	15133275	15133321	447	493	46	RIGHT	C361.EDF	C36	1
77	15133679	15133796	851	968	117	RIGHT	C361.EDF	C36	1
77	15134415	15134457	1587	1629	42	RIGHT	C361.EDF	C36	1
77	15135974	15136079	3146	3251	105	RIGHT	C361.EDF	C36	1
78	15142211	15142316	57	162	105	RIGHT	C361.EDF	C36	1
78	15142645	15142736	491	582	91	RIGHT	C361.EDF	C36	1
78	15143082	15143208	928	1054	126	RIGHT	C361.EDF	C36	1
78	15143462	15143634	1308	1480	172	RIGHT	C361.EDF	C36	1
79	15151775	15151876	57	158	101	RIGHT	C361.EDF	C36	1
79	15152258	15152396	540	678	138	RIGHT	C361.EDF	C36	1
80	15159987	15160033	57	103	46	RIGHT	C361.EDF	C36	1
80	15160178	15160349	248	419	171	RIGHT	C361.EDF	C36	1
80	15160943	15161071	1013	1141	128	RIGHT	C361.EDF	C36	1
80	15161266	15161379	1336	1449	113	RIGHT	C361.EDF	C36	1
80	15163594	15163709	3664	3779	115	RIGHT	C361.EDF	C36	1
81	15168399	15168697	58	356	298	RIGHT	C361.EDF	C36	1
81	15169294	15169400	953	1059	106	RIGHT	C361.EDF	C36	1
81	15169609	15169679	1268	1338	70	RIGHT	C361.EDF	C36	1
81	15174708	15174787	6367	6446	79	RIGHT	C361.EDF	C36	1
82	15178276	15178421	58	203	145	RIGHT	C361.EDF	C36	1
82	15178640	15178727	422	509	87	RIGHT	C361.EDF	C36	1
82	15178900	15179034	682	816	134	RIGHT	C361.EDF	C36	1
82	15179127	15179297	909	1079	170	RIGHT	C361.EDF	C36	1
82	15179392	15179536	1174	1318	144	RIGHT	C361.EDF	C36	1
82	15179719	15179832	1501	1614	113	RIGHT	C361.EDF	C36	1
82	15181691	15181786	3473	3568	95	RIGHT	C361.EDF	C36	1
83	15186654	15186807	601	754	153	RIGHT	C361.EDF	C36	1
83	15187155	15187302	1102	1249	147	RIGHT	C361.EDF	C36	1
83	15190078	15190177	4025	4124	99	RIGHT	C361.EDF	C36	1
84	15199557	15199674	4856	4973	117	RIGHT	C361.EDF	C36	1
85	15205124	15205226	81	183	102	RIGHT	C361.EDF	C36	1
85	15206491	15206631	1448	1588	140	RIGHT	C361.EDF	C36	1
85	15207970	15208098	2927	3055	128	RIGHT	C361.EDF	C36	1
85	15209184	15209323	4141	4280	139	RIGHT	C361.EDF	C36	1
85	15210192	15210335	5149	5292	143	RIGHT	C361.EDF	C36	1
86	15214229	15214317	120	208	88	RIGHT	C361.EDF	C36	1
86	15214441	15214555	332	446	114	RIGHT	C361.EDF	C36	1
86	15214781	15214892	672	783	111	RIGHT	C361.EDF	C36	1
86	15215056	15215165	947	1056	109	RIGHT	C361.EDF	C36	1
86	15215277	15215384	1168	1275	107	RIGHT	C361.EDF	C36	1
86	15215504	15215592	1395	1483	88	RIGHT	C361.EDF	C36	1
86	15215823	15215926	1714	1817	103	RIGHT	C361.EDF	C36	1
86	15216610	15216724	2501	2615	114	RIGHT	C361.EDF	C36	1
86	15217091	15217219	2982	3110	128	RIGHT	C361.EDF	C36	1
86	15217575	15217684	3466	3575	109	RIGHT	C361.EDF	C36	1
86	15218116	15218237	4007	4128	121	RIGHT	C361.EDF	C36	1
86	15218553	15218675	4444	4566	122	RIGHT	C361.EDF	C36	1
87	15222531	15222656	628	753	125	RIGHT	C361.EDF	C36	1
87	15222921	15223044	1018	1141	123	RIGHT	C361.EDF	C36	1
87	15223557	15223662	1654	1759	105	RIGHT	C361.EDF	C36	1
87	15224753	15224864	2850	2961	111	RIGHT	C361.EDF	C36	1
88	15230370	15230450	57	137	80	RIGHT	C361.EDF	C36	1
88	15230594	15230708	281	395	114	RIGHT	C361.EDF	C36	1
88	15231605	15231695	1292	1382	90	RIGHT	C361.EDF	C36	1
89	15239070	15239234	57	221	164	RIGHT	C361.EDF	C36	1
89	15239286	15239431	273	418	145	RIGHT	C361.EDF	C36	1
89	15240091	15240206	1078	1193	115	RIGHT	C361.EDF	C36	1
89	15241949	15242059	2936	3046	110	RIGHT	C361.EDF	C36	1
90	15248375	15248448	57	130	73	RIGHT	C361.EDF	C36	1
90	15248543	15248563	225	245	20	RIGHT	C361.EDF	C36	1
90	15248639	15248669	321	351	30	RIGHT	C361.EDF	C36	1
90	15248697	15248990	379	672	293	RIGHT	C361.EDF	C36	1
90	15249247	15249353	929	1035	106	RIGHT	C361.EDF	C36	1
91	15256481	15256595	57	171	114	RIGHT	C361.EDF	C36	1
91	15256806	15256835	382	411	29	RIGHT	C361.EDF	C36	1
91	15256949	15257067	525	643	118	RIGHT	C361.EDF	C36	1
91	15257378	15257502	954	1078	124	RIGHT	C361.EDF	C36	1
92	15264590	15264745	548	703	155	RIGHT	C361.EDF	C36	1
92	15267538	15267635	3496	3593	97	RIGHT	C361.EDF	C36	1
92	15269270	15269356	5228	5314	86	RIGHT	C361.EDF	C36	1
93	15273582	15273690	57	165	108	RIGHT	C361.EDF	C36	1
93	15273749	15273882	224	357	133	RIGHT	C361.EDF	C36	1
93	15274804	15274904	1279	1379	100	RIGHT	C361.EDF	C36	1
93	15275128	15275240	1603	1715	112	RIGHT	C361.EDF	C36	1
93	15276218	15276318	2693	2793	100	RIGHT	C361.EDF	C36	1
94	15281667	15281732	57	122	65	RIGHT	C361.EDF	C36	1
94	15282673	15282821	1063	1211	148	RIGHT	C361.EDF	C36	1
94	15284955	15285078	3345	3468	123	RIGHT	C361.EDF	C36	1
95	15290018	15290102	58	142	84	RIGHT	C361.EDF	C36	1
95	15290230	15290367	270	407	137	RIGHT	C361.EDF	C36	1
95	15291276	15291424	1316	1464	148	RIGHT	C361.EDF	C36	1
95	15293453	15293538	3493	3578	85	RIGHT	C361.EDF	C36	1
96	15298828	15298868	58	98	40	RIGHT	C361.EDF	C36	1
96	15298974	15299144	204	374	170	RIGHT	C361.EDF	C36	1
96	15299693	15299751	923	981	58	RIGHT	C361.EDF	C36	1
96	15299992	15300125	1222	1355	133	RIGHT	C361.EDF	C36	1
97	15307537	15307675	512	650	138	RIGHT	C361.EDF	C36	1
97	15308496	15308647	1471	1622	151	RIGHT	C361.EDF	C36	1
97	15308871	15308947	1846	1922	76	RIGHT	C361.EDF	C36	1
98	15315189	15315297	57	165	108	RIGHT	C361.EDF	C36	1
98	15315478	15315582	346	450	104	RIGHT	C361.EDF	C36	1
98	15320542	15320656	5410	5524	114	RIGHT	C361.EDF	C36	1
99	15323556	15323692	58	194	136	RIGHT	C361.EDF	C36	1
99	15323815	15323932	317	434	117	RIGHT	C361.EDF	C36	1
99	15327167	15327223	3669	3725	56	RIGHT	C361.EDF	C36	1
100	15331726	15331992	57	323	266	RIGHT	C361.EDF	C36	1
100	15332453	15332593	784	924	140	RIGHT	C361.EDF	C36	1
101	15339328	15339424	212	308	96	RIGHT	C361.EDF	C36	1
101	15340794	15340913	1678	1797	119	RIGHT	C361.EDF	C36	1
101	15344646	15344708	5530	5592	62	RIGHT	C361.EDF	C36	1
102	15347351	15347437	109	195	86	RIGHT	C361.EDF	C36	1
102	15351220	15351260	3978	4018	40	RIGHT	C361.EDF	C36	1
103	15356609	15356707	190	288	98	RIGHT	C361.EDF	C36	1
103	15357123	15357214	704	795	91	RIGHT	C361.EDF	C36	1
103	15357674	15357795	1255	1376	121	RIGHT	C361.EDF	C36	1
104	15364572	15364625	57	110	53	RIGHT	C361.EDF	C36	1
104	15364714	15364836	199	321	122	RIGHT	C361.EDF	C36	1
104	15365530	15365605	1015	1090	75	RIGHT	C361.EDF	C36	1
104	15365854	15365900	1339	1385	46	RIGHT	C361.EDF	C36	1
104	15370671	15370740	6156	6225	69	RIGHT	C361.EDF	C36	1
105	15373716	15374039	58	381	323	RIGHT	C361.EDF	C36	1
105	15374205	15374269	547	611	64	RIGHT	C361.EDF	C36	1
105	15375122	15375232	1464	1574	110	RIGHT	C361.EDF	C36	1
105	15378471	15378571	4813	4913	100	RIGHT	C361.EDF	C36	1
106	15381498	15381557	57	116	59	RIGHT	C361.EDF	C36	1
106	15381717	15381868	276	427	151	RIGHT	C361.EDF	C36	1
106	15385836	15385972	4395	4531	136	RIGHT	C361.EDF	C36	1
107	15391467	15391689	110	332	222	RIGHT	C361.EDF	C36	1
107	15392152	15392282	795	925	130	RIGHT	C361.EDF	C36	1
107	15396965	15397046	5608	5689	81	RIGHT	C361.EDF	C36	1
108	15400793	15400820	57	84	27	RIGHT	C361.EDF	C36	1
108	15401030	15401146	294	410	116	RIGHT	C361.EDF	C36	1
108	15406953	15407078	6217	6342	125	RIGHT	C361.EDF	C36	1
109	15410068	15410270	57	259	202	RIGHT	C361.EDF	C36	1
109	15413160	15413261	3149	3250	101	RIGHT	C361.EDF	C36	1
110	15417977	15418106	94	223	129	RIGHT	C361.EDF	C36	1
110	15422295	15422321	4412	4438	26	RIGHT	C361.EDF	C36	1
110	15422345	15422347	4462	4464	2	RIGHT	C361.EDF	C36	1
111	15425622	15425676	57	111	54	RIGHT	C361.EDF	C36	1
111	15425899	15425975	334	410	76	RIGHT	C361.EDF	C36	1
111	15426090	15426186	525	621	96	RIGHT	C361.EDF	C36	1
112	15434677	15434693	95	111	16	RIGHT	C361.EDF	C36	1
112	15434818	15434986	236	404	168	RIGHT	C361.EDF	C36	1
112	15435429	15435548	847	966	119	RIGHT	C361.EDF	C36	1
112	15438561	15438646	3979	4064	85	RIGHT	C361.EDF	C36	1
112	15440623	15440730	6041	6148	107	RIGHT	C361.EDF	C36	1
113	15444191	15444307	211	327	116	RIGHT	C361.EDF	C36	1
113	15444335	15444343	355	363	8	RIGHT	C361.EDF	C36	1
113	15444531	15444635	551	655	104	RIGHT	C361.EDF	C36	1
113	15444818	15444957	838	977	139	RIGHT	C361.EDF	C36	1
113	15446182	15446350	2202	2370	168	RIGHT	C361.EDF	C36	1
114	15453643	15453735	57	149	92	RIGHT	C361.EDF	C36	1
114	15455988	15456088	2402	2502	100	RIGHT	C361.EDF	C36	1
115	15462929	15463050	58	179	121	RIGHT	C361.EDF	C36	1
115	15467988	15468032	5117	5161	44	RIGHT	C361.EDF	C36	1
116	15470441	15470634	151	344	193	RIGHT	C361.EDF	C36	1
116	15471208	15471274	918	984	66	RIGHT	C361.EDF	C36	1
116	15471300	15471301	1010	1011	1	RIGHT	C361.EDF	C36	1
116	15471895	15471994	1605	1704	99	RIGHT	C361.EDF	C36	1
116	15477133	15477148	6843	6858	15	RIGHT	C361.EDF	C36	1
117	15479625	15479729	57	161	104	RIGHT	C361.EDF	C36	1
117	15479891	15480019	323	451	128	RIGHT	C361.EDF	C36	1
117	15480253	15480316	685	748	63	RIGHT	C361.EDF	C36	1
118	15487745	15487810	57	122	65	RIGHT	C361.EDF	C36	1
118	15487960	15488071	272	383	111	RIGHT	C361.EDF	C36	1
118	15488092	15488096	404	408	4	RIGHT	C361.EDF	C36	1
118	15492425	15492487	4737	4799	62	RIGHT	C361.EDF	C36	1
119	15495520	15495545	57	82	25	RIGHT	C361.EDF	C36	1
119	15495848	15495911	385	448	63	RIGHT	C361.EDF	C36	1
119	15496129	15496246	666	783	117	RIGHT	C361.EDF	C36	1
119	15498923	15498987	3460	3524	64	RIGHT	C361.EDF	C36	1
119	15499020	15499020	3557	3557	0	RIGHT	C361.EDF	C36	1
120	15504065	15504163	57	155	98	RIGHT	C361.EDF	C36	1
120	15504318	15504417	310	409	99	RIGHT	C361.EDF	C36	1
120	15505042	15505112	1034	1104	70	RIGHT	C361.EDF	C36	1
120	15505207	15505344	1199	1336	137	RIGHT	C361.EDF	C36	1
1	16204531	16204584	5095	5148	53	RIGHT	C362.EDF	C36	2
2	16208736	16208758	255	277	22	RIGHT	C362.EDF	C36	2
2	16209187	16209837	706	1356	650	RIGHT	C362.EDF	C36	2
2	16211988	16212318	3507	3837	330	RIGHT	C362.EDF	C36	2
2	16212848	16212891	4367	4410	43	RIGHT	C362.EDF	C36	2
2	16213780	16213817	5299	5336	37	RIGHT	C362.EDF	C36	2
3	16216774	16216961	58	245	187	RIGHT	C362.EDF	C36	2
3	16217093	16217159	377	443	66	RIGHT	C362.EDF	C36	2
3	16217501	16217599	785	883	98	RIGHT	C362.EDF	C36	2
3	16218078	16218200	1362	1484	122	RIGHT	C362.EDF	C36	2
3	16221966	16222060	5250	5344	94	RIGHT	C362.EDF	C36	2
4	16225936	16226279	57	400	343	RIGHT	C362.EDF	C36	2
4	16226684	16226754	805	875	70	RIGHT	C362.EDF	C36	2
5	16235539	16236265	57	783	726	RIGHT	C362.EDF	C36	2
5	16236388	16236545	906	1063	157	RIGHT	C362.EDF	C36	2
5	16236948	16237044	1466	1562	96	RIGHT	C362.EDF	C36	2
6	16243144	16243355	57	268	211	RIGHT	C362.EDF	C36	2
6	16243685	16243783	598	696	98	RIGHT	C362.EDF	C36	2
7	16251432	16251488	262	318	56	RIGHT	C362.EDF	C36	2
7	16251704	16251842	534	672	138	RIGHT	C362.EDF	C36	2
8	16259033	16259070	57	94	37	RIGHT	C362.EDF	C36	2
8	16259192	16259329	216	353	137	RIGHT	C362.EDF	C36	2
8	16259567	16259683	591	707	116	RIGHT	C362.EDF	C36	2
8	16260310	16260373	1334	1397	63	RIGHT	C362.EDF	C36	2
8	16264435	16264578	5459	5602	143	RIGHT	C362.EDF	C36	2
9	16267388	16267642	57	311	254	RIGHT	C362.EDF	C36	2
9	16271052	16271184	3721	3853	132	RIGHT	C362.EDF	C36	2
10	16274883	16275157	58	332	274	RIGHT	C362.EDF	C36	2
10	16279645	16279763	4820	4938	118	RIGHT	C362.EDF	C36	2
11	16284049	16284181	67	199	132	RIGHT	C362.EDF	C36	2
11	16285184	16285281	1202	1299	97	RIGHT	C362.EDF	C36	2
12	16293746	16293856	164	274	110	RIGHT	C362.EDF	C36	2
12	16294052	16294168	470	586	116	RIGHT	C362.EDF	C36	2
12	16299154	16299227	5572	5645	73	RIGHT	C362.EDF	C36	2
13	16303730	16304157	58	485	427	RIGHT	C362.EDF	C36	2
13	16308035	16308125	4363	4453	90	RIGHT	C362.EDF	C36	2
14	16312739	16312885	105	251	146	RIGHT	C362.EDF	C36	2
14	16313689	16313819	1055	1185	130	RIGHT	C362.EDF	C36	2
14	16314166	16314208	1532	1574	42	RIGHT	C362.EDF	C36	2
15	16321719	16321836	57	174	117	RIGHT	C362.EDF	C36	2
15	16321976	16322102	314	440	126	RIGHT	C362.EDF	C36	2
15	16322450	16322583	788	921	133	RIGHT	C362.EDF	C36	2
16	16329877	16330236	57	416	359	RIGHT	C362.EDF	C36	2
16	16330912	16331053	1092	1233	141	RIGHT	C362.EDF	C36	2
17	16339438	16339525	57	144	87	RIGHT	C362.EDF	C36	2
17	16339676	16339846	295	465	170	RIGHT	C362.EDF	C36	2
17	16340278	16340402	897	1021	124	RIGHT	C362.EDF	C36	2
17	16344061	16344110	4680	4729	49	RIGHT	C362.EDF	C36	2
17	16344148	16344148	4767	4767	0	RIGHT	C362.EDF	C36	2
18	16349213	16349341	204	332	128	RIGHT	C362.EDF	C36	2
18	16349411	16349532	402	523	121	RIGHT	C362.EDF	C36	2
18	16350418	16350518	1409	1509	100	RIGHT	C362.EDF	C36	2
19	16357362	16357514	57	209	152	RIGHT	C362.EDF	C36	2
19	16357645	16357745	340	440	100	RIGHT	C362.EDF	C36	2
19	16358341	16358438	1036	1133	97	RIGHT	C362.EDF	C36	2
20	16365609	16365708	58	157	99	RIGHT	C362.EDF	C36	2
20	16365850	16366004	299	453	154	RIGHT	C362.EDF	C36	2
20	16366679	16366771	1128	1220	92	RIGHT	C362.EDF	C36	2
20	16367044	16367153	1493	1602	109	RIGHT	C362.EDF	C36	2
21	16373401	16373584	58	241	183	RIGHT	C362.EDF	C36	2
21	16373877	16373962	534	619	85	RIGHT	C362.EDF	C36	2
21	16374218	16374290	875	947	72	RIGHT	C362.EDF	C36	2
22	16381139	16381279	57	197	140	RIGHT	C362.EDF	C36	2
22	16381398	16381482	316	400	84	RIGHT	C362.EDF	C36	2
23	16389341	16389588	58	305	247	RIGHT	C362.EDF	C36	2
23	16389912	16390031	629	748	119	RIGHT	C362.EDF	C36	2
24	16398637	16398867	57	287	230	RIGHT	C362.EDF	C36	2
24	16399481	16399560	901	980	79	RIGHT	C362.EDF	C36	2
25	16408118	16408207	261	350	89	RIGHT	C362.EDF	C36	2
25	16408702	16408798	845	941	96	RIGHT	C362.EDF	C36	2
25	16411011	16411102	3154	3245	91	RIGHT	C362.EDF	C36	2
25	16411123	16411124	3266	3267	1	RIGHT	C362.EDF	C36	2
25	16412078	16412219	4221	4362	141	RIGHT	C362.EDF	C36	2
26	16415731	16415831	149	249	100	RIGHT	C362.EDF	C36	2
26	16415857	16415861	275	279	4	RIGHT	C362.EDF	C36	2
26	16416848	16416917	1266	1335	69	RIGHT	C362.EDF	C36	2
26	16418526	16418595	2944	3013	69	RIGHT	C362.EDF	C36	2
26	16418620	16418620	3038	3038	0	RIGHT	C362.EDF	C36	2
27	16424675	16424784	57	166	109	RIGHT	C362.EDF	C36	2
27	16424947	16425034	329	416	87	RIGHT	C362.EDF	C36	2
27	16425293	16425386	675	768	93	RIGHT	C362.EDF	C36	2
27	16430163	16430204	5545	5586	41	RIGHT	C362.EDF	C36	2
27	16430233	16430234	5615	5616	1	RIGHT	C362.EDF	C36	2
28	16433362	16433565	57	260	203	RIGHT	C362.EDF	C36	2
28	16435562	16435642	2257	2337	80	RIGHT	C362.EDF	C36	2
28	16435672	16435672	2367	2367	0	RIGHT	C362.EDF	C36	2
28	16435857	16435966	2552	2661	109	RIGHT	C362.EDF	C36	2
28	16435988	16435988	2683	2683	0	RIGHT	C362.EDF	C36	2
29	16441782	16441834	108	160	52	RIGHT	C362.EDF	C36	2
29	16442033	16442104	359	430	71	RIGHT	C362.EDF	C36	2
29	16442983	16443087	1309	1413	104	RIGHT	C362.EDF	C36	2
29	16448974	16449001	7300	7327	27	RIGHT	C362.EDF	C36	2
30	16451329	16451740	58	469	411	RIGHT	C362.EDF	C36	2
30	16451935	16452034	664	763	99	RIGHT	C362.EDF	C36	2
30	16452210	16452353	939	1082	143	RIGHT	C362.EDF	C36	2
30	16452488	16452655	1217	1384	167	RIGHT	C362.EDF	C36	2
30	16455885	16455997	4614	4726	112	RIGHT	C362.EDF	C36	2
30	16456666	16456775	5395	5504	109	RIGHT	C362.EDF	C36	2
31	16460455	16460867	58	470	412	RIGHT	C362.EDF	C36	2
31	16461398	16461477	1001	1080	79	RIGHT	C362.EDF	C36	2
32	16470141	16470345	57	261	204	RIGHT	C362.EDF	C36	2
32	16470400	16470503	316	419	103	RIGHT	C362.EDF	C36	2
32	16471069	16471174	985	1090	105	RIGHT	C362.EDF	C36	2
32	16471529	16471647	1445	1563	118	RIGHT	C362.EDF	C36	2
32	16471812	16471940	1728	1856	128	RIGHT	C362.EDF	C36	2
32	16477028	16477072	6944	6988	44	RIGHT	C362.EDF	C36	2
33	16480056	16480213	58	215	157	RIGHT	C362.EDF	C36	2
34	16488135	16488227	839	931	92	RIGHT	C362.EDF	C36	2
34	16488345	16488477	1049	1181	132	RIGHT	C362.EDF	C36	2
35	16495057	16495153	57	153	96	RIGHT	C362.EDF	C36	2
36	16503221	16503332	57	168	111	RIGHT	C362.EDF	C36	2
36	16503420	16503580	256	416	160	RIGHT	C362.EDF	C36	2
36	16504058	16504148	894	984	90	RIGHT	C362.EDF	C36	2
36	16509216	16509228	6052	6064	12	RIGHT	C362.EDF	C36	2
37	16511918	16512075	57	214	157	RIGHT	C362.EDF	C36	2
37	16513683	16513800	1822	1939	117	RIGHT	C362.EDF	C36	2
38	16521796	16521927	734	865	131	RIGHT	C362.EDF	C36	2
38	16522267	16522362	1205	1300	95	RIGHT	C362.EDF	C36	2
38	16522570	16522693	1508	1631	123	RIGHT	C362.EDF	C36	2
39	16529395	16529482	57	144	87	RIGHT	C362.EDF	C36	2
39	16536505	16536556	7167	7218	51	RIGHT	C362.EDF	C36	2
40	16540460	16540582	810	932	122	RIGHT	C362.EDF	C36	2
40	16542490	16542525	2840	2875	35	RIGHT	C362.EDF	C36	2
40	16542555	16542555	2905	2905	0	RIGHT	C362.EDF	C36	2
41	16549516	16549644	1114	1242	128	RIGHT	C362.EDF	C36	2
42	16557579	16557651	874	946	72	RIGHT	C362.EDF	C36	2
42	16559190	16559314	2485	2609	124	RIGHT	C362.EDF	C36	2
43	16565740	16565858	57	175	118	RIGHT	C362.EDF	C36	2
43	16566044	16566139	361	456	95	RIGHT	C362.EDF	C36	2
43	16566382	16566509	699	826	127	RIGHT	C362.EDF	C36	2
43	16567105	16567222	1422	1539	117	RIGHT	C362.EDF	C36	2
43	16569622	16569695	3939	4012	73	RIGHT	C362.EDF	C36	2
43	16569716	16569717	4033	4034	1	RIGHT	C362.EDF	C36	2
44	16575183	16575402	57	276	219	RIGHT	C362.EDF	C36	2
44	16575869	16575971	743	845	102	RIGHT	C362.EDF	C36	2
44	16576342	16576455	1216	1329	113	RIGHT	C362.EDF	C36	2
45	16585445	16585557	1043	1155	112	RIGHT	C362.EDF	C36	2
46	16594975	16595052	3076	3153	77	RIGHT	C362.EDF	C36	2
46	16595076	16595081	3177	3182	5	RIGHT	C362.EDF	C36	2
47	16599674	16599791	57	174	117	RIGHT	C362.EDF	C36	2
47	16601101	16601207	1484	1590	106	RIGHT	C362.EDF	C36	2
48	16609353	16609404	1026	1077	51	RIGHT	C362.EDF	C36	2
48	16609616	16609709	1289	1382	93	RIGHT	C362.EDF	C36	2
49	16621009	16621119	4927	5037	110	RIGHT	C362.EDF	C36	2
50	16625368	16625497	210	339	129	RIGHT	C362.EDF	C36	2
50	16626446	16626548	1288	1390	102	RIGHT	C362.EDF	C36	2
50	16626591	16626595	1433	1437	4	RIGHT	C362.EDF	C36	2
50	16626639	16626814	1481	1656	175	RIGHT	C362.EDF	C36	2
50	16626977	16627108	1819	1950	131	RIGHT	C362.EDF	C36	2
50	16627768	16627935	2610	2777	167	RIGHT	C362.EDF	C36	2
50	16628161	16628326	3003	3168	165	RIGHT	C362.EDF	C36	2
51	16633013	16633082	57	126	69	RIGHT	C362.EDF	C36	2
51	16634138	16634200	1182	1244	62	RIGHT	C362.EDF	C36	2
52	16641011	16641112	83	184	101	RIGHT	C362.EDF	C36	2
52	16641257	16641368	329	440	111	RIGHT	C362.EDF	C36	2
52	16645059	16645124	4131	4196	65	RIGHT	C362.EDF	C36	2
53	16648804	16648988	93	277	184	RIGHT	C362.EDF	C36	2
53	16649568	16649692	857	981	124	RIGHT	C362.EDF	C36	2
53	16649894	16650030	1183	1319	136	RIGHT	C362.EDF	C36	2
53	16650278	16650382	1567	1671	104	RIGHT	C362.EDF	C36	2
54	16657474	16657606	57	189	132	RIGHT	C362.EDF	C36	2
54	16658387	16658416	970	999	29	RIGHT	C362.EDF	C36	2
54	16658727	16658824	1310	1407	97	RIGHT	C362.EDF	C36	2
55	16665436	16665480	58	102	44	RIGHT	C362.EDF	C36	2
55	16666178	16666334	800	956	156	RIGHT	C362.EDF	C36	2
55	16666575	16666688	1197	1310	113	RIGHT	C362.EDF	C36	2
55	16667512	16667649	2134	2271	137	RIGHT	C362.EDF	C36	2
56	16675216	16675327	57	168	111	RIGHT	C362.EDF	C36	2
56	16675470	16675602	311	443	132	RIGHT	C362.EDF	C36	2
56	16677881	16677907	2722	2748	26	RIGHT	C362.EDF	C36	2
57	16683205	16683283	57	135	78	RIGHT	C362.EDF	C36	2
57	16683895	16683976	747	828	81	RIGHT	C362.EDF	C36	2
58	16694075	16694388	71	384	313	RIGHT	C362.EDF	C36	2
59	16703266	16703321	57	112	55	RIGHT	C362.EDF	C36	2
59	16703505	16703597	296	388	92	RIGHT	C362.EDF	C36	2
59	16704279	16704399	1070	1190	120	RIGHT	C362.EDF	C36	2
60	16711506	16711795	58	347	289	RIGHT	C362.EDF	C36	2
61	16719792	16720017	57	282	225	RIGHT	C362.EDF	C36	2
61	16720067	16720173	332	438	106	RIGHT	C362.EDF	C36	2
61	16720674	16720757	939	1022	83	RIGHT	C362.EDF	C36	2
61	16720918	16721057	1183	1322	139	RIGHT	C362.EDF	C36	2
62	16729409	16729731	57	379	322	RIGHT	C362.EDF	C36	2
62	16729948	16730063	596	711	115	RIGHT	C362.EDF	C36	2
62	16730346	16730484	994	1132	138	RIGHT	C362.EDF	C36	2
63	16736479	16736519	58	98	40	RIGHT	C362.EDF	C36	2
63	16736647	16736864	226	443	217	RIGHT	C362.EDF	C36	2
63	16737404	16737496	983	1075	92	RIGHT	C362.EDF	C36	2
63	16738414	16738507	1993	2086	93	RIGHT	C362.EDF	C36	2
64	16746105	16746205	82	182	100	RIGHT	C362.EDF	C36	2
64	16746630	16746730	607	707	100	RIGHT	C362.EDF	C36	2
64	16746891	16747007	868	984	116	RIGHT	C362.EDF	C36	2
64	16747188	16747341	1165	1318	153	RIGHT	C362.EDF	C36	2
65	16754556	16754621	57	122	65	RIGHT	C362.EDF	C36	2
65	16754843	16754933	344	434	90	RIGHT	C362.EDF	C36	2
66	16763397	16763528	282	413	131	RIGHT	C362.EDF	C36	2
66	16763550	16763550	435	435	0	RIGHT	C362.EDF	C36	2
66	16763944	16764038	829	923	94	RIGHT	C362.EDF	C36	2
66	16764203	16764293	1088	1178	90	RIGHT	C362.EDF	C36	2
66	16765870	16765914	2755	2799	44	RIGHT	C362.EDF	C36	2
66	16766271	16766380	3156	3265	109	RIGHT	C362.EDF	C36	2
67	16772716	16773048	58	390	332	RIGHT	C362.EDF	C36	2
67	16773561	16773644	903	986	83	RIGHT	C362.EDF	C36	2
67	16773879	16773913	1221	1255	34	RIGHT	C362.EDF	C36	2
68	16782375	16782509	229	363	134	RIGHT	C362.EDF	C36	2
69	16789960	16790206	57	303	246	RIGHT	C362.EDF	C36	2
69	16790961	16791045	1058	1142	84	RIGHT	C362.EDF	C36	2
69	16791083	16791111	1180	1208	28	RIGHT	C362.EDF	C36	2
70	16798948	16799039	288	379	91	RIGHT	C362.EDF	C36	2
71	16808332	16808482	57	207	150	RIGHT	C362.EDF	C36	2
71	16808612	16808734	337	459	122	RIGHT	C362.EDF	C36	2
71	16808947	16809057	672	782	110	RIGHT	C362.EDF	C36	2
71	16809233	16809359	958	1084	126	RIGHT	C362.EDF	C36	2
71	16809585	16809717	1310	1442	132	RIGHT	C362.EDF	C36	2
71	16813067	16813152	4792	4877	85	RIGHT	C362.EDF	C36	2
72	16816715	16816888	57	230	173	RIGHT	C362.EDF	C36	2
72	16817012	16817119	354	461	107	RIGHT	C362.EDF	C36	2
72	16817965	16818065	1307	1407	100	RIGHT	C362.EDF	C36	2
73	16824400	16824630	57	287	230	RIGHT	C362.EDF	C36	2
73	16825058	16825176	715	833	118	RIGHT	C362.EDF	C36	2
73	16825843	16825907	1500	1564	64	RIGHT	C362.EDF	C36	2
74	16832110	16832223	67	180	113	RIGHT	C362.EDF	C36	2
74	16832932	16833064	889	1021	132	RIGHT	C362.EDF	C36	2
74	16833094	16833104	1051	1061	10	RIGHT	C362.EDF	C36	2
74	16833210	16833355	1167	1312	145	RIGHT	C362.EDF	C36	2
74	16833388	16833397	1345	1354	9	RIGHT	C362.EDF	C36	2
74	16833593	16833676	1550	1633	83	RIGHT	C362.EDF	C36	2
74	16833703	16833703	1660	1660	0	RIGHT	C362.EDF	C36	2
75	16841703	16841740	57	94	37	RIGHT	C362.EDF	C36	2
75	16842612	16842694	966	1048	82	RIGHT	C362.EDF	C36	2
75	16847505	16847551	5859	5905	46	RIGHT	C362.EDF	C36	2
76	16851667	16851775	245	353	108	RIGHT	C362.EDF	C36	2
76	16852293	16852408	871	986	115	RIGHT	C362.EDF	C36	2
76	16852826	16852948	1404	1526	122	RIGHT	C362.EDF	C36	2
76	16857280	16857380	5858	5958	100	RIGHT	C362.EDF	C36	2
77	16861817	16861954	539	676	137	RIGHT	C362.EDF	C36	2
78	16869083	16869302	58	277	219	RIGHT	C362.EDF	C36	2
79	16877103	16877221	58	176	118	RIGHT	C362.EDF	C36	2
79	16878138	16878264	1093	1219	126	RIGHT	C362.EDF	C36	2
80	16884338	16884609	58	329	271	RIGHT	C362.EDF	C36	2
80	16885731	16885809	1451	1529	78	RIGHT	C362.EDF	C36	2
80	16886017	16886129	1737	1849	112	RIGHT	C362.EDF	C36	2
81	16893090	16893729	57	696	639	RIGHT	C362.EDF	C36	2
81	16893750	16893858	717	825	108	RIGHT	C362.EDF	C36	2
81	16893884	16893884	851	851	0	RIGHT	C362.EDF	C36	2
81	16895419	16895525	2386	2492	106	RIGHT	C362.EDF	C36	2
82	16900359	16900475	222	338	116	RIGHT	C362.EDF	C36	2
82	16900819	16900913	682	776	94	RIGHT	C362.EDF	C36	2
82	16901145	16901217	1008	1080	72	RIGHT	C362.EDF	C36	2
82	16901432	16901543	1295	1406	111	RIGHT	C362.EDF	C36	2
83	16907463	16907571	58	166	108	RIGHT	C362.EDF	C36	2
84	16916640	16916750	252	362	110	RIGHT	C362.EDF	C36	2
84	16917589	16917643	1201	1255	54	RIGHT	C362.EDF	C36	2
84	16918745	16918818	2357	2430	73	RIGHT	C362.EDF	C36	2
85	16926451	16926496	58	103	45	RIGHT	C362.EDF	C36	2
85	16926705	16926807	312	414	102	RIGHT	C362.EDF	C36	2
86	16934760	16934885	110	235	125	RIGHT	C362.EDF	C36	2
87	16942734	16942916	57	239	182	RIGHT	C362.EDF	C36	2
87	16943086	16943142	409	465	56	RIGHT	C362.EDF	C36	2
87	16943482	16943591	805	914	109	RIGHT	C362.EDF	C36	2
88	16951757	16951879	57	179	122	RIGHT	C362.EDF	C36	2
88	16951984	16952102	284	402	118	RIGHT	C362.EDF	C36	2
88	16952974	16953092	1274	1392	118	RIGHT	C362.EDF	C36	2
89	16960415	16960611	57	253	196	RIGHT	C362.EDF	C36	2
89	16961080	16961186	722	828	106	RIGHT	C362.EDF	C36	2
89	16961356	16961469	998	1111	113	RIGHT	C362.EDF	C36	2
89	16961626	16961704	1268	1346	78	RIGHT	C362.EDF	C36	2
89	16962794	16962896	2436	2538	102	RIGHT	C362.EDF	C36	2
89	16964579	16964633	4221	4275	54	RIGHT	C362.EDF	C36	2
90	16969267	16969394	138	265	127	RIGHT	C362.EDF	C36	2
91	16978124	16978547	57	480	423	RIGHT	C362.EDF	C36	2
92	16988388	16988678	57	347	290	RIGHT	C362.EDF	C36	2
92	16989436	16989437	1105	1106	1	RIGHT	C362.EDF	C36	2
92	16989475	16989479	1144	1148	4	RIGHT	C362.EDF	C36	2
93	16997454	16997843	58	447	389	RIGHT	C362.EDF	C36	2
94	17004783	17005106	58	381	323	RIGHT	C362.EDF	C36	2
94	17005543	17005654	818	929	111	RIGHT	C362.EDF	C36	2
94	17008631	17008691	3906	3966	60	RIGHT	C362.EDF	C36	2
94	17008713	17008721	3988	3996	8	RIGHT	C362.EDF	C36	2
95	17014904	17014933	57	86	29	RIGHT	C362.EDF	C36	2
95	17017405	17017495	2558	2648	90	RIGHT	C362.EDF	C36	2
96	17024392	17024485	57	150	93	RIGHT	C362.EDF	C36	2
96	17024688	17024689	353	354	1	RIGHT	C362.EDF	C36	2
96	17024732	17024734	397	399	2	RIGHT	C362.EDF	C36	2
96	17028052	17028110	3717	3775	58	RIGHT	C362.EDF	C36	2
96	17029361	17029456	5026	5121	95	RIGHT	C362.EDF	C36	2
96	17029753	17029846	5418	5511	93	RIGHT	C362.EDF	C36	2
97	17033400	17033663	58	321	263	RIGHT	C362.EDF	C36	2
97	17033988	17034104	646	762	116	RIGHT	C362.EDF	C36	2
97	17034318	17034419	976	1077	101	RIGHT	C362.EDF	C36	2
98	17042132	17042334	57	259	202	RIGHT	C362.EDF	C36	2
98	17043055	17043171	980	1096	116	RIGHT	C362.EDF	C36	2
98	17043240	17043377	1165	1302	137	RIGHT	C362.EDF	C36	2
98	17045870	17045965	3795	3890	95	RIGHT	C362.EDF	C36	2
98	17046128	17046239	4053	4164	111	RIGHT	C362.EDF	C36	2
99	17050609	17050706	325	422	97	RIGHT	C362.EDF	C36	2
99	17051439	17051567	1155	1283	128	RIGHT	C362.EDF	C36	2
99	17055053	17055147	4769	4863	94	RIGHT	C362.EDF	C36	2
100	17058196	17058244	57	105	48	RIGHT	C362.EDF	C36	2
100	17058444	17058511	305	372	67	RIGHT	C362.EDF	C36	2
100	17059191	17059217	1052	1078	26	RIGHT	C362.EDF	C36	2
100	17060458	17060561	2319	2422	103	RIGHT	C362.EDF	C36	2
100	17060729	17060796	2590	2657	67	RIGHT	C362.EDF	C36	2
101	17066249	17066332	57	140	83	RIGHT	C362.EDF	C36	2
101	17066533	17066632	341	440	99	RIGHT	C362.EDF	C36	2
101	17067310	17067370	1118	1178	60	RIGHT	C362.EDF	C36	2
101	17067752	17067877	1560	1685	125	RIGHT	C362.EDF	C36	2
101	17069308	17069405	3116	3213	97	RIGHT	C362.EDF	C36	2
101	17070182	17070308	3990	4116	126	RIGHT	C362.EDF	C36	2
101	17073576	17073697	7384	7505	121	RIGHT	C362.EDF	C36	2
102	17076493	17076687	58	252	194	RIGHT	C362.EDF	C36	2
102	17076998	17077104	563	669	106	RIGHT	C362.EDF	C36	2
103	17084091	17084358	57	324	267	RIGHT	C362.EDF	C36	2
103	17084663	17084764	629	730	101	RIGHT	C362.EDF	C36	2
104	17092072	17092295	58	281	223	RIGHT	C362.EDF	C36	2
105	17101110	17101180	57	127	70	RIGHT	C362.EDF	C36	2
105	17101341	17101477	288	424	136	RIGHT	C362.EDF	C36	2
105	17102117	17102224	1064	1171	107	RIGHT	C362.EDF	C36	2
105	17102618	17102679	1565	1626	61	RIGHT	C362.EDF	C36	2
106	17110089	17110191	1084	1186	102	RIGHT	C362.EDF	C36	2
107	17120704	17120744	57	97	40	RIGHT	C362.EDF	C36	2
107	17121323	17121429	676	782	106	RIGHT	C362.EDF	C36	2
107	17123647	17123777	3000	3130	130	RIGHT	C362.EDF	C36	2
107	17125584	17125706	4937	5059	122	RIGHT	C362.EDF	C36	2
107	17125892	17126034	5245	5387	142	RIGHT	C362.EDF	C36	2
108	17129685	17129788	326	429	103	RIGHT	C362.EDF	C36	2
108	17130414	17130560	1055	1201	146	RIGHT	C362.EDF	C36	2
108	17130836	17130958	1477	1599	122	RIGHT	C362.EDF	C36	2
108	17133123	17133247	3764	3888	124	RIGHT	C362.EDF	C36	2
108	17133462	17133566	4103	4207	104	RIGHT	C362.EDF	C36	2
108	17134096	17134200	4737	4841	104	RIGHT	C362.EDF	C36	2
108	17134352	17134459	4993	5100	107	RIGHT	C362.EDF	C36	2
109	17138525	17138754	57	286	229	RIGHT	C362.EDF	C36	2
110	17145801	17146031	58	288	230	RIGHT	C362.EDF	C36	2
110	17146240	17146315	497	572	75	RIGHT	C362.EDF	C36	2
110	17147021	17147102	1278	1359	81	RIGHT	C362.EDF	C36	2
110	17148014	17148036	2271	2293	22	RIGHT	C362.EDF	C36	2
110	17148063	17148070	2320	2327	7	RIGHT	C362.EDF	C36	2
110	17148269	17148379	2526	2636	110	RIGHT	C362.EDF	C36	2
110	17148638	17148698	2895	2955	60	RIGHT	C362.EDF	C36	2
110	17149130	17149218	3387	3475	88	RIGHT	C362.EDF	C36	2
111	17153908	17154003	140	235	95	RIGHT	C362.EDF	C36	2
111	17154030	17154036	262	268	6	RIGHT	C362.EDF	C36	2
111	17158121	17158177	4353	4409	56	RIGHT	C362.EDF	C36	2
112	17160720	17160768	57	105	48	RIGHT	C362.EDF	C36	2
112	17160810	17160941	147	278	131	RIGHT	C362.EDF	C36	2
113	17168197	17168308	211	322	111	RIGHT	C362.EDF	C36	2
113	17168329	17168335	343	349	6	RIGHT	C362.EDF	C36	2
113	17168998	17169091	1012	1105	93	RIGHT	C362.EDF	C36	2
113	17169574	17169687	1588	1701	113	RIGHT	C362.EDF	C36	2
113	17169885	17170004	1899	2018	119	RIGHT	C362.EDF	C36	2
113	17170571	17170679	2585	2693	108	RIGHT	C362.EDF	C36	2
113	17170808	17170902	2822	2916	94	RIGHT	C362.EDF	C36	2
113	17171019	17171134	3033	3148	115	RIGHT	C362.EDF	C36	2
114	17178032	17178164	284	416	132	RIGHT	C362.EDF	C36	2
115	17186868	17187025	115	272	157	RIGHT	C362.EDF	C36	2
115	17187046	17187052	293	299	6	RIGHT	C362.EDF	C36	2
116	17193932	17194089	98	255	157	RIGHT	C362.EDF	C36	2
116	17194578	17194734	744	900	156	RIGHT	C362.EDF	C36	2
116	17195314	17195397	1480	1563	83	RIGHT	C362.EDF	C36	2
116	17197078	17197121	3244	3287	43	RIGHT	C362.EDF	C36	2
116	17197154	17197157	3320	3323	3	RIGHT	C362.EDF	C36	2
116	17198190	17198325	4356	4491	135	RIGHT	C362.EDF	C36	2
117	17201646	17201797	57	208	151	RIGHT	C362.EDF	C36	2
117	17202294	17202400	705	811	106	RIGHT	C362.EDF	C36	2
117	17202611	17202712	1022	1123	101	RIGHT	C362.EDF	C36	2
117	17202826	17203001	1237	1412	175	RIGHT	C362.EDF	C36	2
118	17211950	17212766	58	874	816	RIGHT	C362.EDF	C36	2
118	17212955	17213025	1063	1133	70	RIGHT	C362.EDF	C36	2
118	17213306	17213329	1414	1437	23	RIGHT	C362.EDF	C36	2
118	17214312	17214473	2420	2581	161	RIGHT	C362.EDF	C36	2
119	17220784	17221111	57	384	327	RIGHT	C362.EDF	C36	2
120	17228026	17228143	57	174	117	RIGHT	C362.EDF	C36	2
120	17228257	17228407	288	438	150	RIGHT	C362.EDF	C36	2
120	17229116	17229230	1147	1261	114	RIGHT	C362.EDF	C36	2
120	17229444	17229626	1475	1657	182	RIGHT	C362.EDF	C36	2
120	17230664	17230778	2695	2809	114	RIGHT	C362.EDF	C36	2
120	17231198	17231251	3229	3282	53	RIGHT	C362.EDF	C36	2
120	17231414	17231537	3445	3568	123	RIGHT	C362.EDF	C36	2
1	17838016	17838103	884	971	87	RIGHT	C363.EDF	C36	3
2	17844070	17844253	92	275	183	RIGHT	C363.EDF	C36	3
2	17844635	17844698	657	720	63	RIGHT	C363.EDF	C36	3
2	17845012	17845119	1034	1141	107	RIGHT	C363.EDF	C36	3
3	17852441	17852565	291	415	124	RIGHT	C363.EDF	C36	3
3	17858591	17858734	6441	6584	143	RIGHT	C363.EDF	C36	3
4	17861175	17861396	57	278	221	RIGHT	C363.EDF	C36	3
4	17861781	17861970	663	852	189	RIGHT	C363.EDF	C36	3
5	17868661	17868775	214	328	114	RIGHT	C363.EDF	C36	3
5	17869295	17869361	848	914	66	RIGHT	C363.EDF	C36	3
6	17877390	17877599	58	267	209	RIGHT	C363.EDF	C36	3
6	17877922	17878020	590	688	98	RIGHT	C363.EDF	C36	3
6	17878313	17878368	981	1036	55	RIGHT	C363.EDF	C36	3
7	17886566	17886709	58	201	143	RIGHT	C363.EDF	C36	3
7	17886811	17886982	303	474	171	RIGHT	C363.EDF	C36	3
7	17888942	17888985	2434	2477	43	RIGHT	C363.EDF	C36	3
7	17889118	17889258	2610	2750	140	RIGHT	C363.EDF	C36	3
7	17890630	17890686	4122	4178	56	RIGHT	C363.EDF	C36	3
7	17891031	17891164	4523	4656	133	RIGHT	C363.EDF	C36	3
8	17896199	17896303	58	162	104	RIGHT	C363.EDF	C36	3
8	17896463	17896572	322	431	109	RIGHT	C363.EDF	C36	3
8	17900701	17900765	4560	4624	64	RIGHT	C363.EDF	C36	3
8	17901518	17901682	5377	5541	164	RIGHT	C363.EDF	C36	3
9	17906847	17907030	57	240	183	RIGHT	C363.EDF	C36	3
9	17907828	17907965	1038	1175	137	RIGHT	C363.EDF	C36	3
9	17908074	17908216	1284	1426	142	RIGHT	C363.EDF	C36	3
10	17916003	17916110	58	165	107	RIGHT	C363.EDF	C36	3
10	17916312	17916371	367	426	59	RIGHT	C363.EDF	C36	3
10	17916497	17916656	552	711	159	RIGHT	C363.EDF	C36	3
10	17916813	17916991	868	1046	178	RIGHT	C363.EDF	C36	3
10	17917122	17917272	1177	1327	150	RIGHT	C363.EDF	C36	3
11	17924777	17924852	57	132	75	RIGHT	C363.EDF	C36	3
11	17924983	17925125	263	405	142	RIGHT	C363.EDF	C36	3
12	17933781	17934032	58	309	251	RIGHT	C363.EDF	C36	3
12	17934628	17934705	905	982	77	RIGHT	C363.EDF	C36	3
13	17942481	17942757	58	334	276	RIGHT	C363.EDF	C36	3
13	17943403	17943528	980	1105	125	RIGHT	C363.EDF	C36	3
13	17943917	17944045	1494	1622	128	RIGHT	C363.EDF	C36	3
14	17951131	17951330	57	256	199	RIGHT	C363.EDF	C36	3
14	17951881	17951975	807	901	94	RIGHT	C363.EDF	C36	3
14	17952218	17952338	1144	1264	120	RIGHT	C363.EDF	C36	3
15	17960506	17960626	304	424	120	RIGHT	C363.EDF	C36	3
15	17961482	17961533	1280	1331	51	RIGHT	C363.EDF	C36	3
15	17961774	17961927	1572	1725	153	RIGHT	C363.EDF	C36	3
16	17968176	17968284	57	165	108	RIGHT	C363.EDF	C36	3
16	17968771	17968863	652	744	92	RIGHT	C363.EDF	C36	3
17	17977556	17977658	58	160	102	RIGHT	C363.EDF	C36	3
17	17977816	17977930	318	432	114	RIGHT	C363.EDF	C36	3
17	17978175	17978246	677	748	71	RIGHT	C363.EDF	C36	3
17	17978357	17978486	859	988	129	RIGHT	C363.EDF	C36	3
17	17978971	17979083	1473	1585	112	RIGHT	C363.EDF	C36	3
17	17979224	17979343	1726	1845	119	RIGHT	C363.EDF	C36	3
17	17982518	17982618	5020	5120	100	RIGHT	C363.EDF	C36	3
17	17983078	17983148	5580	5650	70	RIGHT	C363.EDF	C36	3
18	17986603	17986908	57	362	305	RIGHT	C363.EDF	C36	3
18	17987895	17988032	1349	1486	137	RIGHT	C363.EDF	C36	3
18	17988342	17988514	1796	1968	172	RIGHT	C363.EDF	C36	3
19	17994972	17995249	58	335	277	RIGHT	C363.EDF	C36	3
19	17995482	17995615	568	701	133	RIGHT	C363.EDF	C36	3
19	17995829	17995895	915	981	66	RIGHT	C363.EDF	C36	3
19	17996154	17996282	1240	1368	128	RIGHT	C363.EDF	C36	3
20	18003172	18003397	58	283	225	RIGHT	C363.EDF	C36	3
20	18003767	18003898	653	784	131	RIGHT	C363.EDF	C36	3
20	18004009	18004137	895	1023	128	RIGHT	C363.EDF	C36	3
21	18012702	18012922	57	277	220	RIGHT	C363.EDF	C36	3
21	18013204	18013315	559	670	111	RIGHT	C363.EDF	C36	3
22	18020666	18020806	57	197	140	RIGHT	C363.EDF	C36	3
22	18021437	18021473	828	864	36	RIGHT	C363.EDF	C36	3
22	18021496	18021496	887	887	0	RIGHT	C363.EDF	C36	3
23	18028172	18028324	228	380	152	RIGHT	C363.EDF	C36	3
23	18028820	18028948	876	1004	128	RIGHT	C363.EDF	C36	3
23	18029155	18029275	1211	1331	120	RIGHT	C363.EDF	C36	3
24	18036171	18036319	173	321	148	RIGHT	C363.EDF	C36	3
24	18036559	18036655	561	657	96	RIGHT	C363.EDF	C36	3
24	18036848	18036942	850	944	94	RIGHT	C363.EDF	C36	3
24	18037680	18037777	1682	1779	97	RIGHT	C363.EDF	C36	3
25	18045428	18045484	57	113	56	RIGHT	C363.EDF	C36	3
25	18045519	18045661	148	290	142	RIGHT	C363.EDF	C36	3
25	18046718	18046865	1347	1494	147	RIGHT	C363.EDF	C36	3
25	18048623	18048746	3252	3375	123	RIGHT	C363.EDF	C36	3
26	18056039	18056124	57	142	85	RIGHT	C363.EDF	C36	3
26	18056295	18056393	313	411	98	RIGHT	C363.EDF	C36	3
26	18057196	18057298	1214	1316	102	RIGHT	C363.EDF	C36	3
26	18057466	18057600	1484	1618	134	RIGHT	C363.EDF	C36	3
27	18063333	18063515	58	240	182	RIGHT	C363.EDF	C36	3
27	18063868	18063972	593	697	104	RIGHT	C363.EDF	C36	3
27	18069225	18069255	5950	5980	30	RIGHT	C363.EDF	C36	3
28	18073008	18073367	170	529	359	RIGHT	C363.EDF	C36	3
28	18075252	18075364	2414	2526	112	RIGHT	C363.EDF	C36	3
29	18080476	18080597	269	390	121	RIGHT	C363.EDF	C36	3
29	18080811	18080887	604	680	76	RIGHT	C363.EDF	C36	3
29	18081078	18081199	871	992	121	RIGHT	C363.EDF	C36	3
30	18089000	18089059	57	116	59	RIGHT	C363.EDF	C36	3
30	18089106	18089271	163	328	165	RIGHT	C363.EDF	C36	3
30	18089507	18089609	564	666	102	RIGHT	C363.EDF	C36	3
30	18089743	18089871	800	928	128	RIGHT	C363.EDF	C36	3
30	18090072	18090188	1129	1245	116	RIGHT	C363.EDF	C36	3
30	18090394	18090517	1451	1574	123	RIGHT	C363.EDF	C36	3
31	18097613	18097766	57	210	153	RIGHT	C363.EDF	C36	3
31	18097950	18097980	394	424	30	RIGHT	C363.EDF	C36	3
31	18098007	18098011	451	455	4	RIGHT	C363.EDF	C36	3
31	18098192	18098321	636	765	129	RIGHT	C363.EDF	C36	3
31	18099280	18099386	1724	1830	106	RIGHT	C363.EDF	C36	3
32	18104944	18105038	242	336	94	RIGHT	C363.EDF	C36	3
32	18105079	18105089	377	387	10	RIGHT	C363.EDF	C36	3
32	18105207	18105365	505	663	158	RIGHT	C363.EDF	C36	3
32	18105637	18105796	935	1094	159	RIGHT	C363.EDF	C36	3
32	18106031	18106160	1329	1458	129	RIGHT	C363.EDF	C36	3
32	18107417	18107496	2715	2794	79	RIGHT	C363.EDF	C36	3
32	18108266	18108367	3564	3665	101	RIGHT	C363.EDF	C36	3
33	18112582	18112637	57	112	55	RIGHT	C363.EDF	C36	3
33	18112869	18112961	344	436	92	RIGHT	C363.EDF	C36	3
33	18113170	18113275	645	750	105	RIGHT	C363.EDF	C36	3
33	18114044	18114184	1519	1659	140	RIGHT	C363.EDF	C36	3
33	18115848	18116007	3323	3482	159	RIGHT	C363.EDF	C36	3
34	18119701	18119860	169	328	159	RIGHT	C363.EDF	C36	3
34	18120415	18120542	883	1010	127	RIGHT	C363.EDF	C36	3
35	18127572	18127705	58	191	133	RIGHT	C363.EDF	C36	3
35	18127882	18127935	368	421	53	RIGHT	C363.EDF	C36	3
35	18128449	18128602	935	1088	153	RIGHT	C363.EDF	C36	3
36	18135235	18135383	63	211	148	RIGHT	C363.EDF	C36	3
36	18135810	18135923	638	751	113	RIGHT	C363.EDF	C36	3
36	18136160	18136312	988	1140	152	RIGHT	C363.EDF	C36	3
36	18136562	18136721	1390	1549	159	RIGHT	C363.EDF	C36	3
36	18141795	18141883	6623	6711	88	RIGHT	C363.EDF	C36	3
37	18143902	18143990	57	145	88	RIGHT	C363.EDF	C36	3
37	18144131	18144235	286	390	104	RIGHT	C363.EDF	C36	3
37	18144366	18144467	521	622	101	RIGHT	C363.EDF	C36	3
37	18144600	18144725	755	880	125	RIGHT	C363.EDF	C36	3
37	18146784	18146863	2939	3018	79	RIGHT	C363.EDF	C36	3
37	18147098	18147237	3253	3392	139	RIGHT	C363.EDF	C36	3
38	18152825	18152937	134	246	112	RIGHT	C363.EDF	C36	3
38	18153227	18153339	536	648	112	RIGHT	C363.EDF	C36	3
38	18153606	18153756	915	1065	150	RIGHT	C363.EDF	C36	3
38	18155341	18155437	2650	2746	96	RIGHT	C363.EDF	C36	3
39	18161795	18161894	57	156	99	RIGHT	C363.EDF	C36	3
39	18162463	18162565	725	827	102	RIGHT	C363.EDF	C36	3
39	18162710	18162869	972	1131	159	RIGHT	C363.EDF	C36	3
39	18163177	18163331	1439	1593	154	RIGHT	C363.EDF	C36	3
39	18163589	18163718	1851	1980	129	RIGHT	C363.EDF	C36	3
40	18170109	18170299	130	320	190	RIGHT	C363.EDF	C36	3
40	18175161	18175274	5182	5295	113	RIGHT	C363.EDF	C36	3
41	18179681	18179719	58	96	38	RIGHT	C363.EDF	C36	3
41	18179768	18179930	145	307	162	RIGHT	C363.EDF	C36	3
41	18180438	18180601	815	978	163	RIGHT	C363.EDF	C36	3
41	18181859	18181974	2236	2351	115	RIGHT	C363.EDF	C36	3
41	18182078	18182215	2455	2592	137	RIGHT	C363.EDF	C36	3
41	18183918	18184082	4295	4459	164	RIGHT	C363.EDF	C36	3
41	18184905	18184981	5282	5358	76	RIGHT	C363.EDF	C36	3
42	18187943	18187946	74	77	3	RIGHT	C363.EDF	C36	3
42	18188026	18188166	157	297	140	RIGHT	C363.EDF	C36	3
42	18188190	18188367	321	498	177	RIGHT	C363.EDF	C36	3
42	18188561	18188687	692	818	126	RIGHT	C363.EDF	C36	3
42	18189411	18189572	1542	1703	161	RIGHT	C363.EDF	C36	3
43	18197867	18198048	57	238	181	RIGHT	C363.EDF	C36	3
43	18198354	18198409	544	599	55	RIGHT	C363.EDF	C36	3
43	18198572	18198711	762	901	139	RIGHT	C363.EDF	C36	3
43	18198886	18199002	1076	1192	116	RIGHT	C363.EDF	C36	3
43	18199697	18199741	1887	1931	44	RIGHT	C363.EDF	C36	3
43	18200001	18200094	2191	2284	93	RIGHT	C363.EDF	C36	3
43	18200302	18200388	2492	2578	86	RIGHT	C363.EDF	C36	3
43	18201164	18201283	3354	3473	119	RIGHT	C363.EDF	C36	3
43	18203446	18203578	5636	5768	132	RIGHT	C363.EDF	C36	3
44	18208110	18208232	438	560	122	RIGHT	C363.EDF	C36	3
44	18209084	18209207	1412	1535	123	RIGHT	C363.EDF	C36	3
45	18215401	18215587	171	357	186	RIGHT	C363.EDF	C36	3
45	18215845	18215960	615	730	115	RIGHT	C363.EDF	C36	3
45	18216192	18216331	962	1101	139	RIGHT	C363.EDF	C36	3
45	18216672	18216747	1442	1517	75	RIGHT	C363.EDF	C36	3
45	18216875	18217039	1645	1809	164	RIGHT	C363.EDF	C36	3
45	18218148	18218257	2918	3027	109	RIGHT	C363.EDF	C36	3
46	18224731	18224902	192	363	171	RIGHT	C363.EDF	C36	3
46	18225096	18225186	557	647	90	RIGHT	C363.EDF	C36	3
46	18225358	18225470	819	931	112	RIGHT	C363.EDF	C36	3
47	18232745	18232933	58	246	188	RIGHT	C363.EDF	C36	3
47	18233269	18233269	582	582	0	RIGHT	C363.EDF	C36	3
47	18233405	18233540	718	853	135	RIGHT	C363.EDF	C36	3
47	18234036	18234167	1349	1480	131	RIGHT	C363.EDF	C36	3
47	18234287	18234426	1600	1739	139	RIGHT	C363.EDF	C36	3
47	18239334	18239426	6647	6739	92	RIGHT	C363.EDF	C36	3
48	18241999	18242072	57	130	73	RIGHT	C363.EDF	C36	3
48	18242203	18242321	261	379	118	RIGHT	C363.EDF	C36	3
48	18242590	18242708	648	766	118	RIGHT	C363.EDF	C36	3
48	18242903	18243016	961	1074	113	RIGHT	C363.EDF	C36	3
48	18243249	18243388	1307	1446	139	RIGHT	C363.EDF	C36	3
48	18246182	18246279	4240	4337	97	RIGHT	C363.EDF	C36	3
49	18250735	18250907	57	229	172	RIGHT	C363.EDF	C36	3
49	18251162	18251315	484	637	153	RIGHT	C363.EDF	C36	3
50	18259123	18259220	259	356	97	RIGHT	C363.EDF	C36	3
50	18259400	18259486	536	622	86	RIGHT	C363.EDF	C36	3
50	18259748	18259889	884	1025	141	RIGHT	C363.EDF	C36	3
50	18262560	18262677	3696	3813	117	RIGHT	C363.EDF	C36	3
50	18262698	18262700	3834	3836	2	RIGHT	C363.EDF	C36	3
51	18267236	18267299	58	121	63	RIGHT	C363.EDF	C36	3
51	18267322	18267322	144	144	0	RIGHT	C363.EDF	C36	3
51	18267359	18267502	181	324	143	RIGHT	C363.EDF	C36	3
51	18267702	18267824	524	646	122	RIGHT	C363.EDF	C36	3
51	18268015	18268131	837	953	116	RIGHT	C363.EDF	C36	3
51	18268572	18268665	1394	1487	93	RIGHT	C363.EDF	C36	3
52	18275536	18275934	57	455	398	RIGHT	C363.EDF	C36	3
52	18276128	18276238	649	759	110	RIGHT	C363.EDF	C36	3
52	18276494	18276525	1015	1046	31	RIGHT	C363.EDF	C36	3
52	18276641	18276846	1162	1367	205	RIGHT	C363.EDF	C36	3
52	18278090	18278119	2611	2640	29	RIGHT	C363.EDF	C36	3
52	18278153	18278155	2674	2676	2	RIGHT	C363.EDF	C36	3
52	18278320	18278449	2841	2970	129	RIGHT	C363.EDF	C36	3
53	18284515	18284608	467	560	93	RIGHT	C363.EDF	C36	3
53	18284960	18285079	912	1031	119	RIGHT	C363.EDF	C36	3
53	18285200	18285359	1152	1311	159	RIGHT	C363.EDF	C36	3
54	18291943	18292090	79	226	147	RIGHT	C363.EDF	C36	3
54	18292179	18292331	315	467	152	RIGHT	C363.EDF	C36	3
54	18292748	18292892	884	1028	144	RIGHT	C363.EDF	C36	3
54	18292985	18293138	1121	1274	153	RIGHT	C363.EDF	C36	3
54	18293324	18293466	1460	1602	142	RIGHT	C363.EDF	C36	3
55	18301076	18301170	58	152	94	RIGHT	C363.EDF	C36	3
55	18301487	18301586	469	568	99	RIGHT	C363.EDF	C36	3
55	18301875	18302044	857	1026	169	RIGHT	C363.EDF	C36	3
55	18302120	18302295	1102	1277	175	RIGHT	C363.EDF	C36	3
55	18304549	18304645	3531	3627	96	RIGHT	C363.EDF	C36	3
56	18310481	18310522	57	98	41	RIGHT	C363.EDF	C36	3
56	18310902	18311008	478	584	106	RIGHT	C363.EDF	C36	3
56	18311081	18311174	657	750	93	RIGHT	C363.EDF	C36	3
56	18311334	18311473	910	1049	139	RIGHT	C363.EDF	C36	3
57	18319098	18319193	86	181	95	RIGHT	C363.EDF	C36	3
57	18319384	18319501	372	489	117	RIGHT	C363.EDF	C36	3
57	18319690	18319855	678	843	165	RIGHT	C363.EDF	C36	3
57	18320052	18320148	1040	1136	96	RIGHT	C363.EDF	C36	3
57	18320358	18320468	1346	1456	110	RIGHT	C363.EDF	C36	3
58	18328799	18328873	326	400	74	RIGHT	C363.EDF	C36	3
58	18329032	18329155	559	682	123	RIGHT	C363.EDF	C36	3
58	18329358	18329475	885	1002	117	RIGHT	C363.EDF	C36	3
58	18329692	18329800	1219	1327	108	RIGHT	C363.EDF	C36	3
58	18329871	18329995	1398	1522	124	RIGHT	C363.EDF	C36	3
58	18331292	18331397	2819	2924	105	RIGHT	C363.EDF	C36	3
59	18337711	18337760	58	107	49	RIGHT	C363.EDF	C36	3
59	18338198	18338259	545	606	61	RIGHT	C363.EDF	C36	3
59	18338422	18338527	769	874	105	RIGHT	C363.EDF	C36	3
59	18338740	18338900	1087	1247	160	RIGHT	C363.EDF	C36	3
59	18342277	18342320	4624	4667	43	RIGHT	C363.EDF	C36	3
59	18342342	18342344	4689	4691	2	RIGHT	C363.EDF	C36	3
60	18346429	18346582	172	325	153	RIGHT	C363.EDF	C36	3
60	18346805	18346852	548	595	47	RIGHT	C363.EDF	C36	3
60	18347014	18347145	757	888	131	RIGHT	C363.EDF	C36	3
61	18355711	18355792	58	139	81	RIGHT	C363.EDF	C36	3
61	18355833	18355954	180	301	121	RIGHT	C363.EDF	C36	3
61	18356640	18356699	987	1046	59	RIGHT	C363.EDF	C36	3
61	18360588	18360672	4935	5019	84	RIGHT	C363.EDF	C36	3
62	18364645	18364679	58	92	34	RIGHT	C363.EDF	C36	3
62	18365064	18365174	477	587	110	RIGHT	C363.EDF	C36	3
62	18371262	18371345	6675	6758	83	RIGHT	C363.EDF	C36	3
63	18374616	18374810	242	436	194	RIGHT	C363.EDF	C36	3
63	18374884	18374959	510	585	75	RIGHT	C363.EDF	C36	3
63	18375154	18375269	780	895	115	RIGHT	C363.EDF	C36	3
63	18375602	18375781	1228	1407	179	RIGHT	C363.EDF	C36	3
64	18383303	18383434	66	197	131	RIGHT	C363.EDF	C36	3
64	18383612	18383654	375	417	42	RIGHT	C363.EDF	C36	3
64	18383726	18383852	489	615	126	RIGHT	C363.EDF	C36	3
64	18383993	18384147	756	910	154	RIGHT	C363.EDF	C36	3
64	18384579	18384809	1342	1572	230	RIGHT	C363.EDF	C36	3
64	18385948	18386090	2711	2853	142	RIGHT	C363.EDF	C36	3
64	18386963	18387089	3726	3852	126	RIGHT	C363.EDF	C36	3
64	18388445	18388569	5208	5332	124	RIGHT	C363.EDF	C36	3
64	18388979	18389085	5742	5848	106	RIGHT	C363.EDF	C36	3
65	18392480	18392484	73	77	4	RIGHT	C363.EDF	C36	3
65	18392526	18392657	119	250	131	RIGHT	C363.EDF	C36	3
65	18392811	18392969	404	562	158	RIGHT	C363.EDF	C36	3
65	18393084	18393213	677	806	129	RIGHT	C363.EDF	C36	3
65	18393382	18393542	975	1135	160	RIGHT	C363.EDF	C36	3
65	18393611	18393756	1204	1349	145	RIGHT	C363.EDF	C36	3
66	18401407	18401802	57	452	395	RIGHT	C363.EDF	C36	3
66	18402540	18402564	1190	1214	24	RIGHT	C363.EDF	C36	3
66	18407835	18407941	6485	6591	106	RIGHT	C363.EDF	C36	3
67	18410947	18411118	450	621	171	RIGHT	C363.EDF	C36	3
67	18411225	18411358	728	861	133	RIGHT	C363.EDF	C36	3
67	18411509	18411623	1012	1126	114	RIGHT	C363.EDF	C36	3
68	18420039	18420199	57	217	160	RIGHT	C363.EDF	C36	3
68	18420393	18420578	411	596	185	RIGHT	C363.EDF	C36	3
68	18420745	18420889	763	907	144	RIGHT	C363.EDF	C36	3
68	18421196	18421335	1214	1353	139	RIGHT	C363.EDF	C36	3
68	18426183	18426281	6201	6299	98	RIGHT	C363.EDF	C36	3
69	18429145	18429313	227	395	168	RIGHT	C363.EDF	C36	3
69	18429527	18429688	609	770	161	RIGHT	C363.EDF	C36	3
69	18429835	18430026	917	1108	191	RIGHT	C363.EDF	C36	3
69	18430275	18430400	1357	1482	125	RIGHT	C363.EDF	C36	3
69	18434041	18434130	5123	5212	89	RIGHT	C363.EDF	C36	3
70	18437555	18437610	57	112	55	RIGHT	C363.EDF	C36	3
70	18437762	18437930	264	432	168	RIGHT	C363.EDF	C36	3
70	18438469	18438593	971	1095	124	RIGHT	C363.EDF	C36	3
70	18443254	18443312	5756	5814	58	RIGHT	C363.EDF	C36	3
70	18443923	18444049	6425	6551	126	RIGHT	C363.EDF	C36	3
71	18446513	18446669	71	227	156	RIGHT	C363.EDF	C36	3
71	18447009	18447124	567	682	115	RIGHT	C363.EDF	C36	3
71	18447668	18447801	1226	1359	133	RIGHT	C363.EDF	C36	3
71	18448087	18448240	1645	1798	153	RIGHT	C363.EDF	C36	3
71	18450742	18450800	4300	4358	58	RIGHT	C363.EDF	C36	3
71	18451038	18451133	4596	4691	95	RIGHT	C363.EDF	C36	3
71	18452086	18452179	5644	5737	93	RIGHT	C363.EDF	C36	3
71	18452741	18452840	6299	6398	99	RIGHT	C363.EDF	C36	3
72	18455614	18455651	57	94	37	RIGHT	C363.EDF	C36	3
72	18455804	18455925	247	368	121	RIGHT	C363.EDF	C36	3
72	18456095	18456192	538	635	97	RIGHT	C363.EDF	C36	3
72	18456469	18456590	912	1033	121	RIGHT	C363.EDF	C36	3
72	18456925	18457040	1368	1483	115	RIGHT	C363.EDF	C36	3
72	18457203	18457330	1646	1773	127	RIGHT	C363.EDF	C36	3
72	18457464	18457602	1907	2045	138	RIGHT	C363.EDF	C36	3
73	18464678	18464768	57	147	90	RIGHT	C363.EDF	C36	3
73	18464958	18465040	337	419	82	RIGHT	C363.EDF	C36	3
73	18465196	18465446	575	825	250	RIGHT	C363.EDF	C36	3
73	18465669	18465824	1048	1203	155	RIGHT	C363.EDF	C36	3
73	18465979	18466118	1358	1497	139	RIGHT	C363.EDF	C36	3
73	18466352	18466460	1731	1839	108	RIGHT	C363.EDF	C36	3
73	18466623	18466739	2002	2118	116	RIGHT	C363.EDF	C36	3
73	18467168	18467243	2547	2622	75	RIGHT	C363.EDF	C36	3
73	18467352	18467527	2731	2906	175	RIGHT	C363.EDF	C36	3
73	18467621	18467736	3000	3115	115	RIGHT	C363.EDF	C36	3
73	18468228	18468324	3607	3703	96	RIGHT	C363.EDF	C36	3
73	18468441	18468556	3820	3935	115	RIGHT	C363.EDF	C36	3
73	18468659	18468778	4038	4157	119	RIGHT	C363.EDF	C36	3
73	18468983	18469088	4362	4467	105	RIGHT	C363.EDF	C36	3
73	18469336	18469423	4715	4802	87	RIGHT	C363.EDF	C36	3
74	18472233	18472265	57	89	32	RIGHT	C363.EDF	C36	3
74	18472463	18472643	287	467	180	RIGHT	C363.EDF	C36	3
74	18473082	18473153	906	977	71	RIGHT	C363.EDF	C36	3
74	18473218	18473339	1042	1163	121	RIGHT	C363.EDF	C36	3
74	18474164	18474247	1988	2071	83	RIGHT	C363.EDF	C36	3
74	18474273	18474273	2097	2097	0	RIGHT	C363.EDF	C36	3
74	18474342	18474456	2166	2280	114	RIGHT	C363.EDF	C36	3
74	18474588	18474735	2412	2559	147	RIGHT	C363.EDF	C36	3
74	18475242	18475291	3066	3115	49	RIGHT	C363.EDF	C36	3
74	18475395	18475526	3219	3350	131	RIGHT	C363.EDF	C36	3
74	18475787	18475876	3611	3700	89	RIGHT	C363.EDF	C36	3
74	18476094	18476224	3918	4048	130	RIGHT	C363.EDF	C36	3
74	18476414	18476539	4238	4363	125	RIGHT	C363.EDF	C36	3
75	18481568	18481700	117	249	132	RIGHT	C363.EDF	C36	3
75	18481936	18482035	485	584	99	RIGHT	C363.EDF	C36	3
75	18482697	18482795	1246	1344	98	RIGHT	C363.EDF	C36	3
76	18490466	18490585	57	176	119	RIGHT	C363.EDF	C36	3
76	18491016	18491118	607	709	102	RIGHT	C363.EDF	C36	3
76	18491334	18491429	925	1020	95	RIGHT	C363.EDF	C36	3
76	18491666	18491768	1257	1359	102	RIGHT	C363.EDF	C36	3
76	18491908	18492029	1499	1620	121	RIGHT	C363.EDF	C36	3
76	18492188	18492300	1779	1891	112	RIGHT	C363.EDF	C36	3
76	18494369	18494465	3960	4056	96	RIGHT	C363.EDF	C36	3
77	18498896	18499051	116	271	155	RIGHT	C363.EDF	C36	3
77	18499298	18499417	518	637	119	RIGHT	C363.EDF	C36	3
77	18499851	18499987	1071	1207	136	RIGHT	C363.EDF	C36	3
77	18500143	18500289	1363	1509	146	RIGHT	C363.EDF	C36	3
77	18500680	18500795	1900	2015	115	RIGHT	C363.EDF	C36	3
77	18500961	18501090	2181	2310	129	RIGHT	C363.EDF	C36	3
77	18501589	18501686	2809	2906	97	RIGHT	C363.EDF	C36	3
77	18501899	18502009	3119	3229	110	RIGHT	C363.EDF	C36	3
78	18506392	18506602	57	267	210	RIGHT	C363.EDF	C36	3
78	18506809	18506900	474	565	91	RIGHT	C363.EDF	C36	3
78	18507684	18508085	1349	1750	401	RIGHT	C363.EDF	C36	3
78	18510631	18510745	4296	4410	114	RIGHT	C363.EDF	C36	3
78	18511527	18511654	5192	5319	127	RIGHT	C363.EDF	C36	3
79	18514958	18515014	57	113	56	RIGHT	C363.EDF	C36	3
79	18515146	18515267	245	366	121	RIGHT	C363.EDF	C36	3
79	18515781	18515882	880	981	101	RIGHT	C363.EDF	C36	3
79	18516039	18516150	1138	1249	111	RIGHT	C363.EDF	C36	3
79	18518309	18518424	3408	3523	115	RIGHT	C363.EDF	C36	3
80	18522262	18522303	58	99	41	RIGHT	C363.EDF	C36	3
80	18522487	18522662	283	458	175	RIGHT	C363.EDF	C36	3
80	18522756	18522865	552	661	109	RIGHT	C363.EDF	C36	3
80	18523051	18523141	847	937	90	RIGHT	C363.EDF	C36	3
80	18523385	18523508	1181	1304	123	RIGHT	C363.EDF	C36	3
80	18523656	18523807	1452	1603	151	RIGHT	C363.EDF	C36	3
81	18531159	18531229	57	127	70	RIGHT	C363.EDF	C36	3
81	18531302	18531597	200	495	295	RIGHT	C363.EDF	C36	3
81	18531814	18531917	712	815	103	RIGHT	C363.EDF	C36	3
81	18532008	18532190	906	1088	182	RIGHT	C363.EDF	C36	3
81	18532323	18532469	1221	1367	146	RIGHT	C363.EDF	C36	3
81	18534806	18534862	3704	3760	56	RIGHT	C363.EDF	C36	3
81	18536183	18536245	5081	5143	62	RIGHT	C363.EDF	C36	3
82	18539968	18540070	501	603	102	RIGHT	C363.EDF	C36	3
82	18540349	18540462	882	995	113	RIGHT	C363.EDF	C36	3
82	18540720	18540897	1253	1430	177	RIGHT	C363.EDF	C36	3
83	18547498	18547615	86	203	117	RIGHT	C363.EDF	C36	3
83	18547978	18548083	566	671	105	RIGHT	C363.EDF	C36	3
83	18549217	18549361	1805	1949	144	RIGHT	C363.EDF	C36	3
83	18551459	18551575	4047	4163	116	RIGHT	C363.EDF	C36	3
84	18555197	18555323	58	184	126	RIGHT	C363.EDF	C36	3
84	18555725	18555874	586	735	149	RIGHT	C363.EDF	C36	3
84	18557570	18557657	2431	2518	87	RIGHT	C363.EDF	C36	3
84	18557760	18557915	2621	2776	155	RIGHT	C363.EDF	C36	3
84	18560532	18560554	5393	5415	22	RIGHT	C363.EDF	C36	3
84	18560575	18560580	5436	5441	5	RIGHT	C363.EDF	C36	3
85	18563843	18564084	57	298	241	RIGHT	C363.EDF	C36	3
85	18564487	18564596	701	810	109	RIGHT	C363.EDF	C36	3
85	18565001	18565106	1215	1320	105	RIGHT	C363.EDF	C36	3
85	18566647	18566737	2861	2951	90	RIGHT	C363.EDF	C36	3
85	18567291	18567385	3505	3599	94	RIGHT	C363.EDF	C36	3
86	18573240	18573311	661	732	71	RIGHT	C363.EDF	C36	3
86	18573447	18573526	868	947	79	RIGHT	C363.EDF	C36	3
86	18573816	18573962	1237	1383	146	RIGHT	C363.EDF	C36	3
86	18576820	18576895	4241	4316	75	RIGHT	C363.EDF	C36	3
86	18579372	18579515	6793	6936	143	RIGHT	C363.EDF	C36	3
87	18582248	18582283	57	92	35	RIGHT	C363.EDF	C36	3
87	18582319	18582510	128	319	191	RIGHT	C363.EDF	C36	3
87	18582967	18583091	776	900	124	RIGHT	C363.EDF	C36	3
87	18583252	18583374	1061	1183	122	RIGHT	C363.EDF	C36	3
87	18584354	18584469	2163	2278	115	RIGHT	C363.EDF	C36	3
87	18584726	18584858	2535	2667	132	RIGHT	C363.EDF	C36	3
87	18585370	18585455	3179	3264	85	RIGHT	C363.EDF	C36	3
87	18585930	18586039	3739	3848	109	RIGHT	C363.EDF	C36	3
87	18586217	18586270	4026	4079	53	RIGHT	C363.EDF	C36	3
87	18587174	18587227	4983	5036	53	RIGHT	C363.EDF	C36	3
87	18587880	18587949	5689	5758	69	RIGHT	C363.EDF	C36	3
88	18592057	18592248	57	248	191	RIGHT	C363.EDF	C36	3
88	18592493	18592600	493	600	107	RIGHT	C363.EDF	C36	3
88	18593668	18593756	1668	1756	88	RIGHT	C363.EDF	C36	3
88	18593860	18593929	1860	1929	69	RIGHT	C363.EDF	C36	3
88	18595895	18596002	3895	4002	107	RIGHT	C363.EDF	C36	3
88	18596149	18596275	4149	4275	126	RIGHT	C363.EDF	C36	3
89	18599677	18599783	251	357	106	RIGHT	C363.EDF	C36	3
89	18600132	18600228	706	802	96	RIGHT	C363.EDF	C36	3
89	18600847	18600977	1421	1551	130	RIGHT	C363.EDF	C36	3
89	18601033	18601154	1607	1728	121	RIGHT	C363.EDF	C36	3
90	18608524	18608646	521	643	122	RIGHT	C363.EDF	C36	3
90	18609918	18610008	1915	2005	90	RIGHT	C363.EDF	C36	3
90	18612859	18612980	4856	4977	121	RIGHT	C363.EDF	C36	3
90	18614055	18614195	6052	6192	140	RIGHT	C363.EDF	C36	3
91	18617083	18617221	218	356	138	RIGHT	C363.EDF	C36	3
91	18617411	18617534	546	669	123	RIGHT	C363.EDF	C36	3
91	18617767	18618078	902	1213	311	RIGHT	C363.EDF	C36	3
92	18625406	18626134	57	785	728	RIGHT	C363.EDF	C36	3
92	18626478	18626590	1129	1241	112	RIGHT	C363.EDF	C36	3
92	18626689	18626842	1340	1493	153	RIGHT	C363.EDF	C36	3
92	18626988	18627109	1639	1760	121	RIGHT	C363.EDF	C36	3
93	18633623	18633684	57	118	61	RIGHT	C363.EDF	C36	3
93	18633876	18633976	310	410	100	RIGHT	C363.EDF	C36	3
93	18634171	18634281	605	715	110	RIGHT	C363.EDF	C36	3
93	18634508	18634631	942	1065	123	RIGHT	C363.EDF	C36	3
93	18639793	18639926	6227	6360	133	RIGHT	C363.EDF	C36	3
94	18642070	18642164	58	152	94	RIGHT	C363.EDF	C36	3
94	18642292	18642443	280	431	151	RIGHT	C363.EDF	C36	3
94	18642808	18643024	796	1012	216	RIGHT	C363.EDF	C36	3
94	18643508	18643652	1496	1640	144	RIGHT	C363.EDF	C36	3
94	18644429	18644553	2417	2541	124	RIGHT	C363.EDF	C36	3
94	18644753	18644890	2741	2878	137	RIGHT	C363.EDF	C36	3
94	18645156	18645280	3144	3268	124	RIGHT	C363.EDF	C36	3
94	18645302	18645307	3290	3295	5	RIGHT	C363.EDF	C36	3
94	18645477	18645635	3465	3623	158	RIGHT	C363.EDF	C36	3
94	18645801	18645953	3789	3941	152	RIGHT	C363.EDF	C36	3
94	18646649	18646736	4637	4724	87	RIGHT	C363.EDF	C36	3
95	18650430	18650479	172	221	49	RIGHT	C363.EDF	C36	3
95	18650542	18650664	284	406	122	RIGHT	C363.EDF	C36	3
95	18650847	18650931	589	673	84	RIGHT	C363.EDF	C36	3
95	18651357	18651456	1099	1198	99	RIGHT	C363.EDF	C36	3
95	18651559	18651685	1301	1427	126	RIGHT	C363.EDF	C36	3
95	18652745	18652866	2487	2608	121	RIGHT	C363.EDF	C36	3
96	18657841	18657994	237	390	153	RIGHT	C363.EDF	C36	3
96	18658194	18658320	590	716	126	RIGHT	C363.EDF	C36	3
96	18658493	18658644	889	1040	151	RIGHT	C363.EDF	C36	3
97	18666883	18667148	57	322	265	RIGHT	C363.EDF	C36	3
97	18667359	18668010	533	1184	651	RIGHT	C363.EDF	C36	3
97	18668206	18668321	1380	1495	115	RIGHT	C363.EDF	C36	3
97	18668917	18668928	2091	2102	11	RIGHT	C363.EDF	C36	3
97	18669071	18669160	2245	2334	89	RIGHT	C363.EDF	C36	3
97	18669820	18669887	2994	3061	67	RIGHT	C363.EDF	C36	3
97	18670187	18670254	3361	3428	67	RIGHT	C363.EDF	C36	3
97	18671780	18671801	4954	4975	21	RIGHT	C363.EDF	C36	3
98	18674932	18675166	57	291	234	RIGHT	C363.EDF	C36	3
98	18675413	18675535	538	660	122	RIGHT	C363.EDF	C36	3
98	18676755	18676757	1880	1882	2	RIGHT	C363.EDF	C36	3
98	18678279	18678326	3404	3451	47	RIGHT	C363.EDF	C36	3
98	18678353	18678356	3478	3481	3	RIGHT	C363.EDF	C36	3
99	18684571	18684725	57	211	154	RIGHT	C363.EDF	C36	3
99	18684801	18684931	287	417	130	RIGHT	C363.EDF	C36	3
99	18685806	18685931	1292	1417	125	RIGHT	C363.EDF	C36	3
99	18686162	18686232	1648	1718	70	RIGHT	C363.EDF	C36	3
100	18693468	18693616	130	278	148	RIGHT	C363.EDF	C36	3
100	18693894	18694068	556	730	174	RIGHT	C363.EDF	C36	3
100	18694561	18694726	1223	1388	165	RIGHT	C363.EDF	C36	3
100	18694801	18694934	1463	1596	133	RIGHT	C363.EDF	C36	3
101	18702985	18703160	473	648	175	RIGHT	C363.EDF	C36	3
101	18703282	18703451	770	939	169	RIGHT	C363.EDF	C36	3
101	18704591	18704684	2079	2172	93	RIGHT	C363.EDF	C36	3
101	18706650	18706724	4138	4212	74	RIGHT	C363.EDF	C36	3
102	18710050	18710254	58	262	204	RIGHT	C363.EDF	C36	3
102	18710495	18710630	503	638	135	RIGHT	C363.EDF	C36	3
102	18710802	18710961	810	969	159	RIGHT	C363.EDF	C36	3
103	18718335	18718458	71	194	123	RIGHT	C363.EDF	C36	3
103	18718608	18718716	344	452	108	RIGHT	C363.EDF	C36	3
103	18718829	18718974	565	710	145	RIGHT	C363.EDF	C36	3
103	18723173	18723276	4909	5012	103	RIGHT	C363.EDF	C36	3
103	18723298	18723308	5034	5044	10	RIGHT	C363.EDF	C36	3
104	18728186	18728302	72	188	116	RIGHT	C363.EDF	C36	3
104	18729290	18729399	1176	1285	109	RIGHT	C363.EDF	C36	3
104	18729601	18729717	1487	1603	116	RIGHT	C363.EDF	C36	3
105	18738106	18738287	57	238	181	RIGHT	C363.EDF	C36	3
105	18738610	18738714	561	665	104	RIGHT	C363.EDF	C36	3
105	18738850	18738978	801	929	128	RIGHT	C363.EDF	C36	3
105	18739136	18739288	1087	1239	152	RIGHT	C363.EDF	C36	3
105	18740029	18740125	1980	2076	96	RIGHT	C363.EDF	C36	3
105	18740256	18740362	2207	2313	106	RIGHT	C363.EDF	C36	3
106	18746425	18746522	57	154	97	RIGHT	C363.EDF	C36	3
106	18746747	18746769	379	401	22	RIGHT	C363.EDF	C36	3
106	18746827	18746931	459	563	104	RIGHT	C363.EDF	C36	3
106	18747128	18747225	760	857	97	RIGHT	C363.EDF	C36	3
106	18747700	18747852	1332	1484	152	RIGHT	C363.EDF	C36	3
106	18749587	18749719	3219	3351	132	RIGHT	C363.EDF	C36	3
106	18749897	18750022	3529	3654	125	RIGHT	C363.EDF	C36	3
107	18755241	18755353	57	169	112	RIGHT	C363.EDF	C36	3
107	18755709	18755859	525	675	150	RIGHT	C363.EDF	C36	3
107	18756011	18756549	827	1365	538	RIGHT	C363.EDF	C36	3
107	18756755	18756872	1571	1688	117	RIGHT	C363.EDF	C36	3
107	18757749	18757798	2565	2614	49	RIGHT	C363.EDF	C36	3
107	18757820	18757826	2636	2642	6	RIGHT	C363.EDF	C36	3
107	18757968	18758086	2784	2902	118	RIGHT	C363.EDF	C36	3
107	18758238	18758365	3054	3181	127	RIGHT	C363.EDF	C36	3
107	18758618	18758744	3434	3560	126	RIGHT	C363.EDF	C36	3
107	18759115	18759211	3931	4027	96	RIGHT	C363.EDF	C36	3
107	18759342	18759476	4158	4292	134	RIGHT	C363.EDF	C36	3
108	18765166	18765443	57	334	277	RIGHT	C363.EDF	C36	3
108	18765638	18765776	529	667	138	RIGHT	C363.EDF	C36	3
108	18766315	18766395	1206	1286	80	RIGHT	C363.EDF	C36	3
108	18766586	18766701	1477	1592	115	RIGHT	C363.EDF	C36	3
109	18772955	18773093	75	213	138	RIGHT	C363.EDF	C36	3
109	18773407	18773518	527	638	111	RIGHT	C363.EDF	C36	3
109	18774023	18774150	1143	1270	127	RIGHT	C363.EDF	C36	3
109	18777309	18777408	4429	4528	99	RIGHT	C363.EDF	C36	3
110	18781284	18781324	57	97	40	RIGHT	C363.EDF	C36	3
110	18781743	18781837	516	610	94	RIGHT	C363.EDF	C36	3
110	18781911	18782047	684	820	136	RIGHT	C363.EDF	C36	3
110	18782685	18782976	1458	1749	291	RIGHT	C363.EDF	C36	3
111	18790555	18790700	56	201	145	RIGHT	C363.EDF	C36	3
111	18790891	18791216	392	717	325	RIGHT	C363.EDF	C36	3
111	18791341	18791486	842	987	145	RIGHT	C363.EDF	C36	3
112	18798207	18798435	57	285	228	RIGHT	C363.EDF	C36	3
112	18798572	18798680	422	530	108	RIGHT	C363.EDF	C36	3
112	18798833	18798975	683	825	142	RIGHT	C363.EDF	C36	3
112	18799242	18799376	1092	1226	134	RIGHT	C363.EDF	C36	3
112	18799578	18799669	1428	1519	91	RIGHT	C363.EDF	C36	3
112	18799764	18799878	1614	1728	114	RIGHT	C363.EDF	C36	3
112	18800493	18800573	2343	2423	80	RIGHT	C363.EDF	C36	3
112	18801432	18801536	3282	3386	104	RIGHT	C363.EDF	C36	3
113	18806430	18806547	57	174	117	RIGHT	C363.EDF	C36	3
113	18806746	18806819	373	446	73	RIGHT	C363.EDF	C36	3
113	18806872	18807010	499	637	138	RIGHT	C363.EDF	C36	3
113	18807468	18807654	1095	1281	186	RIGHT	C363.EDF	C36	3
113	18807840	18807993	1467	1620	153	RIGHT	C363.EDF	C36	3
113	18808647	18808735	2274	2362	88	RIGHT	C363.EDF	C36	3
113	18809164	18809252	2791	2879	88	RIGHT	C363.EDF	C36	3
113	18809359	18809499	2986	3126	140	RIGHT	C363.EDF	C36	3
114	18816395	18816438	57	100	43	RIGHT	C363.EDF	C36	3
114	18816829	18816933	491	595	104	RIGHT	C363.EDF	C36	3
114	18817076	18817213	738	875	137	RIGHT	C363.EDF	C36	3
114	18817638	18818124	1300	1786	486	RIGHT	C363.EDF	C36	3
114	18818761	18818921	2423	2583	160	RIGHT	C363.EDF	C36	3
115	18825564	18825572	71	79	8	RIGHT	C363.EDF	C36	3
115	18825659	18825786	166	293	127	RIGHT	C363.EDF	C36	3
116	18833524	18833700	83	259	176	RIGHT	C363.EDF	C36	3
116	18833733	18833892	292	451	159	RIGHT	C363.EDF	C36	3
116	18835071	18835101	1630	1660	30	RIGHT	C363.EDF	C36	3
116	18835124	18835126	1683	1685	2	RIGHT	C363.EDF	C36	3
117	18841011	18841132	203	324	121	RIGHT	C363.EDF	C36	3
117	18841370	18841489	562	681	119	RIGHT	C363.EDF	C36	3
117	18841707	18841839	899	1031	132	RIGHT	C363.EDF	C36	3
118	18850165	18850321	57	213	156	RIGHT	C363.EDF	C36	3
118	18850636	18850718	528	610	82	RIGHT	C363.EDF	C36	3
118	18850767	18850870	659	762	103	RIGHT	C363.EDF	C36	3
119	18859123	18859176	57	110	53	RIGHT	C363.EDF	C36	3
119	18859403	18859487	337	421	84	RIGHT	C363.EDF	C36	3
119	18859630	18859757	564	691	127	RIGHT	C363.EDF	C36	3
119	18860263	18860373	1197	1307	110	RIGHT	C363.EDF	C36	3
119	18860583	18860683	1517	1617	100	RIGHT	C363.EDF	C36	3
120	18869339	18869368	58	87	29	RIGHT	C363.EDF	C36	3
120	18869773	18869885	492	604	112	RIGHT	C363.EDF	C36	3
120	18869958	18869959	677	678	1	RIGHT	C363.EDF	C36	3
120	18870079	18870168	798	887	89	RIGHT	C363.EDF	C36	3
120	18870501	18870553	1220	1272	52	RIGHT	C363.EDF	C36	3
120	18870650	18870800	1369	1519	150	RIGHT	C363.EDF	C36	3
1	2182826	2182903	1570	1647	77	RIGHT	C53a.EDF	C53	1
2	2194347	2194423	253	329	76	RIGHT	C53a.EDF	C53	1
2	2194972	2195073	878	979	101	RIGHT	C53a.EDF	C53	1
2	2195798	2195911	1704	1817	113	RIGHT	C53a.EDF	C53	1
2	2196718	2196827	2624	2733	109	RIGHT	C53a.EDF	C53	1
2	2197923	2198000	3829	3906	77	RIGHT	C53a.EDF	C53	1
2	2198883	2198953	4789	4859	70	RIGHT	C53a.EDF	C53	1
3	2205746	2205837	259	350	91	RIGHT	C53a.EDF	C53	1
3	2206382	2206491	895	1004	109	RIGHT	C53a.EDF	C53	1
3	2206765	2206866	1278	1379	101	RIGHT	C53a.EDF	C53	1
4	2217869	2217956	167	254	87	RIGHT	C53a.EDF	C53	1
4	2218520	2218617	818	915	97	RIGHT	C53a.EDF	C53	1
4	2218869	2218978	1167	1276	109	RIGHT	C53a.EDF	C53	1
4	2219983	2220076	2281	2374	93	RIGHT	C53a.EDF	C53	1
5	2228599	2228698	745	844	99	RIGHT	C53a.EDF	C53	1
5	2228949	2229068	1095	1214	119	RIGHT	C53a.EDF	C53	1
5	2229352	2229472	1498	1618	120	RIGHT	C53a.EDF	C53	1
5	2231819	2231928	3965	4074	109	RIGHT	C53a.EDF	C53	1
5	2233909	2233986	6055	6132	77	RIGHT	C53a.EDF	C53	1
6	2241660	2241690	57	87	30	RIGHT	C53a.EDF	C53	1
6	2242328	2242428	725	825	100	RIGHT	C53a.EDF	C53	1
6	2242696	2242816	1093	1213	120	RIGHT	C53a.EDF	C53	1
6	2243072	2243180	1469	1577	108	RIGHT	C53a.EDF	C53	1
7	2252591	2252720	611	740	129	RIGHT	C53a.EDF	C53	1
7	2252937	2253056	957	1076	119	RIGHT	C53a.EDF	C53	1
7	2253319	2253417	1339	1437	98	RIGHT	C53a.EDF	C53	1
7	2253674	2253764	1694	1784	90	RIGHT	C53a.EDF	C53	1
8	2261462	2261538	57	133	76	RIGHT	C53a.EDF	C53	1
8	2262218	2262335	813	930	117	RIGHT	C53a.EDF	C53	1
8	2262590	2262708	1185	1303	118	RIGHT	C53a.EDF	C53	1
8	2262973	2263086	1568	1681	113	RIGHT	C53a.EDF	C53	1
9	2271228	2271323	827	922	95	RIGHT	C53a.EDF	C53	1
9	2271589	2271674	1188	1273	85	RIGHT	C53a.EDF	C53	1
9	2271931	2272032	1530	1631	101	RIGHT	C53a.EDF	C53	1
10	2280180	2280319	303	442	139	RIGHT	C53a.EDF	C53	1
10	2281460	2281567	1583	1690	107	RIGHT	C53a.EDF	C53	1
11	2290209	2290327	113	231	118	RIGHT	C53a.EDF	C53	1
11	2290846	2290936	750	840	90	RIGHT	C53a.EDF	C53	1
11	2291194	2291297	1098	1201	103	RIGHT	C53a.EDF	C53	1
11	2291528	2291636	1432	1540	108	RIGHT	C53a.EDF	C53	1
12	2303426	2303465	58	97	39	RIGHT	C53a.EDF	C53	1
12	2304216	2304301	848	933	85	RIGHT	C53a.EDF	C53	1
12	2304585	2304691	1217	1323	106	RIGHT	C53a.EDF	C53	1
13	2312121	2312190	57	126	69	RIGHT	C53a.EDF	C53	1
13	2312915	2313022	851	958	107	RIGHT	C53a.EDF	C53	1
13	2313248	2313361	1184	1297	113	RIGHT	C53a.EDF	C53	1
14	2324831	2324937	599	705	106	RIGHT	C53a.EDF	C53	1
14	2325616	2325723	1384	1491	107	RIGHT	C53a.EDF	C53	1
14	2329831	2329910	5599	5678	79	RIGHT	C53a.EDF	C53	1
15	2334487	2334603	191	307	116	RIGHT	C53a.EDF	C53	1
15	2335349	2335452	1053	1156	103	RIGHT	C53a.EDF	C53	1
15	2335693	2335807	1397	1511	114	RIGHT	C53a.EDF	C53	1
15	2336114	2336189	1818	1893	75	RIGHT	C53a.EDF	C53	1
16	2344774	2344875	149	250	101	RIGHT	C53a.EDF	C53	1
16	2345980	2346093	1355	1468	113	RIGHT	C53a.EDF	C53	1
17	2356686	2356772	315	401	86	RIGHT	C53a.EDF	C53	1
17	2357576	2357644	1205	1273	68	RIGHT	C53a.EDF	C53	1
17	2357914	2357994	1543	1623	80	RIGHT	C53a.EDF	C53	1
18	2366833	2366924	726	817	91	RIGHT	C53a.EDF	C53	1
18	2367176	2367281	1069	1174	105	RIGHT	C53a.EDF	C53	1
18	2367519	2367632	1412	1525	113	RIGHT	C53a.EDF	C53	1
19	2380797	2380893	582	678	96	RIGHT	C53a.EDF	C53	1
19	2381193	2381300	978	1085	107	RIGHT	C53a.EDF	C53	1
19	2381627	2381716	1412	1501	89	RIGHT	C53a.EDF	C53	1
19	2382010	2382100	1795	1885	90	RIGHT	C53a.EDF	C53	1
20	2392785	2392890	1352	1457	105	RIGHT	C53a.EDF	C53	1
21	2400477	2400563	149	235	86	RIGHT	C53a.EDF	C53	1
21	2401140	2401257	812	929	117	RIGHT	C53a.EDF	C53	1
21	2401506	2401599	1178	1271	93	RIGHT	C53a.EDF	C53	1
21	2401894	2402007	1566	1679	113	RIGHT	C53a.EDF	C53	1
22	2412304	2412399	1039	1134	95	RIGHT	C53a.EDF	C53	1
22	2412791	2412914	1526	1649	123	RIGHT	C53a.EDF	C53	1
23	2427986	2428092	837	943	106	RIGHT	C53a.EDF	C53	1
23	2428585	2428707	1436	1558	122	RIGHT	C53a.EDF	C53	1
24	2436989	2437104	169	284	115	RIGHT	C53a.EDF	C53	1
24	2437512	2437635	692	815	123	RIGHT	C53a.EDF	C53	1
24	2437862	2437975	1042	1155	113	RIGHT	C53a.EDF	C53	1
24	2438206	2438317	1386	1497	111	RIGHT	C53a.EDF	C53	1
24	2438609	2438700	1789	1880	91	RIGHT	C53a.EDF	C53	1
24	2440511	2440523	3691	3703	12	RIGHT	C53a.EDF	C53	1
25	2445773	2445841	57	125	68	RIGHT	C53a.EDF	C53	1
25	2446592	2446722	876	1006	130	RIGHT	C53a.EDF	C53	1
25	2446946	2447066	1230	1350	120	RIGHT	C53a.EDF	C53	1
25	2447340	2447450	1624	1734	110	RIGHT	C53a.EDF	C53	1
26	2455628	2455718	896	986	90	RIGHT	C53a.EDF	C53	1
26	2456111	2456230	1379	1498	119	RIGHT	C53a.EDF	C53	1
27	2464347	2464441	227	321	94	RIGHT	C53a.EDF	C53	1
27	2465146	2465226	1026	1106	80	RIGHT	C53a.EDF	C53	1
27	2465503	2465638	1383	1518	135	RIGHT	C53a.EDF	C53	1
28	2474296	2474415	698	817	119	RIGHT	C53a.EDF	C53	1
28	2474606	2474748	1008	1150	142	RIGHT	C53a.EDF	C53	1
28	2474976	2475115	1378	1517	139	RIGHT	C53a.EDF	C53	1
29	2483715	2483828	245	358	113	RIGHT	C53a.EDF	C53	1
29	2484313	2484396	843	926	83	RIGHT	C53a.EDF	C53	1
29	2484958	2485055	1488	1585	97	RIGHT	C53a.EDF	C53	1
29	2489217	2489317	5747	5847	100	RIGHT	C53a.EDF	C53	1
30	2492273	2492304	58	89	31	RIGHT	C53a.EDF	C53	1
30	2493478	2493600	1263	1385	122	RIGHT	C53a.EDF	C53	1
31	2504411	2504531	288	408	120	RIGHT	C53a.EDF	C53	1
31	2504894	2505023	771	900	129	RIGHT	C53a.EDF	C53	1
31	2505352	2505467	1229	1344	115	RIGHT	C53a.EDF	C53	1
32	2515697	2515803	89	195	106	RIGHT	C53a.EDF	C53	1
32	2516374	2516485	766	877	111	RIGHT	C53a.EDF	C53	1
32	2517252	2517329	1644	1721	77	RIGHT	C53a.EDF	C53	1
33	2526186	2526299	748	861	113	RIGHT	C53a.EDF	C53	1
33	2526520	2526652	1082	1214	132	RIGHT	C53a.EDF	C53	1
33	2526972	2527106	1534	1668	134	RIGHT	C53a.EDF	C53	1
34	2535754	2535824	1104	1174	70	RIGHT	C53a.EDF	C53	1
34	2536060	2536183	1410	1533	123	RIGHT	C53a.EDF	C53	1
35	2546948	2547050	420	522	102	RIGHT	C53a.EDF	C53	1
35	2547292	2547409	764	881	117	RIGHT	C53a.EDF	C53	1
35	2547678	2547771	1150	1243	93	RIGHT	C53a.EDF	C53	1
35	2548031	2548142	1503	1614	111	RIGHT	C53a.EDF	C53	1
35	2549235	2549293	2707	2765	58	RIGHT	C53a.EDF	C53	1
35	2549494	2549505	2966	2977	11	RIGHT	C53a.EDF	C53	1
36	2559336	2559379	671	714	43	RIGHT	C53a.EDF	C53	1
36	2559562	2559666	897	1001	104	RIGHT	C53a.EDF	C53	1
36	2559927	2560077	1262	1412	150	RIGHT	C53a.EDF	C53	1
36	2560334	2560454	1669	1789	120	RIGHT	C53a.EDF	C53	1
37	2569987	2570096	675	784	109	RIGHT	C53a.EDF	C53	1
37	2570319	2570416	1007	1104	97	RIGHT	C53a.EDF	C53	1
38	2578707	2578749	57	99	42	RIGHT	C53a.EDF	C53	1
38	2579951	2580056	1301	1406	105	RIGHT	C53a.EDF	C53	1
39	2588650	2588750	1206	1306	100	RIGHT	C53a.EDF	C53	1
39	2589117	2589228	1673	1784	111	RIGHT	C53a.EDF	C53	1
40	2616155	2616209	58	112	54	RIGHT	C53a.EDF	C53	1
40	2617163	2617275	1066	1178	112	RIGHT	C53a.EDF	C53	1
40	2617744	2617846	1647	1749	102	RIGHT	C53a.EDF	C53	1
40	2618173	2618262	2076	2165	89	RIGHT	C53a.EDF	C53	1
41	2627048	2627172	720	844	124	RIGHT	C53a.EDF	C53	1
41	2627415	2627551	1087	1223	136	RIGHT	C53a.EDF	C53	1
41	2627846	2627966	1518	1638	120	RIGHT	C53a.EDF	C53	1
42	2634740	2634844	57	161	104	RIGHT	C53a.EDF	C53	1
42	2635212	2635314	529	631	102	RIGHT	C53a.EDF	C53	1
42	2635851	2635943	1168	1260	92	RIGHT	C53a.EDF	C53	1
43	2645927	2645996	839	908	69	RIGHT	C53a.EDF	C53	1
43	2646283	2646413	1195	1325	130	RIGHT	C53a.EDF	C53	1
44	2658484	2658561	57	134	77	RIGHT	C53a.EDF	C53	1
44	2659165	2659282	738	855	117	RIGHT	C53a.EDF	C53	1
44	2659592	2659720	1165	1293	128	RIGHT	C53a.EDF	C53	1
44	2659924	2660052	1497	1625	128	RIGHT	C53a.EDF	C53	1
45	2668566	2668685	803	922	119	RIGHT	C53a.EDF	C53	1
45	2668994	2669097	1231	1334	103	RIGHT	C53a.EDF	C53	1
45	2669409	2669522	1646	1759	113	RIGHT	C53a.EDF	C53	1
46	2676602	2676717	194	309	115	RIGHT	C53a.EDF	C53	1
46	2677877	2677991	1469	1583	114	RIGHT	C53a.EDF	C53	1
47	2684664	2684735	106	177	71	RIGHT	C53a.EDF	C53	1
47	2685549	2685665	991	1107	116	RIGHT	C53a.EDF	C53	1
47	2685903	2686007	1345	1449	104	RIGHT	C53a.EDF	C53	1
48	2694390	2694444	57	111	54	RIGHT	C53a.EDF	C53	1
48	2695100	2695236	767	903	136	RIGHT	C53a.EDF	C53	1
48	2695432	2695567	1099	1234	135	RIGHT	C53a.EDF	C53	1
48	2695797	2695926	1464	1593	129	RIGHT	C53a.EDF	C53	1
48	2696156	2696218	1823	1885	62	RIGHT	C53a.EDF	C53	1
49	2704473	2704521	57	105	48	RIGHT	C53a.EDF	C53	1
49	2705099	2705219	683	803	120	RIGHT	C53a.EDF	C53	1
49	2705508	2705632	1092	1216	124	RIGHT	C53a.EDF	C53	1
50	2715550	2715592	58	100	42	RIGHT	C53a.EDF	C53	1
50	2715837	2715960	345	468	123	RIGHT	C53a.EDF	C53	1
50	2716784	2716905	1292	1413	121	RIGHT	C53a.EDF	C53	1
51	2726514	2726638	796	920	124	RIGHT	C53a.EDF	C53	1
51	2726880	2727024	1162	1306	144	RIGHT	C53a.EDF	C53	1
51	2727254	2727385	1536	1667	131	RIGHT	C53a.EDF	C53	1
52	2734404	2734504	76	176	100	RIGHT	C53a.EDF	C53	1
52	2734777	2734884	449	556	107	RIGHT	C53a.EDF	C53	1
52	2735155	2735288	827	960	133	RIGHT	C53a.EDF	C53	1
52	2735545	2735657	1217	1329	112	RIGHT	C53a.EDF	C53	1
52	2735993	2736112	1665	1784	119	RIGHT	C53a.EDF	C53	1
53	2746372	2746489	1611	1728	117	RIGHT	C53a.EDF	C53	1
53	2750152	2750229	5391	5468	77	RIGHT	C53a.EDF	C53	1
54	2759714	2759819	976	1081	105	RIGHT	C53a.EDF	C53	1
54	2760092	2760204	1354	1466	112	RIGHT	C53a.EDF	C53	1
54	2760446	2760537	1708	1799	91	RIGHT	C53a.EDF	C53	1
55	2769049	2769209	894	1054	160	RIGHT	C53a.EDF	C53	1
55	2769455	2769594	1300	1439	139	RIGHT	C53a.EDF	C53	1
56	2777784	2777866	289	371	82	RIGHT	C53a.EDF	C53	1
56	2778202	2778331	707	836	129	RIGHT	C53a.EDF	C53	1
56	2778590	2778717	1095	1222	127	RIGHT	C53a.EDF	C53	1
56	2779030	2779139	1535	1644	109	RIGHT	C53a.EDF	C53	1
56	2780015	2780033	2520	2538	18	RIGHT	C53a.EDF	C53	1
56	2782543	2782627	5048	5132	84	RIGHT	C53a.EDF	C53	1
56	2782987	2782987	5492	5492	0	RIGHT	C53a.EDF	C53	1
56	2783141	2783216	5646	5721	75	RIGHT	C53a.EDF	C53	1
56	2783271	2783381	5776	5886	110	RIGHT	C53a.EDF	C53	1
56	2783437	2783498	5942	6003	61	RIGHT	C53a.EDF	C53	1
57	2787158	2787253	242	337	95	RIGHT	C53a.EDF	C53	1
57	2787506	2787675	590	759	169	RIGHT	C53a.EDF	C53	1
57	2787810	2788501	894	1585	691	RIGHT	C53a.EDF	C53	1
58	2797039	2797148	58	167	109	RIGHT	C53a.EDF	C53	1
58	2798250	2798381	1269	1400	131	RIGHT	C53a.EDF	C53	1
58	2802674	2802755	5693	5774	81	RIGHT	C53a.EDF	C53	1
58	2803329	2803396	6348	6415	67	RIGHT	C53a.EDF	C53	1
59	2807509	2807626	526	643	117	RIGHT	C53a.EDF	C53	1
59	2807846	2807998	863	1015	152	RIGHT	C53a.EDF	C53	1
59	2808242	2808355	1259	1372	113	RIGHT	C53a.EDF	C53	1
59	2808615	2808706	1632	1723	91	RIGHT	C53a.EDF	C53	1
60	2815755	2815862	222	329	107	RIGHT	C53a.EDF	C53	1
60	2817029	2817110	1496	1577	81	RIGHT	C53a.EDF	C53	1
61	2825499	2825606	680	787	107	RIGHT	C53a.EDF	C53	1
61	2825822	2825935	1003	1116	113	RIGHT	C53a.EDF	C53	1
61	2826154	2826253	1335	1434	99	RIGHT	C53a.EDF	C53	1
61	2829004	2829014	4185	4195	10	RIGHT	C53a.EDF	C53	1
61	2829631	2829631	4812	4812	0	RIGHT	C53a.EDF	C53	1
61	2829752	2830061	4933	5242	309	RIGHT	C53a.EDF	C53	1
61	2830177	2830180	5358	5361	3	RIGHT	C53a.EDF	C53	1
61	2830203	2830246	5384	5427	43	RIGHT	C53a.EDF	C53	1
61	2830304	2830304	5485	5485	0	RIGHT	C53a.EDF	C53	1
61	2830398	2830399	5579	5580	1	RIGHT	C53a.EDF	C53	1
62	2834493	2834600	618	725	107	RIGHT	C53a.EDF	C53	1
62	2834827	2834959	952	1084	132	RIGHT	C53a.EDF	C53	1
62	2835228	2835340	1353	1465	112	RIGHT	C53a.EDF	C53	1
62	2835641	2835722	1766	1847	81	RIGHT	C53a.EDF	C53	1
63	2844340	2844428	57	145	88	RIGHT	C53a.EDF	C53	1
63	2845072	2845183	789	900	111	RIGHT	C53a.EDF	C53	1
64	2858877	2859002	773	898	125	RIGHT	C53a.EDF	C53	1
65	2867820	2867935	1091	1206	115	RIGHT	C53a.EDF	C53	1
65	2868201	2868337	1472	1608	136	RIGHT	C53a.EDF	C53	1
66	2876653	2876771	202	320	118	RIGHT	C53a.EDF	C53	1
66	2877062	2877212	611	761	150	RIGHT	C53a.EDF	C53	1
66	2877406	2877512	955	1061	106	RIGHT	C53a.EDF	C53	1
66	2877904	2878020	1453	1569	116	RIGHT	C53a.EDF	C53	1
66	2878251	2878362	1800	1911	111	RIGHT	C53a.EDF	C53	1
67	2888046	2888121	300	375	75	RIGHT	C53a.EDF	C53	1
67	2888435	2888517	689	771	82	RIGHT	C53a.EDF	C53	1
67	2888765	2888879	1019	1133	114	RIGHT	C53a.EDF	C53	1
67	2889127	2889240	1381	1494	113	RIGHT	C53a.EDF	C53	1
68	2896212	2896314	386	488	102	RIGHT	C53a.EDF	C53	1
68	2896749	2896848	923	1022	99	RIGHT	C53a.EDF	C53	1
68	2897119	2897253	1293	1427	134	RIGHT	C53a.EDF	C53	1
69	2905880	2905994	362	476	114	RIGHT	C53a.EDF	C53	1
70	2915392	2915500	243	351	108	RIGHT	C53a.EDF	C53	1
70	2915942	2916035	793	886	93	RIGHT	C53a.EDF	C53	1
70	2916356	2916482	1207	1333	126	RIGHT	C53a.EDF	C53	1
70	2916926	2917022	1777	1873	96	RIGHT	C53a.EDF	C53	1
71	2925793	2925926	241	374	133	RIGHT	C53a.EDF	C53	1
71	2927206	2927316	1654	1764	110	RIGHT	C53a.EDF	C53	1
72	2935615	2935678	57	120	63	RIGHT	C53a.EDF	C53	1
72	2936436	2936541	878	983	105	RIGHT	C53a.EDF	C53	1
73	2943915	2944021	64	170	106	RIGHT	C53a.EDF	C53	1
73	2944897	2945014	1046	1163	117	RIGHT	C53a.EDF	C53	1
74	2953709	2953883	80	254	174	RIGHT	C53a.EDF	C53	1
74	2954413	2954535	784	906	122	RIGHT	C53a.EDF	C53	1
74	2954896	2955013	1267	1384	117	RIGHT	C53a.EDF	C53	1
75	2965122	2965213	1057	1148	91	RIGHT	C53a.EDF	C53	1
76	2973377	2973478	422	523	101	RIGHT	C53a.EDF	C53	1
76	2973885	2973999	930	1044	114	RIGHT	C53a.EDF	C53	1
77	2982938	2983054	181	297	116	RIGHT	C53a.EDF	C53	1
77	2984323	2984412	1566	1655	89	RIGHT	C53a.EDF	C53	1
78	2995417	2995497	253	333	80	RIGHT	C53a.EDF	C53	1
78	2995825	2995931	661	767	106	RIGHT	C53a.EDF	C53	1
79	3003967	3004055	58	146	88	RIGHT	C53a.EDF	C53	1
79	3004739	3004846	830	937	107	RIGHT	C53a.EDF	C53	1
80	3013854	3013970	1158	1274	116	RIGHT	C53a.EDF	C53	1
80	3014553	3014674	1857	1978	121	RIGHT	C53a.EDF	C53	1
81	3023856	3023970	674	788	114	RIGHT	C53a.EDF	C53	1
82	3033379	3033453	411	485	74	RIGHT	C53a.EDF	C53	1
82	3033775	3033917	807	949	142	RIGHT	C53a.EDF	C53	1
82	3034273	3034405	1305	1437	132	RIGHT	C53a.EDF	C53	1
82	3034742	3034832	1774	1864	90	RIGHT	C53a.EDF	C53	1
83	3042566	3042660	278	372	94	RIGHT	C53a.EDF	C53	1
83	3043028	3043137	740	849	109	RIGHT	C53a.EDF	C53	1
83	3043445	3043537	1157	1249	92	RIGHT	C53a.EDF	C53	1
83	3043841	3043964	1553	1676	123	RIGHT	C53a.EDF	C53	1
83	3044188	3044293	1900	2005	105	RIGHT	C53a.EDF	C53	1
84	3052088	3052217	140	269	129	RIGHT	C53a.EDF	C53	1
84	3052846	3052979	898	1031	133	RIGHT	C53a.EDF	C53	1
85	3060822	3060953	102	233	131	RIGHT	C53a.EDF	C53	1
85	3061711	3061816	991	1096	105	RIGHT	C53a.EDF	C53	1
86	3071039	3071134	58	153	95	RIGHT	C53a.EDF	C53	1
86	3071420	3071512	439	531	92	RIGHT	C53a.EDF	C53	1
86	3071842	3071955	861	974	113	RIGHT	C53a.EDF	C53	1
86	3072259	3072387	1278	1406	128	RIGHT	C53a.EDF	C53	1
87	3081838	3081917	790	869	79	RIGHT	C53a.EDF	C53	1
87	3082198	3082286	1150	1238	88	RIGHT	C53a.EDF	C53	1
88	3089483	3089561	75	153	78	RIGHT	C53a.EDF	C53	1
88	3090115	3090262	707	854	147	RIGHT	C53a.EDF	C53	1
88	3090476	3090627	1068	1219	151	RIGHT	C53a.EDF	C53	1
88	3091367	3091452	1959	2044	85	RIGHT	C53a.EDF	C53	1
89	3099616	3099703	58	145	87	RIGHT	C53a.EDF	C53	1
89	3100560	3100676	1002	1118	116	RIGHT	C53a.EDF	C53	1
89	3100988	3101111	1430	1553	123	RIGHT	C53a.EDF	C53	1
90	3107797	3107903	415	521	106	RIGHT	C53a.EDF	C53	1
90	3108311	3108417	929	1035	106	RIGHT	C53a.EDF	C53	1
90	3108653	3108792	1271	1410	139	RIGHT	C53a.EDF	C53	1
91	3118040	3118077	57	94	37	RIGHT	C53a.EDF	C53	1
91	3118551	3118671	568	688	120	RIGHT	C53a.EDF	C53	1
91	3118880	3119020	897	1037	140	RIGHT	C53a.EDF	C53	1
91	3119308	3119441	1325	1458	133	RIGHT	C53a.EDF	C53	1
92	3133316	3133449	66	199	133	RIGHT	C53a.EDF	C53	1
92	3133818	3133950	568	700	132	RIGHT	C53a.EDF	C53	1
92	3134144	3134328	894	1078	184	RIGHT	C53a.EDF	C53	1
92	3134511	3134661	1261	1411	150	RIGHT	C53a.EDF	C53	1
92	3134884	3135030	1634	1780	146	RIGHT	C53a.EDF	C53	1
93	3144627	3144745	222	340	118	RIGHT	C53a.EDF	C53	1
93	3145027	3145148	622	743	121	RIGHT	C53a.EDF	C53	1
93	3145379	3145529	974	1124	150	RIGHT	C53a.EDF	C53	1
93	3145752	3145885	1347	1480	133	RIGHT	C53a.EDF	C53	1
94	3152994	3153142	282	430	148	RIGHT	C53a.EDF	C53	1
94	3153457	3153594	745	882	137	RIGHT	C53a.EDF	C53	1
94	3153793	3153930	1081	1218	137	RIGHT	C53a.EDF	C53	1
95	3161199	3161219	57	77	20	RIGHT	C53a.EDF	C53	1
95	3161847	3161965	705	823	118	RIGHT	C53a.EDF	C53	1
95	3162261	3162376	1119	1234	115	RIGHT	C53a.EDF	C53	1
95	3162732	3162846	1590	1704	114	RIGHT	C53a.EDF	C53	1
96	3172011	3172127	789	905	116	RIGHT	C53a.EDF	C53	1
96	3172407	3172509	1185	1287	102	RIGHT	C53a.EDF	C53	1
97	3179981	3180086	263	368	105	RIGHT	C53a.EDF	C53	1
97	3180675	3180801	957	1083	126	RIGHT	C53a.EDF	C53	1
98	3187709	3187816	125	232	107	RIGHT	C53a.EDF	C53	1
98	3188400	3188513	816	929	113	RIGHT	C53a.EDF	C53	1
98	3188724	3188850	1140	1266	126	RIGHT	C53a.EDF	C53	1
99	3196460	3196574	183	297	114	RIGHT	C53a.EDF	C53	1
99	3197389	3197501	1112	1224	112	RIGHT	C53a.EDF	C53	1
99	3197939	3198060	1662	1783	121	RIGHT	C53a.EDF	C53	1
100	3205948	3206043	170	265	95	RIGHT	C53a.EDF	C53	1
100	3206548	3206656	770	878	108	RIGHT	C53a.EDF	C53	1
100	3207403	3207531	1625	1753	128	RIGHT	C53a.EDF	C53	1
101	3216939	3217057	989	1107	118	RIGHT	C53a.EDF	C53	1
101	3217314	3217451	1364	1501	137	RIGHT	C53a.EDF	C53	1
102	3227137	3227265	859	987	128	RIGHT	C53a.EDF	C53	1
102	3227543	3227683	1265	1405	140	RIGHT	C53a.EDF	C53	1
103	3237853	3237948	820	915	95	RIGHT	C53a.EDF	C53	1
103	3238223	3238337	1190	1304	114	RIGHT	C53a.EDF	C53	1
104	3246992	3247108	182	298	116	RIGHT	C53a.EDF	C53	1
104	3247955	3248047	1145	1237	92	RIGHT	C53a.EDF	C53	1
104	3248408	3248525	1598	1715	117	RIGHT	C53a.EDF	C53	1
105	3254832	3254964	58	190	132	RIGHT	C53a.EDF	C53	1
105	3255478	3255576	704	802	98	RIGHT	C53a.EDF	C53	1
105	3255834	3255946	1060	1172	112	RIGHT	C53a.EDF	C53	1
106	3266318	3266437	687	806	119	RIGHT	C53a.EDF	C53	1
106	3266935	3267045	1304	1414	110	RIGHT	C53a.EDF	C53	1
107	3275231	3275328	189	286	97	RIGHT	C53a.EDF	C53	1
107	3275874	3276028	832	986	154	RIGHT	C53a.EDF	C53	1
107	3276268	3276398	1226	1356	130	RIGHT	C53a.EDF	C53	1
107	3276772	3276903	1730	1861	131	RIGHT	C53a.EDF	C53	1
108	3283680	3283718	58	96	38	RIGHT	C53a.EDF	C53	1
108	3284404	3284517	782	895	113	RIGHT	C53a.EDF	C53	1
108	3284764	3284876	1142	1254	112	RIGHT	C53a.EDF	C53	1
109	3292781	3292910	173	302	129	RIGHT	C53a.EDF	C53	1
109	3293393	3293505	785	897	112	RIGHT	C53a.EDF	C53	1
109	3293824	3293953	1216	1345	129	RIGHT	C53a.EDF	C53	1
110	3303814	3303896	230	312	82	RIGHT	C53a.EDF	C53	1
110	3304314	3304452	730	868	138	RIGHT	C53a.EDF	C53	1
110	3304679	3304829	1095	1245	150	RIGHT	C53a.EDF	C53	1
111	3314146	3314281	146	281	135	RIGHT	C53a.EDF	C53	1
111	3314529	3314669	529	669	140	RIGHT	C53a.EDF	C53	1
111	3314834	3314957	834	957	123	RIGHT	C53a.EDF	C53	1
111	3315222	3315355	1222	1355	133	RIGHT	C53a.EDF	C53	1
112	3322891	3322988	840	937	97	RIGHT	C53a.EDF	C53	1
112	3323783	3323881	1732	1830	98	RIGHT	C53a.EDF	C53	1
113	3332041	3332094	57	110	53	RIGHT	C53a.EDF	C53	1
113	3332379	3332506	395	522	127	RIGHT	C53a.EDF	C53	1
113	3332897	3333024	913	1040	127	RIGHT	C53a.EDF	C53	1
113	3333266	3333391	1282	1407	125	RIGHT	C53a.EDF	C53	1
114	3342904	3343056	294	446	152	RIGHT	C53a.EDF	C53	1
114	3344452	3344573	1842	1963	121	RIGHT	C53a.EDF	C53	1
115	3354484	3354595	749	860	111	RIGHT	C53a.EDF	C53	1
115	3355471	3355574	1736	1839	103	RIGHT	C53a.EDF	C53	1
116	3363731	3363850	739	858	119	RIGHT	C53a.EDF	C53	1
117	3372735	3372818	57	140	83	RIGHT	C53a.EDF	C53	1
117	3373504	3373623	826	945	119	RIGHT	C53a.EDF	C53	1
118	3382144	3382280	211	347	136	RIGHT	C53a.EDF	C53	1
118	3382710	3382831	777	898	121	RIGHT	C53a.EDF	C53	1
118	3383113	3383242	1180	1309	129	RIGHT	C53a.EDF	C53	1
118	3383489	3383613	1556	1680	124	RIGHT	C53a.EDF	C53	1
119	3392612	3392780	208	376	168	RIGHT	C53a.EDF	C53	1
120	3403789	3403903	1454	1568	114	RIGHT	C53a.EDF	C53	1
1	6270390	6270481	798	889	91	RIGHT	C53b.EDF	C53	2
1	6271179	6271266	1587	1674	87	RIGHT	C53b.EDF	C53	2
2	6278432	6278569	57	194	137	RIGHT	C53b.EDF	C53	2
2	6279927	6280040	1552	1665	113	RIGHT	C53b.EDF	C53	2
3	6288578	6288665	58	145	87	RIGHT	C53b.EDF	C53	2
4	6297096	6297165	56	125	69	RIGHT	C53b.EDF	C53	2
4	6297339	6297485	299	445	146	RIGHT	C53b.EDF	C53	2
4	6297820	6297988	780	948	168	RIGHT	C53b.EDF	C53	2
4	6298225	6298363	1185	1323	138	RIGHT	C53b.EDF	C53	2
4	6298592	6298734	1552	1694	142	RIGHT	C53b.EDF	C53	2
5	6306654	6306824	139	309	170	RIGHT	C53b.EDF	C53	2
5	6306996	6307153	481	638	157	RIGHT	C53b.EDF	C53	2
5	6307460	6307626	945	1111	166	RIGHT	C53b.EDF	C53	2
5	6307888	6308034	1373	1519	146	RIGHT	C53b.EDF	C53	2
5	6308322	6308458	1807	1943	136	RIGHT	C53b.EDF	C53	2
6	6314927	6314999	57	129	72	RIGHT	C53b.EDF	C53	2
6	6315180	6315359	310	489	179	RIGHT	C53b.EDF	C53	2
7	6324003	6324178	238	413	175	RIGHT	C53b.EDF	C53	2
7	6324594	6324768	829	1003	174	RIGHT	C53b.EDF	C53	2
7	6324938	6325095	1173	1330	157	RIGHT	C53b.EDF	C53	2
7	6325276	6325438	1511	1673	162	RIGHT	C53b.EDF	C53	2
8	6330968	6331134	168	334	166	RIGHT	C53b.EDF	C53	2
9	6340078	6340243	152	317	165	RIGHT	C53b.EDF	C53	2
10	6347888	6347967	57	136	79	RIGHT	C53b.EDF	C53	2
10	6348110	6348402	279	571	292	RIGHT	C53b.EDF	C53	2
10	6348585	6348757	754	926	172	RIGHT	C53b.EDF	C53	2
10	6348960	6349105	1129	1274	145	RIGHT	C53b.EDF	C53	2
10	6349394	6349529	1563	1698	135	RIGHT	C53b.EDF	C53	2
10	6352310	6352417	4479	4586	107	RIGHT	C53b.EDF	C53	2
10	6353772	6353894	5941	6063	122	RIGHT	C53b.EDF	C53	2
13	6376573	6376654	57	138	81	RIGHT	C53b.EDF	C53	2
13	6376830	6377013	314	497	183	RIGHT	C53b.EDF	C53	2
13	6377419	6377602	903	1086	183	RIGHT	C53b.EDF	C53	2
13	6377817	6377992	1301	1476	175	RIGHT	C53b.EDF	C53	2
13	6378190	6378388	1674	1872	198	RIGHT	C53b.EDF	C53	2
14	6384549	6384694	520	665	145	RIGHT	C53b.EDF	C53	2
15	6394388	6394408	58	78	20	RIGHT	C53b.EDF	C53	2
15	6394595	6394729	265	399	134	RIGHT	C53b.EDF	C53	2
15	6395031	6395193	701	863	162	RIGHT	C53b.EDF	C53	2
15	6395393	6395568	1063	1238	175	RIGHT	C53b.EDF	C53	2
15	6395849	6395989	1519	1659	140	RIGHT	C53b.EDF	C53	2
16	6403784	6403948	57	221	164	RIGHT	C53b.EDF	C53	2
16	6404542	6404690	815	963	148	RIGHT	C53b.EDF	C53	2
16	6404900	6405058	1173	1331	158	RIGHT	C53b.EDF	C53	2
17	6413214	6413373	57	216	159	RIGHT	C53b.EDF	C53	2
17	6413962	6414128	805	971	166	RIGHT	C53b.EDF	C53	2
17	6414306	6414479	1149	1322	173	RIGHT	C53b.EDF	C53	2
17	6414661	6414832	1504	1675	171	RIGHT	C53b.EDF	C53	2
18	6423463	6423600	360	497	137	RIGHT	C53b.EDF	C53	2
18	6424033	6424199	930	1096	166	RIGHT	C53b.EDF	C53	2
18	6424340	6424533	1237	1430	193	RIGHT	C53b.EDF	C53	2
18	6424724	6424894	1621	1791	170	RIGHT	C53b.EDF	C53	2
19	6432313	6432488	163	338	175	RIGHT	C53b.EDF	C53	2
20	6439228	6439372	63	207	144	RIGHT	C53b.EDF	C53	2
20	6440424	6440568	1259	1403	144	RIGHT	C53b.EDF	C53	2
20	6440853	6441022	1688	1857	169	RIGHT	C53b.EDF	C53	2
21	6448508	6448648	150	290	140	RIGHT	C53b.EDF	C53	2
21	6449093	6449236	735	878	143	RIGHT	C53b.EDF	C53	2
21	6449640	6449768	1282	1410	128	RIGHT	C53b.EDF	C53	2
22	6459776	6459897	1476	1597	121	RIGHT	C53b.EDF	C53	2
23	6467905	6468072	128	295	167	RIGHT	C53b.EDF	C53	2
23	6468908	6469085	1131	1308	177	RIGHT	C53b.EDF	C53	2
24	6475614	6475764	158	308	150	RIGHT	C53b.EDF	C53	2
24	6476310	6476454	854	998	144	RIGHT	C53b.EDF	C53	2
24	6476815	6476975	1359	1519	160	RIGHT	C53b.EDF	C53	2
25	6484017	6484146	235	364	129	RIGHT	C53b.EDF	C53	2
25	6484335	6484499	553	717	164	RIGHT	C53b.EDF	C53	2
25	6484641	6484812	859	1030	171	RIGHT	C53b.EDF	C53	2
25	6484965	6485137	1183	1355	172	RIGHT	C53b.EDF	C53	2
26	6492407	6492444	71	108	37	RIGHT	C53b.EDF	C53	2
27	6500394	6500552	262	420	158	RIGHT	C53b.EDF	C53	2
27	6501679	6501830	1547	1698	151	RIGHT	C53b.EDF	C53	2
28	6510277	6510430	125	278	153	RIGHT	C53b.EDF	C53	2
28	6510927	6511075	775	923	148	RIGHT	C53b.EDF	C53	2
28	6511272	6511428	1120	1276	156	RIGHT	C53b.EDF	C53	2
29	6519082	6519221	731	870	139	RIGHT	C53b.EDF	C53	2
30	6526867	6526940	57	130	73	RIGHT	C53b.EDF	C53	2
30	6527568	6527730	758	920	162	RIGHT	C53b.EDF	C53	2
30	6527957	6528114	1147	1304	157	RIGHT	C53b.EDF	C53	2
30	6530754	6530861	3944	4051	107	RIGHT	C53b.EDF	C53	2
30	6531329	6531446	4519	4636	117	RIGHT	C53b.EDF	C53	2
30	6532123	6532258	5313	5448	135	RIGHT	C53b.EDF	C53	2
30	6532865	6533000	6055	6190	135	RIGHT	C53b.EDF	C53	2
31	6536870	6536900	57	87	30	RIGHT	C53b.EDF	C53	2
31	6537671	6537829	858	1016	158	RIGHT	C53b.EDF	C53	2
32	6546119	6546241	119	241	122	RIGHT	C53b.EDF	C53	2
32	6546663	6546802	663	802	139	RIGHT	C53b.EDF	C53	2
32	6547093	6547253	1093	1253	160	RIGHT	C53b.EDF	C53	2
32	6547515	6547685	1515	1685	170	RIGHT	C53b.EDF	C53	2
33	6556004	6556113	58	167	109	RIGHT	C53b.EDF	C53	2
33	6556340	6556486	394	540	146	RIGHT	C53b.EDF	C53	2
33	6556928	6557091	982	1145	163	RIGHT	C53b.EDF	C53	2
33	6557292	6557453	1346	1507	161	RIGHT	C53b.EDF	C53	2
34	6567159	6567351	777	969	192	RIGHT	C53b.EDF	C53	2
34	6567721	6567894	1339	1512	173	RIGHT	C53b.EDF	C53	2
35	6575306	6575311	73	78	5	RIGHT	C53b.EDF	C53	2
36	6585208	6585307	1916	2015	99	RIGHT	C53b.EDF	C53	2
37	6592895	6592960	57	122	65	RIGHT	C53b.EDF	C53	2
37	6593232	6593334	394	496	102	RIGHT	C53b.EDF	C53	2
37	6593578	6593740	740	902	162	RIGHT	C53b.EDF	C53	2
37	6593901	6594078	1063	1240	177	RIGHT	C53b.EDF	C53	2
37	6594251	6594407	1413	1569	156	RIGHT	C53b.EDF	C53	2
38	6601488	6601617	274	403	129	RIGHT	C53b.EDF	C53	2
38	6602414	6602562	1200	1348	148	RIGHT	C53b.EDF	C53	2
40	6619082	6619231	213	362	149	RIGHT	C53b.EDF	C53	2
40	6620063	6620205	1194	1336	142	RIGHT	C53b.EDF	C53	2
41	6630496	6630642	215	361	146	RIGHT	C53b.EDF	C53	2
41	6631064	6631237	783	956	173	RIGHT	C53b.EDF	C53	2
41	6631417	6631561	1136	1280	144	RIGHT	C53b.EDF	C53	2
41	6631850	6632009	1569	1728	159	RIGHT	C53b.EDF	C53	2
42	6639029	6639182	181	334	153	RIGHT	C53b.EDF	C53	2
42	6639653	6639797	805	949	144	RIGHT	C53b.EDF	C53	2
43	6647000	6647193	99	292	193	RIGHT	C53b.EDF	C53	2
43	6647602	6647770	701	869	168	RIGHT	C53b.EDF	C53	2
43	6647983	6648172	1082	1271	189	RIGHT	C53b.EDF	C53	2
44	6656196	6656360	177	341	164	RIGHT	C53b.EDF	C53	2
45	6664766	6664798	58	90	32	RIGHT	C53b.EDF	C53	2
45	6665246	6665453	538	745	207	RIGHT	C53b.EDF	C53	2
45	6665785	6665982	1077	1274	197	RIGHT	C53b.EDF	C53	2
45	6666621	6666795	1913	2087	174	RIGHT	C53b.EDF	C53	2
45	6668879	6668954	4171	4246	75	RIGHT	C53b.EDF	C53	2
46	6674894	6675021	685	812	127	RIGHT	C53b.EDF	C53	2
46	6675043	6675055	834	846	12	RIGHT	C53b.EDF	C53	2
46	6676000	6676144	1791	1935	144	RIGHT	C53b.EDF	C53	2
47	6683508	6683655	178	325	147	RIGHT	C53b.EDF	C53	2
47	6684027	6684189	697	859	162	RIGHT	C53b.EDF	C53	2
47	6684428	6684580	1098	1250	152	RIGHT	C53b.EDF	C53	2
47	6684851	6684977	1521	1647	126	RIGHT	C53b.EDF	C53	2
47	6689180	6689294	5850	5964	114	RIGHT	C53b.EDF	C53	2
48	6693232	6693411	222	401	179	RIGHT	C53b.EDF	C53	2
49	6701552	6701651	57	156	99	RIGHT	C53b.EDF	C53	2
49	6701820	6701995	325	500	175	RIGHT	C53b.EDF	C53	2
50	6709667	6709826	327	486	159	RIGHT	C53b.EDF	C53	2
51	6719563	6719731	157	325	168	RIGHT	C53b.EDF	C53	2
51	6721132	6721276	1726	1870	144	RIGHT	C53b.EDF	C53	2
52	6728843	6728950	57	164	107	RIGHT	C53b.EDF	C53	2
52	6729170	6729353	384	567	183	RIGHT	C53b.EDF	C53	2
52	6729596	6729784	810	998	188	RIGHT	C53b.EDF	C53	2
53	6738333	6738489	205	361	156	RIGHT	C53b.EDF	C53	2
54	6748881	6748966	57	142	85	RIGHT	C53b.EDF	C53	2
54	6749138	6749341	314	517	203	RIGHT	C53b.EDF	C53	2
54	6749749	6749926	925	1102	177	RIGHT	C53b.EDF	C53	2
54	6750336	6750503	1512	1679	167	RIGHT	C53b.EDF	C53	2
54	6750750	6750920	1926	2096	170	RIGHT	C53b.EDF	C53	2
55	6759242	6759284	63	105	42	RIGHT	C53b.EDF	C53	2
55	6759501	6759658	322	479	157	RIGHT	C53b.EDF	C53	2
55	6760099	6760239	920	1060	140	RIGHT	C53b.EDF	C53	2
55	6760678	6760841	1499	1662	163	RIGHT	C53b.EDF	C53	2
56	6769064	6769225	57	218	161	RIGHT	C53b.EDF	C53	2
56	6769799	6769960	792	953	161	RIGHT	C53b.EDF	C53	2
56	6770419	6770588	1412	1581	169	RIGHT	C53b.EDF	C53	2
57	6779618	6779789	873	1044	171	RIGHT	C53b.EDF	C53	2
57	6780021	6780211	1276	1466	190	RIGHT	C53b.EDF	C53	2
58	6788581	6788748	1215	1382	167	RIGHT	C53b.EDF	C53	2
59	6796670	6796827	312	469	157	RIGHT	C53b.EDF	C53	2
60	6805114	6805250	424	560	136	RIGHT	C53b.EDF	C53	2
60	6805578	6805763	888	1073	185	RIGHT	C53b.EDF	C53	2
60	6806207	6806371	1517	1681	164	RIGHT	C53b.EDF	C53	2
61	6814987	6815169	131	313	182	RIGHT	C53b.EDF	C53	2
62	6825219	6825390	177	348	171	RIGHT	C53b.EDF	C53	2
62	6825570	6825769	528	727	199	RIGHT	C53b.EDF	C53	2
62	6826032	6826229	990	1187	197	RIGHT	C53b.EDF	C53	2
62	6826379	6826581	1337	1539	202	RIGHT	C53b.EDF	C53	2
63	6836079	6836228	270	419	149	RIGHT	C53b.EDF	C53	2
63	6836718	6836873	909	1064	155	RIGHT	C53b.EDF	C53	2
64	6847090	6847105	71	86	15	RIGHT	C53b.EDF	C53	2
64	6847717	6847884	698	865	167	RIGHT	C53b.EDF	C53	2
64	6848068	6848247	1049	1228	179	RIGHT	C53b.EDF	C53	2
65	6856588	6856678	58	148	90	RIGHT	C53b.EDF	C53	2
65	6856907	6857090	377	560	183	RIGHT	C53b.EDF	C53	2
65	6857322	6857526	792	996	204	RIGHT	C53b.EDF	C53	2
65	6857756	6857924	1226	1394	168	RIGHT	C53b.EDF	C53	2
66	6865074	6865207	58	191	133	RIGHT	C53b.EDF	C53	2
67	6874410	6874598	898	1086	188	RIGHT	C53b.EDF	C53	2
69	6892457	6892512	62	117	55	RIGHT	C53b.EDF	C53	2
69	6892675	6892850	280	455	175	RIGHT	C53b.EDF	C53	2
69	6893268	6893452	873	1057	184	RIGHT	C53b.EDF	C53	2
69	6893607	6893765	1212	1370	158	RIGHT	C53b.EDF	C53	2
69	6894209	6894375	1814	1980	166	RIGHT	C53b.EDF	C53	2
69	6894561	6894600	2166	2205	39	RIGHT	C53b.EDF	C53	2
70	6902098	6902248	733	883	150	RIGHT	C53b.EDF	C53	2
71	6909792	6909851	58	117	59	RIGHT	C53b.EDF	C53	2
71	6910621	6910784	887	1050	163	RIGHT	C53b.EDF	C53	2
72	6921041	6921199	750	908	158	RIGHT	C53b.EDF	C53	2
73	6930824	6930866	68	110	42	RIGHT	C53b.EDF	C53	2
73	6931054	6931256	298	500	202	RIGHT	C53b.EDF	C53	2
73	6932386	6932573	1630	1817	187	RIGHT	C53b.EDF	C53	2
74	6939740	6939901	106	267	161	RIGHT	C53b.EDF	C53	2
74	6940594	6940768	960	1134	174	RIGHT	C53b.EDF	C53	2
74	6941244	6941415	1610	1781	171	RIGHT	C53b.EDF	C53	2
75	6948054	6948129	57	132	75	RIGHT	C53b.EDF	C53	2
75	6948736	6948865	739	868	129	RIGHT	C53b.EDF	C53	2
75	6949138	6949296	1141	1299	158	RIGHT	C53b.EDF	C53	2
76	6957745	6957890	841	986	145	RIGHT	C53b.EDF	C53	2
77	6967864	6968021	1780	1937	157	RIGHT	C53b.EDF	C53	2
78	6977240	6977426	181	367	186	RIGHT	C53b.EDF	C53	2
79	6985585	6985717	184	316	132	RIGHT	C53b.EDF	C53	2
79	6986201	6986365	800	964	164	RIGHT	C53b.EDF	C53	2
79	6986674	6986850	1273	1449	176	RIGHT	C53b.EDF	C53	2
80	6995815	6995874	58	117	59	RIGHT	C53b.EDF	C53	2
80	6996045	6996202	288	445	157	RIGHT	C53b.EDF	C53	2
80	6996826	6997029	1069	1272	203	RIGHT	C53b.EDF	C53	2
80	6997192	6997402	1435	1645	210	RIGHT	C53b.EDF	C53	2
81	7003992	7004166	80	254	174	RIGHT	C53b.EDF	C53	2
81	7005329	7005329	1417	1417	0	RIGHT	C53b.EDF	C53	2
81	7005412	7005416	1500	1504	4	RIGHT	C53b.EDF	C53	2
83	7021924	7022079	207	362	155	RIGHT	C53b.EDF	C53	2
83	7022472	7022623	755	906	151	RIGHT	C53b.EDF	C53	2
83	7022927	7023090	1210	1373	163	RIGHT	C53b.EDF	C53	2
84	7031276	7031332	58	114	56	RIGHT	C53b.EDF	C53	2
84	7031762	7031926	544	708	164	RIGHT	C53b.EDF	C53	2
84	7032091	7032247	873	1029	156	RIGHT	C53b.EDF	C53	2
84	7032451	7032619	1233	1401	168	RIGHT	C53b.EDF	C53	2
85	7040445	7040540	57	152	95	RIGHT	C53b.EDF	C53	2
85	7040746	7040905	358	517	159	RIGHT	C53b.EDF	C53	2
86	7049489	7049629	110	250	140	RIGHT	C53b.EDF	C53	2
86	7050414	7050559	1035	1180	145	RIGHT	C53b.EDF	C53	2
87	7057779	7057955	99	275	176	RIGHT	C53b.EDF	C53	2
88	7069130	7069274	1203	1347	144	RIGHT	C53b.EDF	C53	2
89	7078240	7078435	228	423	195	RIGHT	C53b.EDF	C53	2
89	7078845	7079013	833	1001	168	RIGHT	C53b.EDF	C53	2
90	7087701	7087847	157	303	146	RIGHT	C53b.EDF	C53	2
90	7088374	7088549	830	1005	175	RIGHT	C53b.EDF	C53	2
91	7097623	7097768	304	449	145	RIGHT	C53b.EDF	C53	2
93	7115949	7116099	309	459	150	RIGHT	C53b.EDF	C53	2
93	7116317	7116488	677	848	171	RIGHT	C53b.EDF	C53	2
93	7116925	7117108	1285	1468	183	RIGHT	C53b.EDF	C53	2
94	7125236	7125347	57	168	111	RIGHT	C53b.EDF	C53	2
94	7125483	7125648	304	469	165	RIGHT	C53b.EDF	C53	2
94	7126074	7126269	895	1090	195	RIGHT	C53b.EDF	C53	2
94	7126518	7126667	1339	1488	149	RIGHT	C53b.EDF	C53	2
95	7133866	7134034	160	328	168	RIGHT	C53b.EDF	C53	2
95	7134454	7134628	748	922	174	RIGHT	C53b.EDF	C53	2
95	7134808	7134986	1102	1280	178	RIGHT	C53b.EDF	C53	2
96	7143115	7143276	456	617	161	RIGHT	C53b.EDF	C53	2
96	7143585	7143777	926	1118	192	RIGHT	C53b.EDF	C53	2
97	7154052	7154246	258	452	194	RIGHT	C53b.EDF	C53	2
98	7162928	7162951	57	80	23	RIGHT	C53b.EDF	C53	2
98	7163068	7163258	197	387	190	RIGHT	C53b.EDF	C53	2
99	7174721	7174898	448	625	177	RIGHT	C53b.EDF	C53	2
99	7175191	7175485	918	1212	294	RIGHT	C53b.EDF	C53	2
99	7175625	7176309	1352	2036	684	RIGHT	C53b.EDF	C53	2
100	7184892	7185100	158	366	208	RIGHT	C53b.EDF	C53	2
100	7185609	7185813	875	1079	204	RIGHT	C53b.EDF	C53	2
101	7197180	7197236	70	126	56	RIGHT	C53b.EDF	C53	2
101	7197423	7197605	313	495	182	RIGHT	C53b.EDF	C53	2
101	7197862	7198094	752	984	232	RIGHT	C53b.EDF	C53	2
101	7198280	7198513	1170	1403	233	RIGHT	C53b.EDF	C53	2
102	7208015	7208215	749	949	200	RIGHT	C53b.EDF	C53	2
102	7208517	7208718	1251	1452	201	RIGHT	C53b.EDF	C53	2
103	7216331	7216502	57	228	171	RIGHT	C53b.EDF	C53	2
103	7217038	7217244	764	970	206	RIGHT	C53b.EDF	C53	2
103	7217413	7217624	1139	1350	211	RIGHT	C53b.EDF	C53	2
103	7217923	7218133	1649	1859	210	RIGHT	C53b.EDF	C53	2
104	7225516	7225637	57	178	121	RIGHT	C53b.EDF	C53	2
104	7225801	7225968	342	509	167	RIGHT	C53b.EDF	C53	2
104	7226365	7226521	906	1062	156	RIGHT	C53b.EDF	C53	2
104	7226695	7226872	1236	1413	177	RIGHT	C53b.EDF	C53	2
104	7227125	7227304	1666	1845	179	RIGHT	C53b.EDF	C53	2
105	7234491	7234537	57	103	46	RIGHT	C53b.EDF	C53	2
105	7234760	7234913	326	479	153	RIGHT	C53b.EDF	C53	2
106	7244946	7245111	196	361	165	RIGHT	C53b.EDF	C53	2
106	7245792	7245963	1042	1213	171	RIGHT	C53b.EDF	C53	2
106	7246717	7246863	1967	2113	146	RIGHT	C53b.EDF	C53	2
107	7255008	7255073	57	122	65	RIGHT	C53b.EDF	C53	2
107	7256058	7256125	1107	1174	67	RIGHT	C53b.EDF	C53	2
107	7256261	7256417	1310	1466	156	RIGHT	C53b.EDF	C53	2
108	7264446	7264592	123	269	146	RIGHT	C53b.EDF	C53	2
108	7265132	7265281	809	958	149	RIGHT	C53b.EDF	C53	2
108	7265652	7265789	1329	1466	137	RIGHT	C53b.EDF	C53	2
109	7274584	7274742	76	234	158	RIGHT	C53b.EDF	C53	2
109	7275435	7275615	927	1107	180	RIGHT	C53b.EDF	C53	2
110	7283630	7283807	146	323	177	RIGHT	C53b.EDF	C53	2
110	7284166	7284351	682	867	185	RIGHT	C53b.EDF	C53	2
110	7284489	7284661	1005	1177	172	RIGHT	C53b.EDF	C53	2
110	7285048	7285225	1564	1741	177	RIGHT	C53b.EDF	C53	2
111	7291317	7291500	98	281	183	RIGHT	C53b.EDF	C53	2
111	7292311	7292466	1092	1247	155	RIGHT	C53b.EDF	C53	2
112	7300306	7300342	57	93	36	RIGHT	C53b.EDF	C53	2
112	7300538	7300705	289	456	167	RIGHT	C53b.EDF	C53	2
112	7301116	7301276	867	1027	160	RIGHT	C53b.EDF	C53	2
112	7301665	7301857	1416	1608	192	RIGHT	C53b.EDF	C53	2
113	7310805	7310932	1044	1171	127	RIGHT	C53b.EDF	C53	2
113	7311224	7311417	1463	1656	193	RIGHT	C53b.EDF	C53	2
114	7319605	7319776	908	1079	171	RIGHT	C53b.EDF	C53	2
115	7327738	7327905	285	452	167	RIGHT	C53b.EDF	C53	2
115	7328823	7328975	1370	1522	152	RIGHT	C53b.EDF	C53	2
116	7338233	7338406	246	419	173	RIGHT	C53b.EDF	C53	2
116	7338901	7339075	914	1088	174	RIGHT	C53b.EDF	C53	2
116	7339264	7339424	1277	1437	160	RIGHT	C53b.EDF	C53	2
117	7345752	7345842	58	148	90	RIGHT	C53b.EDF	C53	2
117	7346493	7346688	799	994	195	RIGHT	C53b.EDF	C53	2
117	7347396	7347569	1702	1875	173	RIGHT	C53b.EDF	C53	2
118	7355544	7355708	59	223	164	RIGHT	C53b.EDF	C53	2
118	7356245	7356407	760	922	162	RIGHT	C53b.EDF	C53	2
118	7360946	7360985	5461	5500	39	RIGHT	C53b.EDF	C53	2
119	7364307	7364489	148	330	182	RIGHT	C53b.EDF	C53	2
119	7365102	7365289	943	1130	187	RIGHT	C53b.EDF	C53	2
120	7373086	7373250	57	221	164	RIGHT	C53b.EDF	C53	2
4	1591711	1591760	609	658	49	RIGHT	C55a.EDF	C55	1
5	1600213	1600214	276	277	1	RIGHT	C55a.EDF	C55	1
5	1600687	1600752	750	815	65	RIGHT	C55a.EDF	C55	1
5	1601162	1601254	1225	1317	92	RIGHT	C55a.EDF	C55	1
6	1608680	1608726	576	622	46	RIGHT	C55a.EDF	C55	1
6	1608964	1609090	860	986	126	RIGHT	C55a.EDF	C55	1
6	1609661	1609745	1557	1641	84	RIGHT	C55a.EDF	C55	1
7	1620324	1620334	300	310	10	RIGHT	C55a.EDF	C55	1
7	1620702	1620721	678	697	19	RIGHT	C55a.EDF	C55	1
7	1621473	1621542	1449	1518	69	RIGHT	C55a.EDF	C55	1
8	1629481	1629501	242	262	20	RIGHT	C55a.EDF	C55	1
9	1640334	1640384	618	668	50	RIGHT	C55a.EDF	C55	1
11	1661757	1661802	235	280	45	RIGHT	C55a.EDF	C55	1
11	1663014	1663107	1492	1585	93	RIGHT	C55a.EDF	C55	1
12	1673010	1673060	636	686	50	RIGHT	C55a.EDF	C55	1
13	1688405	1688473	251	319	68	RIGHT	C55a.EDF	C55	1
13	1688916	1688983	762	829	67	RIGHT	C55a.EDF	C55	1
13	1691518	1691572	3364	3418	54	RIGHT	C55a.EDF	C55	1
14	1699465	1699503	265	303	38	RIGHT	C55a.EDF	C55	1
15	1708426	1708461	96	131	35	RIGHT	C55a.EDF	C55	1
15	1709051	1709099	721	769	48	RIGHT	C55a.EDF	C55	1
16	1717428	1717439	72	83	11	RIGHT	C55a.EDF	C55	1
16	1717928	1717997	572	641	69	RIGHT	C55a.EDF	C55	1
16	1718494	1718565	1138	1209	71	RIGHT	C55a.EDF	C55	1
17	1729061	1729128	323	390	67	RIGHT	C55a.EDF	C55	1
17	1729669	1729745	931	1007	76	RIGHT	C55a.EDF	C55	1
18	1739250	1739325	297	372	75	RIGHT	C55a.EDF	C55	1
18	1740093	1740158	1140	1205	65	RIGHT	C55a.EDF	C55	1
19	1746392	1746442	198	248	50	RIGHT	C55a.EDF	C55	1
19	1746930	1746994	736	800	64	RIGHT	C55a.EDF	C55	1
20	1755264	1755335	249	320	71	RIGHT	C55a.EDF	C55	1
21	1762890	1762946	210	266	56	RIGHT	C55a.EDF	C55	1
21	1763419	1763490	739	810	71	RIGHT	C55a.EDF	C55	1
21	1764221	1764328	1541	1648	107	RIGHT	C55a.EDF	C55	1
22	1774202	1774284	176	258	82	RIGHT	C55a.EDF	C55	1
22	1774762	1774849	736	823	87	RIGHT	C55a.EDF	C55	1
22	1775547	1775595	1521	1569	48	RIGHT	C55a.EDF	C55	1
23	1783873	1783934	565	626	61	RIGHT	C55a.EDF	C55	1
23	1784360	1784467	1052	1159	107	RIGHT	C55a.EDF	C55	1
24	1791480	1791539	142	201	59	RIGHT	C55a.EDF	C55	1
24	1791850	1791952	512	614	102	RIGHT	C55a.EDF	C55	1
25	1800149	1800176	127	154	27	RIGHT	C55a.EDF	C55	1
25	1800883	1800948	861	926	65	RIGHT	C55a.EDF	C55	1
27	1818753	1818848	208	303	95	RIGHT	C55a.EDF	C55	1
27	1819465	1819552	920	1007	87	RIGHT	C55a.EDF	C55	1
28	1828143	1828226	620	703	83	RIGHT	C55a.EDF	C55	1
28	1828351	1828465	828	942	114	RIGHT	C55a.EDF	C55	1
28	1829358	1829424	1835	1901	66	RIGHT	C55a.EDF	C55	1
30	1845751	1845777	58	84	26	RIGHT	C55a.EDF	C55	1
30	1846962	1846975	1269	1282	13	RIGHT	C55a.EDF	C55	1
31	1852771	1852830	102	161	59	RIGHT	C55a.EDF	C55	1
31	1853749	1853792	1080	1123	43	RIGHT	C55a.EDF	C55	1
33	1870572	1870666	117	211	94	RIGHT	C55a.EDF	C55	1
34	1880954	1880998	105	149	44	RIGHT	C55a.EDF	C55	1
34	1882111	1882188	1262	1339	77	RIGHT	C55a.EDF	C55	1
36	1901426	1901496	57	127	70	RIGHT	C55a.EDF	C55	1
36	1902036	1902157	667	788	121	RIGHT	C55a.EDF	C55	1
37	1911539	1911584	58	103	45	RIGHT	C55a.EDF	C55	1
38	1921791	1921879	255	343	88	RIGHT	C55a.EDF	C55	1
38	1922896	1922958	1360	1422	62	RIGHT	C55a.EDF	C55	1
39	1931257	1931273	173	189	16	RIGHT	C55a.EDF	C55	1
39	1931720	1931843	636	759	123	RIGHT	C55a.EDF	C55	1
39	1932354	1932445	1270	1361	91	RIGHT	C55a.EDF	C55	1
40	1940070	1940173	187	290	103	RIGHT	C55a.EDF	C55	1
40	1941064	1941127	1181	1244	63	RIGHT	C55a.EDF	C55	1
41	1949453	1949532	278	357	79	RIGHT	C55a.EDF	C55	1
42	1959747	1959791	848	892	44	RIGHT	C55a.EDF	C55	1
43	1967654	1967712	58	116	58	RIGHT	C55a.EDF	C55	1
44	1977341	1977394	111	164	53	RIGHT	C55a.EDF	C55	1
46	1996098	1996134	1316	1352	36	RIGHT	C55a.EDF	C55	1
48	2015740	2015819	955	1034	79	RIGHT	C55a.EDF	C55	1
51	2040194	2040234	144	184	40	RIGHT	C55a.EDF	C55	1
51	2040714	2040789	664	739	75	RIGHT	C55a.EDF	C55	1
54	2067715	2067784	204	273	69	RIGHT	C55a.EDF	C55	1
55	2075769	2075816	287	334	47	RIGHT	C55a.EDF	C55	1
57	2091467	2091580	184	297	113	RIGHT	C55a.EDF	C55	1
57	2092322	2092408	1039	1125	86	RIGHT	C55a.EDF	C55	1
58	2100743	2100801	59	117	58	RIGHT	C55a.EDF	C55	1
59	2111042	2111161	135	254	119	RIGHT	C55a.EDF	C55	1
59	2111641	2111734	734	827	93	RIGHT	C55a.EDF	C55	1
60	2120594	2120675	706	787	81	RIGHT	C55a.EDF	C55	1
61	2128859	2128966	263	370	107	RIGHT	C55a.EDF	C55	1
62	2137772	2137843	841	912	71	RIGHT	C55a.EDF	C55	1
63	2147374	2147454	629	709	80	RIGHT	C55a.EDF	C55	1
66	2171695	2171763	122	190	68	RIGHT	C55a.EDF	C55	1
66	2172234	2172312	661	739	78	RIGHT	C55a.EDF	C55	1
66	2172766	2172859	1193	1286	93	RIGHT	C55a.EDF	C55	1
67	2180249	2180309	904	964	60	RIGHT	C55a.EDF	C55	1
69	2196120	2196182	645	707	62	RIGHT	C55a.EDF	C55	1
69	2196660	2196743	1185	1268	83	RIGHT	C55a.EDF	C55	1
70	2205110	2205170	238	298	60	RIGHT	C55a.EDF	C55	1
70	2205790	2205874	918	1002	84	RIGHT	C55a.EDF	C55	1
70	2206231	2206338	1359	1466	107	RIGHT	C55a.EDF	C55	1
71	2212551	2212602	274	325	51	RIGHT	C55a.EDF	C55	1
74	2239050	2239068	129	147	18	RIGHT	C55a.EDF	C55	1
74	2239611	2239676	690	755	65	RIGHT	C55a.EDF	C55	1
75	2247139	2247185	202	248	46	RIGHT	C55a.EDF	C55	1
75	2247653	2247764	716	827	111	RIGHT	C55a.EDF	C55	1
75	2251669	2251746	4732	4809	77	RIGHT	C55a.EDF	C55	1
77	2266849	2266934	260	345	85	RIGHT	C55a.EDF	C55	1
77	2267446	2267528	857	939	82	RIGHT	C55a.EDF	C55	1
78	2275433	2275483	648	698	50	RIGHT	C55a.EDF	C55	1
79	2283405	2283434	667	696	29	RIGHT	C55a.EDF	C55	1
80	2292495	2292555	870	930	60	RIGHT	C55a.EDF	C55	1
82	2310492	2310555	74	137	63	RIGHT	C55a.EDF	C55	1
83	2318984	2319039	58	113	55	RIGHT	C55a.EDF	C55	1
84	2327645	2327673	58	86	28	RIGHT	C55a.EDF	C55	1
84	2329384	2329427	1797	1840	43	RIGHT	C55a.EDF	C55	1
86	2345185	2345266	157	238	81	RIGHT	C55a.EDF	C55	1
88	2363969	2364014	625	670	45	RIGHT	C55a.EDF	C55	1
88	2364135	2364237	791	893	102	RIGHT	C55a.EDF	C55	1
90	2382171	2382272	201	302	101	RIGHT	C55a.EDF	C55	1
90	2382972	2383037	1002	1067	65	RIGHT	C55a.EDF	C55	1
91	2392113	2392163	877	927	50	RIGHT	C55a.EDF	C55	1
92	2399151	2399200	197	246	49	RIGHT	C55a.EDF	C55	1
94	2418228	2418294	774	840	66	RIGHT	C55a.EDF	C55	1
95	2425469	2425543	197	271	74	RIGHT	C55a.EDF	C55	1
96	2435485	2435545	892	952	60	RIGHT	C55a.EDF	C55	1
97	2444763	2444839	591	667	76	RIGHT	C55a.EDF	C55	1
98	2451901	2451963	108	170	62	RIGHT	C55a.EDF	C55	1
98	2452176	2452264	383	471	88	RIGHT	C55a.EDF	C55	1
98	2452569	2452643	776	850	74	RIGHT	C55a.EDF	C55	1
102	2484567	2484617	72	122	50	RIGHT	C55a.EDF	C55	1
103	2492132	2492182	313	363	50	RIGHT	C55a.EDF	C55	1
104	2501580	2501676	646	742	96	RIGHT	C55a.EDF	C55	1
105	2509116	2509171	58	113	55	RIGHT	C55a.EDF	C55	1
105	2509725	2509785	667	727	60	RIGHT	C55a.EDF	C55	1
106	2517847	2517920	203	276	73	RIGHT	C55a.EDF	C55	1
106	2518301	2518386	657	742	85	RIGHT	C55a.EDF	C55	1
106	2519537	2519584	1893	1940	47	RIGHT	C55a.EDF	C55	1
108	2534893	2534933	58	98	40	RIGHT	C55a.EDF	C55	1
108	2536258	2536282	1423	1447	24	RIGHT	C55a.EDF	C55	1
109	2543050	2543062	299	311	12	RIGHT	C55a.EDF	C55	1
110	2550641	2550713	157	229	72	RIGHT	C55a.EDF	C55	1
110	2552109	2552190	1625	1706	81	RIGHT	C55a.EDF	C55	1
111	2560077	2560139	618	680	62	RIGHT	C55a.EDF	C55	1
112	2568907	2568946	1007	1046	39	RIGHT	C55a.EDF	C55	1
113	2576188	2576230	58	100	42	RIGHT	C55a.EDF	C55	1
113	2576699	2576785	569	655	86	RIGHT	C55a.EDF	C55	1
116	2601824	2601846	58	80	22	RIGHT	C55a.EDF	C55	1
116	2602468	2602542	702	776	74	RIGHT	C55a.EDF	C55	1
118	2620983	2621055	665	737	72	RIGHT	C55a.EDF	C55	1
1	3772883	3772966	271	354	83	RIGHT	C55b.EDF	C55	2
4	3798553	3798658	154	259	105	RIGHT	C55b.EDF	C55	2
4	3799686	3799732	1287	1333	46	RIGHT	C55b.EDF	C55	2
5	3808262	3808309	140	187	47	RIGHT	C55b.EDF	C55	2
7	3825789	3825827	551	589	38	RIGHT	C55b.EDF	C55	2
7	3825969	3826044	731	806	75	RIGHT	C55b.EDF	C55	2
8	3833967	3834040	163	236	73	RIGHT	C55b.EDF	C55	2
8	3834878	3834953	1074	1149	75	RIGHT	C55b.EDF	C55	2
8	3835284	3835370	1480	1566	86	RIGHT	C55b.EDF	C55	2
9	3842817	3842908	90	181	91	RIGHT	C55b.EDF	C55	2
10	3851509	3851598	179	268	89	RIGHT	C55b.EDF	C55	2
10	3852809	3852833	1479	1503	24	RIGHT	C55b.EDF	C55	2
11	3858851	3858877	58	84	26	RIGHT	C55b.EDF	C55	2
12	3867765	3867876	792	903	111	RIGHT	C55b.EDF	C55	2
15	3892543	3892599	765	821	56	RIGHT	C55b.EDF	C55	2
16	3901293	3901314	244	265	21	RIGHT	C55b.EDF	C55	2
17	3910262	3910340	58	136	78	RIGHT	C55b.EDF	C55	2
17	3910512	3910632	308	428	120	RIGHT	C55b.EDF	C55	2
17	3911390	3911452	1186	1248	62	RIGHT	C55b.EDF	C55	2
18	3918890	3918928	218	256	38	RIGHT	C55b.EDF	C55	2
18	3919537	3919602	865	930	65	RIGHT	C55b.EDF	C55	2
18	3920488	3920506	1816	1834	18	RIGHT	C55b.EDF	C55	2
18	3921825	3921875	3153	3203	50	RIGHT	C55b.EDF	C55	2
19	3927488	3927577	57	146	89	RIGHT	C55b.EDF	C55	2
20	3937938	3937989	57	108	51	RIGHT	C55b.EDF	C55	2
22	3953997	3954068	777	848	71	RIGHT	C55b.EDF	C55	2
23	3961840	3961859	58	77	19	RIGHT	C55b.EDF	C55	2
23	3962410	3962499	628	717	89	RIGHT	C55b.EDF	C55	2
24	3970728	3970795	67	134	67	RIGHT	C55b.EDF	C55	2
24	3971038	3971096	377	435	58	RIGHT	C55b.EDF	C55	2
24	3971633	3971763	972	1102	130	RIGHT	C55b.EDF	C55	2
25	3980236	3980325	150	239	89	RIGHT	C55b.EDF	C55	2
25	3980743	3980840	657	754	97	RIGHT	C55b.EDF	C55	2
26	3989659	3989776	250	367	117	RIGHT	C55b.EDF	C55	2
26	3990484	3990543	1075	1134	59	RIGHT	C55b.EDF	C55	2
27	3998952	3999030	104	182	78	RIGHT	C55b.EDF	C55	2
27	3999910	3999978	1062	1130	68	RIGHT	C55b.EDF	C55	2
28	4008787	4008882	277	372	95	RIGHT	C55b.EDF	C55	2
29	4017378	4017458	963	1043	80	RIGHT	C55b.EDF	C55	2
31	4032787	4032817	631	661	30	RIGHT	C55b.EDF	C55	2
32	4040535	4040619	247	331	84	RIGHT	C55b.EDF	C55	2
32	4041099	4041194	811	906	95	RIGHT	C55b.EDF	C55	2
32	4041524	4041605	1236	1317	81	RIGHT	C55b.EDF	C55	2
33	4056819	4057038	59	278	219	RIGHT	C55b.EDF	C55	2
33	4057125	4057249	365	489	124	RIGHT	C55b.EDF	C55	2
33	4057414	4057499	654	739	85	RIGHT	C55b.EDF	C55	2
33	4057692	4057856	932	1096	164	RIGHT	C55b.EDF	C55	2
33	4058188	4058298	1428	1538	110	RIGHT	C55b.EDF	C55	2
33	4060861	4060914	4101	4154	53	RIGHT	C55b.EDF	C55	2
33	4061709	4061785	4949	5025	76	RIGHT	C55b.EDF	C55	2
34	4064798	4064884	304	390	86	RIGHT	C55b.EDF	C55	2
34	4065202	4065311	708	817	109	RIGHT	C55b.EDF	C55	2
35	4073039	4073058	654	673	19	RIGHT	C55b.EDF	C55	2
36	4081232	4081298	76	142	66	RIGHT	C55b.EDF	C55	2
36	4081903	4081984	747	828	81	RIGHT	C55b.EDF	C55	2
37	4090251	4090329	212	290	78	RIGHT	C55b.EDF	C55	2
37	4090709	4090785	670	746	76	RIGHT	C55b.EDF	C55	2
37	4091322	4091423	1283	1384	101	RIGHT	C55b.EDF	C55	2
38	4100289	4100382	59	152	93	RIGHT	C55b.EDF	C55	2
38	4100909	4100985	679	755	76	RIGHT	C55b.EDF	C55	2
39	4110711	4110741	58	88	30	RIGHT	C55b.EDF	C55	2
39	4110877	4111010	224	357	133	RIGHT	C55b.EDF	C55	2
39	4112076	4112121	1423	1468	45	RIGHT	C55b.EDF	C55	2
40	4119153	4119234	620	701	81	RIGHT	C55b.EDF	C55	2
41	4128908	4129006	234	332	98	RIGHT	C55b.EDF	C55	2
41	4129860	4129963	1186	1289	103	RIGHT	C55b.EDF	C55	2
42	4138177	4138307	601	731	130	RIGHT	C55b.EDF	C55	2
43	4146357	4146461	522	626	104	RIGHT	C55b.EDF	C55	2
44	4156004	4156083	554	633	79	RIGHT	C55b.EDF	C55	2
45	4163380	4163416	58	94	36	RIGHT	C55b.EDF	C55	2
45	4163649	4163730	327	408	81	RIGHT	C55b.EDF	C55	2
45	4164380	4164455	1058	1133	75	RIGHT	C55b.EDF	C55	2
46	4172923	4173015	443	535	92	RIGHT	C55b.EDF	C55	2
47	4180229	4180354	158	283	125	RIGHT	C55b.EDF	C55	2
47	4180926	4181019	855	948	93	RIGHT	C55b.EDF	C55	2
47	4181689	4181758	1618	1687	69	RIGHT	C55b.EDF	C55	2
49	4199785	4199844	897	956	59	RIGHT	C55b.EDF	C55	2
50	4208884	4208963	842	921	79	RIGHT	C55b.EDF	C55	2
51	4217437	4217510	568	641	73	RIGHT	C55b.EDF	C55	2
51	4218526	4218607	1657	1738	81	RIGHT	C55b.EDF	C55	2
52	4226775	4226814	596	635	39	RIGHT	C55b.EDF	C55	2
53	4235786	4235911	155	280	125	RIGHT	C55b.EDF	C55	2
53	4236297	4236426	666	795	129	RIGHT	C55b.EDF	C55	2
54	4246068	4246192	138	262	124	RIGHT	C55b.EDF	C55	2
54	4246535	4246657	605	727	122	RIGHT	C55b.EDF	C55	2
55	4255267	4255380	264	377	113	RIGHT	C55b.EDF	C55	2
55	4256104	4256174	1101	1171	70	RIGHT	C55b.EDF	C55	2
56	4263152	4263249	596	693	97	RIGHT	C55b.EDF	C55	2
57	4270411	4270523	79	191	112	RIGHT	C55b.EDF	C55	2
58	4280595	4280606	177	188	11	RIGHT	C55b.EDF	C55	2
60	4298276	4298352	589	665	76	RIGHT	C55b.EDF	C55	2
61	4305947	4305996	264	313	49	RIGHT	C55b.EDF	C55	2
61	4306142	4306232	459	549	90	RIGHT	C55b.EDF	C55	2
62	4315523	4315576	584	637	53	RIGHT	C55b.EDF	C55	2
63	4323007	4323133	153	279	126	RIGHT	C55b.EDF	C55	2
63	4323566	4323623	712	769	57	RIGHT	C55b.EDF	C55	2
64	4332118	4332214	605	701	96	RIGHT	C55b.EDF	C55	2
64	4332367	4332484	854	971	117	RIGHT	C55b.EDF	C55	2
64	4337252	4337360	5739	5847	108	RIGHT	C55b.EDF	C55	2
65	4340883	4341002	58	177	119	RIGHT	C55b.EDF	C55	2
65	4342254	4342295	1429	1470	41	RIGHT	C55b.EDF	C55	2
66	4351059	4351171	208	320	112	RIGHT	C55b.EDF	C55	2
66	4351581	4351698	730	847	117	RIGHT	C55b.EDF	C55	2
67	4359335	4359387	58	110	52	RIGHT	C55b.EDF	C55	2
68	4368581	4368620	58	97	39	RIGHT	C55b.EDF	C55	2
68	4369146	4369236	623	713	90	RIGHT	C55b.EDF	C55	2
69	4377365	4377390	58	83	25	RIGHT	C55b.EDF	C55	2
71	4394931	4395056	153	278	125	RIGHT	C55b.EDF	C55	2
71	4396069	4396135	1291	1357	66	RIGHT	C55b.EDF	C55	2
72	4404172	4404281	585	694	109	RIGHT	C55b.EDF	C55	2
73	4414206	4414284	597	675	78	RIGHT	C55b.EDF	C55	2
74	4422564	4422610	378	424	46	RIGHT	C55b.EDF	C55	2
74	4422764	4422867	578	681	103	RIGHT	C55b.EDF	C55	2
74	4423761	4423833	1575	1647	72	RIGHT	C55b.EDF	C55	2
75	4430750	4430842	230	322	92	RIGHT	C55b.EDF	C55	2
75	4431620	4431690	1100	1170	70	RIGHT	C55b.EDF	C55	2
76	4440165	4440237	265	337	72	RIGHT	C55b.EDF	C55	2
76	4441260	4441305	1360	1405	45	RIGHT	C55b.EDF	C55	2
76	4444948	4444992	5048	5092	44	RIGHT	C55b.EDF	C55	2
77	4447857	4447961	116	220	104	RIGHT	C55b.EDF	C55	2
78	4455714	4455842	125	253	128	RIGHT	C55b.EDF	C55	2
79	4465053	4465125	441	513	72	RIGHT	C55b.EDF	C55	2
79	4465376	4465484	764	872	108	RIGHT	C55b.EDF	C55	2
80	4474410	4474485	103	178	75	RIGHT	C55b.EDF	C55	2
80	4474932	4475033	625	726	101	RIGHT	C55b.EDF	C55	2
80	4475845	4475926	1538	1619	81	RIGHT	C55b.EDF	C55	2
81	4482835	4482915	273	353	80	RIGHT	C55b.EDF	C55	2
81	4484280	4484320	1718	1758	40	RIGHT	C55b.EDF	C55	2
82	4492087	4492136	58	107	49	RIGHT	C55b.EDF	C55	2
82	4492316	4492443	287	414	127	RIGHT	C55b.EDF	C55	2
82	4492885	4492976	856	947	91	RIGHT	C55b.EDF	C55	2
83	4500895	4500979	617	701	84	RIGHT	C55b.EDF	C55	2
84	4509913	4509996	94	177	83	RIGHT	C55b.EDF	C55	2
84	4510495	4510602	676	783	107	RIGHT	C55b.EDF	C55	2
84	4511546	4511637	1727	1818	91	RIGHT	C55b.EDF	C55	2
85	4517919	4518019	115	215	100	RIGHT	C55b.EDF	C55	2
85	4518747	4518844	943	1040	97	RIGHT	C55b.EDF	C55	2
86	4528108	4528191	58	141	83	RIGHT	C55b.EDF	C55	2
87	4536695	4536799	800	904	104	RIGHT	C55b.EDF	C55	2
88	4544446	4544507	640	701	61	RIGHT	C55b.EDF	C55	2
89	4554148	4554252	249	353	104	RIGHT	C55b.EDF	C55	2
89	4555648	4555651	1749	1752	3	RIGHT	C55b.EDF	C55	2
90	4562478	4562571	767	860	93	RIGHT	C55b.EDF	C55	2
91	4569972	4570081	587	696	109	RIGHT	C55b.EDF	C55	2
92	4579115	4579240	723	848	125	RIGHT	C55b.EDF	C55	2
93	4589530	4589578	1302	1350	48	RIGHT	C55b.EDF	C55	2
94	4597635	4597714	553	632	79	RIGHT	C55b.EDF	C55	2
94	4597939	4598048	857	966	109	RIGHT	C55b.EDF	C55	2
95	4606602	4606672	58	128	70	RIGHT	C55b.EDF	C55	2
96	4616153	4616175	110	132	22	RIGHT	C55b.EDF	C55	2
97	4627824	4627903	603	682	79	RIGHT	C55b.EDF	C55	2
97	4628028	4628137	807	916	109	RIGHT	C55b.EDF	C55	2
98	4636776	4636815	58	97	39	RIGHT	C55b.EDF	C55	2
98	4637381	4637502	663	784	121	RIGHT	C55b.EDF	C55	2
99	4646481	4646495	338	352	14	RIGHT	C55b.EDF	C55	2
101	4663872	4663932	749	809	60	RIGHT	C55b.EDF	C55	2
103	4681599	4681650	1426	1477	51	RIGHT	C55b.EDF	C55	2
104	4689455	4689555	545	645	100	RIGHT	C55b.EDF	C55	2
105	4697302	4697364	339	401	62	RIGHT	C55b.EDF	C55	2
105	4698540	4698593	1577	1630	53	RIGHT	C55b.EDF	C55	2
106	4705997	4706060	58	121	63	RIGHT	C55b.EDF	C55	2
107	4713988	4714027	58	97	39	RIGHT	C55b.EDF	C55	2
108	4721911	4721931	58	78	20	RIGHT	C55b.EDF	C55	2
108	4722216	4722299	363	446	83	RIGHT	C55b.EDF	C55	2
108	4722480	4722586	627	733	106	RIGHT	C55b.EDF	C55	2
109	4731608	4731693	589	674	85	RIGHT	C55b.EDF	C55	2
110	4739553	4739642	292	381	89	RIGHT	C55b.EDF	C55	2
112	4755725	4755784	58	117	59	RIGHT	C55b.EDF	C55	2
112	4756228	4756331	561	664	103	RIGHT	C55b.EDF	C55	2
112	4757410	4757447	1743	1780	37	RIGHT	C55b.EDF	C55	2
113	4763824	4763918	179	273	94	RIGHT	C55b.EDF	C55	2
113	4764600	4764691	955	1046	91	RIGHT	C55b.EDF	C55	2
115	4782384	4782413	58	87	29	RIGHT	C55b.EDF	C55	2
115	4782871	4782982	545	656	111	RIGHT	C55b.EDF	C55	2
115	4783212	4783352	886	1026	140	RIGHT	C55b.EDF	C55	2
116	4792492	4792551	679	738	59	RIGHT	C55b.EDF	C55	2
117	4800433	4800487	335	389	54	RIGHT	C55b.EDF	C55	2
117	4800853	4800923	755	825	70	RIGHT	C55b.EDF	C55	2
118	4811403	4811437	59	93	34	RIGHT	C55b.EDF	C55	2
118	4812024	4812117	680	773	93	RIGHT	C55b.EDF	C55	2
119	4821116	4821199	80	163	83	RIGHT	C55b.EDF	C55	2
119	4821932	4822017	896	981	85	RIGHT	C55b.EDF	C55	2
120	4829585	4829638	58	111	53	RIGHT	C55b.EDF	C55	2
120	4830881	4830979	1354	1452	98	RIGHT	C55b.EDF	C55	2
1	5822817	5822907	1570	1660	90	RIGHT	C55c.EDF	C55	3
2	5830786	5830815	239	268	29	RIGHT	C55c.EDF	C55	3
2	5831619	5831698	1072	1151	79	RIGHT	C55c.EDF	C55	3
3	5839879	5839980	121	222	101	RIGHT	C55c.EDF	C55	3
3	5840393	5840475	635	717	82	RIGHT	C55c.EDF	C55	3
3	5841354	5841410	1596	1652	56	RIGHT	C55c.EDF	C55	3
4	5848091	5848169	119	197	78	RIGHT	C55c.EDF	C55	3
4	5848587	5848678	615	706	91	RIGHT	C55c.EDF	C55	3
5	5856040	5856073	298	331	33	RIGHT	C55c.EDF	C55	3
9	5890005	5890091	220	306	86	RIGHT	C55c.EDF	C55	3
9	5890812	5890897	1027	1112	85	RIGHT	C55c.EDF	C55	3
10	5898024	5898099	354	429	75	RIGHT	C55c.EDF	C55	3
10	5898303	5898401	633	731	98	RIGHT	C55c.EDF	C55	3
13	5924710	5924736	58	84	26	RIGHT	C55c.EDF	C55	3
13	5924957	5925016	305	364	59	RIGHT	C55c.EDF	C55	3
13	5925601	5925670	949	1018	69	RIGHT	C55c.EDF	C55	3
14	5933962	5934069	248	355	107	RIGHT	C55c.EDF	C55	3
15	5942540	5942584	67	111	44	RIGHT	C55c.EDF	C55	3
15	5942631	5942741	158	268	110	RIGHT	C55c.EDF	C55	3
16	5952021	5952047	58	84	26	RIGHT	C55c.EDF	C55	3
16	5952308	5952363	345	400	55	RIGHT	C55c.EDF	C55	3
16	5952616	5952708	653	745	92	RIGHT	C55c.EDF	C55	3
18	5970771	5970848	1054	1131	77	RIGHT	C55c.EDF	C55	3
19	5979573	5979617	58	102	44	RIGHT	C55c.EDF	C55	3
19	5980108	5980181	593	666	73	RIGHT	C55c.EDF	C55	3
20	5989170	5989217	340	387	47	RIGHT	C55c.EDF	C55	3
20	5989428	5989537	598	707	109	RIGHT	C55c.EDF	C55	3
20	5990348	5990394	1518	1564	46	RIGHT	C55c.EDF	C55	3
21	5997163	5997257	188	282	94	RIGHT	C55c.EDF	C55	3
22	6005951	6006028	81	158	77	RIGHT	C55c.EDF	C55	3
23	6014444	6014503	272	331	59	RIGHT	C55c.EDF	C55	3
24	6023103	6023174	696	767	71	RIGHT	C55c.EDF	C55	3
24	6023336	6023438	929	1031	102	RIGHT	C55c.EDF	C55	3
25	6030756	6030860	829	933	104	RIGHT	C55c.EDF	C55	3
27	6048888	6048960	542	614	72	RIGHT	C55c.EDF	C55	3
28	6057627	6057702	57	132	75	RIGHT	C55c.EDF	C55	3
30	6075727	6075781	697	751	54	RIGHT	C55c.EDF	C55	3
31	6084818	6084895	219	296	77	RIGHT	C55c.EDF	C55	3
33	6101620	6101720	79	179	100	RIGHT	C55c.EDF	C55	3
33	6102508	6102586	967	1045	78	RIGHT	C55c.EDF	C55	3
34	6112112	6112198	166	252	86	RIGHT	C55c.EDF	C55	3
34	6112778	6112891	832	945	113	RIGHT	C55c.EDF	C55	3
35	6119996	6120079	111	194	83	RIGHT	C55c.EDF	C55	3
36	6129029	6129102	117	190	73	RIGHT	C55c.EDF	C55	3
37	6138651	6138806	633	788	155	RIGHT	C55c.EDF	C55	3
38	6148152	6148245	168	261	93	RIGHT	C55c.EDF	C55	3
38	6149026	6149084	1042	1100	58	RIGHT	C55c.EDF	C55	3
39	6157278	6157405	58	185	127	RIGHT	C55c.EDF	C55	3
40	6166794	6166845	190	241	51	RIGHT	C55c.EDF	C55	3
40	6167385	6167436	781	832	51	RIGHT	C55c.EDF	C55	3
40	6167934	6167997	1330	1393	63	RIGHT	C55c.EDF	C55	3
41	6174753	6174846	88	181	93	RIGHT	C55c.EDF	C55	3
41	6175626	6175704	961	1039	78	RIGHT	C55c.EDF	C55	3
45	6206298	6206340	59	101	42	RIGHT	C55c.EDF	C55	3
45	6206483	6206637	244	398	154	RIGHT	C55c.EDF	C55	3
45	6206949	6207069	710	830	120	RIGHT	C55c.EDF	C55	3
45	6207725	6207806	1486	1567	81	RIGHT	C55c.EDF	C55	3
46	6215016	6215090	119	193	74	RIGHT	C55c.EDF	C55	3
46	6215529	6215600	632	703	71	RIGHT	C55c.EDF	C55	3
48	6232168	6232224	58	114	56	RIGHT	C55c.EDF	C55	3
48	6232994	6233053	884	943	59	RIGHT	C55c.EDF	C55	3
49	6241151	6241216	384	449	65	RIGHT	C55c.EDF	C55	3
49	6241336	6241442	569	675	106	RIGHT	C55c.EDF	C55	3
50	6249048	6249109	85	146	61	RIGHT	C55c.EDF	C55	3
50	6249561	6249622	598	659	61	RIGHT	C55c.EDF	C55	3
50	6250434	6250504	1471	1541	70	RIGHT	C55c.EDF	C55	3
51	6259490	6259521	1492	1523	31	RIGHT	C55c.EDF	C55	3
52	6267473	6267541	796	864	68	RIGHT	C55c.EDF	C55	3
52	6268295	6268362	1618	1685	67	RIGHT	C55c.EDF	C55	3
53	6275182	6275261	545	624	79	RIGHT	C55c.EDF	C55	3
54	6283553	6283578	57	82	25	RIGHT	C55c.EDF	C55	3
54	6283771	6283833	275	337	62	RIGHT	C55c.EDF	C55	3
54	6284105	6284220	609	724	115	RIGHT	C55c.EDF	C55	3
54	6284902	6284994	1406	1498	92	RIGHT	C55c.EDF	C55	3
55	6293387	6293463	320	396	76	RIGHT	C55c.EDF	C55	3
55	6293777	6293892	710	825	115	RIGHT	C55c.EDF	C55	3
56	6301304	6301360	553	609	56	RIGHT	C55c.EDF	C55	3
57	6308874	6308990	586	702	116	RIGHT	C55c.EDF	C55	3
58	6316201	6316242	323	364	41	RIGHT	C55c.EDF	C55	3
58	6316502	6316621	624	743	119	RIGHT	C55c.EDF	C55	3
59	6324931	6324993	58	120	62	RIGHT	C55c.EDF	C55	3
60	6332699	6332725	406	432	26	RIGHT	C55c.EDF	C55	3
60	6332970	6333092	677	799	122	RIGHT	C55c.EDF	C55	3
61	6342056	6342146	183	273	90	RIGHT	C55c.EDF	C55	3
61	6343100	6343257	1227	1384	157	RIGHT	C55c.EDF	C55	3
62	6351630	6351763	580	713	133	RIGHT	C55c.EDF	C55	3
62	6352878	6352914	1828	1864	36	RIGHT	C55c.EDF	C55	3
63	6360467	6360571	567	671	104	RIGHT	C55c.EDF	C55	3
63	6360699	6360814	799	914	115	RIGHT	C55c.EDF	C55	3
65	6378346	6378372	1279	1305	26	RIGHT	C55c.EDF	C55	3
66	6384728	6384850	113	235	122	RIGHT	C55c.EDF	C55	3
66	6385759	6385812	1144	1197	53	RIGHT	C55c.EDF	C55	3
67	6394384	6394481	553	650	97	RIGHT	C55c.EDF	C55	3
67	6399743	6399812	5912	5981	69	RIGHT	C55c.EDF	C55	3
68	6404396	6404452	1371	1427	56	RIGHT	C55c.EDF	C55	3
69	6411845	6411874	1124	1153	29	RIGHT	C55c.EDF	C55	3
70	6419418	6419522	447	551	104	RIGHT	C55c.EDF	C55	3
71	6429279	6429338	1408	1467	59	RIGHT	C55c.EDF	C55	3
73	6442329	6442420	294	385	91	RIGHT	C55c.EDF	C55	3
73	6443360	6443441	1325	1406	81	RIGHT	C55c.EDF	C55	3
74	6450988	6451096	167	275	108	RIGHT	C55c.EDF	C55	3
74	6452286	6452327	1465	1506	41	RIGHT	C55c.EDF	C55	3
75	6459955	6460031	340	416	76	RIGHT	C55c.EDF	C55	3
75	6460279	6460378	664	763	99	RIGHT	C55c.EDF	C55	3
76	6467659	6467730	57	128	71	RIGHT	C55c.EDF	C55	3
77	6476843	6476927	57	141	84	RIGHT	C55c.EDF	C55	3
77	6477403	6477485	617	699	82	RIGHT	C55c.EDF	C55	3
77	6478521	6478580	1735	1794	59	RIGHT	C55c.EDF	C55	3
78	6485078	6485167	572	661	89	RIGHT	C55c.EDF	C55	3
79	6494165	6494258	352	445	93	RIGHT	C55c.EDF	C55	3
79	6494578	6494671	765	858	93	RIGHT	C55c.EDF	C55	3
79	6496857	6496859	3044	3046	2	RIGHT	C55c.EDF	C55	3
80	6502737	6502819	85	167	82	RIGHT	C55c.EDF	C55	3
80	6503269	6503359	617	707	90	RIGHT	C55c.EDF	C55	3
81	6512244	6512325	611	692	81	RIGHT	C55c.EDF	C55	3
82	6522008	6522092	235	319	84	RIGHT	C55c.EDF	C55	3
82	6522389	6522463	616	690	74	RIGHT	C55c.EDF	C55	3
82	6523145	6523226	1372	1453	81	RIGHT	C55c.EDF	C55	3
83	6530641	6530672	583	614	31	RIGHT	C55c.EDF	C55	3
84	6539612	6539684	1097	1169	72	RIGHT	C55c.EDF	C55	3
85	6546461	6546515	786	840	54	RIGHT	C55c.EDF	C55	3
86	6553927	6554007	244	324	80	RIGHT	C55c.EDF	C55	3
89	6580125	6580231	58	164	106	RIGHT	C55c.EDF	C55	3
89	6581788	6581837	1721	1770	49	RIGHT	C55c.EDF	C55	3
90	6588118	6588234	146	262	116	RIGHT	C55c.EDF	C55	3
90	6592292	6592308	4320	4336	16	RIGHT	C55c.EDF	C55	3
92	6606278	6606364	898	984	86	RIGHT	C55c.EDF	C55	3
93	6616074	6616134	349	409	60	RIGHT	C55c.EDF	C55	3
93	6616580	6616741	855	1016	161	RIGHT	C55c.EDF	C55	3
94	6624579	6624697	175	293	118	RIGHT	C55c.EDF	C55	3
94	6625118	6625251	714	847	133	RIGHT	C55c.EDF	C55	3
95	6634340	6634406	544	610	66	RIGHT	C55c.EDF	C55	3
96	6643302	6643418	140	256	116	RIGHT	C55c.EDF	C55	3
97	6651920	6652003	620	703	83	RIGHT	C55c.EDF	C55	3
98	6659907	6659928	135	156	21	RIGHT	C55c.EDF	C55	3
98	6660509	6660606	737	834	97	RIGHT	C55c.EDF	C55	3
99	6668569	6668592	270	293	23	RIGHT	C55c.EDF	C55	3
100	6678864	6678972	113	221	108	RIGHT	C55c.EDF	C55	3
100	6679280	6679518	529	767	238	RIGHT	C55c.EDF	C55	3
100	6680064	6680142	1313	1391	78	RIGHT	C55c.EDF	C55	3
100	6681913	6681980	3162	3229	67	RIGHT	C55c.EDF	C55	3
100	6683010	6683086	4259	4335	76	RIGHT	C55c.EDF	C55	3
101	6687357	6687468	205	316	111	RIGHT	C55c.EDF	C55	3
101	6687841	6687959	689	807	118	RIGHT	C55c.EDF	C55	3
101	6692547	6692582	5395	5430	35	RIGHT	C55c.EDF	C55	3
102	6696552	6696625	685	758	73	RIGHT	C55c.EDF	C55	3
103	6706361	6706449	677	765	88	RIGHT	C55c.EDF	C55	3
104	6717238	6717346	190	298	108	RIGHT	C55c.EDF	C55	3
104	6717535	6717654	487	606	119	RIGHT	C55c.EDF	C55	3
104	6718651	6718712	1603	1664	61	RIGHT	C55c.EDF	C55	3
105	6725724	6725768	57	101	44	RIGHT	C55c.EDF	C55	3
105	6726292	6726387	625	720	95	RIGHT	C55c.EDF	C55	3
106	6735382	6735454	250	322	72	RIGHT	C55c.EDF	C55	3
107	6745486	6745594	275	383	108	RIGHT	C55c.EDF	C55	3
107	6746843	6746887	1632	1676	44	RIGHT	C55c.EDF	C55	3
108	6753324	6753457	241	374	133	RIGHT	C55c.EDF	C55	3
108	6754216	6754332	1133	1249	116	RIGHT	C55c.EDF	C55	3
109	6762446	6762524	288	366	78	RIGHT	C55c.EDF	C55	3
109	6762821	6762935	663	777	114	RIGHT	C55c.EDF	C55	3
110	6769587	6769693	585	691	106	RIGHT	C55c.EDF	C55	3
111	6777021	6777127	225	331	106	RIGHT	C55c.EDF	C55	3
111	6777927	6777997	1131	1201	70	RIGHT	C55c.EDF	C55	3
112	6785041	6785119	304	382	78	RIGHT	C55c.EDF	C55	3
113	6793060	6793123	104	167	63	RIGHT	C55c.EDF	C55	3
113	6793580	6793644	624	688	64	RIGHT	C55c.EDF	C55	3
113	6794255	6794341	1299	1385	86	RIGHT	C55c.EDF	C55	3
114	6803221	6803371	488	638	150	RIGHT	C55c.EDF	C55	3
114	6804295	6804371	1562	1638	76	RIGHT	C55c.EDF	C55	3
115	6812451	6812490	313	352	39	RIGHT	C55c.EDF	C55	3
115	6813318	6813370	1180	1232	52	RIGHT	C55c.EDF	C55	3
116	6821974	6822055	291	372	81	RIGHT	C55c.EDF	C55	3
116	6822316	6822435	633	752	119	RIGHT	C55c.EDF	C55	3
117	6830850	6830915	58	123	65	RIGHT	C55c.EDF	C55	3
117	6831474	6831743	682	951	269	RIGHT	C55c.EDF	C55	3
118	6838489	6838595	94	200	106	RIGHT	C55c.EDF	C55	3
119	6845801	6845930	127	256	129	RIGHT	C55c.EDF	C55	3
120	6855586	6855711	162	287	125	RIGHT	C55c.EDF	C55	3
120	6856116	6856246	692	822	130	RIGHT	C55c.EDF	C55	3
121	7379474	7379562	6307	6395	88	RIGHT	C55c.EDF	C55	3
121	7380393	7380677	7226	7510	284	RIGHT	C55c.EDF	C55	3
121	7381027	7381154	7860	7987	127	RIGHT	C55c.EDF	C55	3
121	7383687	7383716	10520	10549	29	RIGHT	C55c.EDF	C55	3
121	7383784	7384493	10617	11326	709	RIGHT	C55c.EDF	C55	3
121	7384876	7385136	11709	11969	260	RIGHT	C55c.EDF	C55	3
121	7386241	7386334	13074	13167	93	RIGHT	C55c.EDF	C55	3
121	7387017	7387106	13850	13939	89	RIGHT	C55c.EDF	C55	3
121	7389151	7389196	15984	16029	45	RIGHT	C55c.EDF	C55	3
121	7394478	7394520	21311	21353	42	RIGHT	C55c.EDF	C55	3
121	7395025	7395127	21858	21960	102	RIGHT	C55c.EDF	C55	3
121	7396725	7396789	23558	23622	64	RIGHT	C55c.EDF	C55	3
121	7398502	7398518	25335	25351	16	RIGHT	C55c.EDF	C55	3
121	7398547	7398859	25380	25692	312	RIGHT	C55c.EDF	C55	3
121	7401647	7401932	28480	28765	285	RIGHT	C55c.EDF	C55	3
121	7401992	7402007	28825	28840	15	RIGHT	C55c.EDF	C55	3
121	7406235	7406426	33068	33259	191	RIGHT	C55c.EDF	C55	3
121	7408562	7408581	35395	35414	19	RIGHT	C55c.EDF	C55	3
121	7408651	7408835	35484	35668	184	RIGHT	C55c.EDF	C55	3
121	7408932	7408956	35765	35789	24	RIGHT	C55c.EDF	C55	3
121	7415688	7415705	42521	42538	17	RIGHT	C55c.EDF	C55	3
121	7415897	7415908	42730	42741	11	RIGHT	C55c.EDF	C55	3
121	7425330	7425568	52163	52401	238	RIGHT	C55c.EDF	C55	3
121	7427436	7427529	54269	54362	93	RIGHT	C55c.EDF	C55	3
121	7428580	7428694	55413	55527	114	RIGHT	C55c.EDF	C55	3
121	7431354	7431409	58187	58242	55	RIGHT	C55c.EDF	C55	3
121	7432865	7432922	59698	59755	57	RIGHT	C55c.EDF	C55	3
121	7441676	7442061	68509	68894	385	RIGHT	C55c.EDF	C55	3
121	7443940	7444041	70773	70874	101	RIGHT	C55c.EDF	C55	3
121	7444910	7444972	71743	71805	62	RIGHT	C55c.EDF	C55	3
121	7445410	7445525	72243	72358	115	RIGHT	C55c.EDF	C55	3
121	7456557	7457394	83390	84227	837	RIGHT	C55c.EDF	C55	3
121	7462295	7462311	89128	89144	16	RIGHT	C55c.EDF	C55	3
121	7462404	7462406	89237	89239	2	RIGHT	C55c.EDF	C55	3
121	7477093	7477138	103926	103971	45	RIGHT	C55c.EDF	C55	3
121	7478913	7478976	105746	105809	63	RIGHT	C55c.EDF	C55	3
121	7479337	7479472	106170	106305	135	RIGHT	C55c.EDF	C55	3
121	7480254	7480360	107087	107193	106	RIGHT	C55c.EDF	C55	3
121	7486668	7486722	113501	113555	54	RIGHT	C55c.EDF	C55	3
121	7488402	7488487	115235	115320	85	RIGHT	C55c.EDF	C55	3
121	7506927	7507004	133760	133837	77	RIGHT	C55c.EDF	C55	3
121	7507223	7507270	134056	134103	47	RIGHT	C55c.EDF	C55	3
121	7507408	7507444	134241	134277	36	RIGHT	C55c.EDF	C55	3
121	7507790	7508033	134623	134866	243	RIGHT	C55c.EDF	C55	3
121	7508711	7508847	135544	135680	136	RIGHT	C55c.EDF	C55	3
121	7514673	7514704	141506	141537	31	RIGHT	C55c.EDF	C55	3
121	7534731	7534830	161564	161663	99	RIGHT	C55c.EDF	C55	3
121	7538405	7538483	165238	165316	78	RIGHT	C55c.EDF	C55	3
121	7539906	7540048	166739	166881	142	RIGHT	C55c.EDF	C55	3
121	7559739	7559792	186572	186625	53	RIGHT	C55c.EDF	C55	3
121	7560611	7560677	187444	187510	66	RIGHT	C55c.EDF	C55	3
121	7561832	7561866	188665	188699	34	RIGHT	C55c.EDF	C55	3
121	7588914	7588999	215747	215832	85	RIGHT	C55c.EDF	C55	3
121	7589160	7589259	215993	216092	99	RIGHT	C55c.EDF	C55	3
121	7590680	7590745	217513	217578	65	RIGHT	C55c.EDF	C55	3
121	7591014	7591167	217847	218000	153	RIGHT	C55c.EDF	C55	3
121	7592286	7592350	219119	219183	64	RIGHT	C55c.EDF	C55	3
121	7592807	7592878	219640	219711	71	RIGHT	C55c.EDF	C55	3
121	7593246	7593527	220079	220360	281	RIGHT	C55c.EDF	C55	3
121	7594269	7594338	221102	221171	69	RIGHT	C55c.EDF	C55	3
121	7595637	7595712	222470	222545	75	RIGHT	C55c.EDF	C55	3
121	7595993	7596268	222826	223101	275	RIGHT	C55c.EDF	C55	3
121	7596993	7597109	223826	223942	116	RIGHT	C55c.EDF	C55	3
121	7597471	7597608	224304	224441	137	RIGHT	C55c.EDF	C55	3
121	7597839	7598008	224672	224841	169	RIGHT	C55c.EDF	C55	3
121	7607085	7607103	233918	233936	18	RIGHT	C55c.EDF	C55	3
121	7607261	7607431	234094	234264	170	RIGHT	C55c.EDF	C55	3
121	7607547	7607564	234380	234397	17	RIGHT	C55c.EDF	C55	3
121	7608252	7608337	235085	235170	85	RIGHT	C55c.EDF	C55	3
121	7608883	7608906	235716	235739	23	RIGHT	C55c.EDF	C55	3
121	7609173	7609380	236006	236213	207	RIGHT	C55c.EDF	C55	3
121	7610488	7610537	237321	237370	49	RIGHT	C55c.EDF	C55	3
121	7612114	7612152	238947	238985	38	RIGHT	C55c.EDF	C55	3
121	7649504	7649594	276337	276427	90	RIGHT	C55c.EDF	C55	3
121	7650332	7650430	277165	277263	98	RIGHT	C55c.EDF	C55	3
121	7650971	7651072	277804	277905	101	RIGHT	C55c.EDF	C55	3
121	7651545	7651772	278378	278605	227	RIGHT	C55c.EDF	C55	3
121	7652240	7653147	279073	279980	907	RIGHT	C55c.EDF	C55	3
121	7653927	7656544	280760	283377	2617	RIGHT	C55c.EDF	C55	3
121	7657006	7657049	283839	283882	43	RIGHT	C55c.EDF	C55	3
121	7657077	7663042	283910	289875	5965	RIGHT	C55c.EDF	C55	3
121	7663282	7666546	290115	293379	3264	RIGHT	C55c.EDF	C55	3
121	7666754	7666827	293587	293660	73	RIGHT	C55c.EDF	C55	3
121	7667030	7679098	293863	305931	12068	RIGHT	C55c.EDF	C55	3
121	7679130	7679361	305963	306194	231	RIGHT	C55c.EDF	C55	3
121	7679882	7680176	306715	307009	294	RIGHT	C55c.EDF	C55	3
121	7680540	7680705	307373	307538	165	RIGHT	C55c.EDF	C55	3
121	7680755	7680886	307588	307719	131	RIGHT	C55c.EDF	C55	3
121	7681121	7684624	307954	311457	3503	RIGHT	C55c.EDF	C55	3
121	7684985	7685066	311818	311899	81	RIGHT	C55c.EDF	C55	3
121	7685532	7685642	312365	312475	110	RIGHT	C55c.EDF	C55	3
121	7686307	7686411	313140	313244	104	RIGHT	C55c.EDF	C55	3
121	7689416	7689504	316249	316337	88	RIGHT	C55c.EDF	C55	3
121	7690143	7690274	316976	317107	131	RIGHT	C55c.EDF	C55	3
121	7691312	7691459	318145	318292	147	RIGHT	C55c.EDF	C55	3
121	7692618	7692792	319451	319625	174	RIGHT	C55c.EDF	C55	3
121	7693386	7693528	320219	320361	142	RIGHT	C55c.EDF	C55	3
121	7693553	7693557	320386	320390	4	RIGHT	C55c.EDF	C55	3
121	7694636	7694726	321469	321559	90	RIGHT	C55c.EDF	C55	3
121	7695842	7695913	322675	322746	71	RIGHT	C55c.EDF	C55	3
121	7696444	7696544	323277	323377	100	RIGHT	C55c.EDF	C55	3
121	7697249	7697376	324082	324209	127	RIGHT	C55c.EDF	C55	3
121	7699752	7699841	326585	326674	89	RIGHT	C55c.EDF	C55	3
121	7700398	7700981	327231	327814	583	RIGHT	C55c.EDF	C55	3
121	7711296	7711324	338129	338157	28	RIGHT	C55c.EDF	C55	3
121	7712780	7712866	339613	339699	86	RIGHT	C55c.EDF	C55	3
121	7714513	7714597	341346	341430	84	RIGHT	C55c.EDF	C55	3
121	7717143	7717229	343976	344062	86	RIGHT	C55c.EDF	C55	3
121	7719356	7719443	346189	346276	87	RIGHT	C55c.EDF	C55	3
121	7721847	7722331	348680	349164	484	RIGHT	C55c.EDF	C55	3
121	7722504	7722513	349337	349346	9	RIGHT	C55c.EDF	C55	3
121	7722542	7724313	349375	351146	1771	RIGHT	C55c.EDF	C55	3
121	7725747	7725809	352580	352642	62	RIGHT	C55c.EDF	C55	3
121	7728552	7728636	355385	355469	84	RIGHT	C55c.EDF	C55	3
121	7729449	7729558	356282	356391	109	RIGHT	C55c.EDF	C55	3
121	7729880	7730022	356713	356855	142	RIGHT	C55c.EDF	C55	3
121	7730096	7730266	356929	357099	170	RIGHT	C55c.EDF	C55	3
121	7731987	7732057	358820	358890	70	RIGHT	C55c.EDF	C55	3
121	7732751	7732854	359584	359687	103	RIGHT	C55c.EDF	C55	3
121	7734502	7734584	361335	361417	82	RIGHT	C55c.EDF	C55	3
121	7736307	7736381	363140	363214	74	RIGHT	C55c.EDF	C55	3
121	7740257	7740325	367090	367158	68	RIGHT	C55c.EDF	C55	3
121	7740758	7741304	367591	368137	546	RIGHT	C55c.EDF	C55	3
121	7742583	7742654	369416	369487	71	RIGHT	C55c.EDF	C55	3
121	7743370	7743476	370203	370309	106	RIGHT	C55c.EDF	C55	3
121	7746047	7746126	372880	372959	79	RIGHT	C55c.EDF	C55	3
121	7747627	7747764	374460	374597	137	RIGHT	C55c.EDF	C55	3
121	7748914	7748988	375747	375821	74	RIGHT	C55c.EDF	C55	3
121	7749388	7749488	376221	376321	100	RIGHT	C55c.EDF	C55	3
121	7749776	7749930	376609	376763	154	RIGHT	C55c.EDF	C55	3
121	7753648	7753712	380481	380545	64	RIGHT	C55c.EDF	C55	3
121	7755942	7756015	382775	382848	73	RIGHT	C55c.EDF	C55	3
121	7756932	7757036	383765	383869	104	RIGHT	C55c.EDF	C55	3
121	7758376	7758438	385209	385271	62	RIGHT	C55c.EDF	C55	3
121	7765167	7765250	392000	392083	83	RIGHT	C55c.EDF	C55	3
121	7766569	7767008	393402	393841	439	RIGHT	C55c.EDF	C55	3
121	7767838	7767928	394671	394761	90	RIGHT	C55c.EDF	C55	3
121	7770724	7770851	397557	397684	127	RIGHT	C55c.EDF	C55	3
121	7772853	7772912	399686	399745	59	RIGHT	C55c.EDF	C55	3
121	7775744	7775800	402577	402633	56	RIGHT	C55c.EDF	C55	3
121	7779076	7779076	405909	405909	0	RIGHT	C55c.EDF	C55	3
121	7780553	7780592	407386	407425	39	RIGHT	C55c.EDF	C55	3
121	7781914	7781992	408747	408825	78	RIGHT	C55c.EDF	C55	3
121	7787937	7788006	414770	414839	69	RIGHT	C55c.EDF	C55	3
121	7788161	7788290	414994	415123	129	RIGHT	C55c.EDF	C55	3
121	7789262	7789421	416095	416254	159	RIGHT	C55c.EDF	C55	3
121	7789936	7790089	416769	416922	153	RIGHT	C55c.EDF	C55	3
121	7790641	7790773	417474	417606	132	RIGHT	C55c.EDF	C55	3
121	7801719	7801793	428552	428626	74	RIGHT	C55c.EDF	C55	3
121	7804564	7804603	431397	431436	39	RIGHT	C55c.EDF	C55	3
121	7805866	7805934	432699	432767	68	RIGHT	C55c.EDF	C55	3
121	7808875	7808934	435708	435767	59	RIGHT	C55c.EDF	C55	3
121	7811113	7811187	437946	438020	74	RIGHT	C55c.EDF	C55	3
121	7813980	7814045	440813	440878	65	RIGHT	C55c.EDF	C55	3
121	7814976	7815057	441809	441890	81	RIGHT	C55c.EDF	C55	3
121	7816057	7816190	442890	443023	133	RIGHT	C55c.EDF	C55	3
121	7816311	7816446	443144	443279	135	RIGHT	C55c.EDF	C55	3
121	7819187	7819748	446020	446581	561	RIGHT	C55c.EDF	C55	3
121	7820252	7821097	447085	447930	845	RIGHT	C55c.EDF	C55	3
121	7822037	7822120	448870	448953	83	RIGHT	C55c.EDF	C55	3
121	7825474	7825525	452307	452358	51	RIGHT	C55c.EDF	C55	3
121	7829105	7829186	455938	456019	81	RIGHT	C55c.EDF	C55	3
121	7829291	7829716	456124	456549	425	RIGHT	C55c.EDF	C55	3
121	7829875	7830242	456708	457075	367	RIGHT	C55c.EDF	C55	3
121	7830974	7831066	457807	457899	92	RIGHT	C55c.EDF	C55	3
121	7831666	7832033	458499	458866	367	RIGHT	C55c.EDF	C55	3
121	7832939	7833016	459772	459849	77	RIGHT	C55c.EDF	C55	3
121	7833793	7833892	460626	460725	99	RIGHT	C55c.EDF	C55	3
121	7834675	7834797	461508	461630	122	RIGHT	C55c.EDF	C55	3
121	7835856	7835940	462689	462773	84	RIGHT	C55c.EDF	C55	3
121	7838116	7838216	464949	465049	100	RIGHT	C55c.EDF	C55	3
121	7839270	7839366	466103	466199	96	RIGHT	C55c.EDF	C55	3
121	7839400	7839403	466233	466236	3	RIGHT	C55c.EDF	C55	3
121	7843446	7843486	470279	470319	40	RIGHT	C55c.EDF	C55	3
121	7846034	7846071	472867	472904	37	RIGHT	C55c.EDF	C55	3
121	7846653	7846749	473486	473582	96	RIGHT	C55c.EDF	C55	3
121	7847045	7847215	473878	474048	170	RIGHT	C55c.EDF	C55	3
121	7847393	7847521	474226	474354	128	RIGHT	C55c.EDF	C55	3
121	7847664	7847959	474497	474792	295	RIGHT	C55c.EDF	C55	3
121	7848826	7848959	475659	475792	133	RIGHT	C55c.EDF	C55	3
121	7849430	7849592	476263	476425	162	RIGHT	C55c.EDF	C55	3
121	7850835	7850973	477668	477806	138	RIGHT	C55c.EDF	C55	3
121	7852297	7852405	479130	479238	108	RIGHT	C55c.EDF	C55	3
121	7853152	7853264	479985	480097	112	RIGHT	C55c.EDF	C55	3
121	7854290	7854408	481123	481241	118	RIGHT	C55c.EDF	C55	3
121	7855370	7855475	482203	482308	105	RIGHT	C55c.EDF	C55	3
121	7856563	7856672	483396	483505	109	RIGHT	C55c.EDF	C55	3
121	7857535	7857662	484368	484495	127	RIGHT	C55c.EDF	C55	3
121	7858633	7858754	485466	485587	121	RIGHT	C55c.EDF	C55	3
121	7861493	7861569	488326	488402	76	RIGHT	C55c.EDF	C55	3
121	7867692	7867784	494525	494617	92	RIGHT	C55c.EDF	C55	3
121	7869608	7869698	496441	496531	90	RIGHT	C55c.EDF	C55	3
121	7871983	7872086	498816	498919	103	RIGHT	C55c.EDF	C55	3
121	7872785	7872891	499618	499724	106	RIGHT	C55c.EDF	C55	3
121	7875924	7876041	502757	502874	117	RIGHT	C55c.EDF	C55	3
121	7876077	7876160	502910	502993	83	RIGHT	C55c.EDF	C55	3
121	7876887	7877108	503720	503941	221	RIGHT	C55c.EDF	C55	3
121	7877133	7877144	503966	503977	11	RIGHT	C55c.EDF	C55	3
121	7879914	7879990	506747	506823	76	RIGHT	C55c.EDF	C55	3
121	7880570	7880690	507403	507523	120	RIGHT	C55c.EDF	C55	3
121	7886278	7886312	513111	513145	34	RIGHT	C55c.EDF	C55	3
121	7886530	7886652	513363	513485	122	RIGHT	C55c.EDF	C55	3
121	7887805	7888135	514638	514968	330	RIGHT	C55c.EDF	C55	3
121	7888950	7889072	515783	515905	122	RIGHT	C55c.EDF	C55	3
121	7890550	7890616	517383	517449	66	RIGHT	C55c.EDF	C55	3
121	7890964	7891043	517797	517876	79	RIGHT	C55c.EDF	C55	3
121	7893846	7893927	520679	520760	81	RIGHT	C55c.EDF	C55	3
121	7897748	7897816	524581	524649	68	RIGHT	C55c.EDF	C55	3
121	7899770	7899830	526603	526663	60	RIGHT	C55c.EDF	C55	3
121	7900054	7900340	526887	527173	286	RIGHT	C55c.EDF	C55	3
121	7902049	7902126	528882	528959	77	RIGHT	C55c.EDF	C55	3
121	7903110	7903241	529943	530074	131	RIGHT	C55c.EDF	C55	3
121	7904379	7904494	531212	531327	115	RIGHT	C55c.EDF	C55	3
121	7904835	7904935	531668	531768	100	RIGHT	C55c.EDF	C55	3
121	7906008	7906074	532841	532907	66	RIGHT	C55c.EDF	C55	3
121	7906109	7906109	532942	532942	0	RIGHT	C55c.EDF	C55	3
121	7907779	7907904	534612	534737	125	RIGHT	C55c.EDF	C55	3
121	7911469	7911519	538302	538352	50	RIGHT	C55c.EDF	C55	3
121	7912481	7912570	539314	539403	89	RIGHT	C55c.EDF	C55	3
121	7914579	7914760	541412	541593	181	RIGHT	C55c.EDF	C55	3
121	7915681	7915709	542514	542542	28	RIGHT	C55c.EDF	C55	3
121	7918750	7918991	545583	545824	241	RIGHT	C55c.EDF	C55	3
121	7924422	7924465	551255	551298	43	RIGHT	C55c.EDF	C55	3
121	7926005	7926132	552838	552965	127	RIGHT	C55c.EDF	C55	3
121	7926948	7927021	553781	553854	73	RIGHT	C55c.EDF	C55	3
121	7927750	7927835	554583	554668	85	RIGHT	C55c.EDF	C55	3
121	7927863	7927864	554696	554697	1	RIGHT	C55c.EDF	C55	3
121	7929013	7929132	555846	555965	119	RIGHT	C55c.EDF	C55	3
121	7934600	7934677	561433	561510	77	RIGHT	C55c.EDF	C55	3
121	7935327	7935459	562160	562292	132	RIGHT	C55c.EDF	C55	3
121	7936146	7936268	562979	563101	122	RIGHT	C55c.EDF	C55	3
121	7937933	7938058	564766	564891	125	RIGHT	C55c.EDF	C55	3
121	7940286	7940413	567119	567246	127	RIGHT	C55c.EDF	C55	3
121	7942040	7942145	568873	568978	105	RIGHT	C55c.EDF	C55	3
121	7948520	7948608	575353	575441	88	RIGHT	C55c.EDF	C55	3
121	7948885	7949012	575718	575845	127	RIGHT	C55c.EDF	C55	3
121	7953323	7953460	580156	580293	137	RIGHT	C55c.EDF	C55	3
121	7953934	7953984	580767	580817	50	RIGHT	C55c.EDF	C55	3
121	7954564	7954658	581397	581491	94	RIGHT	C55c.EDF	C55	3
121	7957154	7957298	583987	584131	144	RIGHT	C55c.EDF	C55	3
121	7957626	7957768	584459	584601	142	RIGHT	C55c.EDF	C55	3
121	7957926	7958274	584759	585107	348	RIGHT	C55c.EDF	C55	3
121	7960345	7960426	587178	587259	81	RIGHT	C55c.EDF	C55	3
121	7969439	7969458	596272	596291	19	RIGHT	C55c.EDF	C55	3
121	7969507	7969528	596340	596361	21	RIGHT	C55c.EDF	C55	3
121	7970256	7970339	597089	597172	83	RIGHT	C55c.EDF	C55	3
121	7970563	7970699	597396	597532	136	RIGHT	C55c.EDF	C55	3
121	7971743	7971878	598576	598711	135	RIGHT	C55c.EDF	C55	3
121	7972968	7973111	599801	599944	143	RIGHT	C55c.EDF	C55	3
121	7974294	7974455	601127	601288	161	RIGHT	C55c.EDF	C55	3
121	7974931	7975298	601764	602131	367	RIGHT	C55c.EDF	C55	3
121	7978313	7978496	605146	605329	183	RIGHT	C55c.EDF	C55	3
121	7981296	7981581	608129	608414	285	RIGHT	C55c.EDF	C55	3
121	7983905	7984044	610738	610877	139	RIGHT	C55c.EDF	C55	3
121	7986990	7987142	613823	613975	152	RIGHT	C55c.EDF	C55	3
121	7987791	7987967	614624	614800	176	RIGHT	C55c.EDF	C55	3
121	7988877	7989015	615710	615848	138	RIGHT	C55c.EDF	C55	3
121	7990764	7990921	617597	617754	157	RIGHT	C55c.EDF	C55	3
121	7993156	7993300	619989	620133	144	RIGHT	C55c.EDF	C55	3
121	7994790	7994923	621623	621756	133	RIGHT	C55c.EDF	C55	3
121	7996804	7997133	623637	623966	329	RIGHT	C55c.EDF	C55	3
121	7998967	7999134	625800	625967	167	RIGHT	C55c.EDF	C55	3
121	8001191	8001294	628024	628127	103	RIGHT	C55c.EDF	C55	3
121	8003332	8003481	630165	630314	149	RIGHT	C55c.EDF	C55	3
121	8004601	8004710	631434	631543	109	RIGHT	C55c.EDF	C55	3
121	8005021	8005171	631854	632004	150	RIGHT	C55c.EDF	C55	3
121	8006965	8007021	633798	633854	56	RIGHT	C55c.EDF	C55	3
121	8008659	8008674	635492	635507	15	RIGHT	C55c.EDF	C55	3
121	8008721	8008738	635554	635571	17	RIGHT	C55c.EDF	C55	3
121	8009471	8009630	636304	636463	159	RIGHT	C55c.EDF	C55	3
121	8009834	8010018	636667	636851	184	RIGHT	C55c.EDF	C55	3
121	8010876	8011038	637709	637871	162	RIGHT	C55c.EDF	C55	3
121	8011062	8011300	637895	638133	238	RIGHT	C55c.EDF	C55	3
121	8015156	8015180	641989	642013	24	RIGHT	C55c.EDF	C55	3
121	8015202	8015235	642035	642068	33	RIGHT	C55c.EDF	C55	3
121	8017368	8017426	644201	644259	58	RIGHT	C55c.EDF	C55	3
121	8019164	8019529	645997	646362	365	RIGHT	C55c.EDF	C55	3
121	8022201	8022237	649034	649070	36	RIGHT	C55c.EDF	C55	3
121	8022265	8022289	649098	649122	24	RIGHT	C55c.EDF	C55	3
121	8024918	8025144	651751	651977	226	RIGHT	C55c.EDF	C55	3
121	8028748	8028824	655581	655657	76	RIGHT	C55c.EDF	C55	3
121	8029175	8029321	656008	656154	146	RIGHT	C55c.EDF	C55	3
121	8029509	8029654	656342	656487	145	RIGHT	C55c.EDF	C55	3
121	8030107	8030276	656940	657109	169	RIGHT	C55c.EDF	C55	3
121	8030806	8031125	657639	657958	319	RIGHT	C55c.EDF	C55	3
121	8032496	8032651	659329	659484	155	RIGHT	C55c.EDF	C55	3
121	8033743	8033890	660576	660723	147	RIGHT	C55c.EDF	C55	3
121	8034385	8034572	661218	661405	187	RIGHT	C55c.EDF	C55	3
121	8035136	8035592	661969	662425	456	RIGHT	C55c.EDF	C55	3
121	8037191	8037345	664024	664178	154	RIGHT	C55c.EDF	C55	3
121	8038429	8038573	665262	665406	144	RIGHT	C55c.EDF	C55	3
121	8050595	8050664	677428	677497	69	RIGHT	C55c.EDF	C55	3
121	8052026	8052135	678859	678968	109	RIGHT	C55c.EDF	C55	3
121	8053901	8054043	680734	680876	142	RIGHT	C55c.EDF	C55	3
121	8056267	8056438	683100	683271	171	RIGHT	C55c.EDF	C55	3
121	8058349	8058495	685182	685328	146	RIGHT	C55c.EDF	C55	3
121	8060411	8060515	687244	687348	104	RIGHT	C55c.EDF	C55	3
121	8060538	8060700	687371	687533	162	RIGHT	C55c.EDF	C55	3
121	8062943	8063171	689776	690004	228	RIGHT	C55c.EDF	C55	3
121	8065433	8065773	692266	692606	340	RIGHT	C55c.EDF	C55	3
121	8067922	8068146	694755	694979	224	RIGHT	C55c.EDF	C55	3
121	8070041	8070252	696874	697085	211	RIGHT	C55c.EDF	C55	3
121	8072200	8072430	699033	699263	230	RIGHT	C55c.EDF	C55	3
121	8074287	8074465	701120	701298	178	RIGHT	C55c.EDF	C55	3
121	8076705	8076922	703538	703755	217	RIGHT	C55c.EDF	C55	3
121	8077163	8077500	703996	704333	337	RIGHT	C55c.EDF	C55	3
121	8080486	8080634	707319	707467	148	RIGHT	C55c.EDF	C55	3
121	8085131	8085224	711964	712057	93	RIGHT	C55c.EDF	C55	3
121	8085888	8086025	712721	712858	137	RIGHT	C55c.EDF	C55	3
121	8086459	8086730	713292	713563	271	RIGHT	C55c.EDF	C55	3
121	8087258	8087432	714091	714265	174	RIGHT	C55c.EDF	C55	3
121	8087613	8087908	714446	714741	295	RIGHT	C55c.EDF	C55	3
121	8088507	8088736	715340	715569	229	RIGHT	C55c.EDF	C55	3
121	8089017	8089224	715850	716057	207	RIGHT	C55c.EDF	C55	3
121	8090877	8091027	717710	717860	150	RIGHT	C55c.EDF	C55	3
121	8091675	8092145	718508	718978	470	RIGHT	C55c.EDF	C55	3
121	8092691	8092840	719524	719673	149	RIGHT	C55c.EDF	C55	3
121	8093871	8094127	720704	720960	256	RIGHT	C55c.EDF	C55	3
121	8094270	8094288	721103	721121	18	RIGHT	C55c.EDF	C55	3
121	8094337	8094364	721170	721197	27	RIGHT	C55c.EDF	C55	3
121	8095717	8095982	722550	722815	265	RIGHT	C55c.EDF	C55	3
121	8097784	8098016	724617	724849	232	RIGHT	C55c.EDF	C55	3
121	8098894	8099138	725727	725971	244	RIGHT	C55c.EDF	C55	3
121	8100195	8100383	727028	727216	188	RIGHT	C55c.EDF	C55	3
121	8102120	8102368	728953	729201	248	RIGHT	C55c.EDF	C55	3
121	8104961	8105090	731794	731923	129	RIGHT	C55c.EDF	C55	3
121	8108653	8108784	735486	735617	131	RIGHT	C55c.EDF	C55	3
121	8110348	8110474	737181	737307	126	RIGHT	C55c.EDF	C55	3
121	8116373	8116511	743206	743344	138	RIGHT	C55c.EDF	C55	3
121	8117368	8117531	744201	744364	163	RIGHT	C55c.EDF	C55	3
121	8118394	8118546	745227	745379	152	RIGHT	C55c.EDF	C55	3
121	8119368	8119620	746201	746453	252	RIGHT	C55c.EDF	C55	3
121	8120969	8121188	747802	748021	219	RIGHT	C55c.EDF	C55	3
121	8123763	8123971	750596	750804	208	RIGHT	C55c.EDF	C55	3
121	8127386	8127570	754219	754403	184	RIGHT	C55c.EDF	C55	3
121	8130000	8130521	756833	757354	521	RIGHT	C55c.EDF	C55	3
121	8132086	8132317	758919	759150	231	RIGHT	C55c.EDF	C55	3
121	8137311	8137531	764144	764364	220	RIGHT	C55c.EDF	C55	3
121	8141121	8141274	767954	768107	153	RIGHT	C55c.EDF	C55	3
121	8142981	8143545	769814	770378	564	RIGHT	C55c.EDF	C55	3
121	8143916	8144113	770749	770946	197	RIGHT	C55c.EDF	C55	3
121	8145499	8145756	772332	772589	257	RIGHT	C55c.EDF	C55	3
121	8147379	8147731	774212	774564	352	RIGHT	C55c.EDF	C55	3
121	8149388	8149531	776221	776364	143	RIGHT	C55c.EDF	C55	3
121	8152627	8152781	779460	779614	154	RIGHT	C55c.EDF	C55	3
121	8157562	8157573	784395	784406	11	RIGHT	C55c.EDF	C55	3
121	8157778	8158068	784611	784901	290	RIGHT	C55c.EDF	C55	3
121	8158185	8158352	785018	785185	167	RIGHT	C55c.EDF	C55	3
121	8158375	8158687	785208	785520	312	RIGHT	C55c.EDF	C55	3
121	8159325	8283688	786158	910521	124363	RIGHT	C55c.EDF	C55	3
2	1356382	1356463	58	139	81	LEFT	C65a.EDF	C65	1
2	1357776	1357839	1452	1515	63	LEFT	C65a.EDF	C65	1
3	1365787	1365874	1071	1158	87	LEFT	C65a.EDF	C65	1
4	1372450	1372584	96	230	134	LEFT	C65a.EDF	C65	1
4	1373188	1373275	834	921	87	LEFT	C65a.EDF	C65	1
4	1373820	1373891	1466	1537	71	LEFT	C65a.EDF	C65	1
5	1381963	1381976	70	83	13	LEFT	C65a.EDF	C65	1
5	1382406	1382513	513	620	107	LEFT	C65a.EDF	C65	1
7	1397767	1397791	740	764	24	LEFT	C65a.EDF	C65	1
7	1397815	1397847	788	820	32	LEFT	C65a.EDF	C65	1
9	1414507	1414513	947	953	6	LEFT	C65a.EDF	C65	1
9	1414557	1414571	997	1011	14	LEFT	C65a.EDF	C65	1
10	1422864	1422953	58	147	89	LEFT	C65a.EDF	C65	1
12	1439783	1439895	430	542	112	LEFT	C65a.EDF	C65	1
12	1439928	1439929	575	576	1	LEFT	C65a.EDF	C65	1
13	1448933	1448938	80	85	5	LEFT	C65a.EDF	C65	1
14	1458180	1458311	522	653	131	LEFT	C65a.EDF	C65	1
15	1467419	1467514	58	153	95	LEFT	C65a.EDF	C65	1
15	1468018	1468070	657	709	52	LEFT	C65a.EDF	C65	1
15	1468097	1468111	736	750	14	LEFT	C65a.EDF	C65	1
18	1492454	1492541	1115	1202	87	LEFT	C65a.EDF	C65	1
19	1500914	1501027	639	752	113	LEFT	C65a.EDF	C65	1
20	1509396	1509497	557	658	101	LEFT	C65a.EDF	C65	1
22	1526015	1526177	649	811	162	LEFT	C65a.EDF	C65	1
23	1536417	1536468	59	110	51	LEFT	C65a.EDF	C65	1
23	1536799	1536921	441	563	122	LEFT	C65a.EDF	C65	1
24	1546147	1546265	468	586	118	LEFT	C65a.EDF	C65	1
25	1555056	1555162	1032	1138	106	LEFT	C65a.EDF	C65	1
26	1562147	1562258	749	860	111	LEFT	C65a.EDF	C65	1
28	1579112	1579167	58	113	55	LEFT	C65a.EDF	C65	1
28	1579632	1579771	578	717	139	LEFT	C65a.EDF	C65	1
30	1596067	1596136	58	127	69	LEFT	C65a.EDF	C65	1
30	1596528	1596655	519	646	127	LEFT	C65a.EDF	C65	1
30	1598783	1598856	2774	2847	73	LEFT	C65a.EDF	C65	1
32	1612769	1612951	373	555	182	LEFT	C65a.EDF	C65	1
33	1622042	1622119	116	193	77	LEFT	C65a.EDF	C65	1
33	1622411	1622505	485	579	94	LEFT	C65a.EDF	C65	1
33	1624526	1624534	2600	2608	8	LEFT	C65a.EDF	C65	1
33	1624557	1624607	2631	2681	50	LEFT	C65a.EDF	C65	1
33	1625494	1625511	3568	3585	17	LEFT	C65a.EDF	C65	1
33	1625551	1625584	3625	3658	33	LEFT	C65a.EDF	C65	1
34	1631206	1631309	385	488	103	LEFT	C65a.EDF	C65	1
34	1631620	1631716	799	895	96	LEFT	C65a.EDF	C65	1
35	1639885	1639987	227	329	102	LEFT	C65a.EDF	C65	1
35	1640459	1640519	801	861	60	LEFT	C65a.EDF	C65	1
36	1648108	1648172	767	831	64	LEFT	C65a.EDF	C65	1
37	1656193	1656298	540	645	105	LEFT	C65a.EDF	C65	1
39	1671786	1671831	340	385	45	LEFT	C65a.EDF	C65	1
39	1671852	1671896	406	450	44	LEFT	C65a.EDF	C65	1
39	1672172	1672280	726	834	108	LEFT	C65a.EDF	C65	1
39	1672791	1672801	1345	1355	10	LEFT	C65a.EDF	C65	1
39	1672847	1672883	1401	1437	36	LEFT	C65a.EDF	C65	1
40	1680358	1680446	480	568	88	LEFT	C65a.EDF	C65	1
41	1688479	1688562	532	615	83	LEFT	C65a.EDF	C65	1
42	1697377	1697443	775	841	66	LEFT	C65a.EDF	C65	1
43	1705865	1705931	298	364	66	LEFT	C65a.EDF	C65	1
44	1713983	1714060	111	188	77	LEFT	C65a.EDF	C65	1
44	1714501	1714604	629	732	103	LEFT	C65a.EDF	C65	1
44	1717944	1718052	4072	4180	108	LEFT	C65a.EDF	C65	1
46	1730810	1730922	426	538	112	LEFT	C65a.EDF	C65	1
47	1738697	1738776	475	554	79	LEFT	C65a.EDF	C65	1
48	1745150	1745211	57	118	61	LEFT	C65a.EDF	C65	1
48	1745697	1745901	604	808	204	LEFT	C65a.EDF	C65	1
49	1752546	1752593	131	178	47	LEFT	C65a.EDF	C65	1
49	1757701	1757795	5286	5380	94	LEFT	C65a.EDF	C65	1
50	1761103	1761195	731	823	92	LEFT	C65a.EDF	C65	1
51	1769926	1770036	559	669	110	LEFT	C65a.EDF	C65	1
52	1778317	1778449	210	342	132	LEFT	C65a.EDF	C65	1
52	1778834	1778957	727	850	123	LEFT	C65a.EDF	C65	1
52	1779964	1780050	1857	1943	86	LEFT	C65a.EDF	C65	1
53	1787246	1787355	547	656	109	LEFT	C65a.EDF	C65	1
54	1795552	1795705	90	243	153	LEFT	C65a.EDF	C65	1
54	1796064	1796157	602	695	93	LEFT	C65a.EDF	C65	1
54	1801016	1801115	5554	5653	99	LEFT	C65a.EDF	C65	1
55	1804845	1804931	207	293	86	LEFT	C65a.EDF	C65	1
56	1812400	1812558	228	386	158	LEFT	C65a.EDF	C65	1
57	1821050	1821128	582	660	78	LEFT	C65a.EDF	C65	1
57	1822294	1822311	1826	1843	17	LEFT	C65a.EDF	C65	1
57	1822336	1822358	1868	1890	22	LEFT	C65a.EDF	C65	1
58	1831072	1831197	588	713	125	LEFT	C65a.EDF	C65	1
59	1839388	1839426	724	762	38	LEFT	C65a.EDF	C65	1
59	1839448	1839466	784	802	18	LEFT	C65a.EDF	C65	1
59	1845599	1845616	6935	6952	17	LEFT	C65a.EDF	C65	1
60	1847862	1847912	57	107	50	LEFT	C65a.EDF	C65	1
60	1848353	1848459	548	654	106	LEFT	C65a.EDF	C65	1
60	1850764	1850852	2959	3047	88	LEFT	C65a.EDF	C65	1
61	1855690	1855694	540	544	4	LEFT	C65a.EDF	C65	1
61	1855738	1855772	588	622	34	LEFT	C65a.EDF	C65	1
62	1863511	1863620	58	167	109	LEFT	C65a.EDF	C65	1
63	1872340	1872349	67	76	9	LEFT	C65a.EDF	C65	1
63	1872942	1873036	669	763	94	LEFT	C65a.EDF	C65	1
64	1881758	1881781	58	81	23	LEFT	C65a.EDF	C65	1
64	1882236	1882337	536	637	101	LEFT	C65a.EDF	C65	1
69	1921059	1921175	667	783	116	LEFT	C65a.EDF	C65	1
72	1942479	1942498	156	175	19	LEFT	C65a.EDF	C65	1
72	1942539	1942577	216	254	38	LEFT	C65a.EDF	C65	1
73	1952263	1952324	504	565	61	LEFT	C65a.EDF	C65	1
73	1952348	1952379	589	620	31	LEFT	C65a.EDF	C65	1
73	1956680	1956698	4921	4939	18	LEFT	C65a.EDF	C65	1
75	1968501	1968542	80	121	41	LEFT	C65a.EDF	C65	1
75	1968963	1969113	542	692	150	LEFT	C65a.EDF	C65	1
75	1969141	1969144	720	723	3	LEFT	C65a.EDF	C65	1
77	1985300	1985381	498	579	81	LEFT	C65a.EDF	C65	1
79	2002467	2002569	516	618	102	LEFT	C65a.EDF	C65	1
80	2011433	2011532	473	572	99	LEFT	C65a.EDF	C65	1
81	2019190	2019251	539	600	61	LEFT	C65a.EDF	C65	1
83	2035337	2035456	463	582	119	LEFT	C65a.EDF	C65	1
84	2042532	2042610	428	506	78	LEFT	C65a.EDF	C65	1
85	2049132	2049213	414	495	81	LEFT	C65a.EDF	C65	1
86	2061685	2061764	6232	6311	79	LEFT	C65a.EDF	C65	1
87	2064686	2064749	116	179	63	LEFT	C65a.EDF	C65	1
87	2064771	2064806	201	236	35	LEFT	C65a.EDF	C65	1
87	2065161	2065258	591	688	97	LEFT	C65a.EDF	C65	1
88	2073769	2073890	271	392	121	LEFT	C65a.EDF	C65	1
89	2081421	2081514	271	364	93	LEFT	C65a.EDF	C65	1
90	2089474	2089509	441	476	35	LEFT	C65a.EDF	C65	1
90	2089533	2089573	500	540	40	LEFT	C65a.EDF	C65	1
91	2096867	2096912	57	102	45	LEFT	C65a.EDF	C65	1
91	2096936	2096936	126	126	0	LEFT	C65a.EDF	C65	1
91	2097337	2097448	527	638	111	LEFT	C65a.EDF	C65	1
92	2106348	2106364	714	730	16	LEFT	C65a.EDF	C65	1
92	2106407	2106445	773	811	38	LEFT	C65a.EDF	C65	1
93	2113387	2113518	207	338	131	LEFT	C65a.EDF	C65	1
94	2122404	2122520	268	384	116	LEFT	C65a.EDF	C65	1
95	2130343	2130354	590	601	11	LEFT	C65a.EDF	C65	1
95	2130377	2130398	624	645	21	LEFT	C65a.EDF	C65	1
96	2138802	2138822	347	367	20	LEFT	C65a.EDF	C65	1
96	2138853	2138903	398	448	50	LEFT	C65a.EDF	C65	1
97	2146628	2146746	509	627	118	LEFT	C65a.EDF	C65	1
99	2162956	2162997	537	578	41	LEFT	C65a.EDF	C65	1
99	2163021	2163055	602	636	34	LEFT	C65a.EDF	C65	1
99	2164303	2164317	1884	1898	14	LEFT	C65a.EDF	C65	1
100	2169523	2169544	215	236	21	LEFT	C65a.EDF	C65	1
100	2169565	2169611	257	303	46	LEFT	C65a.EDF	C65	1
100	2175331	2175370	6023	6062	39	LEFT	C65a.EDF	C65	1
102	2188348	2188423	640	715	75	LEFT	C65a.EDF	C65	1
103	2195505	2195632	264	391	127	LEFT	C65a.EDF	C65	1
103	2195984	2196006	743	765	22	LEFT	C65a.EDF	C65	1
103	2196055	2196092	814	851	37	LEFT	C65a.EDF	C65	1
104	2208012	2208083	4759	4830	71	LEFT	C65a.EDF	C65	1
105	2210451	2210585	204	338	134	LEFT	C65a.EDF	C65	1
106	2217587	2217691	58	162	104	LEFT	C65a.EDF	C65	1
106	2218185	2218290	656	761	105	LEFT	C65a.EDF	C65	1
107	2226395	2226497	506	608	102	LEFT	C65a.EDF	C65	1
108	2234999	2235111	546	658	112	LEFT	C65a.EDF	C65	1
109	2242105	2242225	527	647	120	LEFT	C65a.EDF	C65	1
110	2251392	2251488	69	165	96	LEFT	C65a.EDF	C65	1
110	2251796	2251903	473	580	107	LEFT	C65a.EDF	C65	1
111	2261021	2261090	57	126	69	LEFT	C65a.EDF	C65	1
111	2261535	2261542	571	578	7	LEFT	C65a.EDF	C65	1
111	2261570	2261596	606	632	26	LEFT	C65a.EDF	C65	1
112	2270017	2270108	57	148	91	LEFT	C65a.EDF	C65	1
112	2270397	2270437	437	477	40	LEFT	C65a.EDF	C65	1
112	2270460	2270502	500	542	42	LEFT	C65a.EDF	C65	1
113	2280760	2280814	1869	1923	54	LEFT	C65a.EDF	C65	1
114	2286827	2286862	582	617	35	LEFT	C65a.EDF	C65	1
114	2286883	2286931	638	686	48	LEFT	C65a.EDF	C65	1
115	2293730	2293831	311	412	101	LEFT	C65a.EDF	C65	1
116	2302184	2302273	519	608	89	LEFT	C65a.EDF	C65	1
117	2310219	2310341	598	720	122	LEFT	C65a.EDF	C65	1
118	2317275	2317348	271	344	73	LEFT	C65a.EDF	C65	1
2	3186581	3186651	703	773	70	LEFT	C65b.EDF	C65	2
3	3193471	3193542	459	530	71	LEFT	C65b.EDF	C65	2
4	3200697	3200805	367	475	108	LEFT	C65b.EDF	C65	2
5	3209792	3209883	58	149	91	LEFT	C65b.EDF	C65	2
5	3210212	3210390	478	656	178	LEFT	C65b.EDF	C65	2
5	3210761	3210864	1027	1130	103	LEFT	C65b.EDF	C65	2
6	3217418	3217475	57	114	57	LEFT	C65b.EDF	C65	2
6	3218068	3218127	707	766	59	LEFT	C65b.EDF	C65	2
8	3235543	3235650	482	589	107	LEFT	C65b.EDF	C65	2
9	3243022	3243051	58	87	29	LEFT	C65b.EDF	C65	2
9	3243651	3243769	687	805	118	LEFT	C65b.EDF	C65	2
10	3251220	3251369	350	499	149	LEFT	C65b.EDF	C65	2
11	3258825	3258890	57	122	65	LEFT	C65b.EDF	C65	2
12	3267963	3268118	545	700	155	LEFT	C65b.EDF	C65	2
12	3269353	3269356	1935	1938	3	LEFT	C65b.EDF	C65	2
13	3276446	3276552	471	577	106	LEFT	C65b.EDF	C65	2
14	3285384	3285461	664	741	77	LEFT	C65b.EDF	C65	2
14	3288510	3288596	3790	3876	86	LEFT	C65b.EDF	C65	2
15	3292165	3292285	513	633	120	LEFT	C65b.EDF	C65	2
15	3297179	3297180	5527	5528	1	LEFT	C65b.EDF	C65	2
16	3300261	3300280	58	77	19	LEFT	C65b.EDF	C65	2
16	3306518	3306555	6315	6352	37	LEFT	C65b.EDF	C65	2
17	3309122	3309231	57	166	109	LEFT	C65b.EDF	C65	2
17	3309837	3309921	772	856	84	LEFT	C65b.EDF	C65	2
18	3319127	3319222	477	572	95	LEFT	C65b.EDF	C65	2
19	3326712	3326782	58	128	70	LEFT	C65b.EDF	C65	2
19	3327367	3327432	713	778	65	LEFT	C65b.EDF	C65	2
19	3331542	3331636	4888	4982	94	LEFT	C65b.EDF	C65	2
20	3336384	3336497	493	606	113	LEFT	C65b.EDF	C65	2
21	3346446	3346525	1101	1180	79	LEFT	C65b.EDF	C65	2
22	3354179	3354246	58	125	67	LEFT	C65b.EDF	C65	2
22	3354631	3354733	510	612	102	LEFT	C65b.EDF	C65	2
23	3362862	3362915	558	611	53	LEFT	C65b.EDF	C65	2
24	3370139	3370180	57	98	41	LEFT	C65b.EDF	C65	2
25	3377934	3378010	58	134	76	LEFT	C65b.EDF	C65	2
28	3402833	3402863	58	88	30	LEFT	C65b.EDF	C65	2
28	3403320	3403426	545	651	106	LEFT	C65b.EDF	C65	2
30	3419666	3419671	74	79	5	LEFT	C65b.EDF	C65	2
30	3420130	3420217	538	625	87	LEFT	C65b.EDF	C65	2
31	3428855	3428905	480	530	50	LEFT	C65b.EDF	C65	2
33	3447201	3447300	602	701	99	LEFT	C65b.EDF	C65	2
35	3463902	3463943	58	99	41	LEFT	C65b.EDF	C65	2
35	3464730	3464789	886	945	59	LEFT	C65b.EDF	C65	2
36	3473286	3473394	297	405	108	LEFT	C65b.EDF	C65	2
37	3481265	3481337	463	535	72	LEFT	C65b.EDF	C65	2
38	3490144	3490220	249	325	76	LEFT	C65b.EDF	C65	2
39	3499472	3499529	571	628	57	LEFT	C65b.EDF	C65	2
40	3512763	3512811	5431	5479	48	LEFT	C65b.EDF	C65	2
41	3515067	3515094	58	85	27	LEFT	C65b.EDF	C65	2
41	3515562	3515639	553	630	77	LEFT	C65b.EDF	C65	2
42	3523863	3523953	358	448	90	LEFT	C65b.EDF	C65	2
42	3524313	3524402	808	897	89	LEFT	C65b.EDF	C65	2
42	3527735	3527767	4230	4262	32	LEFT	C65b.EDF	C65	2
43	3531361	3531417	762	818	56	LEFT	C65b.EDF	C65	2
44	3539071	3539139	527	595	68	LEFT	C65b.EDF	C65	2
49	3581035	3581145	404	514	110	LEFT	C65b.EDF	C65	2
50	3588033	3588099	58	124	66	LEFT	C65b.EDF	C65	2
52	3604404	3604476	57	129	72	LEFT	C65b.EDF	C65	2
53	3612541	3612598	58	115	57	LEFT	C65b.EDF	C65	2
54	3621173	3621249	568	644	76	LEFT	C65b.EDF	C65	2
56	3638320	3638422	365	467	102	LEFT	C65b.EDF	C65	2
59	3661223	3661269	57	103	46	LEFT	C65b.EDF	C65	2
59	3661648	3661760	482	594	112	LEFT	C65b.EDF	C65	2
61	3676591	3676698	58	165	107	LEFT	C65b.EDF	C65	2
61	3679537	3679594	3004	3061	57	LEFT	C65b.EDF	C65	2
62	3685894	3685922	768	796	28	LEFT	C65b.EDF	C65	2
63	3694036	3694121	554	639	85	LEFT	C65b.EDF	C65	2
64	3700935	3700982	58	105	47	LEFT	C65b.EDF	C65	2
64	3701453	3701533	576	656	80	LEFT	C65b.EDF	C65	2
65	3710800	3710890	560	650	90	LEFT	C65b.EDF	C65	2
67	3728033	3728110	631	708	77	LEFT	C65b.EDF	C65	2
68	3737771	3737851	585	665	80	LEFT	C65b.EDF	C65	2
69	3746501	3746594	488	581	93	LEFT	C65b.EDF	C65	2
70	3753299	3753362	278	341	63	LEFT	C65b.EDF	C65	2
71	3761544	3761645	592	693	101	LEFT	C65b.EDF	C65	2
72	3769930	3769970	642	682	40	LEFT	C65b.EDF	C65	2
73	3777845	3777937	522	614	92	LEFT	C65b.EDF	C65	2
74	3786450	3786537	634	721	87	LEFT	C65b.EDF	C65	2
75	3792947	3792999	476	528	52	LEFT	C65b.EDF	C65	2
76	3800645	3800704	605	664	59	LEFT	C65b.EDF	C65	2
77	3809780	3809801	500	521	21	LEFT	C65b.EDF	C65	2
78	3818429	3818509	511	591	80	LEFT	C65b.EDF	C65	2
79	3826520	3826611	58	149	91	LEFT	C65b.EDF	C65	2
79	3826995	3827085	533	623	90	LEFT	C65b.EDF	C65	2
80	3833480	3833556	162	238	76	LEFT	C65b.EDF	C65	2
81	3842204	3842249	59	104	45	LEFT	C65b.EDF	C65	2
81	3842788	3842861	643	716	73	LEFT	C65b.EDF	C65	2
82	3848943	3848986	296	339	43	LEFT	C65b.EDF	C65	2
83	3857921	3857998	566	643	77	LEFT	C65b.EDF	C65	2
85	3872536	3872578	75	117	42	LEFT	C65b.EDF	C65	2
87	3891549	3891609	557	617	60	LEFT	C65b.EDF	C65	2
89	3909144	3909230	570	656	86	LEFT	C65b.EDF	C65	2
89	3914285	3914318	5711	5744	33	LEFT	C65b.EDF	C65	2
90	3917809	3917875	699	765	66	LEFT	C65b.EDF	C65	2
91	3925303	3925373	459	529	70	LEFT	C65b.EDF	C65	2
92	3933043	3933091	545	593	48	LEFT	C65b.EDF	C65	2
94	3947605	3947662	58	115	57	LEFT	C65b.EDF	C65	2
94	3947929	3948117	382	570	188	LEFT	C65b.EDF	C65	2
95	3956308	3956397	681	770	89	LEFT	C65b.EDF	C65	2
96	3963323	3963382	165	224	59	LEFT	C65b.EDF	C65	2
97	3974856	3974924	524	592	68	LEFT	C65b.EDF	C65	2
98	3988554	3988626	5966	6038	72	LEFT	C65b.EDF	C65	2
99	3991007	3991089	333	415	82	LEFT	C65b.EDF	C65	2
101	4007779	4007810	602	633	31	LEFT	C65b.EDF	C65	2
102	4015363	4015423	475	535	60	LEFT	C65b.EDF	C65	2
103	4024447	4024504	564	621	57	LEFT	C65b.EDF	C65	2
104	4032136	4032164	57	85	28	LEFT	C65b.EDF	C65	2
105	4041053	4041088	529	564	35	LEFT	C65b.EDF	C65	2
105	4045989	4046034	5465	5510	45	LEFT	C65b.EDF	C65	2
106	4048678	4048757	498	577	79	LEFT	C65b.EDF	C65	2
109	4072478	4072567	616	705	89	LEFT	C65b.EDF	C65	2
110	4079336	4079396	428	488	60	LEFT	C65b.EDF	C65	2
110	4083007	4083065	4099	4157	58	LEFT	C65b.EDF	C65	2
111	4088223	4088300	449	526	77	LEFT	C65b.EDF	C65	2
112	4096061	4096167	578	684	106	LEFT	C65b.EDF	C65	2
113	4103081	4103115	58	92	34	LEFT	C65b.EDF	C65	2
113	4103540	4103640	517	617	100	LEFT	C65b.EDF	C65	2
113	4105782	4105854	2759	2831	72	LEFT	C65b.EDF	C65	2
115	4119601	4119810	489	698	209	LEFT	C65b.EDF	C65	2
115	4120103	4120114	991	1002	11	LEFT	C65b.EDF	C65	2
115	4120139	4120150	1027	1038	11	LEFT	C65b.EDF	C65	2
116	4132036	4132076	4088	4128	40	LEFT	C65b.EDF	C65	2
116	4133058	4133099	5110	5151	41	LEFT	C65b.EDF	C65	2
118	4143624	4143654	58	88	30	LEFT	C65b.EDF	C65	2
118	4144235	4144316	669	750	81	LEFT	C65b.EDF	C65	2
119	4152867	4152916	239	288	49	LEFT	C65b.EDF	C65	2
120	4160752	4160852	522	622	100	LEFT	C65b.EDF	C65	2
1	4540511	4540585	726	800	74	LEFT	C65c.EDF	C65	3
1	4541164	4541262	1379	1477	98	LEFT	C65c.EDF	C65	3
2	4548289	4548365	512	588	76	LEFT	C65c.EDF	C65	3
3	4557315	4557387	573	645	72	LEFT	C65c.EDF	C65	3
4	4564270	4564359	567	656	89	LEFT	C65c.EDF	C65	3
6	4578864	4578957	543	636	93	LEFT	C65c.EDF	C65	3
7	4587394	4587485	570	661	91	LEFT	C65c.EDF	C65	3
8	4594835	4594942	470	577	107	LEFT	C65c.EDF	C65	3
9	4602946	4603049	1112	1215	103	LEFT	C65c.EDF	C65	3
10	4610728	4610842	484	598	114	LEFT	C65c.EDF	C65	3
13	4634891	4635057	527	693	166	LEFT	C65c.EDF	C65	3
13	4635351	4635472	987	1108	121	LEFT	C65c.EDF	C65	3
15	4654636	4654687	4457	4508	51	LEFT	C65c.EDF	C65	3
15	4655918	4655994	5739	5815	76	LEFT	C65c.EDF	C65	3
16	4663060	4663133	558	631	73	LEFT	C65c.EDF	C65	3
18	4679617	4679666	550	599	49	LEFT	C65c.EDF	C65	3
18	4681970	4682044	2903	2977	74	LEFT	C65c.EDF	C65	3
18	4682859	4682950	3792	3883	91	LEFT	C65c.EDF	C65	3
19	4691511	4691573	5278	5340	62	LEFT	C65c.EDF	C65	3
19	4693075	4693144	6842	6911	69	LEFT	C65c.EDF	C65	3
20	4696148	4696223	510	585	75	LEFT	C65c.EDF	C65	3
22	4716196	4716249	3826	3879	53	LEFT	C65c.EDF	C65	3
23	4719715	4719800	277	362	85	LEFT	C65c.EDF	C65	3
23	4720147	4720256	709	818	109	LEFT	C65c.EDF	C65	3
24	4727820	4727892	638	710	72	LEFT	C65c.EDF	C65	3
25	4738055	4738136	672	753	81	LEFT	C65c.EDF	C65	3
26	4746494	4746540	602	648	46	LEFT	C65c.EDF	C65	3
27	4754975	4755024	532	581	49	LEFT	C65c.EDF	C65	3
27	4758318	4758360	3875	3917	42	LEFT	C65c.EDF	C65	3
27	4759102	4759177	4659	4734	75	LEFT	C65c.EDF	C65	3
27	4760316	4760380	5873	5937	64	LEFT	C65c.EDF	C65	3
28	4763310	4763385	565	640	75	LEFT	C65c.EDF	C65	3
29	4773107	4773130	553	576	23	LEFT	C65c.EDF	C65	3
30	4781125	4781163	245	283	38	LEFT	C65c.EDF	C65	3
32	4797638	4797733	859	954	95	LEFT	C65c.EDF	C65	3
34	4813344	4813467	64	187	123	LEFT	C65c.EDF	C65	3
34	4813726	4813816	446	536	90	LEFT	C65c.EDF	C65	3
35	4821543	4821612	624	693	69	LEFT	C65c.EDF	C65	3
35	4823618	4823663	2699	2744	45	LEFT	C65c.EDF	C65	3
36	4830341	4830406	512	577	65	LEFT	C65c.EDF	C65	3
36	4834630	4834678	4801	4849	48	LEFT	C65c.EDF	C65	3
38	4848546	4848659	375	488	113	LEFT	C65c.EDF	C65	3
40	4865653	4865756	637	740	103	LEFT	C65c.EDF	C65	3
41	4873418	4873501	60	143	83	LEFT	C65c.EDF	C65	3
41	4873884	4873977	526	619	93	LEFT	C65c.EDF	C65	3
41	4875101	4875139	1743	1781	38	LEFT	C65c.EDF	C65	3
42	4881900	4882000	327	427	100	LEFT	C65c.EDF	C65	3
44	4900945	4901009	4897	4961	64	LEFT	C65c.EDF	C65	3
45	4905350	4905457	518	625	107	LEFT	C65c.EDF	C65	3
46	4914005	4914123	527	645	118	LEFT	C65c.EDF	C65	3
47	4922294	4922360	482	548	66	LEFT	C65c.EDF	C65	3
47	4927787	4927845	5975	6033	58	LEFT	C65c.EDF	C65	3
49	4938481	4938558	303	380	77	LEFT	C65c.EDF	C65	3
49	4938857	4938956	679	778	99	LEFT	C65c.EDF	C65	3
49	4939144	4939278	966	1100	134	LEFT	C65c.EDF	C65	3
50	4946187	4946270	722	805	83	LEFT	C65c.EDF	C65	3
50	4950050	4950127	4585	4662	77	LEFT	C65c.EDF	C65	3
51	4953648	4953738	481	571	90	LEFT	C65c.EDF	C65	3
52	4962155	4962196	549	590	41	LEFT	C65c.EDF	C65	3
53	4971135	4971222	545	632	87	LEFT	C65c.EDF	C65	3
53	4975666	4975710	5076	5120	44	LEFT	C65c.EDF	C65	3
54	4979887	4979959	555	627	72	LEFT	C65c.EDF	C65	3
54	4984567	4984641	5235	5309	74	LEFT	C65c.EDF	C65	3
55	4987918	4987976	58	116	58	LEFT	C65c.EDF	C65	3
56	4995723	4995849	61	187	126	LEFT	C65c.EDF	C65	3
56	4996190	4996286	528	624	96	LEFT	C65c.EDF	C65	3
56	4996765	4996863	1103	1201	98	LEFT	C65c.EDF	C65	3
57	5003395	5003473	478	556	78	LEFT	C65c.EDF	C65	3
58	5011915	5011998	582	665	83	LEFT	C65c.EDF	C65	3
59	5020187	5020262	670	745	75	LEFT	C65c.EDF	C65	3
61	5036132	5036235	402	505	103	LEFT	C65c.EDF	C65	3
61	5036811	5036894	1081	1164	83	LEFT	C65c.EDF	C65	3
63	5053260	5053370	442	552	110	LEFT	C65c.EDF	C65	3
63	5056741	5056831	3923	4013	90	LEFT	C65c.EDF	C65	3
65	5068775	5068905	486	616	130	LEFT	C65c.EDF	C65	3
66	5076660	5076766	433	539	106	LEFT	C65c.EDF	C65	3
67	5085559	5085673	517	631	114	LEFT	C65c.EDF	C65	3
68	5094932	5095130	526	724	198	LEFT	C65c.EDF	C65	3
68	5095382	5095521	976	1115	139	LEFT	C65c.EDF	C65	3
68	5096033	5096130	1627	1724	97	LEFT	C65c.EDF	C65	3
68	5097264	5097344	2858	2938	80	LEFT	C65c.EDF	C65	3
68	5099213	5099237	4807	4831	24	LEFT	C65c.EDF	C65	3
69	5108124	5108204	4163	4243	80	LEFT	C65c.EDF	C65	3
69	5110248	5110317	6287	6356	69	LEFT	C65c.EDF	C65	3
71	5122514	5122607	594	687	93	LEFT	C65c.EDF	C65	3
72	5131320	5131399	503	582	79	LEFT	C65c.EDF	C65	3
73	5137897	5137982	543	628	85	LEFT	C65c.EDF	C65	3
74	5145850	5145943	506	599	93	LEFT	C65c.EDF	C65	3
75	5152769	5152861	569	661	92	LEFT	C65c.EDF	C65	3
76	5161906	5162001	515	610	95	LEFT	C65c.EDF	C65	3
77	5169040	5169117	575	652	77	LEFT	C65c.EDF	C65	3
78	5176431	5176510	583	662	79	LEFT	C65c.EDF	C65	3
79	5184949	5185041	510	602	92	LEFT	C65c.EDF	C65	3
80	5191841	5191866	58	83	25	LEFT	C65c.EDF	C65	3
80	5192252	5192358	469	575	106	LEFT	C65c.EDF	C65	3
81	5200727	5200800	588	661	73	LEFT	C65c.EDF	C65	3
82	5210078	5210152	680	754	74	LEFT	C65c.EDF	C65	3
82	5213147	5213221	3749	3823	74	LEFT	C65c.EDF	C65	3
82	5214232	5214335	4834	4937	103	LEFT	C65c.EDF	C65	3
85	5232793	5232856	1500	1563	63	LEFT	C65c.EDF	C65	3
87	5248785	5248810	58	83	25	LEFT	C65c.EDF	C65	3
88	5256653	5256743	636	726	90	LEFT	C65c.EDF	C65	3
89	5265400	5265466	2368	2434	66	LEFT	C65c.EDF	C65	3
90	5277262	5277297	6850	6885	35	LEFT	C65c.EDF	C65	3
93	5294272	5294346	615	689	74	LEFT	C65c.EDF	C65	3
95	5309297	5309389	557	649	92	LEFT	C65c.EDF	C65	3
96	5316302	5316421	491	610	119	LEFT	C65c.EDF	C65	3
96	5319379	5319441	3568	3630	62	LEFT	C65c.EDF	C65	3
96	5320944	5321005	5133	5194	61	LEFT	C65c.EDF	C65	3
98	5331248	5331283	595	630	35	LEFT	C65c.EDF	C65	3
99	5340541	5340628	560	647	87	LEFT	C65c.EDF	C65	3
99	5346859	5346931	6878	6950	72	LEFT	C65c.EDF	C65	3
100	5350390	5350479	544	633	89	LEFT	C65c.EDF	C65	3
101	5358511	5358607	520	616	96	LEFT	C65c.EDF	C65	3
102	5369787	5369841	2997	3051	54	LEFT	C65c.EDF	C65	3
102	5371736	5371807	4946	5017	71	LEFT	C65c.EDF	C65	3
102	5373583	5373656	6793	6866	73	LEFT	C65c.EDF	C65	3
103	5378150	5378238	241	329	88	LEFT	C65c.EDF	C65	3
103	5378561	5378683	652	774	122	LEFT	C65c.EDF	C65	3
104	5385922	5386007	523	608	85	LEFT	C65c.EDF	C65	3
105	5394636	5394723	654	741	87	LEFT	C65c.EDF	C65	3
106	5406172	5406244	5207	5279	72	LEFT	C65c.EDF	C65	3
108	5419459	5419529	540	610	70	LEFT	C65c.EDF	C65	3
109	5427977	5428006	58	87	29	LEFT	C65c.EDF	C65	3
109	5428562	5428630	643	711	68	LEFT	C65c.EDF	C65	3
111	5446160	5446170	827	837	10	LEFT	C65c.EDF	C65	3
111	5446225	5446244	892	911	19	LEFT	C65c.EDF	C65	3
113	5461787	5461866	512	591	79	LEFT	C65c.EDF	C65	3
114	5470855	5470933	716	794	78	LEFT	C65c.EDF	C65	3
115	5478394	5478486	710	802	92	LEFT	C65c.EDF	C65	3
116	5487330	5487423	559	652	93	LEFT	C65c.EDF	C65	3
117	5496200	5496302	524	626	102	LEFT	C65c.EDF	C65	3
119	5512993	5513104	410	521	111	LEFT	C65c.EDF	C65	3
120	5520399	5520498	619	718	99	LEFT	C65c.EDF	C65	3
2	14741347	14741433	615	701	86	RIGHT	D15a.EDF	D15	1
2	14742014	14742094	1282	1362	80	RIGHT	D15a.EDF	D15	1
4	14754401	14754448	58	105	47	RIGHT	D15a.EDF	D15	1
8	14787405	14787486	523	604	81	RIGHT	D15a.EDF	D15	1
9	14796739	14796821	563	645	82	RIGHT	D15a.EDF	D15	1
10	14804155	14804227	1249	1321	72	RIGHT	D15a.EDF	D15	1
16	14851334	14851381	393	440	47	RIGHT	D15a.EDF	D15	1
17	14857939	14858022	466	549	83	RIGHT	D15a.EDF	D15	1
21	14885571	14885621	114	164	50	RIGHT	D15a.EDF	D15	1
24	14908309	14908424	436	551	115	RIGHT	D15a.EDF	D15	1
30	14950057	14950136	606	685	79	RIGHT	D15a.EDF	D15	1
31	14958482	14958579	464	561	97	RIGHT	D15a.EDF	D15	1
31	14958716	14958833	698	815	117	RIGHT	D15a.EDF	D15	1
31	14959790	14959846	1772	1828	56	RIGHT	D15a.EDF	D15	1
33	14973871	14974026	2364	2519	155	RIGHT	D15a.EDF	D15	1
35	14987824	14987889	2391	2456	65	RIGHT	D15a.EDF	D15	1
37	15002910	15003026	485	601	116	RIGHT	D15a.EDF	D15	1
38	15010493	15010590	420	517	97	RIGHT	D15a.EDF	D15	1
40	15026891	15026956	2123	2188	65	RIGHT	D15a.EDF	D15	1
45	15061496	15061634	671	809	138	RIGHT	D15a.EDF	D15	1
46	15068866	15068956	1277	1367	90	RIGHT	D15a.EDF	D15	1
48	15082812	15082933	641	762	121	RIGHT	D15a.EDF	D15	1
49	15089613	15089721	626	734	108	RIGHT	D15a.EDF	D15	1
50	15096362	15096478	521	637	116	RIGHT	D15a.EDF	D15	1
51	15102861	15103007	469	615	146	RIGHT	D15a.EDF	D15	1
52	15109283	15109334	58	109	51	RIGHT	D15a.EDF	D15	1
53	15116007	15116121	627	741	114	RIGHT	D15a.EDF	D15	1
54	15122677	15122764	743	830	87	RIGHT	D15a.EDF	D15	1
55	15128949	15128993	189	233	44	RIGHT	D15a.EDF	D15	1
57	15143639	15143728	1878	1967	89	RIGHT	D15a.EDF	D15	1
59	15156204	15156237	102	135	33	RIGHT	D15a.EDF	D15	1
60	15162967	15163041	79	153	74	RIGHT	D15a.EDF	D15	1
60	15164938	15165016	2050	2128	78	RIGHT	D15a.EDF	D15	1
61	15169922	15170035	397	510	113	RIGHT	D15a.EDF	D15	1
61	15170213	15170333	688	808	120	RIGHT	D15a.EDF	D15	1
61	15170707	15170946	1182	1421	239	RIGHT	D15a.EDF	D15	1
62	15176633	15176740	414	521	107	RIGHT	D15a.EDF	D15	1
64	15190231	15190304	758	831	73	RIGHT	D15a.EDF	D15	1
66	15205310	15205314	460	464	4	RIGHT	D15a.EDF	D15	1
66	15205343	15205351	493	501	8	RIGHT	D15a.EDF	D15	1
70	15233761	15233870	601	710	109	RIGHT	D15a.EDF	D15	1
75	15268237	15268353	684	800	116	RIGHT	D15a.EDF	D15	1
77	15282590	15282708	505	623	118	RIGHT	D15a.EDF	D15	1
78	15290444	15290506	601	663	62	RIGHT	D15a.EDF	D15	1
81	15310618	15310683	190	255	65	RIGHT	D15a.EDF	D15	1
82	15317556	15317655	576	675	99	RIGHT	D15a.EDF	D15	1
83	15324877	15324964	514	601	87	RIGHT	D15a.EDF	D15	1
84	15331993	15332093	398	498	100	RIGHT	D15a.EDF	D15	1
85	15338588	15338700	516	628	112	RIGHT	D15a.EDF	D15	1
86	15348704	15348751	3627	3674	47	RIGHT	D15a.EDF	D15	1
87	15353693	15353755	1895	1957	62	RIGHT	D15a.EDF	D15	1
88	15360097	15360175	816	894	78	RIGHT	D15a.EDF	D15	1
89	15366573	15366660	645	732	87	RIGHT	D15a.EDF	D15	1
90	15373774	15373945	492	663	171	RIGHT	D15a.EDF	D15	1
90	15374142	15374264	860	982	122	RIGHT	D15a.EDF	D15	1
91	15380373	15380472	437	536	99	RIGHT	D15a.EDF	D15	1
91	15380673	15380779	737	843	106	RIGHT	D15a.EDF	D15	1
92	15389722	15389784	2238	2300	62	RIGHT	D15a.EDF	D15	1
93	15394526	15394616	517	607	90	RIGHT	D15a.EDF	D15	1
94	15403452	15403543	626	717	91	RIGHT	D15a.EDF	D15	1
94	15405617	15405637	2791	2811	20	RIGHT	D15a.EDF	D15	1
95	15412480	15412529	3018	3067	49	RIGHT	D15a.EDF	D15	1
97	15424053	15424108	500	555	55	RIGHT	D15a.EDF	D15	1
97	15425353	15425398	1800	1845	45	RIGHT	D15a.EDF	D15	1
98	15431383	15431458	819	894	75	RIGHT	D15a.EDF	D15	1
99	15437364	15437419	58	113	55	RIGHT	D15a.EDF	D15	1
100	15444631	15444718	536	623	87	RIGHT	D15a.EDF	D15	1
100	15446190	15446283	2095	2188	93	RIGHT	D15a.EDF	D15	1
101	15452183	15452275	539	631	92	RIGHT	D15a.EDF	D15	1
102	15459094	15459154	601	661	60	RIGHT	D15a.EDF	D15	1
102	15459855	15459971	1362	1478	116	RIGHT	D15a.EDF	D15	1
103	15467107	15467192	591	676	85	RIGHT	D15a.EDF	D15	1
104	15473826	15473891	614	679	65	RIGHT	D15a.EDF	D15	1
105	15481619	15481638	1809	1828	19	RIGHT	D15a.EDF	D15	1
108	15499879	15499935	601	657	56	RIGHT	D15a.EDF	D15	1
111	15519703	15519833	456	586	130	RIGHT	D15a.EDF	D15	1
113	15532600	15532669	635	704	69	RIGHT	D15a.EDF	D15	1
115	15544940	15545059	545	664	119	RIGHT	D15a.EDF	D15	1
117	15558046	15558152	509	615	106	RIGHT	D15a.EDF	D15	1
119	15571410	15571502	603	695	92	RIGHT	D15a.EDF	D15	1
120	15578164	15578241	575	652	77	RIGHT	D15a.EDF	D15	1
1	15990146	15990252	567	673	106	RIGHT	D15b.EDF	D15	2
3	16004627	16004667	541	581	40	RIGHT	D15b.EDF	D15	2
9	16048028	16048088	548	608	60	RIGHT	D15b.EDF	D15	2
10	16055811	16055927	518	634	116	RIGHT	D15b.EDF	D15	2
11	16062746	16062766	670	690	20	RIGHT	D15b.EDF	D15	2
14	16082944	16083026	496	578	82	RIGHT	D15b.EDF	D15	2
15	16091097	16091175	535	613	78	RIGHT	D15b.EDF	D15	2
16	16097881	16097972	573	664	91	RIGHT	D15b.EDF	D15	2
18	16110386	16110480	486	580	94	RIGHT	D15b.EDF	D15	2
20	16127925	16128004	427	506	79	RIGHT	D15b.EDF	D15	2
22	16142364	16142484	464	584	120	RIGHT	D15b.EDF	D15	2
23	16149903	16149934	649	680	31	RIGHT	D15b.EDF	D15	2
25	16163889	16163988	528	627	99	RIGHT	D15b.EDF	D15	2
27	16180455	16180543	1905	1993	88	RIGHT	D15b.EDF	D15	2
28	16187518	16187623	656	761	105	RIGHT	D15b.EDF	D15	2
28	16188713	16188714	1851	1852	1	RIGHT	D15b.EDF	D15	2
29	16195073	16195111	558	596	38	RIGHT	D15b.EDF	D15	2
31	16210783	16211114	352	683	331	RIGHT	D15b.EDF	D15	2
31	16211272	16211388	841	957	116	RIGHT	D15b.EDF	D15	2
32	16218286	16218389	599	702	103	RIGHT	D15b.EDF	D15	2
35	16241103	16241221	334	452	118	RIGHT	D15b.EDF	D15	2
36	16247705	16247848	329	472	143	RIGHT	D15b.EDF	D15	2
37	16254436	16254552	564	680	116	RIGHT	D15b.EDF	D15	2
38	16261370	16261448	493	571	78	RIGHT	D15b.EDF	D15	2
41	16282768	16282783	318	333	15	RIGHT	D15b.EDF	D15	2
41	16282871	16283816	421	1366	945	RIGHT	D15b.EDF	D15	2
41	16283882	16283959	1432	1509	77	RIGHT	D15b.EDF	D15	2
43	16300398	16300442	4057	4101	44	RIGHT	D15b.EDF	D15	2
44	16305383	16305493	653	763	110	RIGHT	D15b.EDF	D15	2
45	16311999	16312095	547	643	96	RIGHT	D15b.EDF	D15	2
46	16318130	16318208	647	725	78	RIGHT	D15b.EDF	D15	2
47	16325130	16325183	693	746	53	RIGHT	D15b.EDF	D15	2
48	16331689	16331727	750	788	38	RIGHT	D15b.EDF	D15	2
51	16351418	16351504	687	773	86	RIGHT	D15b.EDF	D15	2
52	16357324	16357419	556	651	95	RIGHT	D15b.EDF	D15	2
56	16385124	16385189	759	824	65	RIGHT	D15b.EDF	D15	2
57	16391192	16391221	108	137	29	RIGHT	D15b.EDF	D15	2
57	16391593	16392371	509	1287	778	RIGHT	D15b.EDF	D15	2
57	16392579	16392618	1495	1534	39	RIGHT	D15b.EDF	D15	2
57	16392924	16392972	1840	1888	48	RIGHT	D15b.EDF	D15	2
58	16398236	16398287	562	613	51	RIGHT	D15b.EDF	D15	2
59	16406213	16406313	439	539	100	RIGHT	D15b.EDF	D15	2
59	16407641	16407642	1867	1868	1	RIGHT	D15b.EDF	D15	2
59	16407673	16407676	1899	1902	3	RIGHT	D15b.EDF	D15	2
60	16413937	16414018	680	761	81	RIGHT	D15b.EDF	D15	2
61	16420079	16420203	346	470	124	RIGHT	D15b.EDF	D15	2
61	16422631	16422757	2898	3024	126	RIGHT	D15b.EDF	D15	2
61	16423663	16423751	3930	4018	88	RIGHT	D15b.EDF	D15	2
62	16427110	16427223	610	723	113	RIGHT	D15b.EDF	D15	2
63	16433610	16433673	605	668	63	RIGHT	D15b.EDF	D15	2
64	16440595	16440701	470	576	106	RIGHT	D15b.EDF	D15	2
66	16454133	16454250	565	682	117	RIGHT	D15b.EDF	D15	2
67	16461297	16461357	545	605	60	RIGHT	D15b.EDF	D15	2
68	16468136	16468215	609	688	79	RIGHT	D15b.EDF	D15	2
69	16475256	16475344	654	742	88	RIGHT	D15b.EDF	D15	2
70	16481777	16481851	553	627	74	RIGHT	D15b.EDF	D15	2
71	16488258	16488371	544	657	113	RIGHT	D15b.EDF	D15	2
72	16496557	16496610	487	540	53	RIGHT	D15b.EDF	D15	2
74	16510335	16510425	589	679	90	RIGHT	D15b.EDF	D15	2
75	16518437	16518539	539	641	102	RIGHT	D15b.EDF	D15	2
76	16526228	16526339	523	634	111	RIGHT	D15b.EDF	D15	2
78	16541151	16541205	2333	2387	54	RIGHT	D15b.EDF	D15	2
79	16546051	16546145	614	708	94	RIGHT	D15b.EDF	D15	2
80	16555407	16555472	541	606	65	RIGHT	D15b.EDF	D15	2
81	16563995	16564079	1625	1709	84	RIGHT	D15b.EDF	D15	2
82	16570329	16570468	420	559	139	RIGHT	D15b.EDF	D15	2
83	16577632	16577743	523	634	111	RIGHT	D15b.EDF	D15	2
84	16585098	16585232	377	511	134	RIGHT	D15b.EDF	D15	2
87	16604704	16604773	480	549	69	RIGHT	D15b.EDF	D15	2
88	16610747	16610780	104	137	33	RIGHT	D15b.EDF	D15	2
88	16611227	16611310	584	667	83	RIGHT	D15b.EDF	D15	2
90	16623468	16623572	575	679	104	RIGHT	D15b.EDF	D15	2
91	16629952	16630094	362	504	142	RIGHT	D15b.EDF	D15	2
91	16630207	16630325	617	735	118	RIGHT	D15b.EDF	D15	2
93	16643808	16643914	517	623	106	RIGHT	D15b.EDF	D15	2
94	16650456	16650518	584	646	62	RIGHT	D15b.EDF	D15	2
95	16656502	16656593	402	493	91	RIGHT	D15b.EDF	D15	2
97	16669093	16669218	534	659	125	RIGHT	D15b.EDF	D15	2
98	16676412	16676533	610	731	121	RIGHT	D15b.EDF	D15	2
99	16682775	16682884	578	687	109	RIGHT	D15b.EDF	D15	2
100	16690278	16690379	474	575	101	RIGHT	D15b.EDF	D15	2
101	16697010	16697120	575	685	110	RIGHT	D15b.EDF	D15	2
103	16709363	16709438	127	202	75	RIGHT	D15b.EDF	D15	2
107	16737549	16737695	504	650	146	RIGHT	D15b.EDF	D15	2
110	16757915	16757985	538	608	70	RIGHT	D15b.EDF	D15	2
111	16764008	16764068	58	118	60	RIGHT	D15b.EDF	D15	2
112	16770911	16770977	589	655	66	RIGHT	D15b.EDF	D15	2
113	16777481	16777619	465	603	138	RIGHT	D15b.EDF	D15	2
114	16784376	16784497	430	551	121	RIGHT	D15b.EDF	D15	2
115	16792061	16792183	431	553	122	RIGHT	D15b.EDF	D15	2
116	16799308	16799405	512	609	97	RIGHT	D15b.EDF	D15	2
117	16805362	16805418	593	649	56	RIGHT	D15b.EDF	D15	2
119	16818454	16818547	483	576	93	RIGHT	D15b.EDF	D15	2
120	16825462	16825557	425	520	95	RIGHT	D15b.EDF	D15	2
120	16825734	16825856	697	819	122	RIGHT	D15b.EDF	D15	2
1	17316731	17316881	58	208	150	RIGHT	D15c.EDF	D15	3
1	17317022	17317117	349	444	95	RIGHT	D15c.EDF	D15	3
1	17318952	17319044	2279	2371	92	RIGHT	D15c.EDF	D15	3
5	17345562	17345615	757	810	53	RIGHT	D15c.EDF	D15	3
8	17364884	17364980	617	713	96	RIGHT	D15c.EDF	D15	3
9	17371673	17371761	517	605	88	RIGHT	D15c.EDF	D15	3
10	17379529	17379651	402	524	122	RIGHT	D15c.EDF	D15	3
11	17385854	17385980	402	528	126	RIGHT	D15c.EDF	D15	3
12	17392404	17392505	458	559	101	RIGHT	D15c.EDF	D15	3
13	17397909	17398000	361	452	91	RIGHT	D15c.EDF	D15	3
14	17405674	17405733	396	455	59	RIGHT	D15c.EDF	D15	3
15	17411448	17411586	433	571	138	RIGHT	D15c.EDF	D15	3
16	17417953	17418034	496	577	81	RIGHT	D15c.EDF	D15	3
17	17424496	17424603	449	556	107	RIGHT	D15c.EDF	D15	3
18	17431167	17431265	406	504	98	RIGHT	D15c.EDF	D15	3
18	17431287	17431287	526	526	0	RIGHT	D15c.EDF	D15	3
19	17438455	17438528	577	650	73	RIGHT	D15c.EDF	D15	3
19	17439075	17439523	1197	1645	448	RIGHT	D15c.EDF	D15	3
20	17445429	17445486	504	561	57	RIGHT	D15c.EDF	D15	3
21	17452292	17452393	560	661	101	RIGHT	D15c.EDF	D15	3
22	17459648	17459737	644	733	89	RIGHT	D15c.EDF	D15	3
23	17465796	17465883	433	520	87	RIGHT	D15c.EDF	D15	3
24	17472563	17472689	415	541	126	RIGHT	D15c.EDF	D15	3
25	17479666	17479773	524	631	107	RIGHT	D15c.EDF	D15	3
26	17486760	17486875	523	638	115	RIGHT	D15c.EDF	D15	3
27	17493374	17493483	113	222	109	RIGHT	D15c.EDF	D15	3
27	17493857	17493962	596	701	105	RIGHT	D15c.EDF	D15	3
27	17494122	17494220	861	959	98	RIGHT	D15c.EDF	D15	3
27	17494365	17494444	1104	1183	79	RIGHT	D15c.EDF	D15	3
29	17509593	17509677	477	561	84	RIGHT	D15c.EDF	D15	3
30	17516834	17516932	494	592	98	RIGHT	D15c.EDF	D15	3
30	17516957	17516957	617	617	0	RIGHT	D15c.EDF	D15	3
31	17523648	17523757	383	492	109	RIGHT	D15c.EDF	D15	3
32	17530546	17530614	552	620	68	RIGHT	D15c.EDF	D15	3
32	17530635	17530636	641	642	1	RIGHT	D15c.EDF	D15	3
33	17536657	17536762	498	603	105	RIGHT	D15c.EDF	D15	3
33	17536783	17536784	624	625	1	RIGHT	D15c.EDF	D15	3
34	17543054	17543117	499	562	63	RIGHT	D15c.EDF	D15	3
35	17550669	17550785	589	705	116	RIGHT	D15c.EDF	D15	3
36	17556745	17556856	471	582	111	RIGHT	D15c.EDF	D15	3
37	17563335	17563454	412	531	119	RIGHT	D15c.EDF	D15	3
38	17569824	17569920	466	562	96	RIGHT	D15c.EDF	D15	3
39	17576663	17576770	325	432	107	RIGHT	D15c.EDF	D15	3
40	17584516	17584600	425	509	84	RIGHT	D15c.EDF	D15	3
41	17593342	17593464	393	515	122	RIGHT	D15c.EDF	D15	3
42	17599790	17599897	394	501	107	RIGHT	D15c.EDF	D15	3
43	17606208	17606331	527	650	123	RIGHT	D15c.EDF	D15	3
44	17613166	17613254	650	738	88	RIGHT	D15c.EDF	D15	3
45	17620385	17620554	421	590	169	RIGHT	D15c.EDF	D15	3
45	17620597	17620767	633	803	170	RIGHT	D15c.EDF	D15	3
46	17628115	17628203	521	609	88	RIGHT	D15c.EDF	D15	3
48	17642124	17642242	393	511	118	RIGHT	D15c.EDF	D15	3
49	17649318	17649421	505	608	103	RIGHT	D15c.EDF	D15	3
50	17656145	17656262	531	648	117	RIGHT	D15c.EDF	D15	3
51	17663467	17663595	376	504	128	RIGHT	D15c.EDF	D15	3
51	17663823	17663966	732	875	143	RIGHT	D15c.EDF	D15	3
52	17670950	17671055	387	492	105	RIGHT	D15c.EDF	D15	3
53	17678584	17678584	426	426	0	RIGHT	D15c.EDF	D15	3
53	17678610	17678623	452	465	13	RIGHT	D15c.EDF	D15	3
54	17685817	17685924	404	511	107	RIGHT	D15c.EDF	D15	3
56	17700351	17700420	575	644	69	RIGHT	D15c.EDF	D15	3
56	17700442	17700443	666	667	1	RIGHT	D15c.EDF	D15	3
57	17707106	17707208	539	641	102	RIGHT	D15c.EDF	D15	3
57	17707229	17707232	662	665	3	RIGHT	D15c.EDF	D15	3
58	17714389	17714513	418	542	124	RIGHT	D15c.EDF	D15	3
61	17732962	17733090	342	470	128	RIGHT	D15c.EDF	D15	3
62	17739660	17739757	505	602	97	RIGHT	D15c.EDF	D15	3
63	17747567	17747683	406	522	116	RIGHT	D15c.EDF	D15	3
64	17755771	17755854	664	747	83	RIGHT	D15c.EDF	D15	3
65	17762056	17762174	489	607	118	RIGHT	D15c.EDF	D15	3
66	17767695	17767748	544	597	53	RIGHT	D15c.EDF	D15	3
67	17774625	17774706	390	471	81	RIGHT	D15c.EDF	D15	3
68	17781695	17781852	516	673	157	RIGHT	D15c.EDF	D15	3
69	17788172	17788261	512	601	89	RIGHT	D15c.EDF	D15	3
69	17788282	17788288	622	628	6	RIGHT	D15c.EDF	D15	3
70	17794144	17794240	518	614	96	RIGHT	D15c.EDF	D15	3
71	17800166	17800283	538	655	117	RIGHT	D15c.EDF	D15	3
72	17806337	17806430	178	271	93	RIGHT	D15c.EDF	D15	3
73	17814033	17814091	539	597	58	RIGHT	D15c.EDF	D15	3
73	17814112	17814116	618	622	4	RIGHT	D15c.EDF	D15	3
74	17820515	17820625	396	506	110	RIGHT	D15c.EDF	D15	3
75	17827030	17827148	449	567	118	RIGHT	D15c.EDF	D15	3
76	17833749	17833878	434	563	129	RIGHT	D15c.EDF	D15	3
77	17841473	17841543	391	461	70	RIGHT	D15c.EDF	D15	3
78	17848030	17848147	594	711	117	RIGHT	D15c.EDF	D15	3
79	17854267	17854438	583	754	171	RIGHT	D15c.EDF	D15	3
80	17862120	17862270	525	675	150	RIGHT	D15c.EDF	D15	3
81	17869818	17869941	592	715	123	RIGHT	D15c.EDF	D15	3
82	17875662	17875816	454	608	154	RIGHT	D15c.EDF	D15	3
83	17882726	17882833	420	527	107	RIGHT	D15c.EDF	D15	3
84	17889703	17889864	480	641	161	RIGHT	D15c.EDF	D15	3
85	17897010	17897128	552	670	118	RIGHT	D15c.EDF	D15	3
86	17904168	17904276	527	635	108	RIGHT	D15c.EDF	D15	3
87	17910689	17910770	518	599	81	RIGHT	D15c.EDF	D15	3
88	17917876	17917973	431	528	97	RIGHT	D15c.EDF	D15	3
89	17925012	17925125	467	580	113	RIGHT	D15c.EDF	D15	3
90	17930952	17931035	595	678	83	RIGHT	D15c.EDF	D15	3
91	17937962	17938095	413	546	133	RIGHT	D15c.EDF	D15	3
91	17938226	17938336	677	787	110	RIGHT	D15c.EDF	D15	3
92	17945149	17945264	437	552	115	RIGHT	D15c.EDF	D15	3
93	17951320	17951369	495	544	49	RIGHT	D15c.EDF	D15	3
93	17951391	17951393	566	568	2	RIGHT	D15c.EDF	D15	3
94	17957203	17957270	487	554	67	RIGHT	D15c.EDF	D15	3
95	17964121	17964224	370	473	103	RIGHT	D15c.EDF	D15	3
95	17968066	17968172	4315	4421	106	RIGHT	D15c.EDF	D15	3
96	17971860	17971941	498	579	81	RIGHT	D15c.EDF	D15	3
98	17986301	17986416	484	599	115	RIGHT	D15c.EDF	D15	3
99	17993383	17993471	558	646	88	RIGHT	D15c.EDF	D15	3
100	17999923	18000026	609	712	103	RIGHT	D15c.EDF	D15	3
101	18005689	18005819	491	621	130	RIGHT	D15c.EDF	D15	3
102	18012850	18012935	506	591	85	RIGHT	D15c.EDF	D15	3
103	18019185	18019325	469	609	140	RIGHT	D15c.EDF	D15	3
105	18032132	18032208	518	594	76	RIGHT	D15c.EDF	D15	3
107	18048687	18048818	4159	4290	131	RIGHT	D15c.EDF	D15	3
108	18051947	18052106	409	568	159	RIGHT	D15c.EDF	D15	3
109	18058487	18058542	522	577	55	RIGHT	D15c.EDF	D15	3
111	18071765	18071899	510	644	134	RIGHT	D15c.EDF	D15	3
112	18078436	18078505	67	136	69	RIGHT	D15c.EDF	D15	3
115	18100159	18100251	654	746	92	RIGHT	D15c.EDF	D15	3
116	18106953	18107097	412	556	144	RIGHT	D15c.EDF	D15	3
117	18114320	18114459	418	557	139	RIGHT	D15c.EDF	D15	3
118	18122188	18122300	392	504	112	RIGHT	D15c.EDF	D15	3
119	18129618	18129697	434	513	79	RIGHT	D15c.EDF	D15	3
120	18136343	18136425	499	581	82	RIGHT	D15c.EDF	D15	3
2	3468552	3468670	654	772	118	LEFT	D61a.EDF	D61	1
2	3469415	3469549	1517	1651	134	LEFT	D61a.EDF	D61	1
3	3476684	3476802	236	354	118	LEFT	D61a.EDF	D61	1
3	3477473	3477603	1025	1155	130	LEFT	D61a.EDF	D61	1
4	3484768	3484897	456	585	129	LEFT	D61a.EDF	D61	1
4	3485491	3485656	1179	1344	165	LEFT	D61a.EDF	D61	1
6	3502281	3502404	236	359	123	LEFT	D61a.EDF	D61	1
6	3502908	3503072	863	1027	164	LEFT	D61a.EDF	D61	1
6	3503789	3503914	1744	1869	125	LEFT	D61a.EDF	D61	1
7	3510334	3510468	404	538	134	LEFT	D61a.EDF	D61	1
8	3519495	3519653	138	296	158	LEFT	D61a.EDF	D61	1
8	3520433	3520576	1076	1219	143	LEFT	D61a.EDF	D61	1
9	3527079	3527211	57	189	132	LEFT	D61a.EDF	D61	1
9	3527877	3528011	855	989	134	LEFT	D61a.EDF	D61	1
9	3528419	3528573	1397	1551	154	LEFT	D61a.EDF	D61	1
13	3564668	3564765	684	781	97	LEFT	D61a.EDF	D61	1
15	3583309	3583441	155	287	132	LEFT	D61a.EDF	D61	1
15	3583704	3583823	550	669	119	LEFT	D61a.EDF	D61	1
17	3601149	3601282	93	226	133	LEFT	D61a.EDF	D61	1
17	3604995	3605099	3939	4043	104	LEFT	D61a.EDF	D61	1
17	3605668	3605790	4612	4734	122	LEFT	D61a.EDF	D61	1
18	3611296	3611407	75	186	111	LEFT	D61a.EDF	D61	1
18	3611705	3611858	484	637	153	LEFT	D61a.EDF	D61	1
18	3613038	3613045	1817	1824	7	LEFT	D61a.EDF	D61	1
18	3613383	3613488	2162	2267	105	LEFT	D61a.EDF	D61	1
19	3620241	3620375	133	267	134	LEFT	D61a.EDF	D61	1
19	3621350	3621478	1242	1370	128	LEFT	D61a.EDF	D61	1
20	3634928	3635026	4885	4983	98	LEFT	D61a.EDF	D61	1
21	3641080	3641194	540	654	114	LEFT	D61a.EDF	D61	1
22	3649489	3649597	213	321	108	LEFT	D61a.EDF	D61	1
23	3658135	3658250	286	401	115	LEFT	D61a.EDF	D61	1
23	3663273	3663373	5424	5524	100	LEFT	D61a.EDF	D61	1
24	3666312	3666405	56	149	93	LEFT	D61a.EDF	D61	1
24	3667375	3667511	1119	1255	136	LEFT	D61a.EDF	D61	1
26	3683596	3683723	210	337	127	LEFT	D61a.EDF	D61	1
26	3684625	3684763	1239	1377	138	LEFT	D61a.EDF	D61	1
27	3691715	3691838	353	476	123	LEFT	D61a.EDF	D61	1
28	3700851	3700962	56	167	111	LEFT	D61a.EDF	D61	1
30	3718121	3718269	482	630	148	LEFT	D61a.EDF	D61	1
35	3760366	3760496	154	284	130	LEFT	D61a.EDF	D61	1
35	3761364	3761492	1152	1280	128	LEFT	D61a.EDF	D61	1
37	3778691	3778812	357	478	121	LEFT	D61a.EDF	D61	1
39	3797279	3797380	723	824	101	LEFT	D61a.EDF	D61	1
42	3829196	3829285	5212	5301	89	LEFT	D61a.EDF	D61	1
45	3850155	3850335	457	637	180	LEFT	D61a.EDF	D61	1
48	3877644	3877750	199	305	106	LEFT	D61a.EDF	D61	1
48	3878534	3878692	1089	1247	158	LEFT	D61a.EDF	D61	1
50	3896784	3896915	226	357	131	LEFT	D61a.EDF	D61	1
53	3922017	3922158	664	805	141	LEFT	D61a.EDF	D61	1
58	3962445	3962537	56	148	92	LEFT	D61a.EDF	D61	1
59	3971888	3972027	168	307	139	LEFT	D61a.EDF	D61	1
59	3975419	3975484	3699	3764	65	LEFT	D61a.EDF	D61	1
60	3980826	3980964	65	203	138	LEFT	D61a.EDF	D61	1
60	3982707	3982753	1946	1992	46	LEFT	D61a.EDF	D61	1
61	3998346	3998358	7009	7021	12	LEFT	D61a.EDF	D61	1
70	4065246	4065312	57	123	66	LEFT	D61a.EDF	D61	1
71	4078422	4078522	5097	5197	100	LEFT	D61a.EDF	D61	1
74	4100297	4100432	153	288	135	LEFT	D61a.EDF	D61	1
75	4108316	4108450	88	222	134	LEFT	D61a.EDF	D61	1
75	4109452	4109593	1224	1365	141	LEFT	D61a.EDF	D61	1
76	4116318	4116393	57	132	75	LEFT	D61a.EDF	D61	1
80	4152489	4152599	94	204	110	LEFT	D61a.EDF	D61	1
81	4161476	4161612	135	271	136	LEFT	D61a.EDF	D61	1
82	4171545	4171689	959	1103	144	LEFT	D61a.EDF	D61	1
91	4245569	4245700	126	257	131	LEFT	D61a.EDF	D61	1
92	4255235	4255379	257	401	144	LEFT	D61a.EDF	D61	1
92	4255845	4256024	867	1046	179	LEFT	D61a.EDF	D61	1
92	4256471	4256604	1493	1626	133	LEFT	D61a.EDF	D61	1
94	4271891	4272062	165	336	171	LEFT	D61a.EDF	D61	1
96	4287463	4287617	566	720	154	LEFT	D61a.EDF	D61	1
97	4295842	4295956	199	313	114	LEFT	D61a.EDF	D61	1
100	4322934	4323090	616	772	156	LEFT	D61a.EDF	D61	1
106	4373945	4374273	204	532	328	LEFT	D61a.EDF	D61	1
106	4374650	4374842	909	1101	192	LEFT	D61a.EDF	D61	1
106	4377540	4377721	3799	3980	181	LEFT	D61a.EDF	D61	1
106	4377808	4377999	4067	4258	191	LEFT	D61a.EDF	D61	1
106	4378041	4378061	4300	4320	20	LEFT	D61a.EDF	D61	1
106	4378086	4378115	4345	4374	29	LEFT	D61a.EDF	D61	1
106	4378464	4378699	4723	4958	235	LEFT	D61a.EDF	D61	1
106	4379327	4379664	5586	5923	337	LEFT	D61a.EDF	D61	1
107	4381919	4382183	196	460	264	LEFT	D61a.EDF	D61	1
107	4382204	4382205	481	482	1	LEFT	D61a.EDF	D61	1
107	4382504	4382714	781	991	210	LEFT	D61a.EDF	D61	1
107	4382740	4382758	1017	1035	18	LEFT	D61a.EDF	D61	1
107	4382789	4382836	1066	1113	47	LEFT	D61a.EDF	D61	1
107	4387210	4388550	5487	6827	1340	LEFT	D61a.EDF	D61	1
108	4390729	4390976	57	304	247	LEFT	D61a.EDF	D61	1
108	4391729	4391861	1057	1189	132	LEFT	D61a.EDF	D61	1
108	4392817	4392935	2145	2263	118	LEFT	D61a.EDF	D61	1
109	4400119	4400252	372	505	133	LEFT	D61a.EDF	D61	1
109	4401215	4401389	1468	1642	174	LEFT	D61a.EDF	D61	1
110	4408621	4408771	1658	1808	150	LEFT	D61a.EDF	D61	1
111	4416996	4417151	1517	1672	155	LEFT	D61a.EDF	D61	1
112	4425328	4425438	57	167	110	LEFT	D61a.EDF	D61	1
112	4426483	4426605	1212	1334	122	LEFT	D61a.EDF	D61	1
113	4434561	4434708	1572	1719	147	LEFT	D61a.EDF	D61	1
114	4445145	4445271	791	917	126	LEFT	D61a.EDF	D61	1
116	4460627	4460761	242	376	134	LEFT	D61a.EDF	D61	1
117	4469846	4469983	826	963	137	LEFT	D61a.EDF	D61	1
119	4485588	4485761	551	724	173	LEFT	D61a.EDF	D61	1
1	5400553	5400847	5497	5791	294	LEFT	D61b.EDF	D61	2
2	5406104	5406275	79	250	171	LEFT	D61b.EDF	D61	2
3	5414507	5414621	147	261	114	LEFT	D61b.EDF	D61	2
3	5415031	5416392	671	2032	1361	LEFT	D61b.EDF	D61	2
3	5416580	5416604	2220	2244	24	LEFT	D61b.EDF	D61	2
3	5416629	5416796	2269	2436	167	LEFT	D61b.EDF	D61	2
3	5416818	5416818	2458	2458	0	LEFT	D61b.EDF	D61	2
4	5422305	5422470	68	233	165	LEFT	D61b.EDF	D61	2
5	5432622	5432751	226	355	129	LEFT	D61b.EDF	D61	2
7	5447861	5448020	132	291	159	LEFT	D61b.EDF	D61	2
8	5457501	5457665	1242	1406	164	LEFT	D61b.EDF	D61	2
10	5474428	5474593	435	600	165	LEFT	D61b.EDF	D61	2
11	5482618	5482769	193	344	151	LEFT	D61b.EDF	D61	2
12	5489878	5490026	88	236	148	LEFT	D61b.EDF	D61	2
15	5515735	5515865	173	303	130	LEFT	D61b.EDF	D61	2
15	5516364	5516510	802	948	146	LEFT	D61b.EDF	D61	2
15	5518226	5518226	2664	2664	0	LEFT	D61b.EDF	D61	2
16	5524169	5524328	438	597	159	LEFT	D61b.EDF	D61	2
17	5532698	5532884	832	1018	186	LEFT	D61b.EDF	D61	2
17	5533277	5533411	1411	1545	134	LEFT	D61b.EDF	D61	2
19	5549079	5549273	224	418	194	LEFT	D61b.EDF	D61	2
19	5551480	5551481	2625	2626	1	LEFT	D61b.EDF	D61	2
20	5559753	5559753	2132	2132	0	LEFT	D61b.EDF	D61	2
20	5559807	5559874	2186	2253	67	LEFT	D61b.EDF	D61	2
20	5559913	5559913	2292	2292	0	LEFT	D61b.EDF	D61	2
20	5559934	5560069	2313	2448	135	LEFT	D61b.EDF	D61	2
20	5560090	5560096	2469	2475	6	LEFT	D61b.EDF	D61	2
21	5566024	5566182	97	255	158	LEFT	D61b.EDF	D61	2
21	5566749	5566905	822	978	156	LEFT	D61b.EDF	D61	2
22	5574761	5574982	83	304	221	LEFT	D61b.EDF	D61	2
22	5576804	5576804	2126	2126	0	LEFT	D61b.EDF	D61	2
22	5576855	5576866	2177	2188	11	LEFT	D61b.EDF	D61	2
22	5576906	5576907	2228	2229	1	LEFT	D61b.EDF	D61	2
22	5580051	5580064	5373	5386	13	LEFT	D61b.EDF	D61	2
23	5583172	5583420	57	305	248	LEFT	D61b.EDF	D61	2
23	5585075	5585082	1960	1967	7	LEFT	D61b.EDF	D61	2
23	5585139	5585139	2024	2024	0	LEFT	D61b.EDF	D61	2
23	5585214	5585214	2099	2099	0	LEFT	D61b.EDF	D61	2
23	5585427	5585526	2312	2411	99	LEFT	D61b.EDF	D61	2
23	5585585	5585585	2470	2470	0	LEFT	D61b.EDF	D61	2
23	5585613	5585629	2498	2514	16	LEFT	D61b.EDF	D61	2
23	5585795	5585795	2680	2680	0	LEFT	D61b.EDF	D61	2
24	5593831	5593857	3124	3150	26	LEFT	D61b.EDF	D61	2
24	5593878	5593971	3171	3264	93	LEFT	D61b.EDF	D61	2
24	5594028	5594031	3321	3324	3	LEFT	D61b.EDF	D61	2
24	5594249	5594249	3542	3542	0	LEFT	D61b.EDF	D61	2
24	5594274	5594276	3567	3569	2	LEFT	D61b.EDF	D61	2
24	5594449	5594451	3742	3744	2	LEFT	D61b.EDF	D61	2
24	5595500	5595501	4793	4794	1	LEFT	D61b.EDF	D61	2
24	5596030	5596030	5323	5323	0	LEFT	D61b.EDF	D61	2
24	5596052	5596052	5345	5345	0	LEFT	D61b.EDF	D61	2
24	5596076	5596111	5369	5404	35	LEFT	D61b.EDF	D61	2
24	5596141	5596141	5434	5434	0	LEFT	D61b.EDF	D61	2
24	5596305	5596305	5598	5598	0	LEFT	D61b.EDF	D61	2
24	5596350	5596355	5643	5648	5	LEFT	D61b.EDF	D61	2
24	5596379	5596383	5672	5676	4	LEFT	D61b.EDF	D61	2
24	5596409	5596409	5702	5702	0	LEFT	D61b.EDF	D61	2
24	5596799	5596799	6092	6092	0	LEFT	D61b.EDF	D61	2
25	5603063	5603063	3328	3328	0	LEFT	D61b.EDF	D61	2
26	5607399	5607555	57	213	156	LEFT	D61b.EDF	D61	2
26	5610403	5610404	3061	3062	1	LEFT	D61b.EDF	D61	2
27	5615954	5616136	67	249	182	LEFT	D61b.EDF	D61	2
27	5616409	5616557	522	670	148	LEFT	D61b.EDF	D61	2
28	5625216	5625288	58	130	72	LEFT	D61b.EDF	D61	2
29	5633382	5633546	68	232	164	LEFT	D61b.EDF	D61	2
31	5650966	5651190	367	591	224	LEFT	D61b.EDF	D61	2
31	5653164	5653267	2565	2668	103	LEFT	D61b.EDF	D61	2
31	5653309	5653344	2710	2745	35	LEFT	D61b.EDF	D61	2
31	5654309	5654309	3710	3710	0	LEFT	D61b.EDF	D61	2
31	5654416	5654436	3817	3837	20	LEFT	D61b.EDF	D61	2
31	5654485	5654487	3886	3888	2	LEFT	D61b.EDF	D61	2
32	5659871	5660045	754	928	174	LEFT	D61b.EDF	D61	2
32	5661462	5661513	2345	2396	51	LEFT	D61b.EDF	D61	2
32	5661591	5661591	2474	2474	0	LEFT	D61b.EDF	D61	2
32	5661616	5661616	2499	2499	0	LEFT	D61b.EDF	D61	2
32	5661640	5661716	2523	2599	76	LEFT	D61b.EDF	D61	2
32	5661772	5661773	2655	2656	1	LEFT	D61b.EDF	D61	2
32	5661800	5661812	2683	2695	12	LEFT	D61b.EDF	D61	2
32	5661834	5662019	2717	2902	185	LEFT	D61b.EDF	D61	2
33	5667177	5667389	58	270	212	LEFT	D61b.EDF	D61	2
33	5667908	5667912	789	793	4	LEFT	D61b.EDF	D61	2
33	5667941	5668165	822	1046	224	LEFT	D61b.EDF	D61	2
33	5668209	5668243	1090	1124	34	LEFT	D61b.EDF	D61	2
33	5668271	5668332	1152	1213	61	LEFT	D61b.EDF	D61	2
33	5668357	5668357	1238	1238	0	LEFT	D61b.EDF	D61	2
33	5668398	5668401	1279	1282	3	LEFT	D61b.EDF	D61	2
33	5668422	5668479	1303	1360	57	LEFT	D61b.EDF	D61	2
33	5668509	5668511	1390	1392	2	LEFT	D61b.EDF	D61	2
33	5668555	5668556	1436	1437	1	LEFT	D61b.EDF	D61	2
33	5668607	5668607	1488	1488	0	LEFT	D61b.EDF	D61	2
33	5668709	5668715	1590	1596	6	LEFT	D61b.EDF	D61	2
33	5668784	5668846	1665	1727	62	LEFT	D61b.EDF	D61	2
33	5669571	5669575	2452	2456	4	LEFT	D61b.EDF	D61	2
33	5669623	5669623	2504	2504	0	LEFT	D61b.EDF	D61	2
33	5669731	5669732	2612	2613	1	LEFT	D61b.EDF	D61	2
33	5669818	5669831	2699	2712	13	LEFT	D61b.EDF	D61	2
33	5669868	5669881	2749	2762	13	LEFT	D61b.EDF	D61	2
33	5670087	5670087	2968	2968	0	LEFT	D61b.EDF	D61	2
34	5675857	5676029	787	959	172	LEFT	D61b.EDF	D61	2
36	5692714	5692902	299	487	188	LEFT	D61b.EDF	D61	2
37	5700161	5700357	194	390	196	LEFT	D61b.EDF	D61	2
37	5704982	5705131	5015	5164	149	LEFT	D61b.EDF	D61	2
38	5708954	5708999	58	103	45	LEFT	D61b.EDF	D61	2
40	5725128	5725334	326	532	206	LEFT	D61b.EDF	D61	2
40	5725693	5725899	891	1097	206	LEFT	D61b.EDF	D61	2
40	5728847	5728976	4045	4174	129	LEFT	D61b.EDF	D61	2
40	5730015	5730153	5213	5351	138	LEFT	D61b.EDF	D61	2
40	5730658	5730806	5856	6004	148	LEFT	D61b.EDF	D61	2
41	5732976	5733134	158	316	158	LEFT	D61b.EDF	D61	2
42	5741661	5741813	127	279	152	LEFT	D61b.EDF	D61	2
42	5741872	5741873	338	339	1	LEFT	D61b.EDF	D61	2
42	5742331	5742455	797	921	124	LEFT	D61b.EDF	D61	2
42	5742541	5742541	1007	1007	0	LEFT	D61b.EDF	D61	2
43	5749229	5749449	505	725	220	LEFT	D61b.EDF	D61	2
44	5756747	5756928	394	575	181	LEFT	D61b.EDF	D61	2
45	5765856	5766053	476	673	197	LEFT	D61b.EDF	D61	2
45	5766658	5766828	1278	1448	170	LEFT	D61b.EDF	D61	2
46	5774117	5774303	692	878	186	LEFT	D61b.EDF	D61	2
47	5782443	5782455	97	109	12	LEFT	D61b.EDF	D61	2
47	5782567	5782586	221	240	19	LEFT	D61b.EDF	D61	2
49	5799712	5799875	181	344	163	LEFT	D61b.EDF	D61	2
50	5808289	5808452	854	1017	163	LEFT	D61b.EDF	D61	2
50	5808872	5809053	1437	1618	181	LEFT	D61b.EDF	D61	2
50	5810315	5810315	2880	2880	0	LEFT	D61b.EDF	D61	2
51	5815235	5815416	64	245	181	LEFT	D61b.EDF	D61	2
51	5815439	5815449	268	278	10	LEFT	D61b.EDF	D61	2
51	5819266	5819281	4095	4110	15	LEFT	D61b.EDF	D61	2
51	5819310	5819311	4139	4140	1	LEFT	D61b.EDF	D61	2
51	5819505	5819506	4334	4335	1	LEFT	D61b.EDF	D61	2
52	5826804	5826806	3274	3276	2	LEFT	D61b.EDF	D61	2
52	5826882	5826882	3352	3352	0	LEFT	D61b.EDF	D61	2
52	5826903	5826904	3373	3374	1	LEFT	D61b.EDF	D61	2
52	5827194	5827195	3664	3665	1	LEFT	D61b.EDF	D61	2
52	5827316	5827345	3786	3815	29	LEFT	D61b.EDF	D61	2
53	5832158	5832318	937	1097	160	LEFT	D61b.EDF	D61	2
53	5833822	5833841	2601	2620	19	LEFT	D61b.EDF	D61	2
53	5833864	5833951	2643	2730	87	LEFT	D61b.EDF	D61	2
53	5833972	5833973	2751	2752	1	LEFT	D61b.EDF	D61	2
53	5834000	5834003	2779	2782	3	LEFT	D61b.EDF	D61	2
53	5834079	5834117	2858	2896	38	LEFT	D61b.EDF	D61	2
53	5834155	5834165	2934	2944	10	LEFT	D61b.EDF	D61	2
53	5834187	5834187	2966	2966	0	LEFT	D61b.EDF	D61	2
53	5834214	5834215	2993	2994	1	LEFT	D61b.EDF	D61	2
53	5834284	5834284	3063	3063	0	LEFT	D61b.EDF	D61	2
53	5836128	5836128	4907	4907	0	LEFT	D61b.EDF	D61	2
53	5836211	5836211	4990	4990	0	LEFT	D61b.EDF	D61	2
54	5845433	5845589	6763	6919	156	LEFT	D61b.EDF	D61	2
55	5848421	5848582	382	543	161	LEFT	D61b.EDF	D61	2
55	5849168	5849169	1129	1130	1	LEFT	D61b.EDF	D61	2
55	5849609	5849610	1570	1571	1	LEFT	D61b.EDF	D61	2
55	5849634	5849636	1595	1597	2	LEFT	D61b.EDF	D61	2
55	5849697	5849752	1658	1713	55	LEFT	D61b.EDF	D61	2
56	5856363	5856519	587	743	156	LEFT	D61b.EDF	D61	2
59	5882342	5882434	59	151	92	LEFT	D61b.EDF	D61	2
60	5890576	5890741	879	1044	165	LEFT	D61b.EDF	D61	2
61	5898289	5898421	268	400	132	LEFT	D61b.EDF	D61	2
62	5905517	5905672	151	306	155	LEFT	D61b.EDF	D61	2
64	5923263	5923408	230	375	145	LEFT	D61b.EDF	D61	2
65	5932381	5932463	80	162	82	LEFT	D61b.EDF	D61	2
65	5932665	5932805	364	504	140	LEFT	D61b.EDF	D61	2
65	5933253	5933386	952	1085	133	LEFT	D61b.EDF	D61	2
66	5942228	5942354	234	360	126	LEFT	D61b.EDF	D61	2
66	5943176	5943402	1182	1408	226	LEFT	D61b.EDF	D61	2
67	5950121	5950250	57	186	129	LEFT	D61b.EDF	D61	2
69	5965700	5965840	637	777	140	LEFT	D61b.EDF	D61	2
70	5974062	5974225	87	250	163	LEFT	D61b.EDF	D61	2
71	5983464	5983616	271	423	152	LEFT	D61b.EDF	D61	2
74	6008787	6008814	57	84	27	LEFT	D61b.EDF	D61	2
74	6008959	6009085	229	355	126	LEFT	D61b.EDF	D61	2
74	6009764	6009905	1034	1175	141	LEFT	D61b.EDF	D61	2
74	6010365	6010464	1635	1734	99	LEFT	D61b.EDF	D61	2
81	6067561	6067708	136	283	147	LEFT	D61b.EDF	D61	2
81	6068463	6068676	1038	1251	213	LEFT	D61b.EDF	D61	2
82	6076692	6076818	151	277	126	LEFT	D61b.EDF	D61	2
82	6077312	6077478	771	937	166	LEFT	D61b.EDF	D61	2
85	6103364	6103543	160	339	179	LEFT	D61b.EDF	D61	2
86	6110550	6110726	58	234	176	LEFT	D61b.EDF	D61	2
87	6118496	6118646	160	310	150	LEFT	D61b.EDF	D61	2
89	6134038	6134207	75	244	169	LEFT	D61b.EDF	D61	2
91	6150040	6150221	88	269	181	LEFT	D61b.EDF	D61	2
91	6151308	6151479	1356	1527	171	LEFT	D61b.EDF	D61	2
93	6168288	6168449	2683	2844	161	LEFT	D61b.EDF	D61	2
97	6198189	6198191	708	710	2	LEFT	D61b.EDF	D61	2
98	6204798	6204904	57	163	106	LEFT	D61b.EDF	D61	2
98	6205164	6205334	423	593	170	LEFT	D61b.EDF	D61	2
98	6205866	6206015	1125	1274	149	LEFT	D61b.EDF	D61	2
99	6212664	6212836	100	272	172	LEFT	D61b.EDF	D61	2
99	6213203	6213367	639	803	164	LEFT	D61b.EDF	D61	2
99	6213839	6214026	1275	1462	187	LEFT	D61b.EDF	D61	2
100	6222427	6222467	57	97	40	LEFT	D61b.EDF	D61	2
100	6224085	6224236	1715	1866	151	LEFT	D61b.EDF	D61	2
100	6225047	6225228	2677	2858	181	LEFT	D61b.EDF	D61	2
102	6240667	6240829	136	298	162	LEFT	D61b.EDF	D61	2
103	6249244	6249396	58	210	152	LEFT	D61b.EDF	D61	2
103	6249639	6249769	453	583	130	LEFT	D61b.EDF	D61	2
104	6256974	6257141	115	282	167	LEFT	D61b.EDF	D61	2
104	6257563	6257717	704	858	154	LEFT	D61b.EDF	D61	2
112	6321596	6321712	57	173	116	LEFT	D61b.EDF	D61	2
112	6322191	6322350	652	811	159	LEFT	D61b.EDF	D61	2
112	6323026	6323170	1487	1631	144	LEFT	D61b.EDF	D61	2
113	6328773	6328884	57	168	111	LEFT	D61b.EDF	D61	2
115	6344774	6344939	99	264	165	LEFT	D61b.EDF	D61	2
116	6355092	6355234	99	241	142	LEFT	D61b.EDF	D61	2
116	6355751	6355900	758	907	149	LEFT	D61b.EDF	D61	2
117	6362517	6362683	110	276	166	LEFT	D61b.EDF	D61	2
118	6370828	6370879	57	108	51	LEFT	D61b.EDF	D61	2
3	6703109	6703261	67	219	152	LEFT	D61c.EDF	D61	3
3	6703863	6704010	821	968	147	LEFT	D61c.EDF	D61	3
5	6718580	6718766	492	678	186	LEFT	D61c.EDF	D61	3
6	6728337	6728338	2224	2225	1	LEFT	D61c.EDF	D61	3
6	6728376	6728376	2263	2263	0	LEFT	D61c.EDF	D61	3
6	6728462	6728485	2349	2372	23	LEFT	D61c.EDF	D61	3
6	6728559	6728585	2446	2472	26	LEFT	D61c.EDF	D61	3
7	6734753	6734923	597	767	170	LEFT	D61c.EDF	D61	3
7	6736212	6736212	2056	2056	0	LEFT	D61c.EDF	D61	3
7	6736332	6736332	2176	2176	0	LEFT	D61c.EDF	D61	3
8	6743057	6743221	715	879	164	LEFT	D61c.EDF	D61	3
8	6744033	6744158	1691	1816	125	LEFT	D61c.EDF	D61	3
10	6761553	6761555	2419	2421	2	LEFT	D61c.EDF	D61	3
11	6768532	6768592	59	119	60	LEFT	D61c.EDF	D61	3
11	6768645	6768645	172	172	0	LEFT	D61c.EDF	D61	3
11	6768666	6768669	193	196	3	LEFT	D61c.EDF	D61	3
11	6768697	6768939	224	466	242	LEFT	D61c.EDF	D61	3
11	6768986	6768986	513	513	0	LEFT	D61c.EDF	D61	3
11	6769009	6769191	536	718	182	LEFT	D61c.EDF	D61	3
11	6769225	6769225	752	752	0	LEFT	D61c.EDF	D61	3
11	6770658	6770662	2185	2189	4	LEFT	D61c.EDF	D61	3
11	6770739	6770755	2266	2282	16	LEFT	D61c.EDF	D61	3
11	6770815	6771043	2342	2570	228	LEFT	D61c.EDF	D61	3
11	6771081	6771081	2608	2608	0	LEFT	D61c.EDF	D61	3
11	6771109	6771112	2636	2639	3	LEFT	D61c.EDF	D61	3
11	6771143	6771144	2670	2671	1	LEFT	D61c.EDF	D61	3
11	6771174	6771175	2701	2702	1	LEFT	D61c.EDF	D61	3
11	6771218	6771276	2745	2803	58	LEFT	D61c.EDF	D61	3
11	6771305	6771305	2832	2832	0	LEFT	D61c.EDF	D61	3
12	6778878	6778878	2076	2076	0	LEFT	D61c.EDF	D61	3
12	6778905	6778921	2103	2119	16	LEFT	D61c.EDF	D61	3
12	6778989	6779001	2187	2199	12	LEFT	D61c.EDF	D61	3
12	6779061	6779142	2259	2340	81	LEFT	D61c.EDF	D61	3
12	6779172	6779285	2370	2483	113	LEFT	D61c.EDF	D61	3
12	6779321	6779389	2519	2587	68	LEFT	D61c.EDF	D61	3
12	6779502	6779520	2700	2718	18	LEFT	D61c.EDF	D61	3
12	6779543	6779543	2741	2741	0	LEFT	D61c.EDF	D61	3
13	6785705	6785884	58	237	179	LEFT	D61c.EDF	D61	3
13	6786987	6787124	1340	1477	137	LEFT	D61c.EDF	D61	3
14	6792513	6792513	331	331	0	LEFT	D61c.EDF	D61	3
14	6795116	6795124	2934	2942	8	LEFT	D61c.EDF	D61	3
14	6795146	6795306	2964	3124	160	LEFT	D61c.EDF	D61	3
14	6795333	6795338	3151	3156	5	LEFT	D61c.EDF	D61	3
14	6795359	6795398	3177	3216	39	LEFT	D61c.EDF	D61	3
14	6795419	6795556	3237	3374	137	LEFT	D61c.EDF	D61	3
14	6795589	6795589	3407	3407	0	LEFT	D61c.EDF	D61	3
14	6795648	6795675	3466	3493	27	LEFT	D61c.EDF	D61	3
14	6795784	6795833	3602	3651	49	LEFT	D61c.EDF	D61	3
14	6796006	6796008	3824	3826	2	LEFT	D61c.EDF	D61	3
14	6796058	6796059	3876	3877	1	LEFT	D61c.EDF	D61	3
14	6796081	6796139	3899	3957	58	LEFT	D61c.EDF	D61	3
14	6796163	6796182	3981	4000	19	LEFT	D61c.EDF	D61	3
14	6796208	6796261	4026	4079	53	LEFT	D61c.EDF	D61	3
14	6796282	6796284	4100	4102	2	LEFT	D61c.EDF	D61	3
14	6796314	6796314	4132	4132	0	LEFT	D61c.EDF	D61	3
14	6796345	6796383	4163	4201	38	LEFT	D61c.EDF	D61	3
14	6796428	6796441	4246	4259	13	LEFT	D61c.EDF	D61	3
14	6796537	6796552	4355	4370	15	LEFT	D61c.EDF	D61	3
14	6796580	6796580	4398	4398	0	LEFT	D61c.EDF	D61	3
14	6796607	6796643	4425	4461	36	LEFT	D61c.EDF	D61	3
14	6796715	6796723	4533	4541	8	LEFT	D61c.EDF	D61	3
14	6796779	6796779	4597	4597	0	LEFT	D61c.EDF	D61	3
14	6797018	6797019	4836	4837	1	LEFT	D61c.EDF	D61	3
15	6799294	6799297	81	84	3	LEFT	D61c.EDF	D61	3
15	6799340	6799352	127	139	12	LEFT	D61c.EDF	D61	3
15	6801309	6801310	2096	2097	1	LEFT	D61c.EDF	D61	3
15	6801333	6801333	2120	2120	0	LEFT	D61c.EDF	D61	3
15	6801372	6801745	2159	2532	373	LEFT	D61c.EDF	D61	3
15	6801780	6801783	2567	2570	3	LEFT	D61c.EDF	D61	3
15	6801880	6801880	2667	2667	0	LEFT	D61c.EDF	D61	3
16	6807074	6807260	475	661	186	LEFT	D61c.EDF	D61	3
16	6808401	6808513	1802	1914	112	LEFT	D61c.EDF	D61	3
16	6808816	6808917	2217	2318	101	LEFT	D61c.EDF	D61	3
16	6808938	6808941	2339	2342	3	LEFT	D61c.EDF	D61	3
16	6808971	6809000	2372	2401	29	LEFT	D61c.EDF	D61	3
16	6809762	6809762	3163	3163	0	LEFT	D61c.EDF	D61	3
17	6813832	6813833	101	102	1	LEFT	D61c.EDF	D61	3
17	6815650	6815650	1919	1919	0	LEFT	D61c.EDF	D61	3
17	6815702	6815797	1971	2066	95	LEFT	D61c.EDF	D61	3
17	6815966	6816065	2235	2334	99	LEFT	D61c.EDF	D61	3
17	6816136	6816174	2405	2443	38	LEFT	D61c.EDF	D61	3
17	6816196	6816256	2465	2525	60	LEFT	D61c.EDF	D61	3
17	6816295	6816295	2564	2564	0	LEFT	D61c.EDF	D61	3
18	6822791	6822951	224	384	160	LEFT	D61c.EDF	D61	3
18	6824376	6824378	1809	1811	2	LEFT	D61c.EDF	D61	3
18	6824446	6824563	1879	1996	117	LEFT	D61c.EDF	D61	3
18	6824596	6824610	2029	2043	14	LEFT	D61c.EDF	D61	3
18	6824674	6824675	2107	2108	1	LEFT	D61c.EDF	D61	3
18	6824697	6824697	2130	2130	0	LEFT	D61c.EDF	D61	3
18	6824761	6824785	2194	2218	24	LEFT	D61c.EDF	D61	3
18	6824820	6824822	2253	2255	2	LEFT	D61c.EDF	D61	3
18	6824849	6824852	2282	2285	3	LEFT	D61c.EDF	D61	3
18	6824874	6824901	2307	2334	27	LEFT	D61c.EDF	D61	3
18	6824959	6825102	2392	2535	143	LEFT	D61c.EDF	D61	3
18	6825123	6825156	2556	2589	33	LEFT	D61c.EDF	D61	3
18	6825221	6825224	2654	2657	3	LEFT	D61c.EDF	D61	3
18	6825245	6825245	2678	2678	0	LEFT	D61c.EDF	D61	3
20	6839305	6839316	2090	2101	11	LEFT	D61c.EDF	D61	3
20	6839531	6839556	2316	2341	25	LEFT	D61c.EDF	D61	3
20	6839581	6839584	2366	2369	3	LEFT	D61c.EDF	D61	3
20	6839615	6839662	2400	2447	47	LEFT	D61c.EDF	D61	3
21	6846298	6846493	147	342	195	LEFT	D61c.EDF	D61	3
21	6848009	6848366	1858	2215	357	LEFT	D61c.EDF	D61	3
21	6848388	6848422	2237	2271	34	LEFT	D61c.EDF	D61	3
21	6848447	6848514	2296	2363	67	LEFT	D61c.EDF	D61	3
21	6848540	6848548	2389	2397	8	LEFT	D61c.EDF	D61	3
21	6848579	6848579	2428	2428	0	LEFT	D61c.EDF	D61	3
22	6855022	6855072	96	146	50	LEFT	D61c.EDF	D61	3
22	6857768	6857769	2842	2843	1	LEFT	D61c.EDF	D61	3
22	6857801	6857802	2875	2876	1	LEFT	D61c.EDF	D61	3
22	6857859	6857859	2933	2933	0	LEFT	D61c.EDF	D61	3
23	6863281	6863492	58	269	211	LEFT	D61c.EDF	D61	3
23	6865115	6865180	1892	1957	65	LEFT	D61c.EDF	D61	3
23	6866940	6867066	3717	3843	126	LEFT	D61c.EDF	D61	3
23	6867131	6867594	3908	4371	463	LEFT	D61c.EDF	D61	3
23	6867619	6868010	4396	4787	391	LEFT	D61c.EDF	D61	3
23	6868040	6868046	4817	4823	6	LEFT	D61c.EDF	D61	3
24	6870403	6870609	562	768	206	LEFT	D61c.EDF	D61	3
24	6872543	6872749	2702	2908	206	LEFT	D61c.EDF	D61	3
24	6872778	6872908	2937	3067	130	LEFT	D61c.EDF	D61	3
24	6872930	6873147	3089	3306	217	LEFT	D61c.EDF	D61	3
24	6873168	6873214	3327	3373	46	LEFT	D61c.EDF	D61	3
24	6873251	6873305	3410	3464	54	LEFT	D61c.EDF	D61	3
24	6873368	6873636	3527	3795	268	LEFT	D61c.EDF	D61	3
24	6873678	6873678	3837	3837	0	LEFT	D61c.EDF	D61	3
24	6873725	6873809	3884	3968	84	LEFT	D61c.EDF	D61	3
24	6873833	6874054	3992	4213	221	LEFT	D61c.EDF	D61	3
24	6874082	6874109	4241	4268	27	LEFT	D61c.EDF	D61	3
24	6874148	6874300	4307	4459	152	LEFT	D61c.EDF	D61	3
24	6874336	6874337	4495	4496	1	LEFT	D61c.EDF	D61	3
24	6874358	6874417	4517	4576	59	LEFT	D61c.EDF	D61	3
24	6874450	6874498	4609	4657	48	LEFT	D61c.EDF	D61	3
24	6874539	6874972	4698	5131	433	LEFT	D61c.EDF	D61	3
24	6875016	6875267	5175	5426	251	LEFT	D61c.EDF	D61	3
24	6875325	6875420	5484	5579	95	LEFT	D61c.EDF	D61	3
24	6875468	6875558	5627	5717	90	LEFT	D61c.EDF	D61	3
24	6875633	6875814	5792	5973	181	LEFT	D61c.EDF	D61	3
24	6875836	6875836	5995	5995	0	LEFT	D61c.EDF	D61	3
24	6875859	6875911	6018	6070	52	LEFT	D61c.EDF	D61	3
24	6875951	6875952	6110	6111	1	LEFT	D61c.EDF	D61	3
25	6878409	6878421	746	758	12	LEFT	D61c.EDF	D61	3
25	6878455	6878855	792	1192	400	LEFT	D61c.EDF	D61	3
25	6878885	6878886	1222	1223	1	LEFT	D61c.EDF	D61	3
25	6878918	6879075	1255	1412	157	LEFT	D61c.EDF	D61	3
25	6879133	6879133	1470	1470	0	LEFT	D61c.EDF	D61	3
25	6879176	6879213	1513	1550	37	LEFT	D61c.EDF	D61	3
25	6879235	6879281	1572	1618	46	LEFT	D61c.EDF	D61	3
25	6879316	6879385	1653	1722	69	LEFT	D61c.EDF	D61	3
25	6879790	6880098	2127	2435	308	LEFT	D61c.EDF	D61	3
25	6880126	6880212	2463	2549	86	LEFT	D61c.EDF	D61	3
25	6880285	6880286	2622	2623	1	LEFT	D61c.EDF	D61	3
26	6885630	6885649	254	273	19	LEFT	D61c.EDF	D61	3
26	6885886	6885911	510	535	25	LEFT	D61c.EDF	D61	3
26	6885937	6885937	561	561	0	LEFT	D61c.EDF	D61	3
26	6885958	6885999	582	623	41	LEFT	D61c.EDF	D61	3
26	6886026	6886036	650	660	10	LEFT	D61c.EDF	D61	3
26	6886081	6886081	705	705	0	LEFT	D61c.EDF	D61	3
26	6886171	6886183	795	807	12	LEFT	D61c.EDF	D61	3
26	6886212	6886274	836	898	62	LEFT	D61c.EDF	D61	3
26	6886318	6886318	942	942	0	LEFT	D61c.EDF	D61	3
26	6886376	6886388	1000	1012	12	LEFT	D61c.EDF	D61	3
26	6886417	6886417	1041	1041	0	LEFT	D61c.EDF	D61	3
26	6886446	6886449	1070	1073	3	LEFT	D61c.EDF	D61	3
26	6886624	6886625	1248	1249	1	LEFT	D61c.EDF	D61	3
26	6886673	6886673	1297	1297	0	LEFT	D61c.EDF	D61	3
26	6886860	6886861	1484	1485	1	LEFT	D61c.EDF	D61	3
26	6887042	6887161	1666	1785	119	LEFT	D61c.EDF	D61	3
26	6888081	6888081	2705	2705	0	LEFT	D61c.EDF	D61	3
26	6888102	6891819	2726	6443	3717	LEFT	D61c.EDF	D61	3
26	6891843	6891937	6467	6561	94	LEFT	D61c.EDF	D61	3
26	6891994	6892011	6618	6635	17	LEFT	D61c.EDF	D61	3
27	6894356	6894570	282	496	214	LEFT	D61c.EDF	D61	3
27	6894627	6894658	553	584	31	LEFT	D61c.EDF	D61	3
27	6894836	6894841	762	767	5	LEFT	D61c.EDF	D61	3
27	6896016	6896028	1942	1954	12	LEFT	D61c.EDF	D61	3
27	6896068	6896356	1994	2282	288	LEFT	D61c.EDF	D61	3
27	6896544	6896772	2470	2698	228	LEFT	D61c.EDF	D61	3
27	6896808	6896860	2734	2786	52	LEFT	D61c.EDF	D61	3
27	6896885	6897321	2811	3247	436	LEFT	D61c.EDF	D61	3
27	6897362	6897453	3288	3379	91	LEFT	D61c.EDF	D61	3
27	6897580	6897596	3506	3522	16	LEFT	D61c.EDF	D61	3
27	6897694	6897695	3620	3621	1	LEFT	D61c.EDF	D61	3
27	6897879	6897880	3805	3806	1	LEFT	D61c.EDF	D61	3
27	6897902	6897906	3828	3832	4	LEFT	D61c.EDF	D61	3
27	6897945	6898248	3871	4174	303	LEFT	D61c.EDF	D61	3
27	6898760	6900316	4686	6242	1556	LEFT	D61c.EDF	D61	3
28	6901976	6902216	76	316	240	LEFT	D61c.EDF	D61	3
28	6902260	6902390	360	490	130	LEFT	D61c.EDF	D61	3
28	6902412	6902495	512	595	83	LEFT	D61c.EDF	D61	3
28	6902537	6902589	637	689	52	LEFT	D61c.EDF	D61	3
28	6902655	6902677	755	777	22	LEFT	D61c.EDF	D61	3
28	6902735	6902752	835	852	17	LEFT	D61c.EDF	D61	3
28	6902841	6902841	941	941	0	LEFT	D61c.EDF	D61	3
28	6902942	6902958	1042	1058	16	LEFT	D61c.EDF	D61	3
28	6903046	6903197	1146	1297	151	LEFT	D61c.EDF	D61	3
28	6903225	6903271	1325	1371	46	LEFT	D61c.EDF	D61	3
28	6903292	6903296	1392	1396	4	LEFT	D61c.EDF	D61	3
28	6903322	6903322	1422	1422	0	LEFT	D61c.EDF	D61	3
28	6903372	6903379	1472	1479	7	LEFT	D61c.EDF	D61	3
28	6903424	6903424	1524	1524	0	LEFT	D61c.EDF	D61	3
28	6903531	6903604	1631	1704	73	LEFT	D61c.EDF	D61	3
28	6903629	6903657	1729	1757	28	LEFT	D61c.EDF	D61	3
28	6904184	6904184	2284	2284	0	LEFT	D61c.EDF	D61	3
28	6904213	6904286	2313	2386	73	LEFT	D61c.EDF	D61	3
28	6904311	6904815	2411	2915	504	LEFT	D61c.EDF	D61	3
28	6904840	6904895	2940	2995	55	LEFT	D61c.EDF	D61	3
28	6904927	6904935	3027	3035	8	LEFT	D61c.EDF	D61	3
28	6904971	6904980	3071	3080	9	LEFT	D61c.EDF	D61	3
28	6905014	6905042	3114	3142	28	LEFT	D61c.EDF	D61	3
28	6905081	6905081	3181	3181	0	LEFT	D61c.EDF	D61	3
28	6905165	6905166	3265	3266	1	LEFT	D61c.EDF	D61	3
28	6905296	6905296	3396	3396	0	LEFT	D61c.EDF	D61	3
29	6910765	6910775	561	571	10	LEFT	D61c.EDF	D61	3
29	6911018	6911018	814	814	0	LEFT	D61c.EDF	D61	3
29	6911097	6911097	893	893	0	LEFT	D61c.EDF	D61	3
29	6911751	6911751	1547	1547	0	LEFT	D61c.EDF	D61	3
29	6911925	6912078	1721	1874	153	LEFT	D61c.EDF	D61	3
29	6912236	6912238	2032	2034	2	LEFT	D61c.EDF	D61	3
29	6912267	6912288	2063	2084	21	LEFT	D61c.EDF	D61	3
29	6912783	6913254	2579	3050	471	LEFT	D61c.EDF	D61	3
29	6913286	6913309	3082	3105	23	LEFT	D61c.EDF	D61	3
29	6913335	6913409	3131	3205	74	LEFT	D61c.EDF	D61	3
29	6913441	6913441	3237	3237	0	LEFT	D61c.EDF	D61	3
29	6913825	6913842	3621	3638	17	LEFT	D61c.EDF	D61	3
29	6913971	6914311	3767	4107	340	LEFT	D61c.EDF	D61	3
29	6914334	6914808	4130	4604	474	LEFT	D61c.EDF	D61	3
29	6914837	6915466	4633	5262	629	LEFT	D61c.EDF	D61	3
30	6918223	6918516	64	357	293	LEFT	D61c.EDF	D61	3
30	6918542	6918559	383	400	17	LEFT	D61c.EDF	D61	3
30	6918585	6918844	426	685	259	LEFT	D61c.EDF	D61	3
30	6919289	6919461	1130	1302	172	LEFT	D61c.EDF	D61	3
30	6919520	6919520	1361	1361	0	LEFT	D61c.EDF	D61	3
30	6919547	6919556	1388	1397	9	LEFT	D61c.EDF	D61	3
30	6919584	6919608	1425	1449	24	LEFT	D61c.EDF	D61	3
30	6919917	6919944	1758	1785	27	LEFT	D61c.EDF	D61	3
30	6920309	6920354	2150	2195	45	LEFT	D61c.EDF	D61	3
30	6920380	6920380	2221	2221	0	LEFT	D61c.EDF	D61	3
30	6921190	6921199	3031	3040	9	LEFT	D61c.EDF	D61	3
30	6921226	6921807	3067	3648	581	LEFT	D61c.EDF	D61	3
30	6921830	6921831	3671	3672	1	LEFT	D61c.EDF	D61	3
30	6921911	6921911	3752	3752	0	LEFT	D61c.EDF	D61	3
30	6922404	6922404	4245	4245	0	LEFT	D61c.EDF	D61	3
30	6922443	6922443	4284	4284	0	LEFT	D61c.EDF	D61	3
30	6922465	6922522	4306	4363	57	LEFT	D61c.EDF	D61	3
30	6922546	6922601	4387	4442	55	LEFT	D61c.EDF	D61	3
30	6922624	6923481	4465	5322	857	LEFT	D61c.EDF	D61	3
31	6925790	6925888	57	155	98	LEFT	D61c.EDF	D61	3
31	6925915	6926889	182	1156	974	LEFT	D61c.EDF	D61	3
31	6926923	6926972	1190	1239	49	LEFT	D61c.EDF	D61	3
31	6927027	6927119	1294	1386	92	LEFT	D61c.EDF	D61	3
31	6927140	6927152	1407	1419	12	LEFT	D61c.EDF	D61	3
31	6927233	6927247	1500	1514	14	LEFT	D61c.EDF	D61	3
31	6927822	6927832	2089	2099	10	LEFT	D61c.EDF	D61	3
31	6927860	6928325	2127	2592	465	LEFT	D61c.EDF	D61	3
31	6928355	6928445	2622	2712	90	LEFT	D61c.EDF	D61	3
31	6928471	6928490	2738	2757	19	LEFT	D61c.EDF	D61	3
31	6928517	6928529	2784	2796	12	LEFT	D61c.EDF	D61	3
31	6928564	6928589	2831	2856	25	LEFT	D61c.EDF	D61	3
31	6930429	6930429	4696	4696	0	LEFT	D61c.EDF	D61	3
32	6933216	6933216	487	487	0	LEFT	D61c.EDF	D61	3
32	6933258	6933457	529	728	199	LEFT	D61c.EDF	D61	3
32	6934529	6934620	1800	1891	91	LEFT	D61c.EDF	D61	3
32	6935157	6935332	2428	2603	175	LEFT	D61c.EDF	D61	3
32	6935355	6935355	2626	2626	0	LEFT	D61c.EDF	D61	3
32	6935390	6935390	2661	2661	0	LEFT	D61c.EDF	D61	3
32	6935412	6935554	2683	2825	142	LEFT	D61c.EDF	D61	3
33	6939219	6939560	76	417	341	LEFT	D61c.EDF	D61	3
33	6939724	6939724	581	581	0	LEFT	D61c.EDF	D61	3
33	6939796	6939796	653	653	0	LEFT	D61c.EDF	D61	3
33	6939828	6939842	685	699	14	LEFT	D61c.EDF	D61	3
33	6940802	6940804	1659	1661	2	LEFT	D61c.EDF	D61	3
33	6940841	6940939	1698	1796	98	LEFT	D61c.EDF	D61	3
33	6941694	6941697	2551	2554	3	LEFT	D61c.EDF	D61	3
33	6941719	6944278	2576	5135	2559	LEFT	D61c.EDF	D61	3
33	6944316	6944622	5173	5479	306	LEFT	D61c.EDF	D61	3
33	6944647	6944677	5504	5534	30	LEFT	D61c.EDF	D61	3
33	6944702	6945118	5559	5975	416	LEFT	D61c.EDF	D61	3
33	6945147	6945150	6004	6007	3	LEFT	D61c.EDF	D61	3
33	6945207	6945231	6064	6088	24	LEFT	D61c.EDF	D61	3
33	6945317	6945384	6174	6241	67	LEFT	D61c.EDF	D61	3
33	6945434	6945436	6291	6293	2	LEFT	D61c.EDF	D61	3
33	6945467	6945467	6324	6324	0	LEFT	D61c.EDF	D61	3
33	6946036	6946087	6893	6944	51	LEFT	D61c.EDF	D61	3
33	6946152	6946164	7009	7021	12	LEFT	D61c.EDF	D61	3
34	6948212	6948215	104	107	3	LEFT	D61c.EDF	D61	3
34	6948287	6948299	179	191	12	LEFT	D61c.EDF	D61	3
34	6948323	6948550	215	442	227	LEFT	D61c.EDF	D61	3
34	6948698	6948716	590	608	18	LEFT	D61c.EDF	D61	3
34	6948792	6948803	684	695	11	LEFT	D61c.EDF	D61	3
34	6948858	6948878	750	770	20	LEFT	D61c.EDF	D61	3
34	6949506	6949507	1398	1399	1	LEFT	D61c.EDF	D61	3
34	6949799	6949799	1691	1691	0	LEFT	D61c.EDF	D61	3
34	6949847	6949976	1739	1868	129	LEFT	D61c.EDF	D61	3
34	6950278	6950280	2170	2172	2	LEFT	D61c.EDF	D61	3
34	6950324	6950869	2216	2761	545	LEFT	D61c.EDF	D61	3
34	6951101	6951101	2993	2993	0	LEFT	D61c.EDF	D61	3
34	6951425	6951425	3317	3317	0	LEFT	D61c.EDF	D61	3
34	6951505	6951505	3397	3397	0	LEFT	D61c.EDF	D61	3
34	6951668	6951668	3560	3560	0	LEFT	D61c.EDF	D61	3
34	6951731	6951731	3623	3623	0	LEFT	D61c.EDF	D61	3
34	6951872	6951873	3764	3765	1	LEFT	D61c.EDF	D61	3
34	6951929	6951930	3821	3822	1	LEFT	D61c.EDF	D61	3
34	6951951	6951964	3843	3856	13	LEFT	D61c.EDF	D61	3
34	6952004	6952004	3896	3896	0	LEFT	D61c.EDF	D61	3
34	6952059	6952062	3951	3954	3	LEFT	D61c.EDF	D61	3
34	6952089	6952315	3981	4207	226	LEFT	D61c.EDF	D61	3
34	6952371	6952388	4263	4280	17	LEFT	D61c.EDF	D61	3
34	6952430	6952430	4322	4322	0	LEFT	D61c.EDF	D61	3
34	6952452	6952470	4344	4362	18	LEFT	D61c.EDF	D61	3
34	6952589	6952589	4481	4481	0	LEFT	D61c.EDF	D61	3
34	6953054	6953055	4946	4947	1	LEFT	D61c.EDF	D61	3
34	6954633	6954633	6525	6525	0	LEFT	D61c.EDF	D61	3
34	6954672	6954672	6564	6564	0	LEFT	D61c.EDF	D61	3
34	6954864	6954864	6756	6756	0	LEFT	D61c.EDF	D61	3
34	6954907	6954920	6799	6812	13	LEFT	D61c.EDF	D61	3
35	6956867	6957038	58	229	171	LEFT	D61c.EDF	D61	3
35	6957078	6957079	269	270	1	LEFT	D61c.EDF	D61	3
35	6957102	6957138	293	329	36	LEFT	D61c.EDF	D61	3
35	6957185	6957193	376	384	8	LEFT	D61c.EDF	D61	3
35	6957221	6957229	412	420	8	LEFT	D61c.EDF	D61	3
35	6957288	6957288	479	479	0	LEFT	D61c.EDF	D61	3
35	6957388	6957388	579	579	0	LEFT	D61c.EDF	D61	3
35	6957592	6957758	783	949	166	LEFT	D61c.EDF	D61	3
35	6958433	6958434	1624	1625	1	LEFT	D61c.EDF	D61	3
35	6958643	6958654	1834	1845	11	LEFT	D61c.EDF	D61	3
35	6959231	6959424	2422	2615	193	LEFT	D61c.EDF	D61	3
35	6959549	6959554	2740	2745	5	LEFT	D61c.EDF	D61	3
36	6964347	6964528	139	320	181	LEFT	D61c.EDF	D61	3
36	6964910	6964911	702	703	1	LEFT	D61c.EDF	D61	3
36	6964998	6964999	790	791	1	LEFT	D61c.EDF	D61	3
36	6965137	6965139	929	931	2	LEFT	D61c.EDF	D61	3
36	6965270	6965272	1062	1064	2	LEFT	D61c.EDF	D61	3
36	6965320	6965320	1112	1112	0	LEFT	D61c.EDF	D61	3
36	6965415	6965415	1207	1207	0	LEFT	D61c.EDF	D61	3
36	6965464	6965473	1256	1265	9	LEFT	D61c.EDF	D61	3
36	6965731	6965748	1523	1540	17	LEFT	D61c.EDF	D61	3
36	6965800	6965899	1592	1691	99	LEFT	D61c.EDF	D61	3
36	6965928	6965939	1720	1731	11	LEFT	D61c.EDF	D61	3
36	6966077	6966079	1869	1871	2	LEFT	D61c.EDF	D61	3
36	6966130	6966157	1922	1949	27	LEFT	D61c.EDF	D61	3
36	6967483	6967483	3275	3275	0	LEFT	D61c.EDF	D61	3
36	6967530	6967604	3322	3396	74	LEFT	D61c.EDF	D61	3
36	6967628	6967690	3420	3482	62	LEFT	D61c.EDF	D61	3
36	6967715	6967801	3507	3593	86	LEFT	D61c.EDF	D61	3
36	6967889	6967891	3681	3683	2	LEFT	D61c.EDF	D61	3
36	6967930	6967933	3722	3725	3	LEFT	D61c.EDF	D61	3
36	6967962	6967966	3754	3758	4	LEFT	D61c.EDF	D61	3
36	6968010	6968013	3802	3805	3	LEFT	D61c.EDF	D61	3
36	6968042	6968098	3834	3890	56	LEFT	D61c.EDF	D61	3
36	6968217	6968220	4009	4012	3	LEFT	D61c.EDF	D61	3
36	6968335	6968335	4127	4127	0	LEFT	D61c.EDF	D61	3
36	6968562	6968569	4354	4361	7	LEFT	D61c.EDF	D61	3
36	6968614	6968630	4406	4422	16	LEFT	D61c.EDF	D61	3
36	6968689	6968728	4481	4520	39	LEFT	D61c.EDF	D61	3
36	6968854	6968856	4646	4648	2	LEFT	D61c.EDF	D61	3
36	6968890	6968893	4682	4685	3	LEFT	D61c.EDF	D61	3
36	6968942	6968982	4734	4774	40	LEFT	D61c.EDF	D61	3
36	6969041	6969384	4833	5176	343	LEFT	D61c.EDF	D61	3
36	6969414	6969810	5206	5602	396	LEFT	D61c.EDF	D61	3
37	6972080	6972295	58	273	215	LEFT	D61c.EDF	D61	3
37	6972491	6972543	469	521	52	LEFT	D61c.EDF	D61	3
37	6972572	6972589	550	567	17	LEFT	D61c.EDF	D61	3
37	6972619	6972687	597	665	68	LEFT	D61c.EDF	D61	3
37	6972770	6972770	748	748	0	LEFT	D61c.EDF	D61	3
37	6972914	6972993	892	971	79	LEFT	D61c.EDF	D61	3
37	6973017	6973075	995	1053	58	LEFT	D61c.EDF	D61	3
37	6973114	6973123	1092	1101	9	LEFT	D61c.EDF	D61	3
37	6973163	6973163	1141	1141	0	LEFT	D61c.EDF	D61	3
37	6973195	6973205	1173	1183	10	LEFT	D61c.EDF	D61	3
37	6973226	6973228	1204	1206	2	LEFT	D61c.EDF	D61	3
37	6973249	6973278	1227	1256	29	LEFT	D61c.EDF	D61	3
37	6973303	6973338	1281	1316	35	LEFT	D61c.EDF	D61	3
37	6973718	6973718	1696	1696	0	LEFT	D61c.EDF	D61	3
37	6973747	6973749	1725	1727	2	LEFT	D61c.EDF	D61	3
37	6973784	6973790	1762	1768	6	LEFT	D61c.EDF	D61	3
37	6973822	6973849	1800	1827	27	LEFT	D61c.EDF	D61	3
37	6973894	6973894	1872	1872	0	LEFT	D61c.EDF	D61	3
37	6973945	6973947	1923	1925	2	LEFT	D61c.EDF	D61	3
37	6973970	6974012	1948	1990	42	LEFT	D61c.EDF	D61	3
38	6979882	6980774	57	949	892	LEFT	D61c.EDF	D61	3
38	6980813	6980813	988	988	0	LEFT	D61c.EDF	D61	3
38	6980865	6980865	1040	1040	0	LEFT	D61c.EDF	D61	3
38	6980925	6980961	1100	1136	36	LEFT	D61c.EDF	D61	3
38	6981037	6981080	1212	1255	43	LEFT	D61c.EDF	D61	3
38	6981104	6981133	1279	1308	29	LEFT	D61c.EDF	D61	3
38	6981159	6981159	1334	1334	0	LEFT	D61c.EDF	D61	3
38	6981187	6981189	1362	1364	2	LEFT	D61c.EDF	D61	3
38	6981236	6981280	1411	1455	44	LEFT	D61c.EDF	D61	3
38	6981330	6981330	1505	1505	0	LEFT	D61c.EDF	D61	3
38	6981358	6981424	1533	1599	66	LEFT	D61c.EDF	D61	3
38	6981469	6981471	1644	1646	2	LEFT	D61c.EDF	D61	3
38	6981567	6981571	1742	1746	4	LEFT	D61c.EDF	D61	3
38	6981667	6981667	1842	1842	0	LEFT	D61c.EDF	D61	3
38	6981697	6981701	1872	1876	4	LEFT	D61c.EDF	D61	3
38	6981748	6981951	1923	2126	203	LEFT	D61c.EDF	D61	3
38	6982294	6984888	2469	5063	2594	LEFT	D61c.EDF	D61	3
38	6985043	6985043	5218	5218	0	LEFT	D61c.EDF	D61	3
38	6985182	6985185	5357	5360	3	LEFT	D61c.EDF	D61	3
38	6985219	6985219	5394	5394	0	LEFT	D61c.EDF	D61	3
38	6985403	6985419	5578	5594	16	LEFT	D61c.EDF	D61	3
39	6988043	6988172	89	218	129	LEFT	D61c.EDF	D61	3
39	6988207	6988433	253	479	226	LEFT	D61c.EDF	D61	3
39	6988653	6988654	699	700	1	LEFT	D61c.EDF	D61	3
39	6988717	6988728	763	774	11	LEFT	D61c.EDF	D61	3
39	6988803	6988811	849	857	8	LEFT	D61c.EDF	D61	3
39	6988867	6988869	913	915	2	LEFT	D61c.EDF	D61	3
39	6988960	6988989	1006	1035	29	LEFT	D61c.EDF	D61	3
39	6989023	6989035	1069	1081	12	LEFT	D61c.EDF	D61	3
39	6989056	6989077	1102	1123	21	LEFT	D61c.EDF	D61	3
39	6989106	6989113	1152	1159	7	LEFT	D61c.EDF	D61	3
39	6989134	6989139	1180	1185	5	LEFT	D61c.EDF	D61	3
39	6990371	6990381	2417	2427	10	LEFT	D61c.EDF	D61	3
39	6990438	6990753	2484	2799	315	LEFT	D61c.EDF	D61	3
39	6990779	6990780	2825	2826	1	LEFT	D61c.EDF	D61	3
39	6990886	6990892	2932	2938	6	LEFT	D61c.EDF	D61	3
39	6991007	6991007	3053	3053	0	LEFT	D61c.EDF	D61	3
40	6995634	6996073	57	496	439	LEFT	D61c.EDF	D61	3
40	6996101	6996163	524	586	62	LEFT	D61c.EDF	D61	3
40	6996211	6996223	634	646	12	LEFT	D61c.EDF	D61	3
40	6996323	6996338	746	761	15	LEFT	D61c.EDF	D61	3
40	6996362	6996415	785	838	53	LEFT	D61c.EDF	D61	3
40	6997755	6997763	2178	2186	8	LEFT	D61c.EDF	D61	3
40	6997788	6998652	2211	3075	864	LEFT	D61c.EDF	D61	3
40	6998731	6998749	3154	3172	18	LEFT	D61c.EDF	D61	3
40	6998821	6998822	3244	3245	1	LEFT	D61c.EDF	D61	3
40	6998865	6998896	3288	3319	31	LEFT	D61c.EDF	D61	3
40	6999098	6999098	3521	3521	0	LEFT	D61c.EDF	D61	3
40	6999357	6999365	3780	3788	8	LEFT	D61c.EDF	D61	3
40	6999725	6999726	4148	4149	1	LEFT	D61c.EDF	D61	3
40	6999838	6999838	4261	4261	0	LEFT	D61c.EDF	D61	3
40	6999874	6999874	4297	4297	0	LEFT	D61c.EDF	D61	3
40	7000107	7000108	4530	4531	1	LEFT	D61c.EDF	D61	3
40	7000184	7000225	4607	4648	41	LEFT	D61c.EDF	D61	3
40	7000560	7000571	4983	4994	11	LEFT	D61c.EDF	D61	3
40	7000679	7000680	5102	5103	1	LEFT	D61c.EDF	D61	3
40	7000772	7000797	5195	5220	25	LEFT	D61c.EDF	D61	3
40	7000824	7000824	5247	5247	0	LEFT	D61c.EDF	D61	3
40	7000953	7001011	5376	5434	58	LEFT	D61c.EDF	D61	3
40	7001129	7001166	5552	5589	37	LEFT	D61c.EDF	D61	3
40	7001262	7001279	5685	5702	17	LEFT	D61c.EDF	D61	3
40	7001311	7001311	5734	5734	0	LEFT	D61c.EDF	D61	3
40	7001335	7001336	5758	5759	1	LEFT	D61c.EDF	D61	3
40	7001369	7001402	5792	5825	33	LEFT	D61c.EDF	D61	3
40	7001527	7001527	5950	5950	0	LEFT	D61c.EDF	D61	3
40	7001781	7001805	6204	6228	24	LEFT	D61c.EDF	D61	3
40	7001827	7001828	6250	6251	1	LEFT	D61c.EDF	D61	3
40	7001859	7001878	6282	6301	19	LEFT	D61c.EDF	D61	3
40	7001976	7001987	6399	6410	11	LEFT	D61c.EDF	D61	3
40	7002014	7002028	6437	6451	14	LEFT	D61c.EDF	D61	3
40	7002086	7002106	6509	6529	20	LEFT	D61c.EDF	D61	3
41	7004319	7004479	58	218	160	LEFT	D61c.EDF	D61	3
41	7004750	7004936	489	675	186	LEFT	D61c.EDF	D61	3
41	7004965	7004965	704	704	0	LEFT	D61c.EDF	D61	3
41	7005016	7005016	755	755	0	LEFT	D61c.EDF	D61	3
41	7005108	7005110	847	849	2	LEFT	D61c.EDF	D61	3
41	7005304	7005323	1043	1062	19	LEFT	D61c.EDF	D61	3
41	7005681	7005681	1420	1420	0	LEFT	D61c.EDF	D61	3
41	7006212	7007014	1951	2753	802	LEFT	D61c.EDF	D61	3
41	7007058	7007064	2797	2803	6	LEFT	D61c.EDF	D61	3
41	7007226	7007230	2965	2969	4	LEFT	D61c.EDF	D61	3
41	7010150	7010153	5889	5892	3	LEFT	D61c.EDF	D61	3
42	7012955	7013226	57	328	271	LEFT	D61c.EDF	D61	3
42	7013259	7013289	361	391	30	LEFT	D61c.EDF	D61	3
42	7013317	7013457	419	559	140	LEFT	D61c.EDF	D61	3
42	7013601	7013615	703	717	14	LEFT	D61c.EDF	D61	3
42	7014034	7014034	1136	1136	0	LEFT	D61c.EDF	D61	3
42	7014988	7015143	2090	2245	155	LEFT	D61c.EDF	D61	3
42	7015166	7015195	2268	2297	29	LEFT	D61c.EDF	D61	3
42	7015314	7015621	2416	2723	307	LEFT	D61c.EDF	D61	3
42	7015678	7015745	2780	2847	67	LEFT	D61c.EDF	D61	3
42	7015880	7015880	2982	2982	0	LEFT	D61c.EDF	D61	3
43	7020441	7020471	58	88	30	LEFT	D61c.EDF	D61	3
43	7021074	7021363	691	980	289	LEFT	D61c.EDF	D61	3
43	7021430	7021455	1047	1072	25	LEFT	D61c.EDF	D61	3
43	7021500	7021500	1117	1117	0	LEFT	D61c.EDF	D61	3
43	7021569	7021599	1186	1216	30	LEFT	D61c.EDF	D61	3
43	7021624	7021624	1241	1241	0	LEFT	D61c.EDF	D61	3
43	7021676	7021676	1293	1293	0	LEFT	D61c.EDF	D61	3
43	7022245	7022274	1862	1891	29	LEFT	D61c.EDF	D61	3
43	7022906	7022907	2523	2524	1	LEFT	D61c.EDF	D61	3
43	7022928	7023008	2545	2625	80	LEFT	D61c.EDF	D61	3
43	7023946	7023966	3563	3583	20	LEFT	D61c.EDF	D61	3
43	7024004	7024006	3621	3623	2	LEFT	D61c.EDF	D61	3
43	7024043	7024043	3660	3660	0	LEFT	D61c.EDF	D61	3
43	7024281	7024288	3898	3905	7	LEFT	D61c.EDF	D61	3
43	7026840	7026841	6457	6458	1	LEFT	D61c.EDF	D61	3
44	7029500	7029684	142	326	184	LEFT	D61c.EDF	D61	3
44	7030423	7030424	1065	1066	1	LEFT	D61c.EDF	D61	3
44	7031376	7031376	2018	2018	0	LEFT	D61c.EDF	D61	3
44	7034205	7034208	4847	4850	3	LEFT	D61c.EDF	D61	3
44	7034244	7034273	4886	4915	29	LEFT	D61c.EDF	D61	3
44	7034800	7034801	5442	5443	1	LEFT	D61c.EDF	D61	3
44	7034825	7034837	5467	5479	12	LEFT	D61c.EDF	D61	3
44	7035041	7035094	5683	5736	53	LEFT	D61c.EDF	D61	3
44	7035222	7035273	5864	5915	51	LEFT	D61c.EDF	D61	3
45	7037715	7037806	57	148	91	LEFT	D61c.EDF	D61	3
45	7037912	7037921	254	263	9	LEFT	D61c.EDF	D61	3
45	7037963	7037963	305	305	0	LEFT	D61c.EDF	D61	3
45	7037994	7038002	336	344	8	LEFT	D61c.EDF	D61	3
45	7038107	7038107	449	449	0	LEFT	D61c.EDF	D61	3
45	7038131	7038169	473	511	38	LEFT	D61c.EDF	D61	3
45	7038394	7038395	736	737	1	LEFT	D61c.EDF	D61	3
45	7038442	7038461	784	803	19	LEFT	D61c.EDF	D61	3
45	7038502	7038502	844	844	0	LEFT	D61c.EDF	D61	3
45	7038526	7038545	868	887	19	LEFT	D61c.EDF	D61	3
45	7038692	7038695	1034	1037	3	LEFT	D61c.EDF	D61	3
45	7038734	7038749	1076	1091	15	LEFT	D61c.EDF	D61	3
45	7038808	7038829	1150	1171	21	LEFT	D61c.EDF	D61	3
45	7038861	7038887	1203	1229	26	LEFT	D61c.EDF	D61	3
45	7038942	7038942	1284	1284	0	LEFT	D61c.EDF	D61	3
45	7038970	7039039	1312	1381	69	LEFT	D61c.EDF	D61	3
45	7039074	7039078	1416	1420	4	LEFT	D61c.EDF	D61	3
45	7039159	7039161	1501	1503	2	LEFT	D61c.EDF	D61	3
45	7039210	7039210	1552	1552	0	LEFT	D61c.EDF	D61	3
45	7039235	7039235	1577	1577	0	LEFT	D61c.EDF	D61	3
45	7039263	7039363	1605	1705	100	LEFT	D61c.EDF	D61	3
45	7039545	7039547	1887	1889	2	LEFT	D61c.EDF	D61	3
45	7039732	7039736	2074	2078	4	LEFT	D61c.EDF	D61	3
45	7040054	7040809	2396	3151	755	LEFT	D61c.EDF	D61	3
45	7040852	7041017	3194	3359	165	LEFT	D61c.EDF	D61	3
45	7041038	7041811	3380	4153	773	LEFT	D61c.EDF	D61	3
45	7041840	7041840	4182	4182	0	LEFT	D61c.EDF	D61	3
45	7041864	7042030	4206	4372	166	LEFT	D61c.EDF	D61	3
45	7042059	7042062	4401	4404	3	LEFT	D61c.EDF	D61	3
45	7042111	7042283	4453	4625	172	LEFT	D61c.EDF	D61	3
45	7042332	7042614	4674	4956	282	LEFT	D61c.EDF	D61	3
46	7045157	7045618	611	1072	461	LEFT	D61c.EDF	D61	3
46	7045649	7045679	1103	1133	30	LEFT	D61c.EDF	D61	3
46	7045723	7045726	1177	1180	3	LEFT	D61c.EDF	D61	3
46	7045843	7045844	1297	1298	1	LEFT	D61c.EDF	D61	3
46	7045868	7045868	1322	1322	0	LEFT	D61c.EDF	D61	3
46	7046161	7046164	1615	1618	3	LEFT	D61c.EDF	D61	3
46	7046229	7046389	1683	1843	160	LEFT	D61c.EDF	D61	3
46	7047055	7047537	2509	2991	482	LEFT	D61c.EDF	D61	3
46	7047558	7047578	3012	3032	20	LEFT	D61c.EDF	D61	3
46	7047608	7047812	3062	3266	204	LEFT	D61c.EDF	D61	3
46	7047857	7047862	3311	3316	5	LEFT	D61c.EDF	D61	3
46	7047901	7047902	3355	3356	1	LEFT	D61c.EDF	D61	3
46	7048019	7048020	3473	3474	1	LEFT	D61c.EDF	D61	3
46	7048047	7048049	3501	3503	2	LEFT	D61c.EDF	D61	3
46	7048076	7048169	3530	3623	93	LEFT	D61c.EDF	D61	3
46	7048221	7048434	3675	3888	213	LEFT	D61c.EDF	D61	3
46	7048475	7048489	3929	3943	14	LEFT	D61c.EDF	D61	3
46	7048514	7048616	3968	4070	102	LEFT	D61c.EDF	D61	3
46	7048639	7048669	4093	4123	30	LEFT	D61c.EDF	D61	3
46	7048705	7048705	4159	4159	0	LEFT	D61c.EDF	D61	3
46	7048795	7048796	4249	4250	1	LEFT	D61c.EDF	D61	3
46	7048839	7048861	4293	4315	22	LEFT	D61c.EDF	D61	3
46	7048921	7048921	4375	4375	0	LEFT	D61c.EDF	D61	3
46	7048984	7048987	4438	4441	3	LEFT	D61c.EDF	D61	3
46	7049008	7049096	4462	4550	88	LEFT	D61c.EDF	D61	3
46	7049119	7049128	4573	4582	9	LEFT	D61c.EDF	D61	3
46	7049157	7049161	4611	4615	4	LEFT	D61c.EDF	D61	3
46	7049248	7049273	4702	4727	25	LEFT	D61c.EDF	D61	3
46	7049353	7049398	4807	4852	45	LEFT	D61c.EDF	D61	3
46	7049431	7049432	4885	4886	1	LEFT	D61c.EDF	D61	3
46	7049458	7049479	4912	4933	21	LEFT	D61c.EDF	D61	3
46	7049501	7049521	4955	4975	20	LEFT	D61c.EDF	D61	3
46	7049545	7049595	4999	5049	50	LEFT	D61c.EDF	D61	3
46	7049622	7049643	5076	5097	21	LEFT	D61c.EDF	D61	3
46	7049673	7049688	5127	5142	15	LEFT	D61c.EDF	D61	3
46	7049749	7050095	5203	5549	346	LEFT	D61c.EDF	D61	3
46	7050116	7050119	5570	5573	3	LEFT	D61c.EDF	D61	3
46	7050168	7050317	5622	5771	149	LEFT	D61c.EDF	D61	3
46	7050338	7050469	5792	5923	131	LEFT	D61c.EDF	D61	3
46	7050493	7050649	5947	6103	156	LEFT	D61c.EDF	D61	3
47	7052457	7052716	119	378	259	LEFT	D61c.EDF	D61	3
47	7052755	7052755	417	417	0	LEFT	D61c.EDF	D61	3
47	7052884	7052894	546	556	10	LEFT	D61c.EDF	D61	3
47	7052935	7052949	597	611	14	LEFT	D61c.EDF	D61	3
47	7052974	7052975	636	637	1	LEFT	D61c.EDF	D61	3
47	7053022	7053025	684	687	3	LEFT	D61c.EDF	D61	3
47	7053106	7053131	768	793	25	LEFT	D61c.EDF	D61	3
47	7053226	7053227	888	889	1	LEFT	D61c.EDF	D61	3
47	7053251	7053253	913	915	2	LEFT	D61c.EDF	D61	3
47	7054211	7054227	1873	1889	16	LEFT	D61c.EDF	D61	3
47	7054252	7054355	1914	2017	103	LEFT	D61c.EDF	D61	3
47	7054990	7055590	2652	3252	600	LEFT	D61c.EDF	D61	3
47	7055643	7055797	3305	3459	154	LEFT	D61c.EDF	D61	3
47	7055838	7055936	3500	3598	98	LEFT	D61c.EDF	D61	3
47	7055958	7055960	3620	3622	2	LEFT	D61c.EDF	D61	3
47	7056004	7056006	3666	3668	2	LEFT	D61c.EDF	D61	3
47	7056027	7056078	3689	3740	51	LEFT	D61c.EDF	D61	3
47	7056151	7056187	3813	3849	36	LEFT	D61c.EDF	D61	3
47	7056220	7056220	3882	3882	0	LEFT	D61c.EDF	D61	3
47	7056302	7056347	3964	4009	45	LEFT	D61c.EDF	D61	3
47	7056376	7056377	4038	4039	1	LEFT	D61c.EDF	D61	3
47	7056417	7056434	4079	4096	17	LEFT	D61c.EDF	D61	3
47	7056455	7056636	4117	4298	181	LEFT	D61c.EDF	D61	3
47	7056699	7056859	4361	4521	160	LEFT	D61c.EDF	D61	3
47	7056880	7056881	4542	4543	1	LEFT	D61c.EDF	D61	3
47	7056915	7056915	4577	4577	0	LEFT	D61c.EDF	D61	3
47	7056964	7057054	4626	4716	90	LEFT	D61c.EDF	D61	3
47	7057112	7057138	4774	4800	26	LEFT	D61c.EDF	D61	3
47	7057161	7058244	4823	5906	1083	LEFT	D61c.EDF	D61	3
48	7060396	7060495	58	157	99	LEFT	D61c.EDF	D61	3
48	7062169	7062312	1831	1974	143	LEFT	D61c.EDF	D61	3
48	7062942	7063826	2604	3488	884	LEFT	D61c.EDF	D61	3
48	7063856	7063867	3518	3529	11	LEFT	D61c.EDF	D61	3
48	7063902	7063968	3564	3630	66	LEFT	D61c.EDF	D61	3
48	7063989	7064097	3651	3759	108	LEFT	D61c.EDF	D61	3
48	7064126	7064266	3788	3928	140	LEFT	D61c.EDF	D61	3
48	7064288	7064442	3950	4104	154	LEFT	D61c.EDF	D61	3
48	7064481	7066579	4143	6241	2098	LEFT	D61c.EDF	D61	3
49	7069591	7069613	1219	1241	22	LEFT	D61c.EDF	D61	3
49	7069635	7069791	1263	1419	156	LEFT	D61c.EDF	D61	3
49	7069815	7069906	1443	1534	91	LEFT	D61c.EDF	D61	3
49	7069931	7069968	1559	1596	37	LEFT	D61c.EDF	D61	3
49	7069998	7070035	1626	1663	37	LEFT	D61c.EDF	D61	3
49	7070057	7070084	1685	1712	27	LEFT	D61c.EDF	D61	3
49	7070114	7070252	1742	1880	138	LEFT	D61c.EDF	D61	3
49	7071623	7071632	3251	3260	9	LEFT	D61c.EDF	D61	3
49	7071670	7071730	3298	3358	60	LEFT	D61c.EDF	D61	3
49	7071753	7073201	3381	4829	1448	LEFT	D61c.EDF	D61	3
49	7073223	7073689	4851	5317	466	LEFT	D61c.EDF	D61	3
49	7073712	7074827	5340	6455	1115	LEFT	D61c.EDF	D61	3
49	7074849	7074849	6477	6477	0	LEFT	D61c.EDF	D61	3
49	7074880	7074957	6508	6585	77	LEFT	D61c.EDF	D61	3
49	7074980	7075315	6608	6943	335	LEFT	D61c.EDF	D61	3
50	7077454	7077656	58	260	202	LEFT	D61c.EDF	D61	3
50	7077799	7077821	403	425	22	LEFT	D61c.EDF	D61	3
50	7077850	7078023	454	627	173	LEFT	D61c.EDF	D61	3
50	7078128	7078130	732	734	2	LEFT	D61c.EDF	D61	3
50	7078158	7078183	762	787	25	LEFT	D61c.EDF	D61	3
50	7078204	7078315	808	919	111	LEFT	D61c.EDF	D61	3
50	7078336	7078515	940	1119	179	LEFT	D61c.EDF	D61	3
50	7078539	7078588	1143	1192	49	LEFT	D61c.EDF	D61	3
50	7081120	7081120	3724	3724	0	LEFT	D61c.EDF	D61	3
50	7081269	7081284	3873	3888	15	LEFT	D61c.EDF	D61	3
50	7081306	7081399	3910	4003	93	LEFT	D61c.EDF	D61	3
50	7081432	7081449	4036	4053	17	LEFT	D61c.EDF	D61	3
50	7081599	7081599	4203	4203	0	LEFT	D61c.EDF	D61	3
50	7081630	7081630	4234	4234	0	LEFT	D61c.EDF	D61	3
50	7081717	7081720	4321	4324	3	LEFT	D61c.EDF	D61	3
51	7086037	7086069	94	126	32	LEFT	D61c.EDF	D61	3
51	7086102	7086161	159	218	59	LEFT	D61c.EDF	D61	3
51	7086209	7086210	266	267	1	LEFT	D61c.EDF	D61	3
51	7086604	7086704	661	761	100	LEFT	D61c.EDF	D61	3
51	7086748	7086748	805	805	0	LEFT	D61c.EDF	D61	3
51	7086832	7086832	889	889	0	LEFT	D61c.EDF	D61	3
51	7086855	7086954	912	1011	99	LEFT	D61c.EDF	D61	3
51	7086987	7087201	1044	1258	214	LEFT	D61c.EDF	D61	3
51	7087231	7087304	1288	1361	73	LEFT	D61c.EDF	D61	3
51	7087354	7087381	1411	1438	27	LEFT	D61c.EDF	D61	3
51	7087451	7087467	1508	1524	16	LEFT	D61c.EDF	D61	3
51	7087540	7087569	1597	1626	29	LEFT	D61c.EDF	D61	3
51	7087595	7087653	1652	1710	58	LEFT	D61c.EDF	D61	3
51	7087691	7087693	1748	1750	2	LEFT	D61c.EDF	D61	3
51	7087721	7087721	1778	1778	0	LEFT	D61c.EDF	D61	3
51	7087841	7087872	1898	1929	31	LEFT	D61c.EDF	D61	3
51	7087922	7087934	1979	1991	12	LEFT	D61c.EDF	D61	3
52	7094802	7094805	938	941	3	LEFT	D61c.EDF	D61	3
52	7095048	7095086	1184	1222	38	LEFT	D61c.EDF	D61	3
52	7095126	7095139	1262	1275	13	LEFT	D61c.EDF	D61	3
52	7095160	7095229	1296	1365	69	LEFT	D61c.EDF	D61	3
52	7095255	7095256	1391	1392	1	LEFT	D61c.EDF	D61	3
52	7095906	7095908	2042	2044	2	LEFT	D61c.EDF	D61	3
52	7096015	7096015	2151	2151	0	LEFT	D61c.EDF	D61	3
52	7096052	7096111	2188	2247	59	LEFT	D61c.EDF	D61	3
52	7096953	7098287	3089	4423	1334	LEFT	D61c.EDF	D61	3
52	7098312	7098962	4448	5098	650	LEFT	D61c.EDF	D61	3
52	7099008	7099124	5144	5260	116	LEFT	D61c.EDF	D61	3
52	7099145	7099333	5281	5469	188	LEFT	D61c.EDF	D61	3
52	7099369	7099374	5505	5510	5	LEFT	D61c.EDF	D61	3
52	7099396	7099429	5532	5565	33	LEFT	D61c.EDF	D61	3
52	7099457	7099469	5593	5605	12	LEFT	D61c.EDF	D61	3
52	7099521	7099521	5657	5657	0	LEFT	D61c.EDF	D61	3
52	7099548	7099563	5684	5699	15	LEFT	D61c.EDF	D61	3
52	7099589	7099592	5725	5728	3	LEFT	D61c.EDF	D61	3
52	7099614	7099627	5750	5763	13	LEFT	D61c.EDF	D61	3
52	7099844	7099844	5980	5980	0	LEFT	D61c.EDF	D61	3
52	7100050	7100050	6186	6186	0	LEFT	D61c.EDF	D61	3
52	7100074	7100088	6210	6224	14	LEFT	D61c.EDF	D61	3
52	7100405	7100418	6541	6554	13	LEFT	D61c.EDF	D61	3
52	7100456	7100503	6592	6639	47	LEFT	D61c.EDF	D61	3
52	7100526	7100558	6662	6694	32	LEFT	D61c.EDF	D61	3
52	7100579	7100606	6715	6742	27	LEFT	D61c.EDF	D61	3
53	7102566	7102738	57	229	172	LEFT	D61c.EDF	D61	3
53	7102771	7102977	262	468	206	LEFT	D61c.EDF	D61	3
53	7103006	7103029	497	520	23	LEFT	D61c.EDF	D61	3
53	7103059	7103599	550	1090	540	LEFT	D61c.EDF	D61	3
53	7103630	7103632	1121	1123	2	LEFT	D61c.EDF	D61	3
53	7103680	7103680	1171	1171	0	LEFT	D61c.EDF	D61	3
53	7103720	7103765	1211	1256	45	LEFT	D61c.EDF	D61	3
53	7103791	7103856	1282	1347	65	LEFT	D61c.EDF	D61	3
53	7103919	7103919	1410	1410	0	LEFT	D61c.EDF	D61	3
53	7103941	7103941	1432	1432	0	LEFT	D61c.EDF	D61	3
53	7103980	7103982	1471	1473	2	LEFT	D61c.EDF	D61	3
53	7104026	7104026	1517	1517	0	LEFT	D61c.EDF	D61	3
53	7104095	7104095	1586	1586	0	LEFT	D61c.EDF	D61	3
53	7104140	7104158	1631	1649	18	LEFT	D61c.EDF	D61	3
53	7104197	7104197	1688	1688	0	LEFT	D61c.EDF	D61	3
53	7104231	7104231	1722	1722	0	LEFT	D61c.EDF	D61	3
53	7104286	7104287	1777	1778	1	LEFT	D61c.EDF	D61	3
53	7104352	7104352	1843	1843	0	LEFT	D61c.EDF	D61	3
53	7104404	7104489	1895	1980	85	LEFT	D61c.EDF	D61	3
53	7105126	7107169	2617	4660	2043	LEFT	D61c.EDF	D61	3
53	7107235	7107261	4726	4752	26	LEFT	D61c.EDF	D61	3
53	7107293	7107295	4784	4786	2	LEFT	D61c.EDF	D61	3
53	7107322	7107322	4813	4813	0	LEFT	D61c.EDF	D61	3
53	7107437	7107437	4928	4928	0	LEFT	D61c.EDF	D61	3
53	7107548	7107567	5039	5058	19	LEFT	D61c.EDF	D61	3
53	7107617	7107643	5108	5134	26	LEFT	D61c.EDF	D61	3
53	7107671	7107694	5162	5185	23	LEFT	D61c.EDF	D61	3
53	7107812	7107813	5303	5304	1	LEFT	D61c.EDF	D61	3
53	7107834	7107845	5325	5336	11	LEFT	D61c.EDF	D61	3
53	7107938	7107939	5429	5430	1	LEFT	D61c.EDF	D61	3
53	7107971	7108053	5462	5544	82	LEFT	D61c.EDF	D61	3
53	7108087	7108161	5578	5652	74	LEFT	D61c.EDF	D61	3
53	7108206	7108219	5697	5710	13	LEFT	D61c.EDF	D61	3
53	7108244	7108275	5735	5766	31	LEFT	D61c.EDF	D61	3
53	7108301	7108303	5792	5794	2	LEFT	D61c.EDF	D61	3
53	7108336	7108400	5827	5891	64	LEFT	D61c.EDF	D61	3
53	7108426	7108451	5917	5942	25	LEFT	D61c.EDF	D61	3
53	7108619	7108628	6110	6119	9	LEFT	D61c.EDF	D61	3
53	7108652	7108653	6143	6144	1	LEFT	D61c.EDF	D61	3
53	7108685	7108685	6176	6176	0	LEFT	D61c.EDF	D61	3
54	7112045	7112045	1270	1270	0	LEFT	D61c.EDF	D61	3
54	7112159	7112166	1384	1391	7	LEFT	D61c.EDF	D61	3
54	7112198	7112311	1423	1536	113	LEFT	D61c.EDF	D61	3
54	7112355	7112374	1580	1599	19	LEFT	D61c.EDF	D61	3
54	7112397	7112398	1622	1623	1	LEFT	D61c.EDF	D61	3
54	7112427	7112427	1652	1652	0	LEFT	D61c.EDF	D61	3
54	7112736	7112751	1961	1976	15	LEFT	D61c.EDF	D61	3
54	7112801	7112803	2026	2028	2	LEFT	D61c.EDF	D61	3
54	7112847	7112849	2072	2074	2	LEFT	D61c.EDF	D61	3
54	7112912	7112912	2137	2137	0	LEFT	D61c.EDF	D61	3
54	7112937	7112988	2162	2213	51	LEFT	D61c.EDF	D61	3
54	7113763	7113764	2988	2989	1	LEFT	D61c.EDF	D61	3
54	7113792	7114132	3017	3357	340	LEFT	D61c.EDF	D61	3
54	7114154	7114240	3379	3465	86	LEFT	D61c.EDF	D61	3
54	7114268	7114290	3493	3515	22	LEFT	D61c.EDF	D61	3
54	7114322	7114361	3547	3586	39	LEFT	D61c.EDF	D61	3
54	7114383	7114444	3608	3669	61	LEFT	D61c.EDF	D61	3
54	7114533	7114643	3758	3868	110	LEFT	D61c.EDF	D61	3
54	7114689	7114720	3914	3945	31	LEFT	D61c.EDF	D61	3
54	7114759	7114812	3984	4037	53	LEFT	D61c.EDF	D61	3
54	7114836	7114995	4061	4220	159	LEFT	D61c.EDF	D61	3
54	7115026	7115038	4251	4263	12	LEFT	D61c.EDF	D61	3
54	7115061	7115063	4286	4288	2	LEFT	D61c.EDF	D61	3
54	7115086	7115174	4311	4399	88	LEFT	D61c.EDF	D61	3
54	7115198	7115250	4423	4475	52	LEFT	D61c.EDF	D61	3
54	7115320	7115389	4545	4614	69	LEFT	D61c.EDF	D61	3
54	7115415	7115443	4640	4668	28	LEFT	D61c.EDF	D61	3
54	7115476	7115476	4701	4701	0	LEFT	D61c.EDF	D61	3
54	7115537	7115550	4762	4775	13	LEFT	D61c.EDF	D61	3
54	7115637	7115640	4862	4865	3	LEFT	D61c.EDF	D61	3
54	7115701	7116270	4926	5495	569	LEFT	D61c.EDF	D61	3
54	7116295	7116411	5520	5636	116	LEFT	D61c.EDF	D61	3
54	7116473	7116536	5698	5761	63	LEFT	D61c.EDF	D61	3
54	7116559	7116621	5784	5846	62	LEFT	D61c.EDF	D61	3
54	7116664	7116776	5889	6001	112	LEFT	D61c.EDF	D61	3
54	7116797	7117165	6022	6390	368	LEFT	D61c.EDF	D61	3
54	7117186	7117256	6411	6481	70	LEFT	D61c.EDF	D61	3
54	7117278	7117361	6503	6586	83	LEFT	D61c.EDF	D61	3
54	7117384	7117395	6609	6620	11	LEFT	D61c.EDF	D61	3
54	7117417	7117501	6642	6726	84	LEFT	D61c.EDF	D61	3
54	7117523	7118030	6748	7255	507	LEFT	D61c.EDF	D61	3
55	7119941	7120431	58	548	490	LEFT	D61c.EDF	D61	3
55	7120480	7120481	597	598	1	LEFT	D61c.EDF	D61	3
55	7120537	7120537	654	654	0	LEFT	D61c.EDF	D61	3
55	7120601	7120610	718	727	9	LEFT	D61c.EDF	D61	3
55	7120636	7120648	753	765	12	LEFT	D61c.EDF	D61	3
55	7120721	7120726	838	843	5	LEFT	D61c.EDF	D61	3
55	7120755	7120764	872	881	9	LEFT	D61c.EDF	D61	3
55	7120839	7121060	956	1177	221	LEFT	D61c.EDF	D61	3
55	7121326	7121508	1443	1625	182	LEFT	D61c.EDF	D61	3
55	7121655	7121655	1772	1772	0	LEFT	D61c.EDF	D61	3
55	7121676	7121700	1793	1817	24	LEFT	D61c.EDF	D61	3
55	7121731	7121951	1848	2068	220	LEFT	D61c.EDF	D61	3
55	7121972	7122026	2089	2143	54	LEFT	D61c.EDF	D61	3
55	7122047	7122048	2164	2165	1	LEFT	D61c.EDF	D61	3
55	7122089	7125228	2206	5345	3139	LEFT	D61c.EDF	D61	3
55	7125249	7125825	5366	5942	576	LEFT	D61c.EDF	D61	3
55	7125851	7125883	5968	6000	32	LEFT	D61c.EDF	D61	3
55	7125910	7126028	6027	6145	118	LEFT	D61c.EDF	D61	3
55	7126052	7126522	6169	6639	470	LEFT	D61c.EDF	D61	3
55	7126555	7126562	6672	6679	7	LEFT	D61c.EDF	D61	3
55	7126584	7126639	6701	6756	55	LEFT	D61c.EDF	D61	3
55	7126662	7126702	6779	6819	40	LEFT	D61c.EDF	D61	3
55	7126757	7126803	6874	6920	46	LEFT	D61c.EDF	D61	3
55	7126852	7126901	6969	7018	49	LEFT	D61c.EDF	D61	3
55	7126923	7126928	7040	7045	5	LEFT	D61c.EDF	D61	3
55	7126955	7126956	7072	7073	1	LEFT	D61c.EDF	D61	3
55	7127031	7127031	7148	7148	0	LEFT	D61c.EDF	D61	3
55	7127054	7127077	7171	7194	23	LEFT	D61c.EDF	D61	3
55	7127119	7127186	7236	7303	67	LEFT	D61c.EDF	D61	3
56	7129116	7129300	58	242	184	LEFT	D61c.EDF	D61	3
56	7129983	7129984	925	926	1	LEFT	D61c.EDF	D61	3
56	7130699	7130699	1641	1641	0	LEFT	D61c.EDF	D61	3
56	7130969	7130983	1911	1925	14	LEFT	D61c.EDF	D61	3
56	7131038	7131554	1980	2496	516	LEFT	D61c.EDF	D61	3
56	7131824	7131825	2766	2767	1	LEFT	D61c.EDF	D61	3
56	7132132	7132149	3074	3091	17	LEFT	D61c.EDF	D61	3
56	7132291	7132291	3233	3233	0	LEFT	D61c.EDF	D61	3
56	7132407	7132409	3349	3351	2	LEFT	D61c.EDF	D61	3
56	7132490	7132491	3432	3433	1	LEFT	D61c.EDF	D61	3
56	7132643	7132643	3585	3585	0	LEFT	D61c.EDF	D61	3
56	7132859	7132859	3801	3801	0	LEFT	D61c.EDF	D61	3
56	7132930	7132932	3872	3874	2	LEFT	D61c.EDF	D61	3
56	7132968	7132970	3910	3912	2	LEFT	D61c.EDF	D61	3
56	7133096	7133099	4038	4041	3	LEFT	D61c.EDF	D61	3
56	7133182	7133182	4124	4124	0	LEFT	D61c.EDF	D61	3
56	7133221	7133225	4163	4167	4	LEFT	D61c.EDF	D61	3
56	7133255	7133274	4197	4216	19	LEFT	D61c.EDF	D61	3
56	7133336	7133336	4278	4278	0	LEFT	D61c.EDF	D61	3
56	7133360	7133389	4302	4331	29	LEFT	D61c.EDF	D61	3
56	7133457	7133457	4399	4399	0	LEFT	D61c.EDF	D61	3
56	7133496	7133513	4438	4455	17	LEFT	D61c.EDF	D61	3
56	7133557	7133566	4499	4508	9	LEFT	D61c.EDF	D61	3
56	7133597	7133597	4539	4539	0	LEFT	D61c.EDF	D61	3
56	7133738	7133738	4680	4680	0	LEFT	D61c.EDF	D61	3
56	7133884	7133884	4826	4826	0	LEFT	D61c.EDF	D61	3
56	7133973	7133973	4915	4915	0	LEFT	D61c.EDF	D61	3
56	7134072	7134074	5014	5016	2	LEFT	D61c.EDF	D61	3
56	7134143	7134143	5085	5085	0	LEFT	D61c.EDF	D61	3
56	7134194	7134209	5136	5151	15	LEFT	D61c.EDF	D61	3
56	7134230	7134253	5172	5195	23	LEFT	D61c.EDF	D61	3
56	7134299	7134347	5241	5289	48	LEFT	D61c.EDF	D61	3
56	7134403	7134415	5345	5357	12	LEFT	D61c.EDF	D61	3
56	7134437	7134439	5379	5381	2	LEFT	D61c.EDF	D61	3
56	7134462	7134510	5404	5452	48	LEFT	D61c.EDF	D61	3
56	7134532	7134543	5474	5485	11	LEFT	D61c.EDF	D61	3
56	7134572	7134592	5514	5534	20	LEFT	D61c.EDF	D61	3
56	7134623	7134666	5565	5608	43	LEFT	D61c.EDF	D61	3
56	7134687	7134687	5629	5629	0	LEFT	D61c.EDF	D61	3
56	7134713	7134721	5655	5663	8	LEFT	D61c.EDF	D61	3
57	7136587	7136587	154	154	0	LEFT	D61c.EDF	D61	3
57	7136682	7136692	249	259	10	LEFT	D61c.EDF	D61	3
57	7136777	7136791	344	358	14	LEFT	D61c.EDF	D61	3
57	7136820	7136821	387	388	1	LEFT	D61c.EDF	D61	3
57	7136888	7136955	455	522	67	LEFT	D61c.EDF	D61	3
57	7137047	7137047	614	614	0	LEFT	D61c.EDF	D61	3
57	7137075	7137075	642	642	0	LEFT	D61c.EDF	D61	3
57	7137101	7137101	668	668	0	LEFT	D61c.EDF	D61	3
57	7137294	7137317	861	884	23	LEFT	D61c.EDF	D61	3
57	7137485	7137485	1052	1052	0	LEFT	D61c.EDF	D61	3
57	7137617	7137617	1184	1184	0	LEFT	D61c.EDF	D61	3
57	7137665	7137697	1232	1264	32	LEFT	D61c.EDF	D61	3
57	7137774	7137774	1341	1341	0	LEFT	D61c.EDF	D61	3
57	7137809	7137809	1376	1376	0	LEFT	D61c.EDF	D61	3
57	7137840	7137841	1407	1408	1	LEFT	D61c.EDF	D61	3
57	7137863	7137863	1430	1430	0	LEFT	D61c.EDF	D61	3
57	7137908	7137918	1475	1485	10	LEFT	D61c.EDF	D61	3
57	7137979	7138001	1546	1568	22	LEFT	D61c.EDF	D61	3
57	7138026	7138080	1593	1647	54	LEFT	D61c.EDF	D61	3
57	7138124	7138183	1691	1750	59	LEFT	D61c.EDF	D61	3
57	7138227	7138263	1794	1830	36	LEFT	D61c.EDF	D61	3
57	7138295	7138295	1862	1862	0	LEFT	D61c.EDF	D61	3
57	7138361	7138364	1928	1931	3	LEFT	D61c.EDF	D61	3
57	7138397	7138413	1964	1980	16	LEFT	D61c.EDF	D61	3
57	7138484	7138484	2051	2051	0	LEFT	D61c.EDF	D61	3
57	7138528	7138532	2095	2099	4	LEFT	D61c.EDF	D61	3
57	7138563	7138564	2130	2131	1	LEFT	D61c.EDF	D61	3
57	7138588	7138588	2155	2155	0	LEFT	D61c.EDF	D61	3
57	7138616	7138618	2183	2185	2	LEFT	D61c.EDF	D61	3
57	7139549	7139926	3116	3493	377	LEFT	D61c.EDF	D61	3
57	7139950	7139954	3517	3521	4	LEFT	D61c.EDF	D61	3
57	7139986	7140129	3553	3696	143	LEFT	D61c.EDF	D61	3
57	7140153	7140185	3720	3752	32	LEFT	D61c.EDF	D61	3
57	7140233	7140244	3800	3811	11	LEFT	D61c.EDF	D61	3
57	7140301	7140428	3868	3995	127	LEFT	D61c.EDF	D61	3
57	7140454	7140484	4021	4051	30	LEFT	D61c.EDF	D61	3
57	7140535	7140597	4102	4164	62	LEFT	D61c.EDF	D61	3
57	7140621	7140683	4188	4250	62	LEFT	D61c.EDF	D61	3
57	7140721	7140759	4288	4326	38	LEFT	D61c.EDF	D61	3
57	7140833	7140839	4400	4406	6	LEFT	D61c.EDF	D61	3
57	7140890	7140890	4457	4457	0	LEFT	D61c.EDF	D61	3
57	7140914	7140918	4481	4485	4	LEFT	D61c.EDF	D61	3
57	7140983	7140984	4550	4551	1	LEFT	D61c.EDF	D61	3
57	7141011	7141036	4578	4603	25	LEFT	D61c.EDF	D61	3
57	7141085	7141101	4652	4668	16	LEFT	D61c.EDF	D61	3
57	7141141	7141144	4708	4711	3	LEFT	D61c.EDF	D61	3
57	7141165	7141174	4732	4741	9	LEFT	D61c.EDF	D61	3
57	7141207	7141285	4774	4852	78	LEFT	D61c.EDF	D61	3
57	7141308	7141323	4875	4890	15	LEFT	D61c.EDF	D61	3
57	7141356	7141356	4923	4923	0	LEFT	D61c.EDF	D61	3
57	7141393	7141397	4960	4964	4	LEFT	D61c.EDF	D61	3
57	7141422	7141863	4989	5430	441	LEFT	D61c.EDF	D61	3
57	7141910	7142091	5477	5658	181	LEFT	D61c.EDF	D61	3
57	7142154	7142157	5721	5724	3	LEFT	D61c.EDF	D61	3
57	7142185	7142205	5752	5772	20	LEFT	D61c.EDF	D61	3
57	7142226	7142230	5793	5797	4	LEFT	D61c.EDF	D61	3
57	7142287	7142315	5854	5882	28	LEFT	D61c.EDF	D61	3
57	7142452	7142467	6019	6034	15	LEFT	D61c.EDF	D61	3
57	7142501	7142572	6068	6139	71	LEFT	D61c.EDF	D61	3
57	7142600	7142658	6167	6225	58	LEFT	D61c.EDF	D61	3
57	7142686	7142695	6253	6262	9	LEFT	D61c.EDF	D61	3
57	7142730	7142934	6297	6501	204	LEFT	D61c.EDF	D61	3
57	7142963	7143003	6530	6570	40	LEFT	D61c.EDF	D61	3
57	7143025	7143032	6592	6599	7	LEFT	D61c.EDF	D61	3
57	7143068	7143175	6635	6742	107	LEFT	D61c.EDF	D61	3
57	7143203	7143225	6770	6792	22	LEFT	D61c.EDF	D61	3
57	7143301	7143351	6868	6918	50	LEFT	D61c.EDF	D61	3
57	7143372	7143374	6939	6941	2	LEFT	D61c.EDF	D61	3
57	7143408	7143484	6975	7051	76	LEFT	D61c.EDF	D61	3
57	7143507	7143527	7074	7094	20	LEFT	D61c.EDF	D61	3
57	7143548	7143576	7115	7143	28	LEFT	D61c.EDF	D61	3
58	7145422	7145622	58	258	200	LEFT	D61c.EDF	D61	3
58	7145748	7145783	384	419	35	LEFT	D61c.EDF	D61	3
58	7145866	7145879	502	515	13	LEFT	D61c.EDF	D61	3
58	7145936	7145937	572	573	1	LEFT	D61c.EDF	D61	3
58	7146787	7146789	1423	1425	2	LEFT	D61c.EDF	D61	3
58	7147552	7147552	2188	2188	0	LEFT	D61c.EDF	D61	3
58	7147579	7147666	2215	2302	87	LEFT	D61c.EDF	D61	3
58	7147975	7148291	2611	2927	316	LEFT	D61c.EDF	D61	3
58	7148317	7148384	2953	3020	67	LEFT	D61c.EDF	D61	3
58	7148411	7148417	3047	3053	6	LEFT	D61c.EDF	D61	3
58	7148447	7148449	3083	3085	2	LEFT	D61c.EDF	D61	3
58	7148530	7148642	3166	3278	112	LEFT	D61c.EDF	D61	3
58	7148707	7148708	3343	3344	1	LEFT	D61c.EDF	D61	3
58	7148741	7148809	3377	3445	68	LEFT	D61c.EDF	D61	3
58	7148858	7148890	3494	3526	32	LEFT	D61c.EDF	D61	3
58	7148915	7148935	3551	3571	20	LEFT	D61c.EDF	D61	3
58	7148987	7149003	3623	3639	16	LEFT	D61c.EDF	D61	3
58	7149034	7149066	3670	3702	32	LEFT	D61c.EDF	D61	3
58	7149250	7149289	3886	3925	39	LEFT	D61c.EDF	D61	3
58	7149318	7149342	3954	3978	24	LEFT	D61c.EDF	D61	3
58	7149369	7149370	4005	4006	1	LEFT	D61c.EDF	D61	3
58	7149400	7149401	4036	4037	1	LEFT	D61c.EDF	D61	3
58	7149433	7149603	4069	4239	170	LEFT	D61c.EDF	D61	3
58	7149643	7149661	4279	4297	18	LEFT	D61c.EDF	D61	3
58	7149703	7149724	4339	4360	21	LEFT	D61c.EDF	D61	3
58	7149760	7149762	4396	4398	2	LEFT	D61c.EDF	D61	3
58	7149785	7149791	4421	4427	6	LEFT	D61c.EDF	D61	3
58	7149812	7149829	4448	4465	17	LEFT	D61c.EDF	D61	3
58	7149859	7150009	4495	4645	150	LEFT	D61c.EDF	D61	3
58	7150089	7150089	4725	4725	0	LEFT	D61c.EDF	D61	3
58	7150126	7150126	4762	4762	0	LEFT	D61c.EDF	D61	3
58	7150159	7150307	4795	4943	148	LEFT	D61c.EDF	D61	3
58	7150330	7150526	4966	5162	196	LEFT	D61c.EDF	D61	3
58	7150550	7152542	5186	7178	1992	LEFT	D61c.EDF	D61	3
59	7154420	7154458	58	96	38	LEFT	D61c.EDF	D61	3
59	7154830	7154979	468	617	149	LEFT	D61c.EDF	D61	3
59	7155027	7155080	665	718	53	LEFT	D61c.EDF	D61	3
59	7155125	7155210	763	848	85	LEFT	D61c.EDF	D61	3
59	7155252	7155353	890	991	101	LEFT	D61c.EDF	D61	3
59	7155391	7155394	1029	1032	3	LEFT	D61c.EDF	D61	3
59	7155427	7155469	1065	1107	42	LEFT	D61c.EDF	D61	3
59	7155507	7155574	1145	1212	67	LEFT	D61c.EDF	D61	3
59	7155603	7155638	1241	1276	35	LEFT	D61c.EDF	D61	3
59	7155878	7155881	1516	1519	3	LEFT	D61c.EDF	D61	3
59	7155906	7155907	1544	1545	1	LEFT	D61c.EDF	D61	3
59	7155942	7155975	1580	1613	33	LEFT	D61c.EDF	D61	3
59	7156016	7157126	1654	2764	1110	LEFT	D61c.EDF	D61	3
59	7157171	7157171	2809	2809	0	LEFT	D61c.EDF	D61	3
59	7157258	7157258	2896	2896	0	LEFT	D61c.EDF	D61	3
59	7157430	7157433	3068	3071	3	LEFT	D61c.EDF	D61	3
59	7157493	7157768	3131	3406	275	LEFT	D61c.EDF	D61	3
59	7157804	7157821	3442	3459	17	LEFT	D61c.EDF	D61	3
59	7157866	7157866	3504	3504	0	LEFT	D61c.EDF	D61	3
59	7157904	7157907	3542	3545	3	LEFT	D61c.EDF	D61	3
59	7157958	7158018	3596	3656	60	LEFT	D61c.EDF	D61	3
59	7158093	7158148	3731	3786	55	LEFT	D61c.EDF	D61	3
59	7158184	7158212	3822	3850	28	LEFT	D61c.EDF	D61	3
59	7158283	7158301	3921	3939	18	LEFT	D61c.EDF	D61	3
59	7158331	7158345	3969	3983	14	LEFT	D61c.EDF	D61	3
59	7158404	7158406	4042	4044	2	LEFT	D61c.EDF	D61	3
59	7158557	7158558	4195	4196	1	LEFT	D61c.EDF	D61	3
59	7158589	7158616	4227	4254	27	LEFT	D61c.EDF	D61	3
59	7158743	7158777	4381	4415	34	LEFT	D61c.EDF	D61	3
59	7158800	7158821	4438	4459	21	LEFT	D61c.EDF	D61	3
59	7158882	7158891	4520	4529	9	LEFT	D61c.EDF	D61	3
59	7159045	7159109	4683	4747	64	LEFT	D61c.EDF	D61	3
59	7159131	7159133	4769	4771	2	LEFT	D61c.EDF	D61	3
59	7159167	7159168	4805	4806	1	LEFT	D61c.EDF	D61	3
59	7159215	7159254	4853	4892	39	LEFT	D61c.EDF	D61	3
59	7159283	7159284	4921	4922	1	LEFT	D61c.EDF	D61	3
59	7159317	7159319	4955	4957	2	LEFT	D61c.EDF	D61	3
59	7159367	7159367	5005	5005	0	LEFT	D61c.EDF	D61	3
59	7159480	7159482	5118	5120	2	LEFT	D61c.EDF	D61	3
59	7159550	7159553	5188	5191	3	LEFT	D61c.EDF	D61	3
59	7159610	7159611	5248	5249	1	LEFT	D61c.EDF	D61	3
59	7159744	7159786	5382	5424	42	LEFT	D61c.EDF	D61	3
59	7159810	7159849	5448	5487	39	LEFT	D61c.EDF	D61	3
59	7159878	7160040	5516	5678	162	LEFT	D61c.EDF	D61	3
59	7160069	7160225	5707	5863	156	LEFT	D61c.EDF	D61	3
59	7160249	7160272	5887	5910	23	LEFT	D61c.EDF	D61	3
59	7160294	7160323	5932	5961	29	LEFT	D61c.EDF	D61	3
59	7160346	7160418	5984	6056	72	LEFT	D61c.EDF	D61	3
59	7160450	7160485	6088	6123	35	LEFT	D61c.EDF	D61	3
59	7160510	7160512	6148	6150	2	LEFT	D61c.EDF	D61	3
59	7160551	7160566	6189	6204	15	LEFT	D61c.EDF	D61	3
60	7162589	7162772	58	241	183	LEFT	D61c.EDF	D61	3
60	7163086	7163089	555	558	3	LEFT	D61c.EDF	D61	3
60	7163185	7163186	654	655	1	LEFT	D61c.EDF	D61	3
60	7164002	7164002	1471	1471	0	LEFT	D61c.EDF	D61	3
60	7164142	7164142	1611	1611	0	LEFT	D61c.EDF	D61	3
60	7164327	7164425	1796	1894	98	LEFT	D61c.EDF	D61	3
60	7165145	7165145	2614	2614	0	LEFT	D61c.EDF	D61	3
60	7165202	7165207	2671	2676	5	LEFT	D61c.EDF	D61	3
60	7165231	7168222	2700	5691	2991	LEFT	D61c.EDF	D61	3
61	7170383	7171260	58	935	877	LEFT	D61c.EDF	D61	3
61	7171281	7171282	956	957	1	LEFT	D61c.EDF	D61	3
61	7171312	7171520	987	1195	208	LEFT	D61c.EDF	D61	3
61	7171547	7171767	1222	1442	220	LEFT	D61c.EDF	D61	3
61	7171835	7171838	1510	1513	3	LEFT	D61c.EDF	D61	3
61	7171894	7171895	1569	1570	1	LEFT	D61c.EDF	D61	3
61	7171938	7172055	1613	1730	117	LEFT	D61c.EDF	D61	3
61	7172076	7172077	1751	1752	1	LEFT	D61c.EDF	D61	3
61	7172109	7172197	1784	1872	88	LEFT	D61c.EDF	D61	3
61	7172244	7172254	1919	1929	10	LEFT	D61c.EDF	D61	3
61	7172275	7172758	1950	2433	483	LEFT	D61c.EDF	D61	3
61	7172781	7172793	2456	2468	12	LEFT	D61c.EDF	D61	3
61	7172865	7172866	2540	2541	1	LEFT	D61c.EDF	D61	3
61	7173387	7173388	3062	3063	1	LEFT	D61c.EDF	D61	3
61	7173415	7177717	3090	7392	4302	LEFT	D61c.EDF	D61	3
62	7179763	7179842	57	136	79	LEFT	D61c.EDF	D61	3
62	7180101	7180721	395	1015	620	LEFT	D61c.EDF	D61	3
62	7180754	7180790	1048	1084	36	LEFT	D61c.EDF	D61	3
62	7180831	7180852	1125	1146	21	LEFT	D61c.EDF	D61	3
62	7180920	7180920	1214	1214	0	LEFT	D61c.EDF	D61	3
62	7180944	7180944	1238	1238	0	LEFT	D61c.EDF	D61	3
62	7181004	7181005	1298	1299	1	LEFT	D61c.EDF	D61	3
62	7181034	7181060	1328	1354	26	LEFT	D61c.EDF	D61	3
62	7181168	7181225	1462	1519	57	LEFT	D61c.EDF	D61	3
62	7181261	7181303	1555	1597	42	LEFT	D61c.EDF	D61	3
62	7181328	7181328	1622	1622	0	LEFT	D61c.EDF	D61	3
62	7181369	7181379	1663	1673	10	LEFT	D61c.EDF	D61	3
62	7181462	7181463	1756	1757	1	LEFT	D61c.EDF	D61	3
62	7181503	7181503	1797	1797	0	LEFT	D61c.EDF	D61	3
62	7181542	7181543	1836	1837	1	LEFT	D61c.EDF	D61	3
62	7181641	7181643	1935	1937	2	LEFT	D61c.EDF	D61	3
62	7181669	7181745	1963	2039	76	LEFT	D61c.EDF	D61	3
62	7181770	7181924	2064	2218	154	LEFT	D61c.EDF	D61	3
62	7182178	7183459	2472	3753	1281	LEFT	D61c.EDF	D61	3
62	7183482	7183677	3776	3971	195	LEFT	D61c.EDF	D61	3
62	7183705	7183707	3999	4001	2	LEFT	D61c.EDF	D61	3
62	7183729	7183922	4023	4216	193	LEFT	D61c.EDF	D61	3
62	7183943	7183951	4237	4245	8	LEFT	D61c.EDF	D61	3
62	7183992	7184080	4286	4374	88	LEFT	D61c.EDF	D61	3
62	7184102	7184611	4396	4905	509	LEFT	D61c.EDF	D61	3
63	7186533	7186712	57	236	179	LEFT	D61c.EDF	D61	3
63	7186770	7186771	294	295	1	LEFT	D61c.EDF	D61	3
63	7186810	7187030	334	554	220	LEFT	D61c.EDF	D61	3
63	7187052	7187171	576	695	119	LEFT	D61c.EDF	D61	3
63	7187209	7187232	733	756	23	LEFT	D61c.EDF	D61	3
63	7187255	7187255	779	779	0	LEFT	D61c.EDF	D61	3
63	7187304	7187304	828	828	0	LEFT	D61c.EDF	D61	3
63	7187341	7187341	865	865	0	LEFT	D61c.EDF	D61	3
63	7187374	7187374	898	898	0	LEFT	D61c.EDF	D61	3
63	7187418	7187496	942	1020	78	LEFT	D61c.EDF	D61	3
63	7187537	7187538	1061	1062	1	LEFT	D61c.EDF	D61	3
63	7187829	7187844	1353	1368	15	LEFT	D61c.EDF	D61	3
63	7187880	7187880	1404	1404	0	LEFT	D61c.EDF	D61	3
63	7187906	7187906	1430	1430	0	LEFT	D61c.EDF	D61	3
63	7187938	7187939	1462	1463	1	LEFT	D61c.EDF	D61	3
63	7187996	7187996	1520	1520	0	LEFT	D61c.EDF	D61	3
63	7188019	7188050	1543	1574	31	LEFT	D61c.EDF	D61	3
63	7188078	7188093	1602	1617	15	LEFT	D61c.EDF	D61	3
63	7188147	7188163	1671	1687	16	LEFT	D61c.EDF	D61	3
63	7188223	7188225	1747	1749	2	LEFT	D61c.EDF	D61	3
63	7188327	7188329	1851	1853	2	LEFT	D61c.EDF	D61	3
63	7188500	7188615	2024	2139	115	LEFT	D61c.EDF	D61	3
63	7189047	7189048	2571	2572	1	LEFT	D61c.EDF	D61	3
63	7189079	7191411	2603	4935	2332	LEFT	D61c.EDF	D61	3
63	7191436	7191466	4960	4990	30	LEFT	D61c.EDF	D61	3
63	7191521	7191521	5045	5045	0	LEFT	D61c.EDF	D61	3
63	7191545	7191550	5069	5074	5	LEFT	D61c.EDF	D61	3
63	7191592	7191593	5116	5117	1	LEFT	D61c.EDF	D61	3
63	7191621	7192132	5145	5656	511	LEFT	D61c.EDF	D61	3
63	7192153	7192231	5677	5755	78	LEFT	D61c.EDF	D61	3
63	7192261	7193247	5785	6771	986	LEFT	D61c.EDF	D61	3
64	7195254	7195653	58	457	399	LEFT	D61c.EDF	D61	3
64	7195725	7195742	529	546	17	LEFT	D61c.EDF	D61	3
64	7195764	7195784	568	588	20	LEFT	D61c.EDF	D61	3
64	7195848	7195849	652	653	1	LEFT	D61c.EDF	D61	3
64	7196057	7196061	861	865	4	LEFT	D61c.EDF	D61	3
64	7196585	7196594	1389	1398	9	LEFT	D61c.EDF	D61	3
64	7197067	7197067	1871	1871	0	LEFT	D61c.EDF	D61	3
64	7197188	7197190	1992	1994	2	LEFT	D61c.EDF	D61	3
64	7197427	7198067	2231	2871	640	LEFT	D61c.EDF	D61	3
64	7198112	7198156	2916	2960	44	LEFT	D61c.EDF	D61	3
64	7198183	7198183	2987	2987	0	LEFT	D61c.EDF	D61	3
64	7198204	7198205	3008	3009	1	LEFT	D61c.EDF	D61	3
64	7198513	7198696	3317	3500	183	LEFT	D61c.EDF	D61	3
64	7198748	7198750	3552	3554	2	LEFT	D61c.EDF	D61	3
64	7198931	7198932	3735	3736	1	LEFT	D61c.EDF	D61	3
64	7198957	7199010	3761	3814	53	LEFT	D61c.EDF	D61	3
64	7199382	7199409	4186	4213	27	LEFT	D61c.EDF	D61	3
64	7199440	7199441	4244	4245	1	LEFT	D61c.EDF	D61	3
64	7199496	7199496	4300	4300	0	LEFT	D61c.EDF	D61	3
64	7199555	7199557	4359	4361	2	LEFT	D61c.EDF	D61	3
64	7199813	7199817	4617	4621	4	LEFT	D61c.EDF	D61	3
64	7199914	7199927	4718	4731	13	LEFT	D61c.EDF	D61	3
64	7200062	7200076	4866	4880	14	LEFT	D61c.EDF	D61	3
64	7200314	7200314	5118	5118	0	LEFT	D61c.EDF	D61	3
64	7200482	7200482	5286	5286	0	LEFT	D61c.EDF	D61	3
64	7200546	7200546	5350	5350	0	LEFT	D61c.EDF	D61	3
64	7200731	7200731	5535	5535	0	LEFT	D61c.EDF	D61	3
64	7201101	7201101	5905	5905	0	LEFT	D61c.EDF	D61	3
64	7201437	7201445	6241	6249	8	LEFT	D61c.EDF	D61	3
64	7201494	7201513	6298	6317	19	LEFT	D61c.EDF	D61	3
64	7201823	7201842	6627	6646	19	LEFT	D61c.EDF	D61	3
65	7204043	7204199	57	213	156	LEFT	D61c.EDF	D61	3
65	7205822	7205825	1836	1839	3	LEFT	D61c.EDF	D61	3
65	7205850	7205976	1864	1990	126	LEFT	D61c.EDF	D61	3
65	7206283	7206766	2297	2780	483	LEFT	D61c.EDF	D61	3
65	7206803	7206865	2817	2879	62	LEFT	D61c.EDF	D61	3
65	7206891	7206928	2905	2942	37	LEFT	D61c.EDF	D61	3
65	7206973	7206982	2987	2996	9	LEFT	D61c.EDF	D61	3
65	7207009	7207069	3023	3083	60	LEFT	D61c.EDF	D61	3
65	7207117	7207125	3131	3139	8	LEFT	D61c.EDF	D61	3
65	7207162	7207215	3176	3229	53	LEFT	D61c.EDF	D61	3
65	7207241	7207248	3255	3262	7	LEFT	D61c.EDF	D61	3
65	7207336	7207337	3350	3351	1	LEFT	D61c.EDF	D61	3
65	7207362	7207362	3376	3376	0	LEFT	D61c.EDF	D61	3
65	7207387	7207388	3401	3402	1	LEFT	D61c.EDF	D61	3
65	7207434	7207446	3448	3460	12	LEFT	D61c.EDF	D61	3
65	7207470	7207486	3484	3500	16	LEFT	D61c.EDF	D61	3
65	7207566	7207566	3580	3580	0	LEFT	D61c.EDF	D61	3
65	7207631	7207680	3645	3694	49	LEFT	D61c.EDF	D61	3
65	7207729	7207729	3743	3743	0	LEFT	D61c.EDF	D61	3
65	7207895	7207895	3909	3909	0	LEFT	D61c.EDF	D61	3
65	7208691	7208691	4705	4705	0	LEFT	D61c.EDF	D61	3
65	7208815	7208815	4829	4829	0	LEFT	D61c.EDF	D61	3
65	7208846	7208847	4860	4861	1	LEFT	D61c.EDF	D61	3
65	7208900	7208900	4914	4914	0	LEFT	D61c.EDF	D61	3
65	7209003	7209003	5017	5017	0	LEFT	D61c.EDF	D61	3
65	7209078	7209079	5092	5093	1	LEFT	D61c.EDF	D61	3
65	7209180	7209182	5194	5196	2	LEFT	D61c.EDF	D61	3
65	7209228	7209282	5242	5296	54	LEFT	D61c.EDF	D61	3
65	7209309	7209335	5323	5349	26	LEFT	D61c.EDF	D61	3
65	7209366	7209366	5380	5380	0	LEFT	D61c.EDF	D61	3
65	7209395	7209400	5409	5414	5	LEFT	D61c.EDF	D61	3
65	7209469	7209500	5483	5514	31	LEFT	D61c.EDF	D61	3
65	7209545	7209697	5559	5711	152	LEFT	D61c.EDF	D61	3
66	7211849	7212032	86	269	183	LEFT	D61c.EDF	D61	3
66	7212223	7212364	460	601	141	LEFT	D61c.EDF	D61	3
66	7212408	7212615	645	852	207	LEFT	D61c.EDF	D61	3
66	7212639	7212639	876	876	0	LEFT	D61c.EDF	D61	3
66	7212713	7212860	950	1097	147	LEFT	D61c.EDF	D61	3
66	7212894	7212984	1131	1221	90	LEFT	D61c.EDF	D61	3
66	7214387	7214429	2624	2666	42	LEFT	D61c.EDF	D61	3
66	7214680	7214875	2917	3112	195	LEFT	D61c.EDF	D61	3
66	7214901	7214938	3138	3175	37	LEFT	D61c.EDF	D61	3
66	7214966	7214996	3203	3233	30	LEFT	D61c.EDF	D61	3
66	7215028	7215082	3265	3319	54	LEFT	D61c.EDF	D61	3
66	7215118	7215141	3355	3378	23	LEFT	D61c.EDF	D61	3
66	7215164	7215249	3401	3486	85	LEFT	D61c.EDF	D61	3
66	7215270	7215451	3507	3688	181	LEFT	D61c.EDF	D61	3
66	7215490	7215491	3727	3728	1	LEFT	D61c.EDF	D61	3
66	7215619	7215619	3856	3856	0	LEFT	D61c.EDF	D61	3
66	7215819	7215820	4056	4057	1	LEFT	D61c.EDF	D61	3
66	7215921	7215922	4158	4159	1	LEFT	D61c.EDF	D61	3
66	7215976	7215990	4213	4227	14	LEFT	D61c.EDF	D61	3
66	7216016	7216017	4253	4254	1	LEFT	D61c.EDF	D61	3
66	7216094	7216124	4331	4361	30	LEFT	D61c.EDF	D61	3
66	7216149	7216153	4386	4390	4	LEFT	D61c.EDF	D61	3
66	7216175	7216181	4412	4418	6	LEFT	D61c.EDF	D61	3
66	7216221	7216275	4458	4512	54	LEFT	D61c.EDF	D61	3
66	7216296	7216356	4533	4593	60	LEFT	D61c.EDF	D61	3
66	7216382	7216393	4619	4630	11	LEFT	D61c.EDF	D61	3
66	7216418	7216418	4655	4655	0	LEFT	D61c.EDF	D61	3
66	7216445	7216502	4682	4739	57	LEFT	D61c.EDF	D61	3
66	7216552	7216597	4789	4834	45	LEFT	D61c.EDF	D61	3
66	7216696	7216697	4933	4934	1	LEFT	D61c.EDF	D61	3
66	7216775	7216775	5012	5012	0	LEFT	D61c.EDF	D61	3
66	7216862	7216862	5099	5099	0	LEFT	D61c.EDF	D61	3
66	7217097	7217138	5334	5375	41	LEFT	D61c.EDF	D61	3
66	7217290	7217290	5527	5527	0	LEFT	D61c.EDF	D61	3
66	7217397	7217432	5634	5669	35	LEFT	D61c.EDF	D61	3
66	7217578	7217584	5815	5821	6	LEFT	D61c.EDF	D61	3
67	7220060	7220830	705	1475	770	LEFT	D61c.EDF	D61	3
67	7220852	7221063	1497	1708	211	LEFT	D61c.EDF	D61	3
67	7221448	7223919	2093	4564	2471	LEFT	D61c.EDF	D61	3
67	7223945	7223971	4590	4616	26	LEFT	D61c.EDF	D61	3
67	7224003	7224019	4648	4664	16	LEFT	D61c.EDF	D61	3
67	7224047	7224107	4692	4752	60	LEFT	D61c.EDF	D61	3
67	7224342	7224344	4987	4989	2	LEFT	D61c.EDF	D61	3
68	7226897	7226981	58	142	84	LEFT	D61c.EDF	D61	3
68	7227027	7227027	188	188	0	LEFT	D61c.EDF	D61	3
68	7227087	7227087	248	248	0	LEFT	D61c.EDF	D61	3
68	7227415	7227445	576	606	30	LEFT	D61c.EDF	D61	3
68	7227646	7227667	807	828	21	LEFT	D61c.EDF	D61	3
68	7227734	7227734	895	895	0	LEFT	D61c.EDF	D61	3
68	7227814	7227814	975	975	0	LEFT	D61c.EDF	D61	3
68	7227844	7227845	1005	1006	1	LEFT	D61c.EDF	D61	3
68	7228013	7228037	1174	1198	24	LEFT	D61c.EDF	D61	3
68	7228081	7228081	1242	1242	0	LEFT	D61c.EDF	D61	3
68	7228505	7228510	1666	1671	5	LEFT	D61c.EDF	D61	3
68	7228532	7228533	1693	1694	1	LEFT	D61c.EDF	D61	3
68	7228566	7228575	1727	1736	9	LEFT	D61c.EDF	D61	3
68	7228620	7228635	1781	1796	15	LEFT	D61c.EDF	D61	3
68	7228669	7228669	1830	1830	0	LEFT	D61c.EDF	D61	3
68	7228722	7228722	1883	1883	0	LEFT	D61c.EDF	D61	3
68	7228746	7228765	1907	1926	19	LEFT	D61c.EDF	D61	3
68	7228790	7228834	1951	1995	44	LEFT	D61c.EDF	D61	3
68	7228859	7228962	2020	2123	103	LEFT	D61c.EDF	D61	3
68	7229595	7229596	2756	2757	1	LEFT	D61c.EDF	D61	3
68	7229633	7230116	2794	3277	483	LEFT	D61c.EDF	D61	3
68	7230141	7230158	3302	3319	17	LEFT	D61c.EDF	D61	3
68	7230221	7230221	3382	3382	0	LEFT	D61c.EDF	D61	3
68	7230280	7230288	3441	3449	8	LEFT	D61c.EDF	D61	3
68	7230312	7230314	3473	3475	2	LEFT	D61c.EDF	D61	3
69	7234442	7234637	57	252	195	LEFT	D61c.EDF	D61	3
69	7235417	7235417	1032	1032	0	LEFT	D61c.EDF	D61	3
69	7235696	7235697	1311	1312	1	LEFT	D61c.EDF	D61	3
69	7235900	7235919	1515	1534	19	LEFT	D61c.EDF	D61	3
69	7235940	7235940	1555	1555	0	LEFT	D61c.EDF	D61	3
69	7235998	7235998	1613	1613	0	LEFT	D61c.EDF	D61	3
69	7236092	7236163	1707	1778	71	LEFT	D61c.EDF	D61	3
69	7236810	7236986	2425	2601	176	LEFT	D61c.EDF	D61	3
69	7237008	7237014	2623	2629	6	LEFT	D61c.EDF	D61	3
69	7237089	7237115	2704	2730	26	LEFT	D61c.EDF	D61	3
69	7237188	7237188	2803	2803	0	LEFT	D61c.EDF	D61	3
69	7237285	7237286	2900	2901	1	LEFT	D61c.EDF	D61	3
69	7237328	7237328	2943	2943	0	LEFT	D61c.EDF	D61	3
69	7237431	7237432	3046	3047	1	LEFT	D61c.EDF	D61	3
69	7240280	7240280	5895	5895	0	LEFT	D61c.EDF	D61	3
69	7241209	7241211	6824	6826	2	LEFT	D61c.EDF	D61	3
70	7243614	7243893	58	337	279	LEFT	D61c.EDF	D61	3
70	7243926	7243928	370	372	2	LEFT	D61c.EDF	D61	3
70	7244311	7244311	755	755	0	LEFT	D61c.EDF	D61	3
70	7244424	7244427	868	871	3	LEFT	D61c.EDF	D61	3
70	7244464	7244466	908	910	2	LEFT	D61c.EDF	D61	3
70	7244488	7244488	932	932	0	LEFT	D61c.EDF	D61	3
70	7244643	7244644	1087	1088	1	LEFT	D61c.EDF	D61	3
70	7244696	7244698	1140	1142	2	LEFT	D61c.EDF	D61	3
70	7244814	7244816	1258	1260	2	LEFT	D61c.EDF	D61	3
70	7244859	7244882	1303	1326	23	LEFT	D61c.EDF	D61	3
70	7244904	7244922	1348	1366	18	LEFT	D61c.EDF	D61	3
70	7245045	7245045	1489	1489	0	LEFT	D61c.EDF	D61	3
70	7245149	7245150	1593	1594	1	LEFT	D61c.EDF	D61	3
70	7245201	7245204	1645	1648	3	LEFT	D61c.EDF	D61	3
70	7245540	7245575	1984	2019	35	LEFT	D61c.EDF	D61	3
70	7245611	7245613	2055	2057	2	LEFT	D61c.EDF	D61	3
70	7245634	7245710	2078	2154	76	LEFT	D61c.EDF	D61	3
70	7245746	7246582	2190	3026	836	LEFT	D61c.EDF	D61	3
70	7246612	7246613	3056	3057	1	LEFT	D61c.EDF	D61	3
70	7246637	7246653	3081	3097	16	LEFT	D61c.EDF	D61	3
70	7246711	7246712	3155	3156	1	LEFT	D61c.EDF	D61	3
70	7246754	7246756	3198	3200	2	LEFT	D61c.EDF	D61	3
70	7246790	7246839	3234	3283	49	LEFT	D61c.EDF	D61	3
70	7247013	7247033	3457	3477	20	LEFT	D61c.EDF	D61	3
70	7247118	7247121	3562	3565	3	LEFT	D61c.EDF	D61	3
70	7247342	7247343	3786	3787	1	LEFT	D61c.EDF	D61	3
71	7250815	7250897	58	140	82	LEFT	D61c.EDF	D61	3
71	7251025	7251227	268	470	202	LEFT	D61c.EDF	D61	3
71	7251725	7251900	968	1143	175	LEFT	D61c.EDF	D61	3
71	7252225	7252225	1468	1468	0	LEFT	D61c.EDF	D61	3
71	7252248	7252270	1491	1513	22	LEFT	D61c.EDF	D61	3
71	7252493	7252493	1736	1736	0	LEFT	D61c.EDF	D61	3
71	7252616	7252617	1859	1860	1	LEFT	D61c.EDF	D61	3
71	7252672	7252672	1915	1915	0	LEFT	D61c.EDF	D61	3
71	7252795	7252821	2038	2064	26	LEFT	D61c.EDF	D61	3
71	7252842	7252849	2085	2092	7	LEFT	D61c.EDF	D61	3
71	7253305	7253699	2548	2942	394	LEFT	D61c.EDF	D61	3
71	7253845	7253846	3088	3089	1	LEFT	D61c.EDF	D61	3
71	7253998	7254013	3241	3256	15	LEFT	D61c.EDF	D61	3
71	7254206	7254207	3449	3450	1	LEFT	D61c.EDF	D61	3
71	7254305	7254320	3548	3563	15	LEFT	D61c.EDF	D61	3
71	7257276	7257276	6519	6519	0	LEFT	D61c.EDF	D61	3
71	7257588	7257588	6831	6831	0	LEFT	D61c.EDF	D61	3
72	7259739	7259958	210	429	219	LEFT	D61c.EDF	D61	3
72	7260380	7260592	851	1063	212	LEFT	D61c.EDF	D61	3
72	7261133	7261133	1604	1604	0	LEFT	D61c.EDF	D61	3
72	7261369	7261385	1840	1856	16	LEFT	D61c.EDF	D61	3
72	7261457	7261467	1928	1938	10	LEFT	D61c.EDF	D61	3
72	7261532	7261607	2003	2078	75	LEFT	D61c.EDF	D61	3
72	7261734	7262466	2205	2937	732	LEFT	D61c.EDF	D61	3
72	7262493	7262500	2964	2971	7	LEFT	D61c.EDF	D61	3
72	7262563	7262567	3034	3038	4	LEFT	D61c.EDF	D61	3
72	7262596	7262597	3067	3068	1	LEFT	D61c.EDF	D61	3
72	7262779	7262779	3250	3250	0	LEFT	D61c.EDF	D61	3
72	7263641	7263653	4112	4124	12	LEFT	D61c.EDF	D61	3
72	7263682	7263694	4153	4165	12	LEFT	D61c.EDF	D61	3
72	7263755	7263756	4226	4227	1	LEFT	D61c.EDF	D61	3
72	7263827	7263830	4298	4301	3	LEFT	D61c.EDF	D61	3
72	7263852	7263852	4323	4323	0	LEFT	D61c.EDF	D61	3
72	7263966	7263966	4437	4437	0	LEFT	D61c.EDF	D61	3
72	7264077	7264078	4548	4549	1	LEFT	D61c.EDF	D61	3
72	7265998	7265998	6469	6469	0	LEFT	D61c.EDF	D61	3
73	7268192	7268440	97	345	248	LEFT	D61c.EDF	D61	3
73	7269465	7269467	1370	1372	2	LEFT	D61c.EDF	D61	3
73	7270078	7270800	1983	2705	722	LEFT	D61c.EDF	D61	3
73	7270821	7270855	2726	2760	34	LEFT	D61c.EDF	D61	3
73	7270883	7270961	2788	2866	78	LEFT	D61c.EDF	D61	3
73	7270985	7270985	2890	2890	0	LEFT	D61c.EDF	D61	3
73	7271093	7271103	2998	3008	10	LEFT	D61c.EDF	D61	3
73	7271289	7271291	3194	3196	2	LEFT	D61c.EDF	D61	3
73	7272397	7272411	4302	4316	14	LEFT	D61c.EDF	D61	3
73	7272885	7272888	4790	4793	3	LEFT	D61c.EDF	D61	3
73	7272963	7272964	4868	4869	1	LEFT	D61c.EDF	D61	3
73	7273006	7273011	4911	4916	5	LEFT	D61c.EDF	D61	3
73	7273102	7273102	5007	5007	0	LEFT	D61c.EDF	D61	3
73	7273167	7273167	5072	5072	0	LEFT	D61c.EDF	D61	3
74	7275197	7275234	57	94	37	LEFT	D61c.EDF	D61	3
74	7275416	7276022	276	882	606	LEFT	D61c.EDF	D61	3
74	7276047	7276050	907	910	3	LEFT	D61c.EDF	D61	3
74	7276123	7276134	983	994	11	LEFT	D61c.EDF	D61	3
74	7276201	7276203	1061	1063	2	LEFT	D61c.EDF	D61	3
74	7276227	7276231	1087	1091	4	LEFT	D61c.EDF	D61	3
74	7276510	7276511	1370	1371	1	LEFT	D61c.EDF	D61	3
74	7276539	7276541	1399	1401	2	LEFT	D61c.EDF	D61	3
74	7276565	7276568	1425	1428	3	LEFT	D61c.EDF	D61	3
74	7276620	7276620	1480	1480	0	LEFT	D61c.EDF	D61	3
74	7276652	7276652	1512	1512	0	LEFT	D61c.EDF	D61	3
74	7276679	7276681	1539	1541	2	LEFT	D61c.EDF	D61	3
74	7276751	7276751	1611	1611	0	LEFT	D61c.EDF	D61	3
74	7276772	7276772	1632	1632	0	LEFT	D61c.EDF	D61	3
74	7276806	7276816	1666	1676	10	LEFT	D61c.EDF	D61	3
74	7276837	7276837	1697	1697	0	LEFT	D61c.EDF	D61	3
74	7276876	7276911	1736	1771	35	LEFT	D61c.EDF	D61	3
74	7276948	7276991	1808	1851	43	LEFT	D61c.EDF	D61	3
74	7277095	7277146	1955	2006	51	LEFT	D61c.EDF	D61	3
74	7277189	7277231	2049	2091	42	LEFT	D61c.EDF	D61	3
74	7277424	7277658	2284	2518	234	LEFT	D61c.EDF	D61	3
74	7277684	7278179	2544	3039	495	LEFT	D61c.EDF	D61	3
74	7278210	7278241	3070	3101	31	LEFT	D61c.EDF	D61	3
74	7278317	7278333	3177	3193	16	LEFT	D61c.EDF	D61	3
74	7278363	7278413	3223	3273	50	LEFT	D61c.EDF	D61	3
74	7278493	7278507	3353	3367	14	LEFT	D61c.EDF	D61	3
74	7278537	7278538	3397	3398	1	LEFT	D61c.EDF	D61	3
74	7278693	7278705	3553	3565	12	LEFT	D61c.EDF	D61	3
74	7278860	7278863	3720	3723	3	LEFT	D61c.EDF	D61	3
74	7280279	7280281	5139	5141	2	LEFT	D61c.EDF	D61	3
74	7280306	7280306	5166	5166	0	LEFT	D61c.EDF	D61	3
74	7280461	7280461	5321	5321	0	LEFT	D61c.EDF	D61	3
74	7280675	7280721	5535	5581	46	LEFT	D61c.EDF	D61	3
74	7280773	7280783	5633	5643	10	LEFT	D61c.EDF	D61	3
74	7280885	7280898	5745	5758	13	LEFT	D61c.EDF	D61	3
74	7281080	7281080	5940	5940	0	LEFT	D61c.EDF	D61	3
75	7283227	7283408	58	239	181	LEFT	D61c.EDF	D61	3
75	7284264	7284264	1095	1095	0	LEFT	D61c.EDF	D61	3
75	7284469	7284494	1300	1325	25	LEFT	D61c.EDF	D61	3
75	7284524	7284563	1355	1394	39	LEFT	D61c.EDF	D61	3
75	7284683	7284732	1514	1563	49	LEFT	D61c.EDF	D61	3
75	7284760	7284764	1591	1595	4	LEFT	D61c.EDF	D61	3
75	7284813	7284813	1644	1644	0	LEFT	D61c.EDF	D61	3
75	7284934	7284935	1765	1766	1	LEFT	D61c.EDF	D61	3
75	7285027	7285028	1858	1859	1	LEFT	D61c.EDF	D61	3
75	7285143	7285145	1974	1976	2	LEFT	D61c.EDF	D61	3
75	7285182	7285192	2013	2023	10	LEFT	D61c.EDF	D61	3
75	7285214	7285300	2045	2131	86	LEFT	D61c.EDF	D61	3
75	7285743	7286031	2574	2862	288	LEFT	D61c.EDF	D61	3
75	7286060	7286115	2891	2946	55	LEFT	D61c.EDF	D61	3
75	7286141	7286188	2972	3019	47	LEFT	D61c.EDF	D61	3
75	7286220	7286234	3051	3065	14	LEFT	D61c.EDF	D61	3
75	7286303	7286320	3134	3151	17	LEFT	D61c.EDF	D61	3
75	7286525	7286525	3356	3356	0	LEFT	D61c.EDF	D61	3
75	7286748	7286749	3579	3580	1	LEFT	D61c.EDF	D61	3
75	7286874	7286881	3705	3712	7	LEFT	D61c.EDF	D61	3
75	7286907	7286907	3738	3738	0	LEFT	D61c.EDF	D61	3
75	7287018	7287029	3849	3860	11	LEFT	D61c.EDF	D61	3
75	7287085	7287089	3916	3920	4	LEFT	D61c.EDF	D61	3
75	7287154	7287154	3985	3985	0	LEFT	D61c.EDF	D61	3
75	7287262	7287263	4093	4094	1	LEFT	D61c.EDF	D61	3
75	7287302	7287313	4133	4144	11	LEFT	D61c.EDF	D61	3
75	7287475	7287475	4306	4306	0	LEFT	D61c.EDF	D61	3
75	7287593	7287603	4424	4434	10	LEFT	D61c.EDF	D61	3
75	7287643	7287644	4474	4475	1	LEFT	D61c.EDF	D61	3
75	7287670	7287670	4501	4501	0	LEFT	D61c.EDF	D61	3
75	7287695	7287734	4526	4565	39	LEFT	D61c.EDF	D61	3
75	7287773	7287779	4604	4610	6	LEFT	D61c.EDF	D61	3
75	7287828	7287881	4659	4712	53	LEFT	D61c.EDF	D61	3
75	7287923	7287924	4754	4755	1	LEFT	D61c.EDF	D61	3
75	7287963	7287963	4794	4794	0	LEFT	D61c.EDF	D61	3
75	7287992	7287992	4823	4823	0	LEFT	D61c.EDF	D61	3
75	7288046	7288071	4877	4902	25	LEFT	D61c.EDF	D61	3
75	7288142	7288153	4973	4984	11	LEFT	D61c.EDF	D61	3
75	7288237	7288252	5068	5083	15	LEFT	D61c.EDF	D61	3
75	7288277	7288277	5108	5108	0	LEFT	D61c.EDF	D61	3
75	7288368	7288370	5199	5201	2	LEFT	D61c.EDF	D61	3
75	7288640	7288667	5471	5498	27	LEFT	D61c.EDF	D61	3
75	7288708	7288728	5539	5559	20	LEFT	D61c.EDF	D61	3
75	7288753	7288779	5584	5610	26	LEFT	D61c.EDF	D61	3
75	7288814	7288814	5645	5645	0	LEFT	D61c.EDF	D61	3
75	7288838	7288968	5669	5799	130	LEFT	D61c.EDF	D61	3
75	7288990	7289060	5821	5891	70	LEFT	D61c.EDF	D61	3
75	7289081	7289097	5912	5928	16	LEFT	D61c.EDF	D61	3
75	7289118	7289139	5949	5970	21	LEFT	D61c.EDF	D61	3
75	7289160	7289193	5991	6024	33	LEFT	D61c.EDF	D61	3
75	7289216	7289217	6047	6048	1	LEFT	D61c.EDF	D61	3
75	7289245	7289299	6076	6130	54	LEFT	D61c.EDF	D61	3
75	7289323	7289334	6154	6165	11	LEFT	D61c.EDF	D61	3
75	7289371	7289430	6202	6261	59	LEFT	D61c.EDF	D61	3
75	7289461	7289461	6292	6292	0	LEFT	D61c.EDF	D61	3
75	7289485	7289486	6316	6317	1	LEFT	D61c.EDF	D61	3
75	7289553	7289554	6384	6385	1	LEFT	D61c.EDF	D61	3
75	7289591	7289665	6422	6496	74	LEFT	D61c.EDF	D61	3
75	7289695	7289708	6526	6539	13	LEFT	D61c.EDF	D61	3
75	7289729	7289786	6560	6617	57	LEFT	D61c.EDF	D61	3
76	7291943	7292160	164	381	217	LEFT	D61c.EDF	D61	3
76	7292925	7292925	1146	1146	0	LEFT	D61c.EDF	D61	3
76	7293022	7293025	1243	1246	3	LEFT	D61c.EDF	D61	3
76	7293794	7293796	2015	2017	2	LEFT	D61c.EDF	D61	3
76	7293944	7297795	2165	6016	3851	LEFT	D61c.EDF	D61	3
76	7297839	7297858	6060	6079	19	LEFT	D61c.EDF	D61	3
76	7297931	7297952	6152	6173	21	LEFT	D61c.EDF	D61	3
76	7298088	7298088	6309	6309	0	LEFT	D61c.EDF	D61	3
76	7298234	7298239	6455	6460	5	LEFT	D61c.EDF	D61	3
76	7298337	7298347	6558	6568	10	LEFT	D61c.EDF	D61	3
76	7298505	7298508	6726	6729	3	LEFT	D61c.EDF	D61	3
76	7298678	7298700	6899	6921	22	LEFT	D61c.EDF	D61	3
76	7298848	7298848	7069	7069	0	LEFT	D61c.EDF	D61	3
77	7300844	7301032	57	245	188	LEFT	D61c.EDF	D61	3
77	7301123	7301301	336	514	178	LEFT	D61c.EDF	D61	3
77	7301872	7301872	1085	1085	0	LEFT	D61c.EDF	D61	3
77	7302068	7302068	1281	1281	0	LEFT	D61c.EDF	D61	3
77	7302137	7302142	1350	1355	5	LEFT	D61c.EDF	D61	3
77	7302265	7302266	1478	1479	1	LEFT	D61c.EDF	D61	3
77	7302322	7302326	1535	1539	4	LEFT	D61c.EDF	D61	3
77	7302373	7302373	1586	1586	0	LEFT	D61c.EDF	D61	3
77	7302505	7302508	1718	1721	3	LEFT	D61c.EDF	D61	3
77	7302545	7302545	1758	1758	0	LEFT	D61c.EDF	D61	3
77	7302645	7302645	1858	1858	0	LEFT	D61c.EDF	D61	3
77	7302792	7302896	2005	2109	104	LEFT	D61c.EDF	D61	3
77	7303626	7303626	2839	2839	0	LEFT	D61c.EDF	D61	3
77	7303647	7303866	2860	3079	219	LEFT	D61c.EDF	D61	3
77	7303942	7303967	3155	3180	25	LEFT	D61c.EDF	D61	3
77	7304006	7304006	3219	3219	0	LEFT	D61c.EDF	D61	3
77	7304028	7304029	3241	3242	1	LEFT	D61c.EDF	D61	3
77	7304064	7305002	3277	4215	938	LEFT	D61c.EDF	D61	3
77	7305070	7305070	4283	4283	0	LEFT	D61c.EDF	D61	3
77	7305107	7305107	4320	4320	0	LEFT	D61c.EDF	D61	3
77	7305771	7305773	4984	4986	2	LEFT	D61c.EDF	D61	3
77	7305837	7305866	5050	5079	29	LEFT	D61c.EDF	D61	3
77	7306350	7306359	5563	5572	9	LEFT	D61c.EDF	D61	3
77	7306434	7306434	5647	5647	0	LEFT	D61c.EDF	D61	3
77	7306456	7306470	5669	5683	14	LEFT	D61c.EDF	D61	3
77	7306493	7307687	5706	6900	1194	LEFT	D61c.EDF	D61	3
78	7309527	7310487	57	1017	960	LEFT	D61c.EDF	D61	3
78	7310512	7310544	1042	1074	32	LEFT	D61c.EDF	D61	3
78	7310567	7310567	1097	1097	0	LEFT	D61c.EDF	D61	3
78	7310597	7310597	1127	1127	0	LEFT	D61c.EDF	D61	3
78	7310652	7310798	1182	1328	146	LEFT	D61c.EDF	D61	3
78	7310855	7310855	1385	1385	0	LEFT	D61c.EDF	D61	3
78	7310901	7310902	1431	1432	1	LEFT	D61c.EDF	D61	3
78	7310949	7311034	1479	1564	85	LEFT	D61c.EDF	D61	3
78	7311079	7311094	1609	1624	15	LEFT	D61c.EDF	D61	3
78	7311183	7311183	1713	1713	0	LEFT	D61c.EDF	D61	3
78	7311243	7311264	1773	1794	21	LEFT	D61c.EDF	D61	3
78	7311314	7311347	1844	1877	33	LEFT	D61c.EDF	D61	3
78	7311434	7311434	1964	1964	0	LEFT	D61c.EDF	D61	3
78	7311460	7311466	1990	1996	6	LEFT	D61c.EDF	D61	3
78	7311493	7311615	2023	2145	122	LEFT	D61c.EDF	D61	3
78	7312218	7313030	2748	3560	812	LEFT	D61c.EDF	D61	3
78	7313058	7313069	3588	3599	11	LEFT	D61c.EDF	D61	3
78	7313115	7313412	3645	3942	297	LEFT	D61c.EDF	D61	3
78	7313472	7313536	4002	4066	64	LEFT	D61c.EDF	D61	3
78	7313565	7313591	4095	4121	26	LEFT	D61c.EDF	D61	3
78	7313615	7313637	4145	4167	22	LEFT	D61c.EDF	D61	3
78	7313677	7313912	4207	4442	235	LEFT	D61c.EDF	D61	3
78	7313943	7313955	4473	4485	12	LEFT	D61c.EDF	D61	3
78	7314013	7314119	4543	4649	106	LEFT	D61c.EDF	D61	3
78	7314143	7314148	4673	4678	5	LEFT	D61c.EDF	D61	3
78	7314201	7314205	4731	4735	4	LEFT	D61c.EDF	D61	3
78	7314232	7314261	4762	4791	29	LEFT	D61c.EDF	D61	3
78	7314293	7314310	4823	4840	17	LEFT	D61c.EDF	D61	3
78	7314353	7314373	4883	4903	20	LEFT	D61c.EDF	D61	3
78	7314399	7314419	4929	4949	20	LEFT	D61c.EDF	D61	3
78	7314466	7314475	4996	5005	9	LEFT	D61c.EDF	D61	3
78	7314521	7314551	5051	5081	30	LEFT	D61c.EDF	D61	3
78	7314606	7314609	5136	5139	3	LEFT	D61c.EDF	D61	3
78	7314689	7314909	5219	5439	220	LEFT	D61c.EDF	D61	3
78	7314930	7314935	5460	5465	5	LEFT	D61c.EDF	D61	3
78	7314977	7314979	5507	5509	2	LEFT	D61c.EDF	D61	3
78	7315007	7315090	5537	5620	83	LEFT	D61c.EDF	D61	3
78	7315116	7315116	5646	5646	0	LEFT	D61c.EDF	D61	3
78	7315174	7315174	5704	5704	0	LEFT	D61c.EDF	D61	3
78	7315209	7315209	5739	5739	0	LEFT	D61c.EDF	D61	3
78	7315251	7315252	5781	5782	1	LEFT	D61c.EDF	D61	3
78	7315501	7315501	6031	6031	0	LEFT	D61c.EDF	D61	3
78	7315523	7315524	6053	6054	1	LEFT	D61c.EDF	D61	3
79	7317574	7317888	57	371	314	LEFT	D61c.EDF	D61	3
79	7317921	7318007	404	490	86	LEFT	D61c.EDF	D61	3
79	7318160	7318161	643	644	1	LEFT	D61c.EDF	D61	3
79	7318189	7318192	672	675	3	LEFT	D61c.EDF	D61	3
79	7318222	7318222	705	705	0	LEFT	D61c.EDF	D61	3
79	7318457	7318457	940	940	0	LEFT	D61c.EDF	D61	3
79	7318784	7318795	1267	1278	11	LEFT	D61c.EDF	D61	3
79	7318967	7318967	1450	1450	0	LEFT	D61c.EDF	D61	3
79	7319614	7319945	2097	2428	331	LEFT	D61c.EDF	D61	3
79	7319967	7319970	2450	2453	3	LEFT	D61c.EDF	D61	3
79	7320071	7320074	2554	2557	3	LEFT	D61c.EDF	D61	3
79	7320271	7322136	2754	4619	1865	LEFT	D61c.EDF	D61	3
79	7322173	7322236	4656	4719	63	LEFT	D61c.EDF	D61	3
79	7322268	7322292	4751	4775	24	LEFT	D61c.EDF	D61	3
79	7322350	7322352	4833	4835	2	LEFT	D61c.EDF	D61	3
79	7322389	7322392	4872	4875	3	LEFT	D61c.EDF	D61	3
79	7322459	7322461	4942	4944	2	LEFT	D61c.EDF	D61	3
79	7322518	7322525	5001	5008	7	LEFT	D61c.EDF	D61	3
79	7322547	7322548	5030	5031	1	LEFT	D61c.EDF	D61	3
79	7322666	7322666	5149	5149	0	LEFT	D61c.EDF	D61	3
79	7322726	7322740	5209	5223	14	LEFT	D61c.EDF	D61	3
79	7322766	7323040	5249	5523	274	LEFT	D61c.EDF	D61	3
79	7323068	7323537	5551	6020	469	LEFT	D61c.EDF	D61	3
79	7323568	7323577	6051	6060	9	LEFT	D61c.EDF	D61	3
80	7325278	7325498	57	277	220	LEFT	D61c.EDF	D61	3
80	7325519	7325595	298	374	76	LEFT	D61c.EDF	D61	3
80	7325629	7325645	408	424	16	LEFT	D61c.EDF	D61	3
80	7325702	7325721	481	500	19	LEFT	D61c.EDF	D61	3
80	7325743	7325743	522	522	0	LEFT	D61c.EDF	D61	3
80	7325829	7326006	608	785	177	LEFT	D61c.EDF	D61	3
80	7326182	7326184	961	963	2	LEFT	D61c.EDF	D61	3
80	7326374	7326391	1153	1170	17	LEFT	D61c.EDF	D61	3
80	7326459	7326593	1238	1372	134	LEFT	D61c.EDF	D61	3
80	7326640	7326801	1419	1580	161	LEFT	D61c.EDF	D61	3
80	7327033	7327034	1812	1813	1	LEFT	D61c.EDF	D61	3
80	7327195	7327196	1974	1975	1	LEFT	D61c.EDF	D61	3
80	7327223	7327424	2002	2203	201	LEFT	D61c.EDF	D61	3
80	7327449	7328204	2228	2983	755	LEFT	D61c.EDF	D61	3
80	7328273	7328328	3052	3107	55	LEFT	D61c.EDF	D61	3
80	7328358	7328388	3137	3167	30	LEFT	D61c.EDF	D61	3
80	7328418	7328428	3197	3207	10	LEFT	D61c.EDF	D61	3
80	7328472	7328475	3251	3254	3	LEFT	D61c.EDF	D61	3
80	7328553	7328553	3332	3332	0	LEFT	D61c.EDF	D61	3
80	7328599	7328609	3378	3388	10	LEFT	D61c.EDF	D61	3
80	7328630	7328641	3409	3420	11	LEFT	D61c.EDF	D61	3
80	7328685	7328692	3464	3471	7	LEFT	D61c.EDF	D61	3
80	7328725	7328803	3504	3582	78	LEFT	D61c.EDF	D61	3
80	7328897	7328985	3676	3764	88	LEFT	D61c.EDF	D61	3
80	7329075	7329075	3854	3854	0	LEFT	D61c.EDF	D61	3
80	7329142	7329142	3921	3921	0	LEFT	D61c.EDF	D61	3
80	7329176	7329177	3955	3956	1	LEFT	D61c.EDF	D61	3
80	7329339	7329360	4118	4139	21	LEFT	D61c.EDF	D61	3
80	7329384	7329384	4163	4163	0	LEFT	D61c.EDF	D61	3
80	7329411	7329411	4190	4190	0	LEFT	D61c.EDF	D61	3
80	7329448	7329453	4227	4232	5	LEFT	D61c.EDF	D61	3
80	7329483	7329492	4262	4271	9	LEFT	D61c.EDF	D61	3
80	7329513	7329566	4292	4345	53	LEFT	D61c.EDF	D61	3
80	7329614	7329616	4393	4395	2	LEFT	D61c.EDF	D61	3
80	7329642	7329692	4421	4471	50	LEFT	D61c.EDF	D61	3
80	7329724	7330059	4503	4838	335	LEFT	D61c.EDF	D61	3
80	7330087	7330094	4866	4873	7	LEFT	D61c.EDF	D61	3
80	7330119	7330124	4898	4903	5	LEFT	D61c.EDF	D61	3
80	7330162	7330179	4941	4958	17	LEFT	D61c.EDF	D61	3
80	7330222	7330238	5001	5017	16	LEFT	D61c.EDF	D61	3
80	7330263	7330283	5042	5062	20	LEFT	D61c.EDF	D61	3
80	7330331	7330331	5110	5110	0	LEFT	D61c.EDF	D61	3
80	7330368	7330380	5147	5159	12	LEFT	D61c.EDF	D61	3
80	7330451	7330451	5230	5230	0	LEFT	D61c.EDF	D61	3
80	7330565	7330601	5344	5380	36	LEFT	D61c.EDF	D61	3
80	7330669	7330710	5448	5489	41	LEFT	D61c.EDF	D61	3
80	7330764	7330765	5543	5544	1	LEFT	D61c.EDF	D61	3
80	7330788	7330844	5567	5623	56	LEFT	D61c.EDF	D61	3
80	7330866	7330870	5645	5649	4	LEFT	D61c.EDF	D61	3
80	7330891	7330937	5670	5716	46	LEFT	D61c.EDF	D61	3
80	7330981	7331138	5760	5917	157	LEFT	D61c.EDF	D61	3
80	7331163	7331219	5942	5998	56	LEFT	D61c.EDF	D61	3
80	7331258	7331297	6037	6076	39	LEFT	D61c.EDF	D61	3
80	7331352	7331367	6131	6146	15	LEFT	D61c.EDF	D61	3
80	7331389	7331393	6168	6172	4	LEFT	D61c.EDF	D61	3
80	7331418	7331463	6197	6242	45	LEFT	D61c.EDF	D61	3
80	7331489	7331489	6268	6268	0	LEFT	D61c.EDF	D61	3
80	7331545	7331698	6324	6477	153	LEFT	D61c.EDF	D61	3
80	7331723	7331759	6502	6538	36	LEFT	D61c.EDF	D61	3
80	7331780	7331886	6559	6665	106	LEFT	D61c.EDF	D61	3
80	7331909	7332012	6688	6791	103	LEFT	D61c.EDF	D61	3
81	7333994	7334025	98	129	31	LEFT	D61c.EDF	D61	3
81	7334111	7334160	215	264	49	LEFT	D61c.EDF	D61	3
81	7334237	7334237	341	341	0	LEFT	D61c.EDF	D61	3
81	7334332	7334335	436	439	3	LEFT	D61c.EDF	D61	3
81	7334677	7334677	781	781	0	LEFT	D61c.EDF	D61	3
81	7334700	7334700	804	804	0	LEFT	D61c.EDF	D61	3
81	7334826	7334827	930	931	1	LEFT	D61c.EDF	D61	3
81	7334889	7334889	993	993	0	LEFT	D61c.EDF	D61	3
81	7334988	7334989	1092	1093	1	LEFT	D61c.EDF	D61	3
81	7335134	7335156	1238	1260	22	LEFT	D61c.EDF	D61	3
81	7335351	7335355	1455	1459	4	LEFT	D61c.EDF	D61	3
81	7335389	7335391	1493	1495	2	LEFT	D61c.EDF	D61	3
81	7335620	7335620	1724	1724	0	LEFT	D61c.EDF	D61	3
81	7335654	7335810	1758	1914	156	LEFT	D61c.EDF	D61	3
81	7336331	7336331	2435	2435	0	LEFT	D61c.EDF	D61	3
81	7336366	7336396	2470	2500	30	LEFT	D61c.EDF	D61	3
81	7336444	7340748	2548	6852	4304	LEFT	D61c.EDF	D61	3
82	7342667	7342707	57	97	40	LEFT	D61c.EDF	D61	3
82	7342844	7342844	234	234	0	LEFT	D61c.EDF	D61	3
82	7342868	7343424	258	814	556	LEFT	D61c.EDF	D61	3
82	7343456	7343668	846	1058	212	LEFT	D61c.EDF	D61	3
82	7343742	7343743	1132	1133	1	LEFT	D61c.EDF	D61	3
82	7343769	7343815	1159	1205	46	LEFT	D61c.EDF	D61	3
82	7343854	7343878	1244	1268	24	LEFT	D61c.EDF	D61	3
82	7343925	7343949	1315	1339	24	LEFT	D61c.EDF	D61	3
82	7343975	7344125	1365	1515	150	LEFT	D61c.EDF	D61	3
82	7344151	7344151	1541	1541	0	LEFT	D61c.EDF	D61	3
82	7344177	7344196	1567	1586	19	LEFT	D61c.EDF	D61	3
82	7344221	7344276	1611	1666	55	LEFT	D61c.EDF	D61	3
82	7344300	7344451	1690	1841	151	LEFT	D61c.EDF	D61	3
82	7344498	7344514	1888	1904	16	LEFT	D61c.EDF	D61	3
82	7344539	7344567	1929	1957	28	LEFT	D61c.EDF	D61	3
82	7344618	7344646	2008	2036	28	LEFT	D61c.EDF	D61	3
82	7344671	7344671	2061	2061	0	LEFT	D61c.EDF	D61	3
82	7344693	7344694	2083	2084	1	LEFT	D61c.EDF	D61	3
82	7344716	7345643	2106	3033	927	LEFT	D61c.EDF	D61	3
82	7345668	7345757	3058	3147	89	LEFT	D61c.EDF	D61	3
82	7345780	7345834	3170	3224	54	LEFT	D61c.EDF	D61	3
82	7345859	7345964	3249	3354	105	LEFT	D61c.EDF	D61	3
82	7346007	7346016	3397	3406	9	LEFT	D61c.EDF	D61	3
82	7346038	7346172	3428	3562	134	LEFT	D61c.EDF	D61	3
82	7346210	7346254	3600	3644	44	LEFT	D61c.EDF	D61	3
82	7346291	7346291	3681	3681	0	LEFT	D61c.EDF	D61	3
82	7346315	7346334	3705	3724	19	LEFT	D61c.EDF	D61	3
82	7346411	7346417	3801	3807	6	LEFT	D61c.EDF	D61	3
82	7346443	7346443	3833	3833	0	LEFT	D61c.EDF	D61	3
82	7346464	7346465	3854	3855	1	LEFT	D61c.EDF	D61	3
82	7346500	7346511	3890	3901	11	LEFT	D61c.EDF	D61	3
82	7346532	7346532	3922	3922	0	LEFT	D61c.EDF	D61	3
82	7346553	7346557	3943	3947	4	LEFT	D61c.EDF	D61	3
82	7346591	7347521	3981	4911	930	LEFT	D61c.EDF	D61	3
82	7347542	7347872	4932	5262	330	LEFT	D61c.EDF	D61	3
83	7349631	7350439	56	864	808	LEFT	D61c.EDF	D61	3
83	7350591	7350591	1016	1016	0	LEFT	D61c.EDF	D61	3
83	7350617	7350617	1042	1042	0	LEFT	D61c.EDF	D61	3
83	7350726	7350727	1151	1152	1	LEFT	D61c.EDF	D61	3
83	7350829	7350829	1254	1254	0	LEFT	D61c.EDF	D61	3
83	7350858	7350858	1283	1283	0	LEFT	D61c.EDF	D61	3
83	7350952	7350952	1377	1377	0	LEFT	D61c.EDF	D61	3
83	7351016	7351016	1441	1441	0	LEFT	D61c.EDF	D61	3
83	7351093	7351093	1518	1518	0	LEFT	D61c.EDF	D61	3
83	7351144	7351145	1569	1570	1	LEFT	D61c.EDF	D61	3
83	7351229	7351230	1654	1655	1	LEFT	D61c.EDF	D61	3
83	7351329	7351329	1754	1754	0	LEFT	D61c.EDF	D61	3
83	7351476	7351476	1901	1901	0	LEFT	D61c.EDF	D61	3
83	7351592	7351918	2017	2343	326	LEFT	D61c.EDF	D61	3
83	7352041	7352502	2466	2927	461	LEFT	D61c.EDF	D61	3
83	7352524	7352922	2949	3347	398	LEFT	D61c.EDF	D61	3
83	7352945	7352965	3370	3390	20	LEFT	D61c.EDF	D61	3
83	7353146	7353146	3571	3571	0	LEFT	D61c.EDF	D61	3
83	7353198	7353209	3623	3634	11	LEFT	D61c.EDF	D61	3
83	7353251	7353262	3676	3687	11	LEFT	D61c.EDF	D61	3
83	7353290	7353306	3715	3731	16	LEFT	D61c.EDF	D61	3
83	7353337	7353338	3762	3763	1	LEFT	D61c.EDF	D61	3
83	7353376	7353399	3801	3824	23	LEFT	D61c.EDF	D61	3
83	7353429	7353457	3854	3882	28	LEFT	D61c.EDF	D61	3
83	7353519	7353546	3944	3971	27	LEFT	D61c.EDF	D61	3
83	7353570	7353584	3995	4009	14	LEFT	D61c.EDF	D61	3
83	7353606	7353642	4031	4067	36	LEFT	D61c.EDF	D61	3
83	7353667	7353687	4092	4112	20	LEFT	D61c.EDF	D61	3
83	7353714	7353718	4139	4143	4	LEFT	D61c.EDF	D61	3
83	7353744	7354281	4169	4706	537	LEFT	D61c.EDF	D61	3
83	7354312	7354384	4737	4809	72	LEFT	D61c.EDF	D61	3
83	7354408	7354408	4833	4833	0	LEFT	D61c.EDF	D61	3
83	7354519	7354520	4944	4945	1	LEFT	D61c.EDF	D61	3
83	7354653	7354653	5078	5078	0	LEFT	D61c.EDF	D61	3
83	7354685	7354696	5110	5121	11	LEFT	D61c.EDF	D61	3
83	7354754	7354754	5179	5179	0	LEFT	D61c.EDF	D61	3
83	7354777	7354785	5202	5210	8	LEFT	D61c.EDF	D61	3
83	7354807	7354811	5232	5236	4	LEFT	D61c.EDF	D61	3
83	7354888	7355019	5313	5444	131	LEFT	D61c.EDF	D61	3
83	7355104	7355221	5529	5646	117	LEFT	D61c.EDF	D61	3
83	7355260	7355276	5685	5701	16	LEFT	D61c.EDF	D61	3
83	7355319	7355319	5744	5744	0	LEFT	D61c.EDF	D61	3
83	7355340	7355362	5765	5787	22	LEFT	D61c.EDF	D61	3
83	7355401	7355422	5826	5847	21	LEFT	D61c.EDF	D61	3
83	7355543	7355543	5968	5968	0	LEFT	D61c.EDF	D61	3
83	7355661	7355689	6086	6114	28	LEFT	D61c.EDF	D61	3
83	7355736	7355736	6161	6161	0	LEFT	D61c.EDF	D61	3
83	7355790	7355790	6215	6215	0	LEFT	D61c.EDF	D61	3
84	7357494	7357710	58	274	216	LEFT	D61c.EDF	D61	3
84	7357737	7357796	301	360	59	LEFT	D61c.EDF	D61	3
84	7357823	7358021	387	585	198	LEFT	D61c.EDF	D61	3
84	7358187	7358201	751	765	14	LEFT	D61c.EDF	D61	3
84	7358243	7358244	807	808	1	LEFT	D61c.EDF	D61	3
84	7358320	7358320	884	884	0	LEFT	D61c.EDF	D61	3
84	7358394	7358395	958	959	1	LEFT	D61c.EDF	D61	3
84	7358532	7358532	1096	1096	0	LEFT	D61c.EDF	D61	3
84	7358731	7358731	1295	1295	0	LEFT	D61c.EDF	D61	3
84	7358845	7358847	1409	1411	2	LEFT	D61c.EDF	D61	3
84	7358883	7358883	1447	1447	0	LEFT	D61c.EDF	D61	3
84	7358949	7358953	1513	1517	4	LEFT	D61c.EDF	D61	3
84	7358998	7358999	1562	1563	1	LEFT	D61c.EDF	D61	3
84	7359027	7359028	1591	1592	1	LEFT	D61c.EDF	D61	3
84	7359102	7359114	1666	1678	12	LEFT	D61c.EDF	D61	3
84	7359135	7359136	1699	1700	1	LEFT	D61c.EDF	D61	3
84	7359186	7359186	1750	1750	0	LEFT	D61c.EDF	D61	3
84	7359239	7359245	1803	1809	6	LEFT	D61c.EDF	D61	3
84	7359421	7359435	1985	1999	14	LEFT	D61c.EDF	D61	3
84	7359536	7359753	2100	2317	217	LEFT	D61c.EDF	D61	3
84	7360020	7360325	2584	2889	305	LEFT	D61c.EDF	D61	3
84	7360350	7360350	2914	2914	0	LEFT	D61c.EDF	D61	3
84	7360386	7361064	2950	3628	678	LEFT	D61c.EDF	D61	3
84	7361091	7361100	3655	3664	9	LEFT	D61c.EDF	D61	3
84	7361145	7361145	3709	3709	0	LEFT	D61c.EDF	D61	3
84	7361177	7361213	3741	3777	36	LEFT	D61c.EDF	D61	3
84	7361236	7361237	3800	3801	1	LEFT	D61c.EDF	D61	3
84	7361274	7361293	3838	3857	19	LEFT	D61c.EDF	D61	3
84	7361329	7361331	3893	3895	2	LEFT	D61c.EDF	D61	3
84	7361354	7361365	3918	3929	11	LEFT	D61c.EDF	D61	3
84	7361444	7361528	4008	4092	84	LEFT	D61c.EDF	D61	3
84	7361562	7361734	4126	4298	172	LEFT	D61c.EDF	D61	3
84	7361757	7361881	4321	4445	124	LEFT	D61c.EDF	D61	3
84	7361905	7362059	4469	4623	154	LEFT	D61c.EDF	D61	3
84	7362083	7362086	4647	4650	3	LEFT	D61c.EDF	D61	3
84	7362108	7362115	4672	4679	7	LEFT	D61c.EDF	D61	3
84	7362144	7362145	4708	4709	1	LEFT	D61c.EDF	D61	3
84	7362183	7362196	4747	4760	13	LEFT	D61c.EDF	D61	3
84	7362234	7362239	4798	4803	5	LEFT	D61c.EDF	D61	3
84	7362262	7362262	4826	4826	0	LEFT	D61c.EDF	D61	3
84	7362326	7362344	4890	4908	18	LEFT	D61c.EDF	D61	3
84	7362398	7362424	4962	4988	26	LEFT	D61c.EDF	D61	3
84	7362464	7362535	5028	5099	71	LEFT	D61c.EDF	D61	3
84	7362557	7362561	5121	5125	4	LEFT	D61c.EDF	D61	3
84	7362637	7362637	5201	5201	0	LEFT	D61c.EDF	D61	3
84	7362663	7362748	5227	5312	85	LEFT	D61c.EDF	D61	3
84	7362775	7362779	5339	5343	4	LEFT	D61c.EDF	D61	3
84	7362807	7362873	5371	5437	66	LEFT	D61c.EDF	D61	3
84	7362895	7363973	5459	6537	1078	LEFT	D61c.EDF	D61	3
85	7366013	7366571	58	616	558	LEFT	D61c.EDF	D61	3
85	7366594	7366596	639	641	2	LEFT	D61c.EDF	D61	3
85	7366623	7366739	668	784	116	LEFT	D61c.EDF	D61	3
85	7366770	7366868	815	913	98	LEFT	D61c.EDF	D61	3
85	7366892	7366892	937	937	0	LEFT	D61c.EDF	D61	3
85	7366972	7367063	1017	1108	91	LEFT	D61c.EDF	D61	3
85	7367088	7367112	1133	1157	24	LEFT	D61c.EDF	D61	3
85	7367140	7367147	1185	1192	7	LEFT	D61c.EDF	D61	3
85	7367174	7367291	1219	1336	117	LEFT	D61c.EDF	D61	3
85	7367320	7367585	1365	1630	265	LEFT	D61c.EDF	D61	3
85	7367614	7367653	1659	1698	39	LEFT	D61c.EDF	D61	3
85	7367685	7370389	1730	4434	2704	LEFT	D61c.EDF	D61	3
85	7370410	7371039	4455	5084	629	LEFT	D61c.EDF	D61	3
85	7371060	7371166	5105	5211	106	LEFT	D61c.EDF	D61	3
86	7372909	7372912	79	82	3	LEFT	D61c.EDF	D61	3
86	7372947	7372948	117	118	1	LEFT	D61c.EDF	D61	3
86	7373007	7373235	177	405	228	LEFT	D61c.EDF	D61	3
86	7373285	7373338	455	508	53	LEFT	D61c.EDF	D61	3
86	7373466	7373466	636	636	0	LEFT	D61c.EDF	D61	3
86	7373489	7373496	659	666	7	LEFT	D61c.EDF	D61	3
86	7373547	7373620	717	790	73	LEFT	D61c.EDF	D61	3
86	7373646	7373715	816	885	69	LEFT	D61c.EDF	D61	3
86	7373758	7373767	928	937	9	LEFT	D61c.EDF	D61	3
86	7373811	7373811	981	981	0	LEFT	D61c.EDF	D61	3
86	7373843	7373864	1013	1034	21	LEFT	D61c.EDF	D61	3
86	7373904	7373932	1074	1102	28	LEFT	D61c.EDF	D61	3
86	7373954	7373964	1124	1134	10	LEFT	D61c.EDF	D61	3
86	7374002	7374006	1172	1176	4	LEFT	D61c.EDF	D61	3
86	7374029	7374067	1199	1237	38	LEFT	D61c.EDF	D61	3
86	7374107	7374149	1277	1319	42	LEFT	D61c.EDF	D61	3
86	7374178	7374231	1348	1401	53	LEFT	D61c.EDF	D61	3
86	7374266	7374283	1436	1453	17	LEFT	D61c.EDF	D61	3
86	7374310	7374347	1480	1517	37	LEFT	D61c.EDF	D61	3
86	7374422	7374453	1592	1623	31	LEFT	D61c.EDF	D61	3
86	7374492	7374597	1662	1767	105	LEFT	D61c.EDF	D61	3
86	7375099	7375480	2269	2650	381	LEFT	D61c.EDF	D61	3
86	7375525	7375525	2695	2695	0	LEFT	D61c.EDF	D61	3
86	7375651	7375651	2821	2821	0	LEFT	D61c.EDF	D61	3
86	7376049	7376049	3219	3219	0	LEFT	D61c.EDF	D61	3
86	7376132	7376133	3302	3303	1	LEFT	D61c.EDF	D61	3
86	7376266	7376267	3436	3437	1	LEFT	D61c.EDF	D61	3
86	7376344	7376344	3514	3514	0	LEFT	D61c.EDF	D61	3
86	7376450	7376454	3620	3624	4	LEFT	D61c.EDF	D61	3
86	7376476	7376536	3646	3706	60	LEFT	D61c.EDF	D61	3
86	7376580	7376624	3750	3794	44	LEFT	D61c.EDF	D61	3
86	7376649	7376745	3819	3915	96	LEFT	D61c.EDF	D61	3
86	7376766	7376771	3936	3941	5	LEFT	D61c.EDF	D61	3
86	7376832	7376834	4002	4004	2	LEFT	D61c.EDF	D61	3
86	7376905	7376906	4075	4076	1	LEFT	D61c.EDF	D61	3
86	7376939	7376940	4109	4110	1	LEFT	D61c.EDF	D61	3
86	7376981	7377018	4151	4188	37	LEFT	D61c.EDF	D61	3
86	7377057	7377074	4227	4244	17	LEFT	D61c.EDF	D61	3
86	7377203	7377203	4373	4373	0	LEFT	D61c.EDF	D61	3
86	7377246	7377246	4416	4416	0	LEFT	D61c.EDF	D61	3
86	7377478	7377491	4648	4661	13	LEFT	D61c.EDF	D61	3
86	7377528	7377561	4698	4731	33	LEFT	D61c.EDF	D61	3
86	7377588	7377615	4758	4785	27	LEFT	D61c.EDF	D61	3
86	7377641	7377819	4811	4989	178	LEFT	D61c.EDF	D61	3
86	7377843	7377931	5013	5101	88	LEFT	D61c.EDF	D61	3
86	7377962	7378001	5132	5171	39	LEFT	D61c.EDF	D61	3
86	7378025	7378081	5195	5251	56	LEFT	D61c.EDF	D61	3
87	7379873	7380128	79	334	255	LEFT	D61c.EDF	D61	3
87	7380151	7380279	357	485	128	LEFT	D61c.EDF	D61	3
87	7380559	7380559	765	765	0	LEFT	D61c.EDF	D61	3
87	7380617	7380624	823	830	7	LEFT	D61c.EDF	D61	3
87	7380664	7380731	870	937	67	LEFT	D61c.EDF	D61	3
87	7380752	7380785	958	991	33	LEFT	D61c.EDF	D61	3
87	7380809	7380880	1015	1086	71	LEFT	D61c.EDF	D61	3
87	7380918	7380918	1124	1124	0	LEFT	D61c.EDF	D61	3
87	7380946	7380946	1152	1152	0	LEFT	D61c.EDF	D61	3
87	7380978	7380989	1184	1195	11	LEFT	D61c.EDF	D61	3
87	7381016	7381017	1222	1223	1	LEFT	D61c.EDF	D61	3
87	7381062	7381064	1268	1270	2	LEFT	D61c.EDF	D61	3
87	7381086	7381087	1292	1293	1	LEFT	D61c.EDF	D61	3
87	7381155	7381156	1361	1362	1	LEFT	D61c.EDF	D61	3
87	7381289	7381289	1495	1495	0	LEFT	D61c.EDF	D61	3
87	7381370	7381370	1576	1576	0	LEFT	D61c.EDF	D61	3
87	7381405	7381407	1611	1613	2	LEFT	D61c.EDF	D61	3
87	7381497	7381497	1703	1703	0	LEFT	D61c.EDF	D61	3
87	7381525	7381527	1731	1733	2	LEFT	D61c.EDF	D61	3
87	7381571	7381571	1777	1777	0	LEFT	D61c.EDF	D61	3
87	7381611	7381752	1817	1958	141	LEFT	D61c.EDF	D61	3
87	7381793	7381794	1999	2000	1	LEFT	D61c.EDF	D61	3
87	7382285	7384090	2491	4296	1805	LEFT	D61c.EDF	D61	3
87	7386265	7386265	6471	6471	0	LEFT	D61c.EDF	D61	3
87	7386307	7386321	6513	6527	14	LEFT	D61c.EDF	D61	3
87	7386344	7386816	6550	7022	472	LEFT	D61c.EDF	D61	3
88	7388898	7389056	73	231	158	LEFT	D61c.EDF	D61	3
88	7389084	7389119	259	294	35	LEFT	D61c.EDF	D61	3
88	7389140	7389184	315	359	44	LEFT	D61c.EDF	D61	3
88	7389210	7389226	385	401	16	LEFT	D61c.EDF	D61	3
88	7389250	7389311	425	486	61	LEFT	D61c.EDF	D61	3
88	7389351	7389393	526	568	42	LEFT	D61c.EDF	D61	3
88	7389414	7389613	589	788	199	LEFT	D61c.EDF	D61	3
88	7389636	7389720	811	895	84	LEFT	D61c.EDF	D61	3
88	7389743	7389802	918	977	59	LEFT	D61c.EDF	D61	3
88	7389831	7389832	1006	1007	1	LEFT	D61c.EDF	D61	3
88	7389853	7389882	1028	1057	29	LEFT	D61c.EDF	D61	3
88	7390014	7390015	1189	1190	1	LEFT	D61c.EDF	D61	3
88	7390216	7390216	1391	1391	0	LEFT	D61c.EDF	D61	3
88	7390383	7390384	1558	1559	1	LEFT	D61c.EDF	D61	3
88	7390446	7390449	1621	1624	3	LEFT	D61c.EDF	D61	3
88	7390556	7390556	1731	1731	0	LEFT	D61c.EDF	D61	3
88	7390611	7390614	1786	1789	3	LEFT	D61c.EDF	D61	3
88	7390635	7390669	1810	1844	34	LEFT	D61c.EDF	D61	3
88	7390692	7390693	1867	1868	1	LEFT	D61c.EDF	D61	3
88	7390718	7390723	1893	1898	5	LEFT	D61c.EDF	D61	3
88	7390754	7390754	1929	1929	0	LEFT	D61c.EDF	D61	3
88	7390791	7390791	1966	1966	0	LEFT	D61c.EDF	D61	3
88	7390816	7390965	1991	2140	149	LEFT	D61c.EDF	D61	3
88	7390986	7390987	2161	2162	1	LEFT	D61c.EDF	D61	3
88	7391611	7391611	2786	2786	0	LEFT	D61c.EDF	D61	3
88	7391635	7394471	2810	5646	2836	LEFT	D61c.EDF	D61	3
89	7396352	7396460	61	169	108	LEFT	D61c.EDF	D61	3
89	7396492	7396649	201	358	157	LEFT	D61c.EDF	D61	3
89	7396952	7397283	661	992	331	LEFT	D61c.EDF	D61	3
89	7397625	7397625	1334	1334	0	LEFT	D61c.EDF	D61	3
89	7397809	7397809	1518	1518	0	LEFT	D61c.EDF	D61	3
89	7398128	7398129	1837	1838	1	LEFT	D61c.EDF	D61	3
89	7398167	7398239	1876	1948	72	LEFT	D61c.EDF	D61	3
89	7399080	7399334	2789	3043	254	LEFT	D61c.EDF	D61	3
89	7399379	7399381	3088	3090	2	LEFT	D61c.EDF	D61	3
89	7399785	7399786	3494	3495	1	LEFT	D61c.EDF	D61	3
89	7399973	7399990	3682	3699	17	LEFT	D61c.EDF	D61	3
89	7400080	7400169	3789	3878	89	LEFT	D61c.EDF	D61	3
89	7400198	7400262	3907	3971	64	LEFT	D61c.EDF	D61	3
89	7400286	7400668	3995	4377	382	LEFT	D61c.EDF	D61	3
89	7400704	7400704	4413	4413	0	LEFT	D61c.EDF	D61	3
89	7400732	7400738	4441	4447	6	LEFT	D61c.EDF	D61	3
89	7400765	7400765	4474	4474	0	LEFT	D61c.EDF	D61	3
89	7400846	7400882	4555	4591	36	LEFT	D61c.EDF	D61	3
89	7400977	7400977	4686	4686	0	LEFT	D61c.EDF	D61	3
89	7401102	7401164	4811	4873	62	LEFT	D61c.EDF	D61	3
89	7401187	7401223	4896	4932	36	LEFT	D61c.EDF	D61	3
89	7401245	7401256	4954	4965	11	LEFT	D61c.EDF	D61	3
89	7401303	7401980	5012	5689	677	LEFT	D61c.EDF	D61	3
89	7402009	7402047	5718	5756	38	LEFT	D61c.EDF	D61	3
89	7402087	7402119	5796	5828	32	LEFT	D61c.EDF	D61	3
89	7402182	7402182	5891	5891	0	LEFT	D61c.EDF	D61	3
89	7402293	7402362	6002	6071	69	LEFT	D61c.EDF	D61	3
89	7402395	7402427	6104	6136	32	LEFT	D61c.EDF	D61	3
89	7402454	7402470	6163	6179	16	LEFT	D61c.EDF	D61	3
89	7402502	7402502	6211	6211	0	LEFT	D61c.EDF	D61	3
90	7404885	7405114	63	292	229	LEFT	D61c.EDF	D61	3
90	7405586	7405743	764	921	157	LEFT	D61c.EDF	D61	3
90	7406594	7406680	1772	1858	86	LEFT	D61c.EDF	D61	3
90	7407234	7407754	2412	2932	520	LEFT	D61c.EDF	D61	3
90	7407848	7407850	3026	3028	2	LEFT	D61c.EDF	D61	3
90	7408068	7408092	3246	3270	24	LEFT	D61c.EDF	D61	3
90	7408115	7408196	3293	3374	81	LEFT	D61c.EDF	D61	3
90	7408237	7408262	3415	3440	25	LEFT	D61c.EDF	D61	3
91	7413446	7413616	216	386	170	LEFT	D61c.EDF	D61	3
91	7415214	7415310	1984	2080	96	LEFT	D61c.EDF	D61	3
91	7415429	7416106	2199	2876	677	LEFT	D61c.EDF	D61	3
91	7416130	7416130	2900	2900	0	LEFT	D61c.EDF	D61	3
91	7416320	7416320	3090	3090	0	LEFT	D61c.EDF	D61	3
92	7421421	7421719	93	391	298	LEFT	D61c.EDF	D61	3
92	7421804	7421804	476	476	0	LEFT	D61c.EDF	D61	3
92	7421834	7421834	506	506	0	LEFT	D61c.EDF	D61	3
92	7421868	7421869	540	541	1	LEFT	D61c.EDF	D61	3
92	7421941	7421953	613	625	12	LEFT	D61c.EDF	D61	3
92	7422127	7422127	799	799	0	LEFT	D61c.EDF	D61	3
92	7423421	7423467	2093	2139	46	LEFT	D61c.EDF	D61	3
92	7423853	7424040	2525	2712	187	LEFT	D61c.EDF	D61	3
92	7424104	7424121	2776	2793	17	LEFT	D61c.EDF	D61	3
92	7424280	7424280	2952	2952	0	LEFT	D61c.EDF	D61	3
92	7424476	7424479	3148	3151	3	LEFT	D61c.EDF	D61	3
92	7425861	7425861	4533	4533	0	LEFT	D61c.EDF	D61	3
93	7429993	7430220	532	759	227	LEFT	D61c.EDF	D61	3
93	7431358	7431546	1897	2085	188	LEFT	D61c.EDF	D61	3
93	7431567	7431629	2106	2168	62	LEFT	D61c.EDF	D61	3
93	7431657	7431658	2196	2197	1	LEFT	D61c.EDF	D61	3
93	7431679	7432237	2218	2776	558	LEFT	D61c.EDF	D61	3
93	7432302	7432394	2841	2933	92	LEFT	D61c.EDF	D61	3
93	7432438	7432562	2977	3101	124	LEFT	D61c.EDF	D61	3
93	7432601	7432616	3140	3155	15	LEFT	D61c.EDF	D61	3
93	7432642	7432643	3181	3182	1	LEFT	D61c.EDF	D61	3
93	7432918	7432919	3457	3458	1	LEFT	D61c.EDF	D61	3
93	7433179	7433179	3718	3718	0	LEFT	D61c.EDF	D61	3
94	7436867	7437701	58	892	834	LEFT	D61c.EDF	D61	3
94	7437722	7437766	913	957	44	LEFT	D61c.EDF	D61	3
94	7437810	7437810	1001	1001	0	LEFT	D61c.EDF	D61	3
94	7437856	7437904	1047	1095	48	LEFT	D61c.EDF	D61	3
94	7438079	7438093	1270	1284	14	LEFT	D61c.EDF	D61	3
94	7438890	7444172	2081	7363	5282	LEFT	D61c.EDF	D61	3
95	7447870	7447871	2149	2150	1	LEFT	D61c.EDF	D61	3
95	7447902	7447902	2181	2181	0	LEFT	D61c.EDF	D61	3
95	7447924	7447926	2203	2205	2	LEFT	D61c.EDF	D61	3
95	7447963	7448090	2242	2369	127	LEFT	D61c.EDF	D61	3
95	7448118	7448333	2397	2612	215	LEFT	D61c.EDF	D61	3
95	7448372	7448476	2651	2755	104	LEFT	D61c.EDF	D61	3
95	7449385	7449389	3664	3668	4	LEFT	D61c.EDF	D61	3
96	7452565	7453045	75	555	480	LEFT	D61c.EDF	D61	3
96	7453192	7453195	702	705	3	LEFT	D61c.EDF	D61	3
96	7453243	7453283	753	793	40	LEFT	D61c.EDF	D61	3
96	7454508	7454524	2018	2034	16	LEFT	D61c.EDF	D61	3
96	7454545	7454545	2055	2055	0	LEFT	D61c.EDF	D61	3
96	7454566	7455398	2076	2908	832	LEFT	D61c.EDF	D61	3
96	7455556	7455560	3066	3070	4	LEFT	D61c.EDF	D61	3
96	7455586	7455610	3096	3120	24	LEFT	D61c.EDF	D61	3
96	7455694	7455694	3204	3204	0	LEFT	D61c.EDF	D61	3
96	7455879	7455888	3389	3398	9	LEFT	D61c.EDF	D61	3
96	7455911	7455911	3421	3421	0	LEFT	D61c.EDF	D61	3
96	7456427	7456437	3937	3947	10	LEFT	D61c.EDF	D61	3
96	7456848	7456848	4358	4358	0	LEFT	D61c.EDF	D61	3
96	7456872	7457047	4382	4557	175	LEFT	D61c.EDF	D61	3
96	7457139	7457175	4649	4685	36	LEFT	D61c.EDF	D61	3
96	7457277	7457280	4787	4790	3	LEFT	D61c.EDF	D61	3
96	7457456	7457456	4966	4966	0	LEFT	D61c.EDF	D61	3
96	7457889	7457912	5399	5422	23	LEFT	D61c.EDF	D61	3
96	7458005	7458021	5515	5531	16	LEFT	D61c.EDF	D61	3
96	7458066	7458215	5576	5725	149	LEFT	D61c.EDF	D61	3
97	7460510	7460685	57	232	175	LEFT	D61c.EDF	D61	3
97	7462500	7462500	2047	2047	0	LEFT	D61c.EDF	D61	3
97	7462550	7462561	2097	2108	11	LEFT	D61c.EDF	D61	3
97	7462610	7463198	2157	2745	588	LEFT	D61c.EDF	D61	3
97	7463269	7463310	2816	2857	41	LEFT	D61c.EDF	D61	3
97	7463362	7463417	2909	2964	55	LEFT	D61c.EDF	D61	3
97	7463477	7463479	3024	3026	2	LEFT	D61c.EDF	D61	3
97	7464561	7464578	4108	4125	17	LEFT	D61c.EDF	D61	3
97	7464658	7464658	4205	4205	0	LEFT	D61c.EDF	D61	3
97	7464681	7464684	4228	4231	3	LEFT	D61c.EDF	D61	3
97	7464929	7464930	4476	4477	1	LEFT	D61c.EDF	D61	3
97	7465054	7465063	4601	4610	9	LEFT	D61c.EDF	D61	3
97	7465167	7465201	4714	4748	34	LEFT	D61c.EDF	D61	3
97	7465289	7465291	4836	4838	2	LEFT	D61c.EDF	D61	3
97	7465341	7465474	4888	5021	133	LEFT	D61c.EDF	D61	3
98	7467442	7468272	58	888	830	LEFT	D61c.EDF	D61	3
98	7468503	7468503	1119	1119	0	LEFT	D61c.EDF	D61	3
98	7469416	7469706	2032	2322	290	LEFT	D61c.EDF	D61	3
98	7469731	7472415	2347	5031	2684	LEFT	D61c.EDF	D61	3
99	7474279	7475658	57	1436	1379	LEFT	D61c.EDF	D61	3
99	7475903	7475924	1681	1702	21	LEFT	D61c.EDF	D61	3
99	7475950	7475950	1728	1728	0	LEFT	D61c.EDF	D61	3
99	7476017	7476021	1795	1799	4	LEFT	D61c.EDF	D61	3
99	7476175	7476175	1953	1953	0	LEFT	D61c.EDF	D61	3
99	7476210	7476215	1988	1993	5	LEFT	D61c.EDF	D61	3
99	7476242	7476417	2020	2195	175	LEFT	D61c.EDF	D61	3
99	7476623	7477193	2401	2971	570	LEFT	D61c.EDF	D61	3
99	7477220	7477221	2998	2999	1	LEFT	D61c.EDF	D61	3
99	7477354	7477413	3132	3191	59	LEFT	D61c.EDF	D61	3
100	7481290	7481575	57	342	285	LEFT	D61c.EDF	D61	3
100	7481596	7481596	363	363	0	LEFT	D61c.EDF	D61	3
100	7483026	7483161	1793	1928	135	LEFT	D61c.EDF	D61	3
100	7483215	7483245	1982	2012	30	LEFT	D61c.EDF	D61	3
100	7483285	7483471	2052	2238	186	LEFT	D61c.EDF	D61	3
100	7483499	7483507	2266	2274	8	LEFT	D61c.EDF	D61	3
100	7483559	7483559	2326	2326	0	LEFT	D61c.EDF	D61	3
100	7483591	7483593	2358	2360	2	LEFT	D61c.EDF	D61	3
100	7483907	7483907	2674	2674	0	LEFT	D61c.EDF	D61	3
100	7483935	7483945	2702	2712	10	LEFT	D61c.EDF	D61	3
100	7484079	7484097	2846	2864	18	LEFT	D61c.EDF	D61	3
100	7484167	7484169	2934	2936	2	LEFT	D61c.EDF	D61	3
100	7484202	7484229	2969	2996	27	LEFT	D61c.EDF	D61	3
100	7484257	7484275	3024	3042	18	LEFT	D61c.EDF	D61	3
100	7484640	7484641	3407	3408	1	LEFT	D61c.EDF	D61	3
100	7484668	7484668	3435	3435	0	LEFT	D61c.EDF	D61	3
100	7484695	7484695	3462	3462	0	LEFT	D61c.EDF	D61	3
100	7484739	7484753	3506	3520	14	LEFT	D61c.EDF	D61	3
100	7484866	7484888	3633	3655	22	LEFT	D61c.EDF	D61	3
100	7484961	7484961	3728	3728	0	LEFT	D61c.EDF	D61	3
101	7487576	7487581	76	81	5	LEFT	D61c.EDF	D61	3
101	7487615	7487652	115	152	37	LEFT	D61c.EDF	D61	3
101	7487697	7487697	197	197	0	LEFT	D61c.EDF	D61	3
101	7487745	7487757	245	257	12	LEFT	D61c.EDF	D61	3
101	7487793	7487816	293	316	23	LEFT	D61c.EDF	D61	3
101	7489382	7489502	1882	2002	120	LEFT	D61c.EDF	D61	3
101	7489683	7489688	2183	2188	5	LEFT	D61c.EDF	D61	3
101	7489731	7490075	2231	2575	344	LEFT	D61c.EDF	D61	3
101	7490177	7490179	2677	2679	2	LEFT	D61c.EDF	D61	3
101	7490640	7490641	3140	3141	1	LEFT	D61c.EDF	D61	3
101	7491765	7491807	4265	4307	42	LEFT	D61c.EDF	D61	3
101	7491829	7491855	4329	4355	26	LEFT	D61c.EDF	D61	3
101	7491893	7492026	4393	4526	133	LEFT	D61c.EDF	D61	3
101	7492053	7492053	4553	4553	0	LEFT	D61c.EDF	D61	3
101	7492075	7492075	4575	4575	0	LEFT	D61c.EDF	D61	3
101	7492102	7492128	4602	4628	26	LEFT	D61c.EDF	D61	3
101	7492183	7492184	4683	4684	1	LEFT	D61c.EDF	D61	3
101	7492221	7492314	4721	4814	93	LEFT	D61c.EDF	D61	3
101	7492364	7492450	4864	4950	86	LEFT	D61c.EDF	D61	3
101	7492516	7492517	5016	5017	1	LEFT	D61c.EDF	D61	3
101	7492547	7492550	5047	5050	3	LEFT	D61c.EDF	D61	3
101	7492573	7492574	5073	5074	1	LEFT	D61c.EDF	D61	3
101	7492680	7492733	5180	5233	53	LEFT	D61c.EDF	D61	3
101	7492820	7492867	5320	5367	47	LEFT	D61c.EDF	D61	3
101	7493148	7493194	5648	5694	46	LEFT	D61c.EDF	D61	3
101	7493282	7493283	5782	5783	1	LEFT	D61c.EDF	D61	3
101	7493412	7493435	5912	5935	23	LEFT	D61c.EDF	D61	3
101	7493522	7493532	6022	6032	10	LEFT	D61c.EDF	D61	3
102	7495173	7495677	58	562	504	LEFT	D61c.EDF	D61	3
102	7495755	7495762	640	647	7	LEFT	D61c.EDF	D61	3
102	7497297	7500806	2182	5691	3509	LEFT	D61c.EDF	D61	3
103	7502545	7503674	57	1186	1129	LEFT	D61c.EDF	D61	3
103	7504297	7504437	1809	1949	140	LEFT	D61c.EDF	D61	3
103	7504879	7504881	2391	2393	2	LEFT	D61c.EDF	D61	3
103	7504902	7504934	2414	2446	32	LEFT	D61c.EDF	D61	3
103	7504959	7505709	2471	3221	750	LEFT	D61c.EDF	D61	3
103	7505748	7506077	3260	3589	329	LEFT	D61c.EDF	D61	3
103	7506147	7506189	3659	3701	42	LEFT	D61c.EDF	D61	3
103	7506214	7506270	3726	3782	56	LEFT	D61c.EDF	D61	3
103	7506417	7506417	3929	3929	0	LEFT	D61c.EDF	D61	3
103	7506438	7506463	3950	3975	25	LEFT	D61c.EDF	D61	3
103	7506503	7506587	4015	4099	84	LEFT	D61c.EDF	D61	3
103	7506700	7506709	4212	4221	9	LEFT	D61c.EDF	D61	3
103	7506730	7506889	4242	4401	159	LEFT	D61c.EDF	D61	3
103	7507285	7507286	4797	4798	1	LEFT	D61c.EDF	D61	3
103	7507785	7507793	5297	5305	8	LEFT	D61c.EDF	D61	3
103	7507838	7507851	5350	5363	13	LEFT	D61c.EDF	D61	3
103	7507913	7507913	5425	5425	0	LEFT	D61c.EDF	D61	3
103	7509247	7509247	6759	6759	0	LEFT	D61c.EDF	D61	3
104	7511832	7512013	57	238	181	LEFT	D61c.EDF	D61	3
104	7512060	7512063	285	288	3	LEFT	D61c.EDF	D61	3
104	7514030	7514308	2255	2533	278	LEFT	D61c.EDF	D61	3
104	7514354	7514439	2579	2664	85	LEFT	D61c.EDF	D61	3
104	7514475	7514476	2700	2701	1	LEFT	D61c.EDF	D61	3
104	7514499	7514502	2724	2727	3	LEFT	D61c.EDF	D61	3
104	7514554	7514554	2779	2779	0	LEFT	D61c.EDF	D61	3
104	7514643	7514645	2868	2870	2	LEFT	D61c.EDF	D61	3
104	7514834	7514834	3059	3059	0	LEFT	D61c.EDF	D61	3
104	7516370	7516372	4595	4597	2	LEFT	D61c.EDF	D61	3
104	7516820	7516821	5045	5046	1	LEFT	D61c.EDF	D61	3
104	7516843	7516848	5068	5073	5	LEFT	D61c.EDF	D61	3
104	7516891	7516891	5116	5116	0	LEFT	D61c.EDF	D61	3
105	7519801	7519827	101	127	26	LEFT	D61c.EDF	D61	3
105	7521687	7522095	1987	2395	408	LEFT	D61c.EDF	D61	3
105	7522124	7522124	2424	2424	0	LEFT	D61c.EDF	D61	3
105	7522146	7522172	2446	2472	26	LEFT	D61c.EDF	D61	3
105	7522196	7522202	2496	2502	6	LEFT	D61c.EDF	D61	3
106	7528368	7528590	106	328	222	LEFT	D61c.EDF	D61	3
106	7530141	7530259	1879	1997	118	LEFT	D61c.EDF	D61	3
106	7530297	7530989	2035	2727	692	LEFT	D61c.EDF	D61	3
106	7531033	7531045	2771	2783	12	LEFT	D61c.EDF	D61	3
106	7531186	7531205	2924	2943	19	LEFT	D61c.EDF	D61	3
106	7531259	7531260	2997	2998	1	LEFT	D61c.EDF	D61	3
106	7531389	7531402	3127	3140	13	LEFT	D61c.EDF	D61	3
106	7531438	7531442	3176	3180	4	LEFT	D61c.EDF	D61	3
106	7531464	7531464	3202	3202	0	LEFT	D61c.EDF	D61	3
106	7531493	7531493	3231	3231	0	LEFT	D61c.EDF	D61	3
106	7531768	7531770	3506	3508	2	LEFT	D61c.EDF	D61	3
106	7532674	7532674	4412	4412	0	LEFT	D61c.EDF	D61	3
106	7532701	7532731	4439	4469	30	LEFT	D61c.EDF	D61	3
106	7532752	7532752	4490	4490	0	LEFT	D61c.EDF	D61	3
106	7532780	7532857	4518	4595	77	LEFT	D61c.EDF	D61	3
106	7532893	7532904	4631	4642	11	LEFT	D61c.EDF	D61	3
106	7532986	7532996	4724	4734	10	LEFT	D61c.EDF	D61	3
107	7534913	7535001	125	213	88	LEFT	D61c.EDF	D61	3
107	7535532	7535535	744	747	3	LEFT	D61c.EDF	D61	3
107	7535565	7535565	777	777	0	LEFT	D61c.EDF	D61	3
107	7536816	7536950	2028	2162	134	LEFT	D61c.EDF	D61	3
107	7537298	7537675	2510	2887	377	LEFT	D61c.EDF	D61	3
107	7537733	7537762	2945	2974	29	LEFT	D61c.EDF	D61	3
107	7537927	7537928	3139	3140	1	LEFT	D61c.EDF	D61	3
107	7538037	7538049	3249	3261	12	LEFT	D61c.EDF	D61	3
107	7538072	7538072	3284	3284	0	LEFT	D61c.EDF	D61	3
107	7538113	7538116	3325	3328	3	LEFT	D61c.EDF	D61	3
107	7540041	7540061	5253	5273	20	LEFT	D61c.EDF	D61	3
107	7540093	7540093	5305	5305	0	LEFT	D61c.EDF	D61	3
107	7540143	7540171	5355	5383	28	LEFT	D61c.EDF	D61	3
108	7542013	7542398	64	449	385	LEFT	D61c.EDF	D61	3
108	7542450	7542450	501	501	0	LEFT	D61c.EDF	D61	3
108	7544038	7544693	2089	2744	655	LEFT	D61c.EDF	D61	3
108	7544717	7544722	2768	2773	5	LEFT	D61c.EDF	D61	3
108	7544762	7544843	2813	2894	81	LEFT	D61c.EDF	D61	3
109	7549015	7549217	57	259	202	LEFT	D61c.EDF	D61	3
109	7549864	7550025	906	1067	161	LEFT	D61c.EDF	D61	3
109	7550856	7550857	1898	1899	1	LEFT	D61c.EDF	D61	3
109	7550885	7551074	1927	2116	189	LEFT	D61c.EDF	D61	3
109	7551111	7551176	2153	2218	65	LEFT	D61c.EDF	D61	3
109	7551210	7551242	2252	2284	32	LEFT	D61c.EDF	D61	3
109	7551295	7551324	2337	2366	29	LEFT	D61c.EDF	D61	3
109	7551357	7551366	2399	2408	9	LEFT	D61c.EDF	D61	3
110	7557520	7557623	58	161	103	LEFT	D61c.EDF	D61	3
110	7557674	7557675	212	213	1	LEFT	D61c.EDF	D61	3
110	7557711	7557854	249	392	143	LEFT	D61c.EDF	D61	3
110	7557896	7557902	434	440	6	LEFT	D61c.EDF	D61	3
110	7557984	7557992	522	530	8	LEFT	D61c.EDF	D61	3
110	7558059	7558072	597	610	13	LEFT	D61c.EDF	D61	3
110	7558096	7558097	634	635	1	LEFT	D61c.EDF	D61	3
110	7558176	7558377	714	915	201	LEFT	D61c.EDF	D61	3
110	7558642	7558642	1180	1180	0	LEFT	D61c.EDF	D61	3
110	7558787	7558817	1325	1355	30	LEFT	D61c.EDF	D61	3
110	7558950	7558950	1488	1488	0	LEFT	D61c.EDF	D61	3
110	7558984	7558995	1522	1533	11	LEFT	D61c.EDF	D61	3
110	7559032	7559051	1570	1589	19	LEFT	D61c.EDF	D61	3
110	7559075	7559075	1613	1613	0	LEFT	D61c.EDF	D61	3
110	7560326	7560610	2864	3148	284	LEFT	D61c.EDF	D61	3
110	7560645	7560646	3183	3184	1	LEFT	D61c.EDF	D61	3
110	7560685	7560698	3223	3236	13	LEFT	D61c.EDF	D61	3
110	7560911	7560947	3449	3485	36	LEFT	D61c.EDF	D61	3
111	7566095	7566220	58	183	125	LEFT	D61c.EDF	D61	3
111	7566271	7566271	234	234	0	LEFT	D61c.EDF	D61	3
111	7566601	7566602	564	565	1	LEFT	D61c.EDF	D61	3
111	7567856	7567857	1819	1820	1	LEFT	D61c.EDF	D61	3
111	7569756	7570412	3719	4375	656	LEFT	D61c.EDF	D61	3
111	7570470	7570487	4433	4450	17	LEFT	D61c.EDF	D61	3
111	7570516	7570567	4479	4530	51	LEFT	D61c.EDF	D61	3
111	7570588	7570600	4551	4563	12	LEFT	D61c.EDF	D61	3
111	7570623	7570705	4586	4668	82	LEFT	D61c.EDF	D61	3
111	7570736	7570763	4699	4726	27	LEFT	D61c.EDF	D61	3
111	7570806	7570836	4769	4799	30	LEFT	D61c.EDF	D61	3
111	7570871	7570905	4834	4868	34	LEFT	D61c.EDF	D61	3
111	7570947	7571031	4910	4994	84	LEFT	D61c.EDF	D61	3
111	7571053	7571053	5016	5016	0	LEFT	D61c.EDF	D61	3
111	7571076	7571116	5039	5079	40	LEFT	D61c.EDF	D61	3
111	7571149	7571159	5112	5122	10	LEFT	D61c.EDF	D61	3
111	7571241	7571241	5204	5204	0	LEFT	D61c.EDF	D61	3
111	7571371	7571374	5334	5337	3	LEFT	D61c.EDF	D61	3
112	7573573	7573618	94	139	45	LEFT	D61c.EDF	D61	3
112	7573735	7573737	256	258	2	LEFT	D61c.EDF	D61	3
112	7573768	7573769	289	290	1	LEFT	D61c.EDF	D61	3
112	7573903	7573908	424	429	5	LEFT	D61c.EDF	D61	3
112	7573945	7574131	466	652	186	LEFT	D61c.EDF	D61	3
112	7574255	7574259	776	780	4	LEFT	D61c.EDF	D61	3
112	7574356	7574444	877	965	88	LEFT	D61c.EDF	D61	3
112	7574542	7574542	1063	1063	0	LEFT	D61c.EDF	D61	3
112	7574582	7574582	1103	1103	0	LEFT	D61c.EDF	D61	3
112	7574865	7574908	1386	1429	43	LEFT	D61c.EDF	D61	3
112	7574932	7575004	1453	1525	72	LEFT	D61c.EDF	D61	3
112	7575030	7575154	1551	1675	124	LEFT	D61c.EDF	D61	3
112	7575206	7575247	1727	1768	41	LEFT	D61c.EDF	D61	3
112	7575642	7575777	2163	2298	135	LEFT	D61c.EDF	D61	3
112	7575802	7575949	2323	2470	147	LEFT	D61c.EDF	D61	3
112	7575979	7575997	2500	2518	18	LEFT	D61c.EDF	D61	3
112	7576038	7576050	2559	2571	12	LEFT	D61c.EDF	D61	3
112	7576135	7576156	2656	2677	21	LEFT	D61c.EDF	D61	3
113	7580239	7580254	73	88	15	LEFT	D61c.EDF	D61	3
113	7580761	7580869	595	703	108	LEFT	D61c.EDF	D61	3
113	7580890	7580900	724	734	10	LEFT	D61c.EDF	D61	3
113	7580937	7580979	771	813	42	LEFT	D61c.EDF	D61	3
113	7581002	7581008	836	842	6	LEFT	D61c.EDF	D61	3
113	7581034	7581035	868	869	1	LEFT	D61c.EDF	D61	3
113	7581066	7581068	900	902	2	LEFT	D61c.EDF	D61	3
113	7582039	7582096	1873	1930	57	LEFT	D61c.EDF	D61	3
113	7582171	7582183	2005	2017	12	LEFT	D61c.EDF	D61	3
113	7582244	7582244	2078	2078	0	LEFT	D61c.EDF	D61	3
113	7582286	7582631	2120	2465	345	LEFT	D61c.EDF	D61	3
113	7582671	7582671	2505	2505	0	LEFT	D61c.EDF	D61	3
113	7582798	7582798	2632	2632	0	LEFT	D61c.EDF	D61	3
114	7588549	7588725	57	233	176	LEFT	D61c.EDF	D61	3
114	7590160	7590162	1668	1670	2	LEFT	D61c.EDF	D61	3
114	7591301	7591633	2809	3141	332	LEFT	D61c.EDF	D61	3
114	7591675	7591678	3183	3186	3	LEFT	D61c.EDF	D61	3
114	7592014	7592015	3522	3523	1	LEFT	D61c.EDF	D61	3
114	7592242	7592242	3750	3750	0	LEFT	D61c.EDF	D61	3
114	7593762	7593762	5270	5270	0	LEFT	D61c.EDF	D61	3
114	7593949	7594269	5457	5777	320	LEFT	D61c.EDF	D61	3
114	7594351	7594352	5859	5860	1	LEFT	D61c.EDF	D61	3
114	7594438	7594492	5946	6000	54	LEFT	D61c.EDF	D61	3
114	7594530	7594530	6038	6038	0	LEFT	D61c.EDF	D61	3
114	7594590	7594594	6098	6102	4	LEFT	D61c.EDF	D61	3
114	7594660	7594750	6168	6258	90	LEFT	D61c.EDF	D61	3
114	7594790	7594800	6298	6308	10	LEFT	D61c.EDF	D61	3
114	7594839	7594844	6347	6352	5	LEFT	D61c.EDF	D61	3
115	7596971	7597201	247	477	230	LEFT	D61c.EDF	D61	3
115	7597485	7597506	761	782	21	LEFT	D61c.EDF	D61	3
115	7597658	7597677	934	953	19	LEFT	D61c.EDF	D61	3
115	7597699	7597718	975	994	19	LEFT	D61c.EDF	D61	3
115	7597790	7597790	1066	1066	0	LEFT	D61c.EDF	D61	3
115	7597869	7597874	1145	1150	5	LEFT	D61c.EDF	D61	3
115	7598025	7598027	1301	1303	2	LEFT	D61c.EDF	D61	3
115	7598095	7598095	1371	1371	0	LEFT	D61c.EDF	D61	3
115	7598120	7598142	1396	1418	22	LEFT	D61c.EDF	D61	3
115	7598165	7598193	1441	1469	28	LEFT	D61c.EDF	D61	3
115	7598244	7598246	1520	1522	2	LEFT	D61c.EDF	D61	3
115	7598450	7598494	1726	1770	44	LEFT	D61c.EDF	D61	3
115	7598515	7598672	1791	1948	157	LEFT	D61c.EDF	D61	3
115	7599316	7599416	2592	2692	100	LEFT	D61c.EDF	D61	3
115	7599439	7599443	2715	2719	4	LEFT	D61c.EDF	D61	3
115	7599477	7599489	2753	2765	12	LEFT	D61c.EDF	D61	3
115	7599734	7599740	3010	3016	6	LEFT	D61c.EDF	D61	3
115	7599831	7599835	3107	3111	4	LEFT	D61c.EDF	D61	3
116	7604983	7605166	79	262	183	LEFT	D61c.EDF	D61	3
116	7605189	7605191	285	287	2	LEFT	D61c.EDF	D61	3
116	7605257	7605264	353	360	7	LEFT	D61c.EDF	D61	3
116	7605477	7605479	573	575	2	LEFT	D61c.EDF	D61	3
116	7605614	7605628	710	724	14	LEFT	D61c.EDF	D61	3
116	7605657	7605659	753	755	2	LEFT	D61c.EDF	D61	3
116	7605721	7605873	817	969	152	LEFT	D61c.EDF	D61	3
116	7607012	7607095	2108	2191	83	LEFT	D61c.EDF	D61	3
116	7607790	7607796	2886	2892	6	LEFT	D61c.EDF	D61	3
116	7607834	7607898	2930	2994	64	LEFT	D61c.EDF	D61	3
116	7607940	7607968	3036	3064	28	LEFT	D61c.EDF	D61	3
116	7607989	7607990	3085	3086	1	LEFT	D61c.EDF	D61	3
116	7608041	7608059	3137	3155	18	LEFT	D61c.EDF	D61	3
116	7608107	7608107	3203	3203	0	LEFT	D61c.EDF	D61	3
117	7612772	7612956	100	284	184	LEFT	D61c.EDF	D61	3
117	7613429	7613429	757	757	0	LEFT	D61c.EDF	D61	3
117	7613927	7613927	1255	1255	0	LEFT	D61c.EDF	D61	3
117	7613983	7613989	1311	1317	6	LEFT	D61c.EDF	D61	3
117	7614092	7614103	1420	1431	11	LEFT	D61c.EDF	D61	3
117	7614215	7614226	1543	1554	11	LEFT	D61c.EDF	D61	3
117	7614703	7614873	2031	2201	170	LEFT	D61c.EDF	D61	3
117	7614896	7614896	2224	2224	0	LEFT	D61c.EDF	D61	3
117	7615119	7615127	2447	2455	8	LEFT	D61c.EDF	D61	3
117	7615223	7615224	2551	2552	1	LEFT	D61c.EDF	D61	3
117	7615287	7616658	2615	3986	1371	LEFT	D61c.EDF	D61	3
117	7617217	7617218	4545	4546	1	LEFT	D61c.EDF	D61	3
117	7617260	7617307	4588	4635	47	LEFT	D61c.EDF	D61	3
117	7617328	7617405	4656	4733	77	LEFT	D61c.EDF	D61	3
117	7617534	7617543	4862	4871	9	LEFT	D61c.EDF	D61	3
117	7617749	7617773	5077	5101	24	LEFT	D61c.EDF	D61	3
117	7617866	7617866	5194	5194	0	LEFT	D61c.EDF	D61	3
117	7617902	7617903	5230	5231	1	LEFT	D61c.EDF	D61	3
117	7617968	7617968	5296	5296	0	LEFT	D61c.EDF	D61	3
117	7617993	7618064	5321	5392	71	LEFT	D61c.EDF	D61	3
117	7618141	7618181	5469	5509	40	LEFT	D61c.EDF	D61	3
117	7618223	7618269	5551	5597	46	LEFT	D61c.EDF	D61	3
118	7620399	7620603	58	262	204	LEFT	D61c.EDF	D61	3
118	7620670	7620670	329	329	0	LEFT	D61c.EDF	D61	3
118	7620691	7620691	350	350	0	LEFT	D61c.EDF	D61	3
118	7620744	7620762	403	421	18	LEFT	D61c.EDF	D61	3
118	7620787	7620837	446	496	50	LEFT	D61c.EDF	D61	3
118	7620864	7620890	523	549	26	LEFT	D61c.EDF	D61	3
118	7620913	7621203	572	862	290	LEFT	D61c.EDF	D61	3
118	7621260	7621260	919	919	0	LEFT	D61c.EDF	D61	3
118	7621308	7621312	967	971	4	LEFT	D61c.EDF	D61	3
118	7621344	7621348	1003	1007	4	LEFT	D61c.EDF	D61	3
118	7622469	7622469	2128	2128	0	LEFT	D61c.EDF	D61	3
118	7622492	7622523	2151	2182	31	LEFT	D61c.EDF	D61	3
118	7623204	7623213	2863	2872	9	LEFT	D61c.EDF	D61	3
118	7623247	7623308	2906	2967	61	LEFT	D61c.EDF	D61	3
118	7623346	7623347	3005	3006	1	LEFT	D61c.EDF	D61	3
118	7623416	7623417	3075	3076	1	LEFT	D61c.EDF	D61	3
119	7628094	7628153	71	130	59	LEFT	D61c.EDF	D61	3
119	7628198	7628198	175	175	0	LEFT	D61c.EDF	D61	3
119	7628219	7628228	196	205	9	LEFT	D61c.EDF	D61	3
119	7628597	7628597	574	574	0	LEFT	D61c.EDF	D61	3
119	7628626	7628673	603	650	47	LEFT	D61c.EDF	D61	3
119	7628702	7628703	679	680	1	LEFT	D61c.EDF	D61	3
119	7628738	7628751	715	728	13	LEFT	D61c.EDF	D61	3
119	7629902	7629902	1879	1879	0	LEFT	D61c.EDF	D61	3
119	7629951	7630129	1928	2106	178	LEFT	D61c.EDF	D61	3
119	7630169	7630173	2146	2150	4	LEFT	D61c.EDF	D61	3
119	7630215	7630226	2192	2203	11	LEFT	D61c.EDF	D61	3
119	7630304	7630332	2281	2309	28	LEFT	D61c.EDF	D61	3
119	7630386	7630387	2363	2364	1	LEFT	D61c.EDF	D61	3
119	7630410	7630410	2387	2387	0	LEFT	D61c.EDF	D61	3
119	7630497	7630501	2474	2478	4	LEFT	D61c.EDF	D61	3
120	7636373	7636416	60	103	43	LEFT	D61c.EDF	D61	3
120	7636754	7637018	441	705	264	LEFT	D61c.EDF	D61	3
120	7638163	7638163	1850	1850	0	LEFT	D61c.EDF	D61	3
120	7638210	7638291	1897	1978	81	LEFT	D61c.EDF	D61	3
120	7638421	7638424	2108	2111	3	LEFT	D61c.EDF	D61	3
120	7638595	7638618	2282	2305	23	LEFT	D61c.EDF	D61	3
120	7638645	7638645	2332	2332	0	LEFT	D61c.EDF	D61	3
120	7638673	7638675	2360	2362	2	LEFT	D61c.EDF	D61	3
120	7638710	7638741	2397	2428	31	LEFT	D61c.EDF	D61	3
121	8019446	8019542	2948	3044	96	LEFT	D61c.EDF	D61	3
121	8022000	8022001	5502	5503	1	LEFT	D61c.EDF	D61	3
121	8022037	8022105	5539	5607	68	LEFT	D61c.EDF	D61	3
121	8023295	8023406	6797	6908	111	LEFT	D61c.EDF	D61	3
121	8024171	8025691	7673	9193	1520	LEFT	D61c.EDF	D61	3
121	8025940	8027372	9442	10874	1432	LEFT	D61c.EDF	D61	3
121	8028072	8028177	11574	11679	105	LEFT	D61c.EDF	D61	3
121	8029542	8029644	13044	13146	102	LEFT	D61c.EDF	D61	3
121	8030708	8030934	14210	14436	226	LEFT	D61c.EDF	D61	3
121	8031104	8031339	14606	14841	235	LEFT	D61c.EDF	D61	3
121	8031880	8033056	15382	16558	1176	LEFT	D61c.EDF	D61	3
121	8033124	8033299	16626	16801	175	LEFT	D61c.EDF	D61	3
121	8033902	8034000	17404	17502	98	LEFT	D61c.EDF	D61	3
121	8036900	8037003	20402	20505	103	LEFT	D61c.EDF	D61	3
121	8038131	8038242	21633	21744	111	LEFT	D61c.EDF	D61	3
121	8038267	8038271	21769	21773	4	LEFT	D61c.EDF	D61	3
121	8039025	8039143	22527	22645	118	LEFT	D61c.EDF	D61	3
121	8040379	8040479	23881	23981	100	LEFT	D61c.EDF	D61	3
121	8041532	8041651	25034	25153	119	LEFT	D61c.EDF	D61	3
121	8044400	8044521	27902	28023	121	LEFT	D61c.EDF	D61	3
121	8045133	8045315	28635	28817	182	LEFT	D61c.EDF	D61	3
121	8046018	8046289	29520	29791	271	LEFT	D61c.EDF	D61	3
121	8046815	8047005	30317	30507	190	LEFT	D61c.EDF	D61	3
121	8048859	8049024	32361	32526	165	LEFT	D61c.EDF	D61	3
121	8049802	8049950	33304	33452	148	LEFT	D61c.EDF	D61	3
121	8051190	8051321	34692	34823	131	LEFT	D61c.EDF	D61	3
121	8057636	8057793	41138	41295	157	LEFT	D61c.EDF	D61	3
121	8060561	8060704	44063	44206	143	LEFT	D61c.EDF	D61	3
121	8066098	8066248	49600	49750	150	LEFT	D61c.EDF	D61	3
121	8072127	8072296	55629	55798	169	LEFT	D61c.EDF	D61	3
121	8074955	8075094	58457	58596	139	LEFT	D61c.EDF	D61	3
121	8077592	8077725	61094	61227	133	LEFT	D61c.EDF	D61	3
121	8078532	8078679	62034	62181	147	LEFT	D61c.EDF	D61	3
121	8080742	8080957	64244	64459	215	LEFT	D61c.EDF	D61	3
121	8082943	8083128	66445	66630	185	LEFT	D61c.EDF	D61	3
121	8084261	8084413	67763	67915	152	LEFT	D61c.EDF	D61	3
121	8100080	8100209	83582	83711	129	LEFT	D61c.EDF	D61	3
121	8104686	8104853	88188	88355	167	LEFT	D61c.EDF	D61	3
121	8104884	8104896	88386	88398	12	LEFT	D61c.EDF	D61	3
121	8110418	8110710	93920	94212	292	LEFT	D61c.EDF	D61	3
121	8110744	8110745	94246	94247	1	LEFT	D61c.EDF	D61	3
121	8110768	8110771	94270	94273	3	LEFT	D61c.EDF	D61	3
121	8118654	8118845	102156	102347	191	LEFT	D61c.EDF	D61	3
121	8118887	8118888	102389	102390	1	LEFT	D61c.EDF	D61	3
121	8135608	8135755	119110	119257	147	LEFT	D61c.EDF	D61	3
121	8137301	8137420	120803	120922	119	LEFT	D61c.EDF	D61	3
121	8153676	8154886	137178	138388	1210	LEFT	D61c.EDF	D61	3
121	8157757	8157911	141259	141413	154	LEFT	D61c.EDF	D61	3
121	8168107	8168259	151609	151761	152	LEFT	D61c.EDF	D61	3
121	8178160	8178283	161662	161785	123	LEFT	D61c.EDF	D61	3
121	8181112	8181128	164614	164630	16	LEFT	D61c.EDF	D61	3
121	8181171	8181276	164673	164778	105	LEFT	D61c.EDF	D61	3
121	8181302	8181318	164804	164820	16	LEFT	D61c.EDF	D61	3
121	8192592	8192734	176094	176236	142	LEFT	D61c.EDF	D61	3
121	8206209	8206474	189711	189976	265	LEFT	D61c.EDF	D61	3
121	8208140	8208290	191642	191792	150	LEFT	D61c.EDF	D61	3
121	8218006	8218127	201508	201629	121	LEFT	D61c.EDF	D61	3
121	8225406	8225571	208908	209073	165	LEFT	D61c.EDF	D61	3
121	8231019	8231192	214521	214694	173	LEFT	D61c.EDF	D61	3
121	8246168	8246317	229670	229819	149	LEFT	D61c.EDF	D61	3
121	8261052	8261189	244554	244691	137	LEFT	D61c.EDF	D61	3
121	8268812	8269656	252314	253158	844	LEFT	D61c.EDF	D61	3
121	8272282	8272383	255784	255885	101	LEFT	D61c.EDF	D61	3
121	8276434	8276535	259936	260037	101	LEFT	D61c.EDF	D61	3
121	8277733	8277847	261235	261349	114	LEFT	D61c.EDF	D61	3
121	8278733	8302773	262235	286275	24040	LEFT	D61c.EDF	D61	3
121	8303160	8303383	286662	286885	223	LEFT	D61c.EDF	D61	3
121	8304532	8304638	288034	288140	106	LEFT	D61c.EDF	D61	3
121	8308167	8308276	291669	291778	109	LEFT	D61c.EDF	D61	3
121	8310881	8310954	294383	294456	73	LEFT	D61c.EDF	D61	3
121	8313060	8313168	296562	296670	108	LEFT	D61c.EDF	D61	3
121	8314588	8314722	298090	298224	134	LEFT	D61c.EDF	D61	3
121	8314807	8314838	298309	298340	31	LEFT	D61c.EDF	D61	3
121	8316132	8316231	299634	299733	99	LEFT	D61c.EDF	D61	3
121	8319725	8319812	303227	303314	87	LEFT	D61c.EDF	D61	3
121	8323159	8323263	306661	306765	104	LEFT	D61c.EDF	D61	3
121	8326707	8326803	310209	310305	96	LEFT	D61c.EDF	D61	3
121	8328176	8328314	311678	311816	138	LEFT	D61c.EDF	D61	3
122	8381594	8381730	2779	2915	136	LEFT	D61c.EDF	D61	3
122	8382288	8382439	3473	3624	151	LEFT	D61c.EDF	D61	3
122	8394444	8394610	15629	15795	166	LEFT	D61c.EDF	D61	3
122	8394636	8394683	15821	15868	47	LEFT	D61c.EDF	D61	3
122	8395430	8395712	16615	16897	282	LEFT	D61c.EDF	D61	3
122	8399954	8400134	21139	21319	180	LEFT	D61c.EDF	D61	3
122	8400913	8401106	22098	22291	193	LEFT	D61c.EDF	D61	3
122	8404241	8404371	25426	25556	130	LEFT	D61c.EDF	D61	3
122	8405079	8405173	26264	26358	94	LEFT	D61c.EDF	D61	3
122	8405329	8405412	26514	26597	83	LEFT	D61c.EDF	D61	3
122	8407371	8407549	28556	28734	178	LEFT	D61c.EDF	D61	3
122	8407874	8408202	29059	29387	328	LEFT	D61c.EDF	D61	3
122	8408285	8408611	29470	29796	326	LEFT	D61c.EDF	D61	3
122	8408634	8408926	29819	30111	292	LEFT	D61c.EDF	D61	3
122	8409654	8409800	30839	30985	146	LEFT	D61c.EDF	D61	3
122	8409836	8409836	31021	31021	0	LEFT	D61c.EDF	D61	3
122	8410928	8411032	32113	32217	104	LEFT	D61c.EDF	D61	3
122	8411575	8411699	32760	32884	124	LEFT	D61c.EDF	D61	3
122	8412633	8412770	33818	33955	137	LEFT	D61c.EDF	D61	3
122	8413413	8413583	34598	34768	170	LEFT	D61c.EDF	D61	3
122	8414556	8414678	35741	35863	122	LEFT	D61c.EDF	D61	3
122	8415056	8415213	36241	36398	157	LEFT	D61c.EDF	D61	3
122	8415632	8415759	36817	36944	127	LEFT	D61c.EDF	D61	3
122	8415834	8415900	37019	37085	66	LEFT	D61c.EDF	D61	3
122	8416126	8416137	37311	37322	11	LEFT	D61c.EDF	D61	3
122	8416174	8416264	37359	37449	90	LEFT	D61c.EDF	D61	3
122	8416898	8417035	38083	38220	137	LEFT	D61c.EDF	D61	3
122	8419446	8419636	40631	40821	190	LEFT	D61c.EDF	D61	3
122	8419678	8419719	40863	40904	41	LEFT	D61c.EDF	D61	3
122	8421150	8421240	42335	42425	90	LEFT	D61c.EDF	D61	3
122	8422338	8422468	43523	43653	130	LEFT	D61c.EDF	D61	3
122	8423261	8423375	44446	44560	114	LEFT	D61c.EDF	D61	3
122	8425044	8425167	46229	46352	123	LEFT	D61c.EDF	D61	3
122	8429724	8429906	50909	51091	182	LEFT	D61c.EDF	D61	3
122	8435637	8435803	56822	56988	166	LEFT	D61c.EDF	D61	3
122	8436011	8436149	57196	57334	138	LEFT	D61c.EDF	D61	3
122	8436283	8436293	57468	57478	10	LEFT	D61c.EDF	D61	3
122	8437809	8437997	58994	59182	188	LEFT	D61c.EDF	D61	3
122	8439484	8439575	60669	60760	91	LEFT	D61c.EDF	D61	3
122	8439608	8439747	60793	60932	139	LEFT	D61c.EDF	D61	3
122	8439830	8440286	61015	61471	456	LEFT	D61c.EDF	D61	3
122	8440939	8440991	62124	62176	52	LEFT	D61c.EDF	D61	3
122	8442756	8443020	63941	64205	264	LEFT	D61c.EDF	D61	3
122	8443162	8447642	64347	68827	4480	LEFT	D61c.EDF	D61	3
122	8447686	8447694	68871	68879	8	LEFT	D61c.EDF	D61	3
122	8447726	8447873	68911	69058	147	LEFT	D61c.EDF	D61	3
122	8448791	8449050	69976	70235	259	LEFT	D61c.EDF	D61	3
122	8449072	8449800	70257	70985	728	LEFT	D61c.EDF	D61	3
122	8450279	8450418	71464	71603	139	LEFT	D61c.EDF	D61	3
122	8451052	8451227	72237	72412	175	LEFT	D61c.EDF	D61	3
122	8453073	8454800	74258	75985	1727	LEFT	D61c.EDF	D61	3
122	8455099	8455275	76284	76460	176	LEFT	D61c.EDF	D61	3
122	8457001	8457197	78186	78382	196	LEFT	D61c.EDF	D61	3
122	8458512	8458631	79697	79816	119	LEFT	D61c.EDF	D61	3
122	8463165	8463281	84350	84466	116	LEFT	D61c.EDF	D61	3
122	8465724	8465828	86909	87013	104	LEFT	D61c.EDF	D61	3
122	8466634	8466752	87819	87937	118	LEFT	D61c.EDF	D61	3
122	8470681	8470829	91866	92014	148	LEFT	D61c.EDF	D61	3
122	8473346	8473485	94531	94670	139	LEFT	D61c.EDF	D61	3
122	8476350	8476487	97535	97672	137	LEFT	D61c.EDF	D61	3
122	8478477	8478594	99662	99779	117	LEFT	D61c.EDF	D61	3
122	8478675	8478766	99860	99951	91	LEFT	D61c.EDF	D61	3
122	8478903	8479011	100088	100196	108	LEFT	D61c.EDF	D61	3
122	8481146	8481269	102331	102454	123	LEFT	D61c.EDF	D61	3
122	8486685	8486795	107870	107980	110	LEFT	D61c.EDF	D61	3
122	8488927	8489080	110112	110265	153	LEFT	D61c.EDF	D61	3
122	8489313	8489801	110498	110986	488	LEFT	D61c.EDF	D61	3
122	8491715	8491845	112900	113030	130	LEFT	D61c.EDF	D61	3
122	8495970	8496074	117155	117259	104	LEFT	D61c.EDF	D61	3
122	8499109	8499109	120294	120294	0	LEFT	D61c.EDF	D61	3
122	8499289	8499348	120474	120533	59	LEFT	D61c.EDF	D61	3
122	8499437	8499501	120622	120686	64	LEFT	D61c.EDF	D61	3
122	8499527	8499543	120712	120728	16	LEFT	D61c.EDF	D61	3
122	8501224	8501354	122409	122539	130	LEFT	D61c.EDF	D61	3
122	8501387	8501387	122572	122572	0	LEFT	D61c.EDF	D61	3
122	8501882	8501997	123067	123182	115	LEFT	D61c.EDF	D61	3
122	8506142	8506261	127327	127446	119	LEFT	D61c.EDF	D61	3
122	8510947	8511100	132132	132285	153	LEFT	D61c.EDF	D61	3
122	8513990	8514124	135175	135309	134	LEFT	D61c.EDF	D61	3
122	8516830	8516950	138015	138135	120	LEFT	D61c.EDF	D61	3
122	8518790	8518924	139975	140109	134	LEFT	D61c.EDF	D61	3
122	8519703	8521154	140888	142339	1451	LEFT	D61c.EDF	D61	3
122	8521207	8521857	142392	143042	650	LEFT	D61c.EDF	D61	3
122	8522043	8522065	143228	143250	22	LEFT	D61c.EDF	D61	3
122	8522187	8522264	143372	143449	77	LEFT	D61c.EDF	D61	3
122	8523821	8523977	145006	145162	156	LEFT	D61c.EDF	D61	3
122	8527397	8527569	148582	148754	172	LEFT	D61c.EDF	D61	3
122	8530783	8530959	151968	152144	176	LEFT	D61c.EDF	D61	3
122	8532791	8532996	153976	154181	205	LEFT	D61c.EDF	D61	3
122	8533852	8534369	155037	155554	517	LEFT	D61c.EDF	D61	3
122	8536977	8537136	158162	158321	159	LEFT	D61c.EDF	D61	3
122	8540688	8541815	161873	163000	1127	LEFT	D61c.EDF	D61	3
122	8543400	8543553	164585	164738	153	LEFT	D61c.EDF	D61	3
122	8548303	8548488	169488	169673	185	LEFT	D61c.EDF	D61	3
122	8550237	8550397	171422	171582	160	LEFT	D61c.EDF	D61	3
122	8556142	8556340	177327	177525	198	LEFT	D61c.EDF	D61	3
122	8556858	8557330	178043	178515	472	LEFT	D61c.EDF	D61	3
122	8558682	8558783	179867	179968	101	LEFT	D61c.EDF	D61	3
122	8563950	8564032	185135	185217	82	LEFT	D61c.EDF	D61	3
122	8567484	8567625	188669	188810	141	LEFT	D61c.EDF	D61	3
122	8569682	8569790	190867	190975	108	LEFT	D61c.EDF	D61	3
122	8570218	8570643	191403	191828	425	LEFT	D61c.EDF	D61	3
122	8572207	8572208	193392	193393	1	LEFT	D61c.EDF	D61	3
122	8572337	8572340	193522	193525	3	LEFT	D61c.EDF	D61	3
122	8573510	8573637	194695	194822	127	LEFT	D61c.EDF	D61	3
122	8575626	8578150	196811	199335	2524	LEFT	D61c.EDF	D61	3
122	8579773	8579974	200958	201159	201	LEFT	D61c.EDF	D61	3
122	8580011	8580034	201196	201219	23	LEFT	D61c.EDF	D61	3
122	8581292	8581315	202477	202500	23	LEFT	D61c.EDF	D61	3
122	8581339	8581748	202524	202933	409	LEFT	D61c.EDF	D61	3
122	8581885	8581895	203070	203080	10	LEFT	D61c.EDF	D61	3
122	8581919	8582225	203104	203410	306	LEFT	D61c.EDF	D61	3
122	8582374	8582375	203559	203560	1	LEFT	D61c.EDF	D61	3
122	8583428	8583429	204613	204614	1	LEFT	D61c.EDF	D61	3
122	8583532	8583546	204717	204731	14	LEFT	D61c.EDF	D61	3
122	8583570	8583582	204755	204767	12	LEFT	D61c.EDF	D61	3
122	8583663	8583666	204848	204851	3	LEFT	D61c.EDF	D61	3
122	8583719	8583720	204904	204905	1	LEFT	D61c.EDF	D61	3
122	8584004	8584196	205189	205381	192	LEFT	D61c.EDF	D61	3
122	8587640	8587787	208825	208972	147	LEFT	D61c.EDF	D61	3
122	8590734	8590865	211919	212050	131	LEFT	D61c.EDF	D61	3
122	8596153	8596386	217338	217571	233	LEFT	D61c.EDF	D61	3
122	8596841	8597154	218026	218339	313	LEFT	D61c.EDF	D61	3
122	8598428	8598430	219613	219615	2	LEFT	D61c.EDF	D61	3
122	8599032	8601588	220217	222773	2556	LEFT	D61c.EDF	D61	3
122	8603135	8603331	224320	224516	196	LEFT	D61c.EDF	D61	3
122	8611015	8611191	232200	232376	176	LEFT	D61c.EDF	D61	3
122	8611899	8611952	233084	233137	53	LEFT	D61c.EDF	D61	3
122	8611999	8612958	233184	234143	959	LEFT	D61c.EDF	D61	3
122	8613071	8613973	234256	235158	902	LEFT	D61c.EDF	D61	3
122	8614148	8614209	235333	235394	61	LEFT	D61c.EDF	D61	3
122	8614241	8614798	235426	235983	557	LEFT	D61c.EDF	D61	3
122	8615001	8619503	236186	240688	4502	LEFT	D61c.EDF	D61	3
1	3608555	3608654	150	249	99	RIGHT	D69a.EDF	D69	1
1	3609177	3609412	772	1007	235	RIGHT	D69a.EDF	D69	1
1	3609863	3610061	1458	1656	198	RIGHT	D69a.EDF	D69	1
1	3612529	3612602	4124	4197	73	RIGHT	D69a.EDF	D69	1
1	3613514	3613580	5109	5175	66	RIGHT	D69a.EDF	D69	1
1	3614446	3614524	6041	6119	78	RIGHT	D69a.EDF	D69	1
2	3619918	3620043	145	270	125	RIGHT	D69a.EDF	D69	1
2	3620586	3620842	813	1069	256	RIGHT	D69a.EDF	D69	1
2	3623112	3623198	3339	3425	86	RIGHT	D69a.EDF	D69	1
2	3623790	3623828	4017	4055	38	RIGHT	D69a.EDF	D69	1
2	3624193	3624291	4420	4518	98	RIGHT	D69a.EDF	D69	1
2	3625187	3625278	5414	5505	91	RIGHT	D69a.EDF	D69	1
2	3625486	3625527	5713	5754	41	RIGHT	D69a.EDF	D69	1
3	3628195	3628290	221	316	95	RIGHT	D69a.EDF	D69	1
3	3628401	3628489	427	515	88	RIGHT	D69a.EDF	D69	1
3	3628908	3629134	934	1160	226	RIGHT	D69a.EDF	D69	1
3	3629542	3629759	1568	1785	217	RIGHT	D69a.EDF	D69	1
3	3631252	3631360	3278	3386	108	RIGHT	D69a.EDF	D69	1
3	3632128	3632197	4154	4223	69	RIGHT	D69a.EDF	D69	1
3	3632290	3632409	4316	4435	119	RIGHT	D69a.EDF	D69	1
3	3632964	3633067	4990	5093	103	RIGHT	D69a.EDF	D69	1
3	3633796	3633887	5822	5913	91	RIGHT	D69a.EDF	D69	1
3	3634447	3634713	6473	6739	266	RIGHT	D69a.EDF	D69	1
4	3637685	3637798	91	204	113	RIGHT	D69a.EDF	D69	1
4	3637897	3637991	303	397	94	RIGHT	D69a.EDF	D69	1
4	3638531	3638793	937	1199	262	RIGHT	D69a.EDF	D69	1
4	3639125	3639236	1531	1642	111	RIGHT	D69a.EDF	D69	1
4	3641286	3641376	3692	3782	90	RIGHT	D69a.EDF	D69	1
4	3641939	3642032	4345	4438	93	RIGHT	D69a.EDF	D69	1
4	3642665	3642755	5071	5161	90	RIGHT	D69a.EDF	D69	1
4	3643194	3643323	5600	5729	129	RIGHT	D69a.EDF	D69	1
4	3644154	3644238	6560	6644	84	RIGHT	D69a.EDF	D69	1
4	3644836	3644927	7242	7333	91	RIGHT	D69a.EDF	D69	1
5	3647744	3647850	333	439	106	RIGHT	D69a.EDF	D69	1
5	3648399	3648653	988	1242	254	RIGHT	D69a.EDF	D69	1
5	3649088	3649192	1677	1781	104	RIGHT	D69a.EDF	D69	1
5	3649866	3649968	2455	2557	102	RIGHT	D69a.EDF	D69	1
5	3650677	3650746	3266	3335	69	RIGHT	D69a.EDF	D69	1
5	3651035	3651145	3624	3734	110	RIGHT	D69a.EDF	D69	1
5	3651943	3652045	4532	4634	102	RIGHT	D69a.EDF	D69	1
5	3653162	3653249	5751	5838	87	RIGHT	D69a.EDF	D69	1
5	3653747	3653833	6336	6422	86	RIGHT	D69a.EDF	D69	1
5	3654047	3654151	6636	6740	104	RIGHT	D69a.EDF	D69	1
6	3656630	3656733	232	335	103	RIGHT	D69a.EDF	D69	1
6	3657131	3657366	733	968	235	RIGHT	D69a.EDF	D69	1
6	3657706	3657827	1308	1429	121	RIGHT	D69a.EDF	D69	1
6	3657989	3658142	1591	1744	153	RIGHT	D69a.EDF	D69	1
6	3660003	3660103	3605	3705	100	RIGHT	D69a.EDF	D69	1
6	3660695	3660779	4297	4381	84	RIGHT	D69a.EDF	D69	1
6	3661151	3661261	4753	4863	110	RIGHT	D69a.EDF	D69	1
6	3661985	3662251	5587	5853	266	RIGHT	D69a.EDF	D69	1
6	3662982	3663091	6584	6693	109	RIGHT	D69a.EDF	D69	1
6	3663281	3663390	6883	6992	109	RIGHT	D69a.EDF	D69	1
7	3666555	3666674	67	186	119	RIGHT	D69a.EDF	D69	1
7	3666850	3666939	362	451	89	RIGHT	D69a.EDF	D69	1
7	3667376	3667500	888	1012	124	RIGHT	D69a.EDF	D69	1
7	3667884	3668003	1396	1515	119	RIGHT	D69a.EDF	D69	1
7	3669702	3669812	3214	3324	110	RIGHT	D69a.EDF	D69	1
7	3670995	3671075	4507	4587	80	RIGHT	D69a.EDF	D69	1
7	3671919	3672011	5431	5523	92	RIGHT	D69a.EDF	D69	1
7	3672733	3672833	6245	6345	100	RIGHT	D69a.EDF	D69	1
7	3673376	3673473	6888	6985	97	RIGHT	D69a.EDF	D69	1
8	3676451	3676566	320	435	115	RIGHT	D69a.EDF	D69	1
8	3677084	3677353	953	1222	269	RIGHT	D69a.EDF	D69	1
8	3680142	3680205	4011	4074	63	RIGHT	D69a.EDF	D69	1
8	3680671	3680745	4540	4614	74	RIGHT	D69a.EDF	D69	1
8	3681373	3681429	5242	5298	56	RIGHT	D69a.EDF	D69	1
9	3684152	3684186	58	92	34	RIGHT	D69a.EDF	D69	1
9	3684395	3684513	301	419	118	RIGHT	D69a.EDF	D69	1
9	3685081	3685166	987	1072	85	RIGHT	D69a.EDF	D69	1
9	3685491	3685597	1397	1503	106	RIGHT	D69a.EDF	D69	1
9	3686680	3686772	2586	2678	92	RIGHT	D69a.EDF	D69	1
9	3688441	3688480	4347	4386	39	RIGHT	D69a.EDF	D69	1
9	3689133	3689220	5039	5126	87	RIGHT	D69a.EDF	D69	1
9	3689849	3689931	5755	5837	82	RIGHT	D69a.EDF	D69	1
9	3690197	3690306	6103	6212	109	RIGHT	D69a.EDF	D69	1
10	3692989	3693071	58	140	82	RIGHT	D69a.EDF	D69	1
10	3693288	3693378	357	447	90	RIGHT	D69a.EDF	D69	1
10	3693833	3693942	902	1011	109	RIGHT	D69a.EDF	D69	1
10	3694306	3694397	1375	1466	91	RIGHT	D69a.EDF	D69	1
10	3695321	3695431	2390	2500	110	RIGHT	D69a.EDF	D69	1
10	3696589	3696646	3658	3715	57	RIGHT	D69a.EDF	D69	1
10	3696934	3697029	4003	4098	95	RIGHT	D69a.EDF	D69	1
10	3697494	3697592	4563	4661	98	RIGHT	D69a.EDF	D69	1
11	3700556	3700667	294	405	111	RIGHT	D69a.EDF	D69	1
11	3701172	3701288	910	1026	116	RIGHT	D69a.EDF	D69	1
11	3701569	3701852	1307	1590	283	RIGHT	D69a.EDF	D69	1
11	3703612	3703705	3350	3443	93	RIGHT	D69a.EDF	D69	1
11	3704836	3704927	4574	4665	91	RIGHT	D69a.EDF	D69	1
11	3705227	3705335	4965	5073	108	RIGHT	D69a.EDF	D69	1
12	3708039	3708162	701	824	123	RIGHT	D69a.EDF	D69	1
12	3708418	3708686	1080	1348	268	RIGHT	D69a.EDF	D69	1
12	3710761	3710813	3423	3475	52	RIGHT	D69a.EDF	D69	1
12	3711229	3711314	3891	3976	85	RIGHT	D69a.EDF	D69	1
12	3711559	3711679	4221	4341	120	RIGHT	D69a.EDF	D69	1
12	3712112	3712193	4774	4855	81	RIGHT	D69a.EDF	D69	1
12	3712833	3712931	5495	5593	98	RIGHT	D69a.EDF	D69	1
13	3715026	3715132	265	371	106	RIGHT	D69a.EDF	D69	1
13	3715553	3715678	792	917	125	RIGHT	D69a.EDF	D69	1
13	3715944	3716245	1183	1484	301	RIGHT	D69a.EDF	D69	1
13	3717876	3717958	3115	3197	82	RIGHT	D69a.EDF	D69	1
13	3718248	3718334	3487	3573	86	RIGHT	D69a.EDF	D69	1
13	3719041	3719129	4280	4368	88	RIGHT	D69a.EDF	D69	1
13	3719847	3719925	5086	5164	78	RIGHT	D69a.EDF	D69	1
13	3720555	3720680	5794	5919	125	RIGHT	D69a.EDF	D69	1
14	3723523	3723783	527	787	260	RIGHT	D69a.EDF	D69	1
14	3724178	3724298	1182	1302	120	RIGHT	D69a.EDF	D69	1
14	3724548	3724651	1552	1655	103	RIGHT	D69a.EDF	D69	1
14	3726046	3726134	3050	3138	88	RIGHT	D69a.EDF	D69	1
14	3726953	3727036	3957	4040	83	RIGHT	D69a.EDF	D69	1
14	3727769	3727856	4773	4860	87	RIGHT	D69a.EDF	D69	1
14	3728187	3728299	5191	5303	112	RIGHT	D69a.EDF	D69	1
14	3728536	3728646	5540	5650	110	RIGHT	D69a.EDF	D69	1
15	3731167	3731299	136	268	132	RIGHT	D69a.EDF	D69	1
15	3731730	3731843	699	812	113	RIGHT	D69a.EDF	D69	1
15	3732020	3732179	989	1148	159	RIGHT	D69a.EDF	D69	1
15	3732680	3732766	1649	1735	86	RIGHT	D69a.EDF	D69	1
15	3734092	3734197	3061	3166	105	RIGHT	D69a.EDF	D69	1
15	3734608	3734720	3577	3689	112	RIGHT	D69a.EDF	D69	1
15	3735316	3735417	4285	4386	101	RIGHT	D69a.EDF	D69	1
15	3735588	3735876	4557	4845	288	RIGHT	D69a.EDF	D69	1
15	3736571	3736677	5540	5646	106	RIGHT	D69a.EDF	D69	1
15	3737018	3737119	5987	6088	101	RIGHT	D69a.EDF	D69	1
15	3737263	3737361	6232	6330	98	RIGHT	D69a.EDF	D69	1
16	3740008	3740091	304	387	83	RIGHT	D69a.EDF	D69	1
16	3740764	3741027	1060	1323	263	RIGHT	D69a.EDF	D69	1
16	3741601	3741686	1897	1982	85	RIGHT	D69a.EDF	D69	1
16	3741708	3741709	2004	2005	1	RIGHT	D69a.EDF	D69	1
16	3742601	3742711	2897	3007	110	RIGHT	D69a.EDF	D69	1
16	3743221	3743335	3517	3631	114	RIGHT	D69a.EDF	D69	1
16	3743715	3743833	4011	4129	118	RIGHT	D69a.EDF	D69	1
16	3744496	3744599	4792	4895	103	RIGHT	D69a.EDF	D69	1
16	3745038	3745163	5334	5459	125	RIGHT	D69a.EDF	D69	1
16	3745586	3745697	5882	5993	111	RIGHT	D69a.EDF	D69	1
17	3748448	3748555	484	591	107	RIGHT	D69a.EDF	D69	1
17	3748827	3748929	863	965	102	RIGHT	D69a.EDF	D69	1
17	3749133	3749292	1169	1328	159	RIGHT	D69a.EDF	D69	1
17	3749674	3749798	1710	1834	124	RIGHT	D69a.EDF	D69	1
17	3750643	3750759	2679	2795	116	RIGHT	D69a.EDF	D69	1
17	3751304	3751406	3340	3442	102	RIGHT	D69a.EDF	D69	1
17	3752134	3752237	4170	4273	103	RIGHT	D69a.EDF	D69	1
17	3752687	3752795	4723	4831	108	RIGHT	D69a.EDF	D69	1
17	3753230	3753344	5266	5380	114	RIGHT	D69a.EDF	D69	1
18	3756299	3756436	191	328	137	RIGHT	D69a.EDF	D69	1
18	3756830	3757126	722	1018	296	RIGHT	D69a.EDF	D69	1
18	3757582	3757738	1474	1630	156	RIGHT	D69a.EDF	D69	1
18	3758673	3758693	2565	2585	20	RIGHT	D69a.EDF	D69	1
18	3758749	3758757	2641	2649	8	RIGHT	D69a.EDF	D69	1
18	3758791	3758888	2683	2780	97	RIGHT	D69a.EDF	D69	1
18	3759732	3759831	3624	3723	99	RIGHT	D69a.EDF	D69	1
18	3760035	3760142	3927	4034	107	RIGHT	D69a.EDF	D69	1
18	3760716	3760826	4608	4718	110	RIGHT	D69a.EDF	D69	1
18	3761012	3761125	4904	5017	113	RIGHT	D69a.EDF	D69	1
18	3761362	3761464	5254	5356	102	RIGHT	D69a.EDF	D69	1
18	3761654	3761748	5546	5640	94	RIGHT	D69a.EDF	D69	1
18	3761898	3762031	5790	5923	133	RIGHT	D69a.EDF	D69	1
19	3764836	3764940	561	665	104	RIGHT	D69a.EDF	D69	1
19	3765092	3765345	817	1070	253	RIGHT	D69a.EDF	D69	1
19	3765726	3765844	1451	1569	118	RIGHT	D69a.EDF	D69	1
19	3766459	3766571	2184	2296	112	RIGHT	D69a.EDF	D69	1
19	3767307	3767434	3032	3159	127	RIGHT	D69a.EDF	D69	1
19	3768495	3768590	4220	4315	95	RIGHT	D69a.EDF	D69	1
19	3769550	3769647	5275	5372	97	RIGHT	D69a.EDF	D69	1
19	3770569	3770660	6294	6385	91	RIGHT	D69a.EDF	D69	1
20	3773927	3774216	438	727	289	RIGHT	D69a.EDF	D69	1
20	3774767	3774896	1278	1407	129	RIGHT	D69a.EDF	D69	1
20	3776502	3776620	3013	3131	118	RIGHT	D69a.EDF	D69	1
20	3777060	3777183	3571	3694	123	RIGHT	D69a.EDF	D69	1
20	3777806	3777924	4317	4435	118	RIGHT	D69a.EDF	D69	1
20	3778288	3778414	4799	4925	126	RIGHT	D69a.EDF	D69	1
20	3779000	3779120	5511	5631	120	RIGHT	D69a.EDF	D69	1
21	3783295	3783407	261	373	112	RIGHT	D69a.EDF	D69	1
21	3783994	3788566	960	5532	4572	RIGHT	D69a.EDF	D69	1
22	3798998	3799310	615	927	312	RIGHT	D69a.EDF	D69	1
22	3799648	3799891	1265	1508	243	RIGHT	D69a.EDF	D69	1
22	3801006	3801102	2623	2719	96	RIGHT	D69a.EDF	D69	1
22	3801670	3801770	3287	3387	100	RIGHT	D69a.EDF	D69	1
22	3801905	3802008	3522	3625	103	RIGHT	D69a.EDF	D69	1
22	3802617	3802717	4234	4334	100	RIGHT	D69a.EDF	D69	1
22	3802816	3802915	4433	4532	99	RIGHT	D69a.EDF	D69	1
22	3803036	3803128	4653	4745	92	RIGHT	D69a.EDF	D69	1
22	3803752	3803826	5369	5443	74	RIGHT	D69a.EDF	D69	1
23	3806823	3806918	58	153	95	RIGHT	D69a.EDF	D69	1
23	3807139	3807189	374	424	50	RIGHT	D69a.EDF	D69	1
23	3807584	3807855	819	1090	271	RIGHT	D69a.EDF	D69	1
23	3808282	3808399	1517	1634	117	RIGHT	D69a.EDF	D69	1
23	3809332	3809450	2567	2685	118	RIGHT	D69a.EDF	D69	1
23	3810031	3810124	3266	3359	93	RIGHT	D69a.EDF	D69	1
23	3810579	3810814	3814	4049	235	RIGHT	D69a.EDF	D69	1
23	3811515	3811635	4750	4870	120	RIGHT	D69a.EDF	D69	1
24	3814413	3814662	729	978	249	RIGHT	D69a.EDF	D69	1
24	3816265	3816369	2581	2685	104	RIGHT	D69a.EDF	D69	1
24	3816904	3817022	3220	3338	118	RIGHT	D69a.EDF	D69	1
24	3817296	3817396	3612	3712	100	RIGHT	D69a.EDF	D69	1
24	3817529	3817785	3845	4101	256	RIGHT	D69a.EDF	D69	1
24	3818231	3818475	4547	4791	244	RIGHT	D69a.EDF	D69	1
24	3818851	3819016	5167	5332	165	RIGHT	D69a.EDF	D69	1
24	3819045	3819184	5361	5500	139	RIGHT	D69a.EDF	D69	1
25	3821909	3822011	131	233	102	RIGHT	D69a.EDF	D69	1
25	3822214	3822491	436	713	277	RIGHT	D69a.EDF	D69	1
25	3822930	3823044	1152	1266	114	RIGHT	D69a.EDF	D69	1
25	3823378	3823510	1600	1732	132	RIGHT	D69a.EDF	D69	1
25	3825576	3825678	3798	3900	102	RIGHT	D69a.EDF	D69	1
25	3826466	3826573	4688	4795	107	RIGHT	D69a.EDF	D69	1
25	3827043	3827161	5265	5383	118	RIGHT	D69a.EDF	D69	1
25	3828005	3828012	6227	6234	7	RIGHT	D69a.EDF	D69	1
26	3830282	3830373	487	578	91	RIGHT	D69a.EDF	D69	1
26	3830674	3830795	879	1000	121	RIGHT	D69a.EDF	D69	1
26	3832065	3832155	2270	2360	90	RIGHT	D69a.EDF	D69	1
26	3832910	3833005	3115	3210	95	RIGHT	D69a.EDF	D69	1
26	3833770	3833880	3975	4085	110	RIGHT	D69a.EDF	D69	1
26	3834430	3834527	4635	4732	97	RIGHT	D69a.EDF	D69	1
26	3835163	3835262	5368	5467	99	RIGHT	D69a.EDF	D69	1
26	3835912	3836008	6117	6213	96	RIGHT	D69a.EDF	D69	1
26	3836500	3836604	6705	6809	104	RIGHT	D69a.EDF	D69	1
27	3839404	3839509	345	450	105	RIGHT	D69a.EDF	D69	1
27	3839868	3840024	809	965	156	RIGHT	D69a.EDF	D69	1
27	3840517	3840645	1458	1586	128	RIGHT	D69a.EDF	D69	1
27	3842184	3842279	3125	3220	95	RIGHT	D69a.EDF	D69	1
27	3842769	3842854	3710	3795	85	RIGHT	D69a.EDF	D69	1
27	3843428	3843525	4369	4466	97	RIGHT	D69a.EDF	D69	1
27	3844107	3844229	5048	5170	122	RIGHT	D69a.EDF	D69	1
27	3844794	3844871	5735	5812	77	RIGHT	D69a.EDF	D69	1
28	3847259	3847374	148	263	115	RIGHT	D69a.EDF	D69	1
28	3847751	3847875	640	764	124	RIGHT	D69a.EDF	D69	1
28	3848146	3848278	1035	1167	132	RIGHT	D69a.EDF	D69	1
28	3848649	3848770	1538	1659	121	RIGHT	D69a.EDF	D69	1
28	3850441	3850563	3330	3452	122	RIGHT	D69a.EDF	D69	1
28	3851213	3851321	4102	4210	108	RIGHT	D69a.EDF	D69	1
28	3851907	3852013	4796	4902	106	RIGHT	D69a.EDF	D69	1
28	3852983	3853075	5872	5964	92	RIGHT	D69a.EDF	D69	1
29	3855735	3855847	75	187	112	RIGHT	D69a.EDF	D69	1
29	3856272	3856391	612	731	119	RIGHT	D69a.EDF	D69	1
29	3856629	3856742	969	1082	113	RIGHT	D69a.EDF	D69	1
29	3857084	3857205	1424	1545	121	RIGHT	D69a.EDF	D69	1
29	3858531	3858630	2871	2970	99	RIGHT	D69a.EDF	D69	1
29	3860304	3860411	4644	4751	107	RIGHT	D69a.EDF	D69	1
30	3862502	3862533	58	89	31	RIGHT	D69a.EDF	D69	1
30	3863322	3863587	878	1143	265	RIGHT	D69a.EDF	D69	1
30	3865022	3865114	2578	2670	92	RIGHT	D69a.EDF	D69	1
30	3865588	3865696	3144	3252	108	RIGHT	D69a.EDF	D69	1
30	3866054	3866163	3610	3719	109	RIGHT	D69a.EDF	D69	1
30	3866586	3866695	4142	4251	109	RIGHT	D69a.EDF	D69	1
30	3867194	3867326	4750	4882	132	RIGHT	D69a.EDF	D69	1
30	3867834	3867936	5390	5492	102	RIGHT	D69a.EDF	D69	1
30	3868507	3868600	6063	6156	93	RIGHT	D69a.EDF	D69	1
31	3871122	3871192	58	128	70	RIGHT	D69a.EDF	D69	1
31	3871852	3871964	788	900	112	RIGHT	D69a.EDF	D69	1
31	3872194	3872491	1130	1427	297	RIGHT	D69a.EDF	D69	1
31	3873627	3873893	2563	2829	266	RIGHT	D69a.EDF	D69	1
31	3875822	3875919	4758	4855	97	RIGHT	D69a.EDF	D69	1
31	3876650	3876750	5586	5686	100	RIGHT	D69a.EDF	D69	1
31	3877129	3877252	6065	6188	123	RIGHT	D69a.EDF	D69	1
32	3879369	3879475	139	245	106	RIGHT	D69a.EDF	D69	1
32	3879651	3879753	421	523	102	RIGHT	D69a.EDF	D69	1
32	3880283	3880397	1053	1167	114	RIGHT	D69a.EDF	D69	1
32	3881704	3881817	2474	2587	113	RIGHT	D69a.EDF	D69	1
32	3882589	3882722	3359	3492	133	RIGHT	D69a.EDF	D69	1
32	3884096	3884165	4866	4935	69	RIGHT	D69a.EDF	D69	1
33	3887025	3887278	727	980	253	RIGHT	D69a.EDF	D69	1
33	3888625	3888721	2327	2423	96	RIGHT	D69a.EDF	D69	1
33	3889286	3889392	2988	3094	106	RIGHT	D69a.EDF	D69	1
33	3890157	3890258	3859	3960	101	RIGHT	D69a.EDF	D69	1
33	3890910	3891014	4612	4716	104	RIGHT	D69a.EDF	D69	1
33	3891551	3891590	5253	5292	39	RIGHT	D69a.EDF	D69	1
34	3895149	3895259	275	385	110	RIGHT	D69a.EDF	D69	1
34	3896087	3896313	1213	1439	226	RIGHT	D69a.EDF	D69	1
34	3897231	3897382	2357	2508	151	RIGHT	D69a.EDF	D69	1
34	3898269	3898357	3395	3483	88	RIGHT	D69a.EDF	D69	1
34	3898979	3899085	4105	4211	106	RIGHT	D69a.EDF	D69	1
34	3899411	3899539	4537	4665	128	RIGHT	D69a.EDF	D69	1
34	3900409	3900540	5535	5666	131	RIGHT	D69a.EDF	D69	1
35	3903381	3903469	276	364	88	RIGHT	D69a.EDF	D69	1
35	3903832	3903932	727	827	100	RIGHT	D69a.EDF	D69	1
35	3904153	3904298	1048	1193	145	RIGHT	D69a.EDF	D69	1
35	3904714	3904828	1609	1723	114	RIGHT	D69a.EDF	D69	1
35	3905673	3905972	2568	2867	299	RIGHT	D69a.EDF	D69	1
35	3906912	3907188	3807	4083	276	RIGHT	D69a.EDF	D69	1
35	3907766	3907883	4661	4778	117	RIGHT	D69a.EDF	D69	1
35	3908364	3908501	5259	5396	137	RIGHT	D69a.EDF	D69	1
35	3909085	3909218	5980	6113	133	RIGHT	D69a.EDF	D69	1
36	3911913	3912177	680	944	264	RIGHT	D69a.EDF	D69	1
36	3912734	3912889	1501	1656	155	RIGHT	D69a.EDF	D69	1
36	3913412	3913430	2179	2197	18	RIGHT	D69a.EDF	D69	1
36	3914017	3914133	2784	2900	116	RIGHT	D69a.EDF	D69	1
36	3914779	3914881	3546	3648	102	RIGHT	D69a.EDF	D69	1
36	3915319	3915434	4086	4201	115	RIGHT	D69a.EDF	D69	1
36	3915723	3915844	4490	4611	121	RIGHT	D69a.EDF	D69	1
37	3918355	3918471	528	644	116	RIGHT	D69a.EDF	D69	1
37	3918629	3918895	802	1068	266	RIGHT	D69a.EDF	D69	1
37	3919368	3919629	1541	1802	261	RIGHT	D69a.EDF	D69	1
37	3920872	3920975	3045	3148	103	RIGHT	D69a.EDF	D69	1
37	3921586	3921670	3759	3843	84	RIGHT	D69a.EDF	D69	1
37	3921863	3921965	4036	4138	102	RIGHT	D69a.EDF	D69	1
37	3922136	3922250	4309	4423	114	RIGHT	D69a.EDF	D69	1
37	3922977	3923074	5150	5247	97	RIGHT	D69a.EDF	D69	1
38	3925433	3925539	281	387	106	RIGHT	D69a.EDF	D69	1
38	3926009	3926130	857	978	121	RIGHT	D69a.EDF	D69	1
38	3926429	3926551	1277	1399	122	RIGHT	D69a.EDF	D69	1
38	3927659	3927765	2507	2613	106	RIGHT	D69a.EDF	D69	1
38	3928388	3928515	3236	3363	127	RIGHT	D69a.EDF	D69	1
38	3929155	3929262	4003	4110	107	RIGHT	D69a.EDF	D69	1
38	3929787	3929887	4635	4735	100	RIGHT	D69a.EDF	D69	1
39	3933880	3934010	135	265	130	RIGHT	D69a.EDF	D69	1
39	3934455	3934562	710	817	107	RIGHT	D69a.EDF	D69	1
39	3935935	3936034	2190	2289	99	RIGHT	D69a.EDF	D69	1
39	3936582	3936689	2837	2944	107	RIGHT	D69a.EDF	D69	1
39	3937251	3937366	3506	3621	115	RIGHT	D69a.EDF	D69	1
39	3938039	3938141	4294	4396	102	RIGHT	D69a.EDF	D69	1
39	3939018	3939085	5273	5340	67	RIGHT	D69a.EDF	D69	1
39	3939959	3940019	6214	6274	60	RIGHT	D69a.EDF	D69	1
39	3940324	3940423	6579	6678	99	RIGHT	D69a.EDF	D69	1
40	3942518	3942598	58	138	80	RIGHT	D69a.EDF	D69	1
40	3943289	3943568	829	1108	279	RIGHT	D69a.EDF	D69	1
40	3943984	3944073	1524	1613	89	RIGHT	D69a.EDF	D69	1
40	3945275	3945419	2815	2959	144	RIGHT	D69a.EDF	D69	1
40	3946388	3946492	3928	4032	104	RIGHT	D69a.EDF	D69	1
40	3946983	3947078	4523	4618	95	RIGHT	D69a.EDF	D69	1
40	3947800	3947895	5340	5435	95	RIGHT	D69a.EDF	D69	1
40	3948304	3948414	5844	5954	110	RIGHT	D69a.EDF	D69	1
40	3948646	3948767	6186	6307	121	RIGHT	D69a.EDF	D69	1
40	3949202	3949335	6742	6875	133	RIGHT	D69a.EDF	D69	1
41	3951371	3951504	144	277	133	RIGHT	D69a.EDF	D69	1
41	3951909	3952090	682	863	181	RIGHT	D69a.EDF	D69	1
41	3952113	3952120	886	893	7	RIGHT	D69a.EDF	D69	1
41	3952801	3952934	1574	1707	133	RIGHT	D69a.EDF	D69	1
41	3953767	3953875	2540	2648	108	RIGHT	D69a.EDF	D69	1
41	3954623	3954729	3396	3502	106	RIGHT	D69a.EDF	D69	1
41	3955676	3955775	4449	4548	99	RIGHT	D69a.EDF	D69	1
41	3956230	3956357	5003	5130	127	RIGHT	D69a.EDF	D69	1
41	3956990	3957102	5763	5875	112	RIGHT	D69a.EDF	D69	1
41	3957509	3957618	6282	6391	109	RIGHT	D69a.EDF	D69	1
41	3958069	3958215	6842	6988	146	RIGHT	D69a.EDF	D69	1
42	3961115	3961364	925	1174	249	RIGHT	D69a.EDF	D69	1
42	3962566	3962695	2376	2505	129	RIGHT	D69a.EDF	D69	1
42	3963534	3963672	3344	3482	138	RIGHT	D69a.EDF	D69	1
42	3963862	3963964	3672	3774	102	RIGHT	D69a.EDF	D69	1
42	3963987	3963993	3797	3803	6	RIGHT	D69a.EDF	D69	1
42	3964798	3964885	4608	4695	87	RIGHT	D69a.EDF	D69	1
42	3965383	3965497	5193	5307	114	RIGHT	D69a.EDF	D69	1
43	3968114	3968227	637	750	113	RIGHT	D69a.EDF	D69	1
43	3968499	3968770	1022	1293	271	RIGHT	D69a.EDF	D69	1
43	3970120	3970205	2643	2728	85	RIGHT	D69a.EDF	D69	1
43	3970791	3970901	3314	3424	110	RIGHT	D69a.EDF	D69	1
43	3971064	3971193	3587	3716	129	RIGHT	D69a.EDF	D69	1
43	3971931	3972152	4454	4675	221	RIGHT	D69a.EDF	D69	1
43	3972651	3972900	5174	5423	249	RIGHT	D69a.EDF	D69	1
43	3973329	3973599	5852	6122	270	RIGHT	D69a.EDF	D69	1
44	3975897	3975995	133	231	98	RIGHT	D69a.EDF	D69	1
44	3976614	3976858	850	1094	244	RIGHT	D69a.EDF	D69	1
44	3978660	3978782	2896	3018	122	RIGHT	D69a.EDF	D69	1
44	3979272	3979395	3508	3631	123	RIGHT	D69a.EDF	D69	1
44	3979678	3979927	3914	4163	249	RIGHT	D69a.EDF	D69	1
44	3980784	3981034	5020	5270	250	RIGHT	D69a.EDF	D69	1
45	3983643	3983771	68	196	128	RIGHT	D69a.EDF	D69	1
45	3984314	3984467	739	892	153	RIGHT	D69a.EDF	D69	1
45	3984659	3984786	1084	1211	127	RIGHT	D69a.EDF	D69	1
45	3986571	3986684	2996	3109	113	RIGHT	D69a.EDF	D69	1
45	3987622	3987713	4047	4138	91	RIGHT	D69a.EDF	D69	1
45	3988278	3988381	4703	4806	103	RIGHT	D69a.EDF	D69	1
45	3989132	3989243	5557	5668	111	RIGHT	D69a.EDF	D69	1
45	3989861	3989948	6286	6373	87	RIGHT	D69a.EDF	D69	1
46	3993261	3993523	647	909	262	RIGHT	D69a.EDF	D69	1
46	3994061	3994180	1447	1566	119	RIGHT	D69a.EDF	D69	1
46	3995091	3995229	2477	2615	138	RIGHT	D69a.EDF	D69	1
46	3996335	3996449	3721	3835	114	RIGHT	D69a.EDF	D69	1
46	3997142	3997231	4528	4617	89	RIGHT	D69a.EDF	D69	1
46	3997686	3997789	5072	5175	103	RIGHT	D69a.EDF	D69	1
46	3998331	3998449	5717	5835	118	RIGHT	D69a.EDF	D69	1
46	3998835	3998962	6221	6348	127	RIGHT	D69a.EDF	D69	1
47	4001811	4002013	624	826	202	RIGHT	D69a.EDF	D69	1
47	4002440	4002566	1253	1379	126	RIGHT	D69a.EDF	D69	1
47	4004419	4004497	3232	3310	78	RIGHT	D69a.EDF	D69	1
47	4005626	4005717	4439	4530	91	RIGHT	D69a.EDF	D69	1
47	4006472	4006549	5285	5362	77	RIGHT	D69a.EDF	D69	1
47	4007824	4007904	6637	6717	80	RIGHT	D69a.EDF	D69	1
48	4010912	4011021	667	776	109	RIGHT	D69a.EDF	D69	1
48	4011210	4011349	965	1104	139	RIGHT	D69a.EDF	D69	1
48	4011553	4011643	1308	1398	90	RIGHT	D69a.EDF	D69	1
48	4012505	4012623	2260	2378	118	RIGHT	D69a.EDF	D69	1
48	4013175	4013276	2930	3031	101	RIGHT	D69a.EDF	D69	1
48	4013535	4013654	3290	3409	119	RIGHT	D69a.EDF	D69	1
48	4014121	4014181	3876	3936	60	RIGHT	D69a.EDF	D69	1
48	4014235	4014396	3990	4151	161	RIGHT	D69a.EDF	D69	1
48	4014915	4015048	4670	4803	133	RIGHT	D69a.EDF	D69	1
48	4015284	4015399	5039	5154	115	RIGHT	D69a.EDF	D69	1
49	4017875	4018009	97	231	134	RIGHT	D69a.EDF	D69	1
49	4018549	4018677	771	899	128	RIGHT	D69a.EDF	D69	1
49	4019165	4019273	1387	1495	108	RIGHT	D69a.EDF	D69	1
49	4019294	4019297	1516	1519	3	RIGHT	D69a.EDF	D69	1
49	4020941	4021068	3163	3290	127	RIGHT	D69a.EDF	D69	1
49	4021942	4022057	4164	4279	115	RIGHT	D69a.EDF	D69	1
49	4023083	4023191	5305	5413	108	RIGHT	D69a.EDF	D69	1
49	4023919	4024033	6141	6255	114	RIGHT	D69a.EDF	D69	1
50	4027694	4027809	1019	1134	115	RIGHT	D69a.EDF	D69	1
50	4028540	4028603	1865	1928	63	RIGHT	D69a.EDF	D69	1
50	4028628	4028745	1953	2070	117	RIGHT	D69a.EDF	D69	1
50	4029596	4029704	2921	3029	108	RIGHT	D69a.EDF	D69	1
50	4030406	4030520	3731	3845	114	RIGHT	D69a.EDF	D69	1
50	4030873	4031001	4198	4326	128	RIGHT	D69a.EDF	D69	1
50	4031247	4031371	4572	4696	124	RIGHT	D69a.EDF	D69	1
50	4031655	4031774	4980	5099	119	RIGHT	D69a.EDF	D69	1
50	4032076	4032198	5401	5523	122	RIGHT	D69a.EDF	D69	1
50	4032734	4032879	6059	6204	145	RIGHT	D69a.EDF	D69	1
50	4033428	4033517	6753	6842	89	RIGHT	D69a.EDF	D69	1
51	4036691	4036820	170	299	129	RIGHT	D69a.EDF	D69	1
51	4037323	4037458	802	937	135	RIGHT	D69a.EDF	D69	1
51	4038008	4038126	1487	1605	118	RIGHT	D69a.EDF	D69	1
51	4039338	4039440	2817	2919	102	RIGHT	D69a.EDF	D69	1
51	4039857	4039962	3336	3441	105	RIGHT	D69a.EDF	D69	1
51	4040374	4040478	3853	3957	104	RIGHT	D69a.EDF	D69	1
51	4040831	4040905	4310	4384	74	RIGHT	D69a.EDF	D69	1
51	4041140	4041236	4619	4715	96	RIGHT	D69a.EDF	D69	1
52	4043805	4043889	363	447	84	RIGHT	D69a.EDF	D69	1
52	4044368	4044493	926	1051	125	RIGHT	D69a.EDF	D69	1
52	4045722	4045823	2280	2381	101	RIGHT	D69a.EDF	D69	1
52	4046456	4046560	3014	3118	104	RIGHT	D69a.EDF	D69	1
52	4047088	4047184	3646	3742	96	RIGHT	D69a.EDF	D69	1
52	4047706	4047816	4264	4374	110	RIGHT	D69a.EDF	D69	1
52	4048394	4048511	4952	5069	117	RIGHT	D69a.EDF	D69	1
52	4048951	4049059	5509	5617	108	RIGHT	D69a.EDF	D69	1
53	4052160	4052417	652	909	257	RIGHT	D69a.EDF	D69	1
53	4054063	4054166	2555	2658	103	RIGHT	D69a.EDF	D69	1
53	4055537	4055635	4029	4127	98	RIGHT	D69a.EDF	D69	1
53	4056425	4056515	4917	5007	90	RIGHT	D69a.EDF	D69	1
53	4057496	4057563	5988	6055	67	RIGHT	D69a.EDF	D69	1
54	4060008	4060148	163	303	140	RIGHT	D69a.EDF	D69	1
54	4060767	4060859	922	1014	92	RIGHT	D69a.EDF	D69	1
54	4061310	4061417	1465	1572	107	RIGHT	D69a.EDF	D69	1
54	4062336	4062431	2491	2586	95	RIGHT	D69a.EDF	D69	1
54	4063848	4063943	4003	4098	95	RIGHT	D69a.EDF	D69	1
54	4064448	4064557	4603	4712	109	RIGHT	D69a.EDF	D69	1
54	4065338	4065438	5493	5593	100	RIGHT	D69a.EDF	D69	1
54	4066011	4066131	6166	6286	120	RIGHT	D69a.EDF	D69	1
55	4068815	4068935	186	306	120	RIGHT	D69a.EDF	D69	1
55	4069291	4069402	662	773	111	RIGHT	D69a.EDF	D69	1
55	4069568	4069693	939	1064	125	RIGHT	D69a.EDF	D69	1
55	4069741	4069887	1112	1258	146	RIGHT	D69a.EDF	D69	1
55	4070229	4070350	1600	1721	121	RIGHT	D69a.EDF	D69	1
55	4071573	4071655	2944	3026	82	RIGHT	D69a.EDF	D69	1
55	4072186	4072295	3557	3666	109	RIGHT	D69a.EDF	D69	1
55	4073230	4073346	4601	4717	116	RIGHT	D69a.EDF	D69	1
55	4074113	4074210	5484	5581	97	RIGHT	D69a.EDF	D69	1
55	4074606	4074716	5977	6087	110	RIGHT	D69a.EDF	D69	1
55	4074963	4075058	6334	6429	95	RIGHT	D69a.EDF	D69	1
56	4077388	4077493	96	201	105	RIGHT	D69a.EDF	D69	1
56	4077678	4077761	386	469	83	RIGHT	D69a.EDF	D69	1
56	4077926	4078046	634	754	120	RIGHT	D69a.EDF	D69	1
56	4078340	4078455	1048	1163	115	RIGHT	D69a.EDF	D69	1
56	4078859	4078996	1567	1704	137	RIGHT	D69a.EDF	D69	1
56	4079021	4079032	1729	1740	11	RIGHT	D69a.EDF	D69	1
56	4080399	4080485	3107	3193	86	RIGHT	D69a.EDF	D69	1
56	4081526	4081586	4234	4294	60	RIGHT	D69a.EDF	D69	1
56	4082357	4082430	5065	5138	73	RIGHT	D69a.EDF	D69	1
56	4082936	4083030	5644	5738	94	RIGHT	D69a.EDF	D69	1
56	4083052	4083055	5760	5763	3	RIGHT	D69a.EDF	D69	1
56	4083227	4083344	5935	6052	117	RIGHT	D69a.EDF	D69	1
57	4086752	4087030	761	1039	278	RIGHT	D69a.EDF	D69	1
57	4087645	4087756	1654	1765	111	RIGHT	D69a.EDF	D69	1
57	4089141	4089239	3150	3248	98	RIGHT	D69a.EDF	D69	1
57	4089446	4089552	3455	3561	106	RIGHT	D69a.EDF	D69	1
57	4090295	4090386	4304	4395	91	RIGHT	D69a.EDF	D69	1
58	4093855	4094065	751	961	210	RIGHT	D69a.EDF	D69	1
58	4095521	4095785	2417	2681	264	RIGHT	D69a.EDF	D69	1
58	4096641	4096756	3537	3652	115	RIGHT	D69a.EDF	D69	1
58	4097164	4097294	4060	4190	130	RIGHT	D69a.EDF	D69	1
58	4097446	4097584	4342	4480	138	RIGHT	D69a.EDF	D69	1
58	4097974	4098103	4870	4999	129	RIGHT	D69a.EDF	D69	1
58	4098488	4098628	5384	5524	140	RIGHT	D69a.EDF	D69	1
58	4098784	4098929	5680	5825	145	RIGHT	D69a.EDF	D69	1
59	4101618	4101720	390	492	102	RIGHT	D69a.EDF	D69	1
59	4101953	4101974	725	746	21	RIGHT	D69a.EDF	D69	1
59	4102033	4102222	805	994	189	RIGHT	D69a.EDF	D69	1
59	4102741	4102835	1513	1607	94	RIGHT	D69a.EDF	D69	1
59	4102859	4102861	1631	1633	2	RIGHT	D69a.EDF	D69	1
59	4103975	4104066	2747	2838	91	RIGHT	D69a.EDF	D69	1
59	4104848	4104954	3620	3726	106	RIGHT	D69a.EDF	D69	1
59	4105546	4105636	4318	4408	90	RIGHT	D69a.EDF	D69	1
59	4106020	4106138	4792	4910	118	RIGHT	D69a.EDF	D69	1
60	4109293	4109404	202	313	111	RIGHT	D69a.EDF	D69	1
60	4109805	4109933	714	842	128	RIGHT	D69a.EDF	D69	1
60	4110286	4110361	1195	1270	75	RIGHT	D69a.EDF	D69	1
60	4110385	4110386	1294	1295	1	RIGHT	D69a.EDF	D69	1
60	4111490	4111614	2399	2523	124	RIGHT	D69a.EDF	D69	1
60	4112623	4112719	3532	3628	96	RIGHT	D69a.EDF	D69	1
60	4113380	4113457	4289	4366	77	RIGHT	D69a.EDF	D69	1
60	4113480	4113484	4389	4393	4	RIGHT	D69a.EDF	D69	1
60	4113725	4113848	4634	4757	123	RIGHT	D69a.EDF	D69	1
60	4114459	4114588	5368	5497	129	RIGHT	D69a.EDF	D69	1
60	4114735	4114869	5644	5778	134	RIGHT	D69a.EDF	D69	1
60	4115196	4115288	6105	6197	92	RIGHT	D69a.EDF	D69	1
60	4115310	4115316	6219	6225	6	RIGHT	D69a.EDF	D69	1
61	4117840	4117972	601	733	132	RIGHT	D69a.EDF	D69	1
61	4118184	4118371	945	1132	187	RIGHT	D69a.EDF	D69	1
61	4119806	4119913	2567	2674	107	RIGHT	D69a.EDF	D69	1
61	4120501	4120601	3262	3362	100	RIGHT	D69a.EDF	D69	1
61	4121349	4121450	4110	4211	101	RIGHT	D69a.EDF	D69	1
61	4121973	4122097	4734	4858	124	RIGHT	D69a.EDF	D69	1
62	4125536	4125655	94	213	119	RIGHT	D69a.EDF	D69	1
62	4126108	4126234	666	792	126	RIGHT	D69a.EDF	D69	1
62	4126743	4126862	1301	1420	119	RIGHT	D69a.EDF	D69	1
62	4127047	4127163	1605	1721	116	RIGHT	D69a.EDF	D69	1
62	4127927	4128043	2485	2601	116	RIGHT	D69a.EDF	D69	1
62	4128747	4128876	3305	3434	129	RIGHT	D69a.EDF	D69	1
62	4129453	4129551	4011	4109	98	RIGHT	D69a.EDF	D69	1
62	4129574	4129574	4132	4132	0	RIGHT	D69a.EDF	D69	1
62	4130270	4130351	4828	4909	81	RIGHT	D69a.EDF	D69	1
62	4130374	4130375	4932	4933	1	RIGHT	D69a.EDF	D69	1
63	4132861	4132990	142	271	129	RIGHT	D69a.EDF	D69	1
63	4133520	4133634	801	915	114	RIGHT	D69a.EDF	D69	1
63	4134128	4134273	1409	1554	145	RIGHT	D69a.EDF	D69	1
63	4135101	4135221	2382	2502	120	RIGHT	D69a.EDF	D69	1
63	4135699	4135998	2980	3279	299	RIGHT	D69a.EDF	D69	1
63	4136522	4136637	3803	3918	115	RIGHT	D69a.EDF	D69	1
63	4136674	4136679	3955	3960	5	RIGHT	D69a.EDF	D69	1
63	4136807	4136919	4088	4200	112	RIGHT	D69a.EDF	D69	1
63	4137674	4137795	4955	5076	121	RIGHT	D69a.EDF	D69	1
63	4137820	4137979	5101	5260	159	RIGHT	D69a.EDF	D69	1
63	4138007	4138015	5288	5296	8	RIGHT	D69a.EDF	D69	1
63	4138845	4138959	6126	6240	114	RIGHT	D69a.EDF	D69	1
63	4139453	4139534	6734	6815	81	RIGHT	D69a.EDF	D69	1
63	4139557	4139566	6838	6847	9	RIGHT	D69a.EDF	D69	1
63	4139874	4139967	7155	7248	93	RIGHT	D69a.EDF	D69	1
63	4139990	4139993	7271	7274	3	RIGHT	D69a.EDF	D69	1
64	4142413	4142514	260	361	101	RIGHT	D69a.EDF	D69	1
64	4142881	4143017	728	864	136	RIGHT	D69a.EDF	D69	1
64	4143383	4143535	1230	1382	152	RIGHT	D69a.EDF	D69	1
64	4145134	4145255	2981	3102	121	RIGHT	D69a.EDF	D69	1
64	4146088	4146198	3935	4045	110	RIGHT	D69a.EDF	D69	1
64	4147166	4147275	5013	5122	109	RIGHT	D69a.EDF	D69	1
65	4149655	4149756	355	456	101	RIGHT	D69a.EDF	D69	1
65	4150302	4150571	1002	1271	269	RIGHT	D69a.EDF	D69	1
65	4152070	4152204	2770	2904	134	RIGHT	D69a.EDF	D69	1
65	4153100	4153178	3800	3878	78	RIGHT	D69a.EDF	D69	1
65	4153722	4153802	4422	4502	80	RIGHT	D69a.EDF	D69	1
65	4154495	4154598	5195	5298	103	RIGHT	D69a.EDF	D69	1
65	4154916	4155038	5616	5738	122	RIGHT	D69a.EDF	D69	1
65	4155402	4155519	6102	6219	117	RIGHT	D69a.EDF	D69	1
66	4158647	4158758	1052	1163	111	RIGHT	D69a.EDF	D69	1
66	4158779	4158781	1184	1186	2	RIGHT	D69a.EDF	D69	1
66	4159533	4159614	1938	2019	81	RIGHT	D69a.EDF	D69	1
66	4159647	4159647	2052	2052	0	RIGHT	D69a.EDF	D69	1
66	4160474	4160580	2879	2985	106	RIGHT	D69a.EDF	D69	1
66	4161228	4161303	3633	3708	75	RIGHT	D69a.EDF	D69	1
66	4161344	4161525	3749	3930	181	RIGHT	D69a.EDF	D69	1
66	4162277	4162325	4682	4730	48	RIGHT	D69a.EDF	D69	1
66	4162348	4162354	4753	4759	6	RIGHT	D69a.EDF	D69	1
66	4162500	4162611	4905	5016	111	RIGHT	D69a.EDF	D69	1
66	4163535	4163650	5940	6055	115	RIGHT	D69a.EDF	D69	1
66	4164210	4164324	6615	6729	114	RIGHT	D69a.EDF	D69	1
67	4166979	4167094	269	384	115	RIGHT	D69a.EDF	D69	1
67	4167678	4167798	968	1088	120	RIGHT	D69a.EDF	D69	1
67	4169025	4169151	2315	2441	126	RIGHT	D69a.EDF	D69	1
67	4169745	4169846	3035	3136	101	RIGHT	D69a.EDF	D69	1
67	4170428	4170549	3718	3839	121	RIGHT	D69a.EDF	D69	1
67	4170960	4171068	4250	4358	108	RIGHT	D69a.EDF	D69	1
67	4171660	4171769	4950	5059	109	RIGHT	D69a.EDF	D69	1
67	4172272	4172404	5562	5694	132	RIGHT	D69a.EDF	D69	1
68	4175159	4175259	694	794	100	RIGHT	D69a.EDF	D69	1
68	4175433	4175705	968	1240	272	RIGHT	D69a.EDF	D69	1
68	4177062	4177167	2597	2702	105	RIGHT	D69a.EDF	D69	1
68	4178121	4178231	3656	3766	110	RIGHT	D69a.EDF	D69	1
68	4178858	4178979	4393	4514	121	RIGHT	D69a.EDF	D69	1
68	4179881	4179985	5416	5520	104	RIGHT	D69a.EDF	D69	1
68	4180511	4180619	6046	6154	108	RIGHT	D69a.EDF	D69	1
68	4180928	4181047	6463	6582	119	RIGHT	D69a.EDF	D69	1
69	4184022	4184137	373	488	115	RIGHT	D69a.EDF	D69	1
69	4184619	4184756	970	1107	137	RIGHT	D69a.EDF	D69	1
69	4185058	4185190	1409	1541	132	RIGHT	D69a.EDF	D69	1
69	4186323	4186613	2674	2964	290	RIGHT	D69a.EDF	D69	1
69	4187436	4187568	3787	3919	132	RIGHT	D69a.EDF	D69	1
69	4188076	4188207	4427	4558	131	RIGHT	D69a.EDF	D69	1
69	4189311	4189451	5662	5802	140	RIGHT	D69a.EDF	D69	1
70	4192952	4193043	1040	1131	91	RIGHT	D69a.EDF	D69	1
70	4193067	4193069	1155	1157	2	RIGHT	D69a.EDF	D69	1
70	4194268	4194367	2356	2455	99	RIGHT	D69a.EDF	D69	1
70	4194967	4195068	3055	3156	101	RIGHT	D69a.EDF	D69	1
70	4195553	4195663	3641	3751	110	RIGHT	D69a.EDF	D69	1
70	4196276	4196380	4364	4468	104	RIGHT	D69a.EDF	D69	1
70	4196811	4196940	4899	5028	129	RIGHT	D69a.EDF	D69	1
71	4199629	4199784	689	844	155	RIGHT	D69a.EDF	D69	1
71	4199946	4200064	1006	1124	118	RIGHT	D69a.EDF	D69	1
71	4202108	4202224	3168	3284	116	RIGHT	D69a.EDF	D69	1
71	4202743	4202842	3803	3902	99	RIGHT	D69a.EDF	D69	1
71	4202998	4203120	4058	4180	122	RIGHT	D69a.EDF	D69	1
71	4203533	4203627	4593	4687	94	RIGHT	D69a.EDF	D69	1
71	4203652	4203654	4712	4714	2	RIGHT	D69a.EDF	D69	1
71	4203771	4203873	4831	4933	102	RIGHT	D69a.EDF	D69	1
71	4203901	4203902	4961	4962	1	RIGHT	D69a.EDF	D69	1
72	4207882	4207991	885	994	109	RIGHT	D69a.EDF	D69	1
72	4208447	4208571	1450	1574	124	RIGHT	D69a.EDF	D69	1
72	4209402	4209540	2405	2543	138	RIGHT	D69a.EDF	D69	1
72	4210357	4210453	3360	3456	96	RIGHT	D69a.EDF	D69	1
72	4210482	4210485	3485	3488	3	RIGHT	D69a.EDF	D69	1
72	4210831	4210949	3834	3952	118	RIGHT	D69a.EDF	D69	1
72	4210979	4210980	3982	3983	1	RIGHT	D69a.EDF	D69	1
72	4211731	4211843	4734	4846	112	RIGHT	D69a.EDF	D69	1
72	4211883	4211889	4886	4892	6	RIGHT	D69a.EDF	D69	1
72	4212289	4212395	5292	5398	106	RIGHT	D69a.EDF	D69	1
72	4212428	4212429	5431	5432	1	RIGHT	D69a.EDF	D69	1
72	4212831	4212929	5834	5932	98	RIGHT	D69a.EDF	D69	1
72	4212951	4212957	5954	5960	6	RIGHT	D69a.EDF	D69	1
73	4216111	4216384	820	1093	273	RIGHT	D69a.EDF	D69	1
73	4217294	4217557	2003	2266	263	RIGHT	D69a.EDF	D69	1
73	4218811	4219062	3520	3771	251	RIGHT	D69a.EDF	D69	1
73	4219657	4219761	4366	4470	104	RIGHT	D69a.EDF	D69	1
73	4219783	4219787	4492	4496	4	RIGHT	D69a.EDF	D69	1
73	4219828	4219948	4537	4657	120	RIGHT	D69a.EDF	D69	1
74	4222120	4222210	355	445	90	RIGHT	D69a.EDF	D69	1
74	4222596	4222749	831	984	153	RIGHT	D69a.EDF	D69	1
74	4224099	4224128	2334	2363	29	RIGHT	D69a.EDF	D69	1
74	4224662	4224777	2897	3012	115	RIGHT	D69a.EDF	D69	1
74	4225053	4225589	3288	3824	536	RIGHT	D69a.EDF	D69	1
74	4225651	4225787	3886	4022	136	RIGHT	D69a.EDF	D69	1
74	4226347	4226480	4582	4715	133	RIGHT	D69a.EDF	D69	1
74	4227018	4227143	5253	5378	125	RIGHT	D69a.EDF	D69	1
74	4227450	4227567	5685	5802	117	RIGHT	D69a.EDF	D69	1
74	4227793	4227915	6028	6150	122	RIGHT	D69a.EDF	D69	1
75	4230494	4230628	128	262	134	RIGHT	D69a.EDF	D69	1
75	4231176	4231440	810	1074	264	RIGHT	D69a.EDF	D69	1
75	4233261	4233369	2895	3003	108	RIGHT	D69a.EDF	D69	1
75	4233894	4233995	3528	3629	101	RIGHT	D69a.EDF	D69	1
75	4234490	4234609	4124	4243	119	RIGHT	D69a.EDF	D69	1
75	4235054	4235179	4688	4813	125	RIGHT	D69a.EDF	D69	1
76	4238955	4238956	230	231	1	RIGHT	D69a.EDF	D69	1
76	4238987	4239072	262	347	85	RIGHT	D69a.EDF	D69	1
76	4239111	4239220	386	495	109	RIGHT	D69a.EDF	D69	1
76	4239275	4239295	550	570	20	RIGHT	D69a.EDF	D69	1
76	4239347	4239359	622	634	12	RIGHT	D69a.EDF	D69	1
76	4239409	4239452	684	727	43	RIGHT	D69a.EDF	D69	1
76	4239499	4239514	774	789	15	RIGHT	D69a.EDF	D69	1
76	4239559	4239577	834	852	18	RIGHT	D69a.EDF	D69	1
76	4239610	4239731	885	1006	121	RIGHT	D69a.EDF	D69	1
76	4239841	4239841	1116	1116	0	RIGHT	D69a.EDF	D69	1
76	4240039	4240051	1314	1326	12	RIGHT	D69a.EDF	D69	1
76	4240096	4240252	1371	1527	156	RIGHT	D69a.EDF	D69	1
76	4240472	4240483	1747	1758	11	RIGHT	D69a.EDF	D69	1
76	4240505	4240507	1780	1782	2	RIGHT	D69a.EDF	D69	1
76	4241100	4241224	2375	2499	124	RIGHT	D69a.EDF	D69	1
76	4241830	4241934	3105	3209	104	RIGHT	D69a.EDF	D69	1
76	4242208	4242208	3483	3483	0	RIGHT	D69a.EDF	D69	1
76	4242404	4242404	3679	3679	0	RIGHT	D69a.EDF	D69	1
76	4242444	4242558	3719	3833	114	RIGHT	D69a.EDF	D69	1
76	4243101	4243219	4376	4494	118	RIGHT	D69a.EDF	D69	1
76	4243348	4243486	4623	4761	138	RIGHT	D69a.EDF	D69	1
77	4246358	4246474	663	779	116	RIGHT	D69a.EDF	D69	1
77	4246816	4246955	1121	1260	139	RIGHT	D69a.EDF	D69	1
77	4248084	4248116	2389	2421	32	RIGHT	D69a.EDF	D69	1
77	4248291	4248430	2596	2735	139	RIGHT	D69a.EDF	D69	1
77	4249124	4249151	3429	3456	27	RIGHT	D69a.EDF	D69	1
77	4249266	4249424	3571	3729	158	RIGHT	D69a.EDF	D69	1
77	4250064	4250068	4369	4373	4	RIGHT	D69a.EDF	D69	1
77	4250276	4250277	4581	4582	1	RIGHT	D69a.EDF	D69	1
77	4250306	4250413	4611	4718	107	RIGHT	D69a.EDF	D69	1
77	4250992	4251104	5297	5409	112	RIGHT	D69a.EDF	D69	1
77	4251209	4251343	5514	5648	134	RIGHT	D69a.EDF	D69	1
77	4251641	4251764	5946	6069	123	RIGHT	D69a.EDF	D69	1
78	4254117	4254276	123	282	159	RIGHT	D69a.EDF	D69	1
78	4254735	4254855	741	861	120	RIGHT	D69a.EDF	D69	1
78	4255346	4255495	1352	1501	149	RIGHT	D69a.EDF	D69	1
78	4257036	4257139	3042	3145	103	RIGHT	D69a.EDF	D69	1
78	4257191	4257205	3197	3211	14	RIGHT	D69a.EDF	D69	1
78	4257248	4257375	3254	3381	127	RIGHT	D69a.EDF	D69	1
78	4258580	4258677	4586	4683	97	RIGHT	D69a.EDF	D69	1
78	4259359	4259459	5365	5465	100	RIGHT	D69a.EDF	D69	1
78	4260512	4260600	6518	6606	88	RIGHT	D69a.EDF	D69	1
79	4262728	4262796	58	126	68	RIGHT	D69a.EDF	D69	1
79	4262826	4262835	156	165	9	RIGHT	D69a.EDF	D69	1
79	4262995	4263104	325	434	109	RIGHT	D69a.EDF	D69	1
79	4263823	4263939	1153	1269	116	RIGHT	D69a.EDF	D69	1
79	4265337	4265429	2667	2759	92	RIGHT	D69a.EDF	D69	1
79	4265466	4265561	2796	2891	95	RIGHT	D69a.EDF	D69	1
79	4265916	4266217	3246	3547	301	RIGHT	D69a.EDF	D69	1
79	4266868	4267156	4198	4486	288	RIGHT	D69a.EDF	D69	1
79	4268090	4268202	5420	5532	112	RIGHT	D69a.EDF	D69	1
79	4268963	4269093	6293	6423	130	RIGHT	D69a.EDF	D69	1
79	4269454	4269593	6784	6923	139	RIGHT	D69a.EDF	D69	1
80	4272057	4272182	252	377	125	RIGHT	D69a.EDF	D69	1
80	4272614	4272781	809	976	167	RIGHT	D69a.EDF	D69	1
80	4272960	4273095	1155	1290	135	RIGHT	D69a.EDF	D69	1
80	4274852	4274951	3047	3146	99	RIGHT	D69a.EDF	D69	1
80	4275227	4275367	3422	3562	140	RIGHT	D69a.EDF	D69	1
80	4275751	4275873	3946	4068	122	RIGHT	D69a.EDF	D69	1
80	4276032	4276163	4227	4358	131	RIGHT	D69a.EDF	D69	1
80	4276293	4276430	4488	4625	137	RIGHT	D69a.EDF	D69	1
80	4276585	4276709	4780	4904	124	RIGHT	D69a.EDF	D69	1
80	4277171	4277303	5366	5498	132	RIGHT	D69a.EDF	D69	1
80	4277537	4277667	5732	5862	130	RIGHT	D69a.EDF	D69	1
80	4277918	4278034	6113	6229	116	RIGHT	D69a.EDF	D69	1
81	4280654	4280794	102	242	140	RIGHT	D69a.EDF	D69	1
81	4281230	4281366	678	814	136	RIGHT	D69a.EDF	D69	1
81	4281796	4282064	1244	1512	268	RIGHT	D69a.EDF	D69	1
81	4283423	4283533	2871	2981	110	RIGHT	D69a.EDF	D69	1
81	4284352	4284449	3800	3897	97	RIGHT	D69a.EDF	D69	1
81	4284897	4285019	4345	4467	122	RIGHT	D69a.EDF	D69	1
81	4285634	4285744	5082	5192	110	RIGHT	D69a.EDF	D69	1
81	4286289	4286362	5737	5810	73	RIGHT	D69a.EDF	D69	1
81	4286384	4286390	5832	5838	6	RIGHT	D69a.EDF	D69	1
81	4286986	4287084	6434	6532	98	RIGHT	D69a.EDF	D69	1
81	4287274	4287384	6722	6832	110	RIGHT	D69a.EDF	D69	1
82	4290074	4290343	627	896	269	RIGHT	D69a.EDF	D69	1
82	4290697	4290822	1250	1375	125	RIGHT	D69a.EDF	D69	1
82	4292459	4292561	3012	3114	102	RIGHT	D69a.EDF	D69	1
82	4293094	4293351	3647	3904	257	RIGHT	D69a.EDF	D69	1
82	4293849	4293961	4402	4514	112	RIGHT	D69a.EDF	D69	1
82	4294164	4294278	4717	4831	114	RIGHT	D69a.EDF	D69	1
82	4294441	4294565	4994	5118	124	RIGHT	D69a.EDF	D69	1
82	4294794	4294943	5347	5496	149	RIGHT	D69a.EDF	D69	1
82	4295448	4295720	6001	6273	272	RIGHT	D69a.EDF	D69	1
82	4296225	4296358	6778	6911	133	RIGHT	D69a.EDF	D69	1
82	4296472	4296590	7025	7143	118	RIGHT	D69a.EDF	D69	1
83	4298712	4298830	112	230	118	RIGHT	D69a.EDF	D69	1
83	4299469	4299615	869	1015	146	RIGHT	D69a.EDF	D69	1
83	4300232	4300401	1632	1801	169	RIGHT	D69a.EDF	D69	1
83	4302111	4302226	3511	3626	115	RIGHT	D69a.EDF	D69	1
83	4303233	4303341	4633	4741	108	RIGHT	D69a.EDF	D69	1
83	4304109	4304218	5509	5618	109	RIGHT	D69a.EDF	D69	1
83	4304778	4304896	6178	6296	118	RIGHT	D69a.EDF	D69	1
84	4307295	4307413	247	365	118	RIGHT	D69a.EDF	D69	1
84	4307778	4308087	730	1039	309	RIGHT	D69a.EDF	D69	1
84	4308689	4308813	1641	1765	124	RIGHT	D69a.EDF	D69	1
84	4309874	4309979	2826	2931	105	RIGHT	D69a.EDF	D69	1
84	4310650	4310754	3602	3706	104	RIGHT	D69a.EDF	D69	1
84	4311625	4311733	4577	4685	108	RIGHT	D69a.EDF	D69	1
84	4312893	4312995	5845	5947	102	RIGHT	D69a.EDF	D69	1
85	4315598	4315700	540	642	102	RIGHT	D69a.EDF	D69	1
85	4316020	4316133	962	1075	113	RIGHT	D69a.EDF	D69	1
85	4317508	4317601	2450	2543	93	RIGHT	D69a.EDF	D69	1
85	4318471	4318569	3413	3511	98	RIGHT	D69a.EDF	D69	1
85	4319436	4319503	4378	4445	67	RIGHT	D69a.EDF	D69	1
85	4319739	4319825	4681	4767	86	RIGHT	D69a.EDF	D69	1
85	4320621	4320726	5563	5668	105	RIGHT	D69a.EDF	D69	1
86	4323334	4323445	496	607	111	RIGHT	D69a.EDF	D69	1
86	4323891	4324010	1053	1172	119	RIGHT	D69a.EDF	D69	1
86	4325739	4325852	2901	3014	113	RIGHT	D69a.EDF	D69	1
86	4326293	4326409	3455	3571	116	RIGHT	D69a.EDF	D69	1
86	4326809	4326939	3971	4101	130	RIGHT	D69a.EDF	D69	1
86	4327440	4327568	4602	4730	128	RIGHT	D69a.EDF	D69	1
86	4327894	4328044	5056	5206	150	RIGHT	D69a.EDF	D69	1
86	4328467	4328616	5629	5778	149	RIGHT	D69a.EDF	D69	1
86	4329031	4329293	6193	6455	262	RIGHT	D69a.EDF	D69	1
86	4329335	4329335	6497	6497	0	RIGHT	D69a.EDF	D69	1
87	4332479	4332585	187	293	106	RIGHT	D69a.EDF	D69	1
87	4332606	4332607	314	315	1	RIGHT	D69a.EDF	D69	1
87	4333085	4333232	793	940	147	RIGHT	D69a.EDF	D69	1
87	4333827	4333918	1535	1626	91	RIGHT	D69a.EDF	D69	1
87	4334075	4334172	1783	1880	97	RIGHT	D69a.EDF	D69	1
87	4335198	4335402	2906	3110	204	RIGHT	D69a.EDF	D69	1
87	4335586	4335710	3294	3418	124	RIGHT	D69a.EDF	D69	1
87	4336246	4336361	3954	4069	115	RIGHT	D69a.EDF	D69	1
87	4336625	4336750	4333	4458	125	RIGHT	D69a.EDF	D69	1
87	4336963	4337091	4671	4799	128	RIGHT	D69a.EDF	D69	1
87	4337540	4337639	5248	5347	99	RIGHT	D69a.EDF	D69	1
87	4338173	4338273	5881	5981	100	RIGHT	D69a.EDF	D69	1
87	4338466	4338574	6174	6282	108	RIGHT	D69a.EDF	D69	1
88	4341681	4341805	185	309	124	RIGHT	D69a.EDF	D69	1
88	4342307	4342406	811	910	99	RIGHT	D69a.EDF	D69	1
88	4343428	4343525	1932	2029	97	RIGHT	D69a.EDF	D69	1
88	4344721	4344836	3225	3340	115	RIGHT	D69a.EDF	D69	1
88	4346060	4346166	4564	4670	106	RIGHT	D69a.EDF	D69	1
88	4347080	4347170	5584	5674	90	RIGHT	D69a.EDF	D69	1
89	4349498	4349628	115	245	130	RIGHT	D69a.EDF	D69	1
89	4350051	4350179	668	796	128	RIGHT	D69a.EDF	D69	1
89	4351006	4351107	1623	1724	101	RIGHT	D69a.EDF	D69	1
89	4352351	4352444	2968	3061	93	RIGHT	D69a.EDF	D69	1
89	4353028	4353043	3645	3660	15	RIGHT	D69a.EDF	D69	1
89	4353196	4353203	3813	3820	7	RIGHT	D69a.EDF	D69	1
89	4353225	4353326	3842	3943	101	RIGHT	D69a.EDF	D69	1
89	4353621	4353919	4238	4536	298	RIGHT	D69a.EDF	D69	1
89	4354122	4354267	4739	4884	145	RIGHT	D69a.EDF	D69	1
89	4354445	4354581	5062	5198	136	RIGHT	D69a.EDF	D69	1
90	4356706	4356835	159	288	129	RIGHT	D69a.EDF	D69	1
90	4357236	4357359	689	812	123	RIGHT	D69a.EDF	D69	1
90	4357980	4358087	1433	1540	107	RIGHT	D69a.EDF	D69	1
90	4359834	4359949	3287	3402	115	RIGHT	D69a.EDF	D69	1
90	4360950	4361047	4403	4500	97	RIGHT	D69a.EDF	D69	1
90	4361648	4361739	5101	5192	91	RIGHT	D69a.EDF	D69	1
90	4362344	4362350	5797	5803	6	RIGHT	D69a.EDF	D69	1
90	4362385	4362500	5838	5953	115	RIGHT	D69a.EDF	D69	1
91	4366339	4366613	728	1002	274	RIGHT	D69a.EDF	D69	1
91	4368274	4368367	2663	2756	93	RIGHT	D69a.EDF	D69	1
91	4369031	4369127	3420	3516	96	RIGHT	D69a.EDF	D69	1
91	4369729	4369809	4118	4198	80	RIGHT	D69a.EDF	D69	1
91	4369949	4370081	4338	4470	132	RIGHT	D69a.EDF	D69	1
91	4370730	4370833	5119	5222	103	RIGHT	D69a.EDF	D69	1
91	4371105	4371229	5494	5618	124	RIGHT	D69a.EDF	D69	1
91	4371986	4372070	6375	6459	84	RIGHT	D69a.EDF	D69	1
92	4374846	4375127	558	839	281	RIGHT	D69a.EDF	D69	1
92	4375820	4375925	1532	1637	105	RIGHT	D69a.EDF	D69	1
92	4376790	4376888	2502	2600	98	RIGHT	D69a.EDF	D69	1
92	4378190	4378314	3902	4026	124	RIGHT	D69a.EDF	D69	1
92	4378856	4378963	4568	4675	107	RIGHT	D69a.EDF	D69	1
92	4380802	4380911	6514	6623	109	RIGHT	D69a.EDF	D69	1
93	4383532	4383627	129	224	95	RIGHT	D69a.EDF	D69	1
93	4384288	4384408	885	1005	120	RIGHT	D69a.EDF	D69	1
93	4384776	4384889	1373	1486	113	RIGHT	D69a.EDF	D69	1
93	4385811	4385931	2408	2528	120	RIGHT	D69a.EDF	D69	1
93	4386730	4386873	3327	3470	143	RIGHT	D69a.EDF	D69	1
93	4387488	4387593	4085	4190	105	RIGHT	D69a.EDF	D69	1
93	4388248	4388366	4845	4963	118	RIGHT	D69a.EDF	D69	1
93	4389076	4389190	5673	5787	114	RIGHT	D69a.EDF	D69	1
93	4389816	4389930	6413	6527	114	RIGHT	D69a.EDF	D69	1
94	4392378	4392449	58	129	71	RIGHT	D69a.EDF	D69	1
94	4393108	4393239	788	919	131	RIGHT	D69a.EDF	D69	1
94	4393698	4393808	1378	1488	110	RIGHT	D69a.EDF	D69	1
94	4394181	4394258	1861	1938	77	RIGHT	D69a.EDF	D69	1
94	4394280	4394282	1960	1962	2	RIGHT	D69a.EDF	D69	1
94	4394964	4395084	2644	2764	120	RIGHT	D69a.EDF	D69	1
94	4395711	4395853	3391	3533	142	RIGHT	D69a.EDF	D69	1
94	4396329	4396449	4009	4129	120	RIGHT	D69a.EDF	D69	1
94	4396620	4396731	4300	4411	111	RIGHT	D69a.EDF	D69	1
94	4396959	4397071	4639	4751	112	RIGHT	D69a.EDF	D69	1
94	4397349	4397445	5029	5125	96	RIGHT	D69a.EDF	D69	1
94	4397616	4397725	5296	5405	109	RIGHT	D69a.EDF	D69	1
94	4398166	4398274	5846	5954	108	RIGHT	D69a.EDF	D69	1
94	4398782	4398899	6462	6579	117	RIGHT	D69a.EDF	D69	1
94	4399054	4399113	6734	6793	59	RIGHT	D69a.EDF	D69	1
95	4412597	4412870	719	992	273	RIGHT	D69a.EDF	D69	1
95	4414503	4414613	2625	2735	110	RIGHT	D69a.EDF	D69	1
95	4415439	4415540	3561	3662	101	RIGHT	D69a.EDF	D69	1
95	4415863	4415978	3985	4100	115	RIGHT	D69a.EDF	D69	1
95	4416172	4416255	4294	4377	83	RIGHT	D69a.EDF	D69	1
95	4416632	4416720	4754	4842	88	RIGHT	D69a.EDF	D69	1
96	4419375	4419480	431	536	105	RIGHT	D69a.EDF	D69	1
96	4419894	4420032	950	1088	138	RIGHT	D69a.EDF	D69	1
96	4420409	4420496	1465	1552	87	RIGHT	D69a.EDF	D69	1
96	4421420	4421506	2476	2562	86	RIGHT	D69a.EDF	D69	1
96	4422264	4422350	3320	3406	86	RIGHT	D69a.EDF	D69	1
96	4422696	4422800	3752	3856	104	RIGHT	D69a.EDF	D69	1
96	4422955	4423056	4011	4112	101	RIGHT	D69a.EDF	D69	1
96	4423263	4423352	4319	4408	89	RIGHT	D69a.EDF	D69	1
96	4423736	4423853	4792	4909	117	RIGHT	D69a.EDF	D69	1
96	4424616	4424726	5672	5782	110	RIGHT	D69a.EDF	D69	1
96	4425036	4425152	6092	6208	116	RIGHT	D69a.EDF	D69	1
96	4425322	4425426	6378	6482	104	RIGHT	D69a.EDF	D69	1
96	4425613	4425753	6669	6809	140	RIGHT	D69a.EDF	D69	1
97	4428476	4428580	89	193	104	RIGHT	D69a.EDF	D69	1
97	4429204	4429562	817	1175	358	RIGHT	D69a.EDF	D69	1
97	4429624	4429790	1237	1403	166	RIGHT	D69a.EDF	D69	1
97	4429914	4429941	1527	1554	27	RIGHT	D69a.EDF	D69	1
97	4429978	4430196	1591	1809	218	RIGHT	D69a.EDF	D69	1
97	4430224	4430235	1837	1848	11	RIGHT	D69a.EDF	D69	1
97	4430290	4430291	1903	1904	1	RIGHT	D69a.EDF	D69	1
97	4430369	4430607	1982	2220	238	RIGHT	D69a.EDF	D69	1
97	4431416	4431534	3029	3147	118	RIGHT	D69a.EDF	D69	1
97	4432077	4432178	3690	3791	101	RIGHT	D69a.EDF	D69	1
97	4432900	4433000	4513	4613	100	RIGHT	D69a.EDF	D69	1
97	4433244	4433363	4857	4976	119	RIGHT	D69a.EDF	D69	1
97	4434136	4434237	5749	5850	101	RIGHT	D69a.EDF	D69	1
97	4434451	4434549	6064	6162	98	RIGHT	D69a.EDF	D69	1
97	4435071	4435115	6684	6728	44	RIGHT	D69a.EDF	D69	1
98	4437409	4437524	401	516	115	RIGHT	D69a.EDF	D69	1
98	4437998	4438093	990	1085	95	RIGHT	D69a.EDF	D69	1
98	4438115	4438118	1107	1110	3	RIGHT	D69a.EDF	D69	1
98	4438557	4438653	1549	1645	96	RIGHT	D69a.EDF	D69	1
98	4438675	4438679	1667	1671	4	RIGHT	D69a.EDF	D69	1
98	4439493	4439600	2485	2592	107	RIGHT	D69a.EDF	D69	1
98	4440724	4440829	3716	3821	105	RIGHT	D69a.EDF	D69	1
98	4441329	4441604	4321	4596	275	RIGHT	D69a.EDF	D69	1
98	4441939	4442064	4931	5056	125	RIGHT	D69a.EDF	D69	1
98	4442089	4442097	5081	5089	8	RIGHT	D69a.EDF	D69	1
98	4442175	4442294	5167	5286	119	RIGHT	D69a.EDF	D69	1
98	4442790	4442916	5782	5908	126	RIGHT	D69a.EDF	D69	1
98	4443053	4443178	6045	6170	125	RIGHT	D69a.EDF	D69	1
99	4445601	4445676	57	132	75	RIGHT	D69a.EDF	D69	1
99	4446439	4446739	895	1195	300	RIGHT	D69a.EDF	D69	1
99	4449634	4449735	4090	4191	101	RIGHT	D69a.EDF	D69	1
99	4450466	4450585	4922	5041	119	RIGHT	D69a.EDF	D69	1
99	4450760	4450885	5216	5341	125	RIGHT	D69a.EDF	D69	1
99	4451386	4451499	5842	5955	113	RIGHT	D69a.EDF	D69	1
99	4451645	4451758	6101	6214	113	RIGHT	D69a.EDF	D69	1
100	4454140	4454146	75	81	6	RIGHT	D69a.EDF	D69	1
100	4454842	4455087	777	1022	245	RIGHT	D69a.EDF	D69	1
100	4455108	4455116	1043	1051	8	RIGHT	D69a.EDF	D69	1
100	4456631	4456741	2566	2676	110	RIGHT	D69a.EDF	D69	1
100	4457386	4457472	3321	3407	86	RIGHT	D69a.EDF	D69	1
100	4458486	4458585	4421	4520	99	RIGHT	D69a.EDF	D69	1
100	4459141	4459245	5076	5180	104	RIGHT	D69a.EDF	D69	1
100	4460088	4460201	6023	6136	113	RIGHT	D69a.EDF	D69	1
100	4460344	4460452	6279	6387	108	RIGHT	D69a.EDF	D69	1
100	4460607	4460712	6542	6647	105	RIGHT	D69a.EDF	D69	1
101	4463703	4463814	318	429	111	RIGHT	D69a.EDF	D69	1
101	4464591	4464864	1206	1479	273	RIGHT	D69a.EDF	D69	1
101	4465894	4466007	2509	2622	113	RIGHT	D69a.EDF	D69	1
101	4467136	4467238	3751	3853	102	RIGHT	D69a.EDF	D69	1
101	4467977	4468081	4592	4696	104	RIGHT	D69a.EDF	D69	1
101	4468706	4468800	5321	5415	94	RIGHT	D69a.EDF	D69	1
101	4469324	4469411	5939	6026	87	RIGHT	D69a.EDF	D69	1
101	4469433	4469435	6048	6050	2	RIGHT	D69a.EDF	D69	1
102	4472157	4472252	90	185	95	RIGHT	D69a.EDF	D69	1
102	4472886	4473138	819	1071	252	RIGHT	D69a.EDF	D69	1
102	4473558	4473640	1491	1573	82	RIGHT	D69a.EDF	D69	1
102	4475733	4475813	3666	3746	80	RIGHT	D69a.EDF	D69	1
102	4476739	4476820	4672	4753	81	RIGHT	D69a.EDF	D69	1
102	4477323	4477427	5256	5360	104	RIGHT	D69a.EDF	D69	1
103	4479523	4479640	499	616	117	RIGHT	D69a.EDF	D69	1
103	4479939	4480027	915	1003	88	RIGHT	D69a.EDF	D69	1
103	4481247	4481340	2223	2316	93	RIGHT	D69a.EDF	D69	1
103	4481863	4481953	2839	2929	90	RIGHT	D69a.EDF	D69	1
103	4482473	4482573	3449	3549	100	RIGHT	D69a.EDF	D69	1
103	4482773	4482856	3749	3832	83	RIGHT	D69a.EDF	D69	1
103	4483240	4483345	4216	4321	105	RIGHT	D69a.EDF	D69	1
103	4484015	4484112	4991	5088	97	RIGHT	D69a.EDF	D69	1
103	4484403	4484522	5379	5498	119	RIGHT	D69a.EDF	D69	1
103	4484961	4485062	5937	6038	101	RIGHT	D69a.EDF	D69	1
103	4485278	4485391	6254	6367	113	RIGHT	D69a.EDF	D69	1
104	4488221	4488355	571	705	134	RIGHT	D69a.EDF	D69	1
104	4488624	4488723	974	1073	99	RIGHT	D69a.EDF	D69	1
104	4489136	4489142	1486	1492	6	RIGHT	D69a.EDF	D69	1
104	4489214	4489317	1564	1667	103	RIGHT	D69a.EDF	D69	1
104	4490513	4490602	2863	2952	89	RIGHT	D69a.EDF	D69	1
104	4491743	4491851	4093	4201	108	RIGHT	D69a.EDF	D69	1
104	4492639	4492739	4989	5089	100	RIGHT	D69a.EDF	D69	1
104	4493182	4493312	5532	5662	130	RIGHT	D69a.EDF	D69	1
104	4493483	4493608	5833	5958	125	RIGHT	D69a.EDF	D69	1
105	4496185	4496297	122	234	112	RIGHT	D69a.EDF	D69	1
105	4496792	4497062	729	999	270	RIGHT	D69a.EDF	D69	1
105	4498912	4499033	2849	2970	121	RIGHT	D69a.EDF	D69	1
105	4499470	4499615	3407	3552	145	RIGHT	D69a.EDF	D69	1
105	4500589	4500696	4526	4633	107	RIGHT	D69a.EDF	D69	1
105	4500866	4500974	4803	4911	108	RIGHT	D69a.EDF	D69	1
105	4501886	4501988	5823	5925	102	RIGHT	D69a.EDF	D69	1
105	4502581	4502690	6518	6627	109	RIGHT	D69a.EDF	D69	1
106	4507184	4507265	644	725	81	RIGHT	D69a.EDF	D69	1
106	4507615	4507750	1075	1210	135	RIGHT	D69a.EDF	D69	1
106	4508214	4508302	1674	1762	88	RIGHT	D69a.EDF	D69	1
106	4509271	4509373	2731	2833	102	RIGHT	D69a.EDF	D69	1
106	4510272	4510376	3732	3836	104	RIGHT	D69a.EDF	D69	1
106	4510938	4511043	4398	4503	105	RIGHT	D69a.EDF	D69	1
106	4511607	4511708	5067	5168	101	RIGHT	D69a.EDF	D69	1
107	4514786	4514895	753	862	109	RIGHT	D69a.EDF	D69	1
107	4515236	4515379	1203	1346	143	RIGHT	D69a.EDF	D69	1
107	4516714	4516857	2681	2824	143	RIGHT	D69a.EDF	D69	1
107	4517202	4517330	3169	3297	128	RIGHT	D69a.EDF	D69	1
107	4518175	4518271	4142	4238	96	RIGHT	D69a.EDF	D69	1
107	4518630	4518763	4597	4730	133	RIGHT	D69a.EDF	D69	1
107	4519252	4519358	5219	5325	106	RIGHT	D69a.EDF	D69	1
107	4519692	4519819	5659	5786	127	RIGHT	D69a.EDF	D69	1
107	4520049	4520174	6016	6141	125	RIGHT	D69a.EDF	D69	1
107	4520436	4520572	6403	6539	136	RIGHT	D69a.EDF	D69	1
107	4520879	4521001	6846	6968	122	RIGHT	D69a.EDF	D69	1
108	4524108	4524206	807	905	98	RIGHT	D69a.EDF	D69	1
108	4525078	4525161	1777	1860	83	RIGHT	D69a.EDF	D69	1
108	4525183	4525185	1882	1884	2	RIGHT	D69a.EDF	D69	1
108	4526633	4526748	3332	3447	115	RIGHT	D69a.EDF	D69	1
108	4527494	4527582	4193	4281	88	RIGHT	D69a.EDF	D69	1
108	4527940	4528030	4639	4729	90	RIGHT	D69a.EDF	D69	1
108	4528284	4528403	4983	5102	119	RIGHT	D69a.EDF	D69	1
109	4530887	4531161	741	1015	274	RIGHT	D69a.EDF	D69	1
109	4531651	4531758	1505	1612	107	RIGHT	D69a.EDF	D69	1
109	4532707	4532811	2561	2665	104	RIGHT	D69a.EDF	D69	1
109	4533999	4534062	3853	3916	63	RIGHT	D69a.EDF	D69	1
109	4534259	4534374	4113	4228	115	RIGHT	D69a.EDF	D69	1
109	4535084	4535181	4938	5035	97	RIGHT	D69a.EDF	D69	1
109	4535872	4535972	5726	5826	100	RIGHT	D69a.EDF	D69	1
109	4536239	4536359	6093	6213	120	RIGHT	D69a.EDF	D69	1
109	4536846	4536960	6700	6814	114	RIGHT	D69a.EDF	D69	1
110	4539619	4539731	548	660	112	RIGHT	D69a.EDF	D69	1
110	4540407	4540478	1336	1407	71	RIGHT	D69a.EDF	D69	1
110	4540501	4540501	1430	1430	0	RIGHT	D69a.EDF	D69	1
110	4542822	4542943	3751	3872	121	RIGHT	D69a.EDF	D69	1
110	4543720	4543817	4649	4746	97	RIGHT	D69a.EDF	D69	1
110	4543846	4544128	4775	5057	282	RIGHT	D69a.EDF	D69	1
110	4544520	4544783	5449	5712	263	RIGHT	D69a.EDF	D69	1
110	4545161	4545279	6090	6208	118	RIGHT	D69a.EDF	D69	1
110	4545505	4545603	6434	6532	98	RIGHT	D69a.EDF	D69	1
111	4547913	4548020	98	205	107	RIGHT	D69a.EDF	D69	1
111	4548380	4548512	565	697	132	RIGHT	D69a.EDF	D69	1
111	4548818	4548938	1003	1123	120	RIGHT	D69a.EDF	D69	1
111	4549188	4549477	1373	1662	289	RIGHT	D69a.EDF	D69	1
111	4549502	4549509	1687	1694	7	RIGHT	D69a.EDF	D69	1
111	4551015	4551118	3200	3303	103	RIGHT	D69a.EDF	D69	1
111	4551810	4551919	3995	4104	109	RIGHT	D69a.EDF	D69	1
111	4552501	4552607	4686	4792	106	RIGHT	D69a.EDF	D69	1
111	4552630	4552635	4815	4820	5	RIGHT	D69a.EDF	D69	1
111	4552755	4552880	4940	5065	125	RIGHT	D69a.EDF	D69	1
112	4555351	4555366	62	77	15	RIGHT	D69a.EDF	D69	1
112	4556000	4556245	711	956	245	RIGHT	D69a.EDF	D69	1
112	4558352	4558443	3063	3154	91	RIGHT	D69a.EDF	D69	1
112	4559123	4559222	3834	3933	99	RIGHT	D69a.EDF	D69	1
112	4559390	4559516	4101	4227	126	RIGHT	D69a.EDF	D69	1
112	4559943	4560204	4654	4915	261	RIGHT	D69a.EDF	D69	1
112	4560622	4560862	5333	5573	240	RIGHT	D69a.EDF	D69	1
113	4563275	4563539	670	934	264	RIGHT	D69a.EDF	D69	1
113	4565354	4565481	2749	2876	127	RIGHT	D69a.EDF	D69	1
113	4566378	4566594	3773	3989	216	RIGHT	D69a.EDF	D69	1
113	4566931	4567170	4326	4565	239	RIGHT	D69a.EDF	D69	1
114	4569669	4569778	220	329	109	RIGHT	D69a.EDF	D69	1
114	4570162	4570307	713	858	145	RIGHT	D69a.EDF	D69	1
114	4570567	4570682	1118	1233	115	RIGHT	D69a.EDF	D69	1
114	4572052	4572181	2603	2732	129	RIGHT	D69a.EDF	D69	1
114	4572307	4572412	2858	2963	105	RIGHT	D69a.EDF	D69	1
114	4572887	4573002	3438	3553	115	RIGHT	D69a.EDF	D69	1
114	4573320	4573442	3871	3993	122	RIGHT	D69a.EDF	D69	1
114	4573663	4573755	4214	4306	92	RIGHT	D69a.EDF	D69	1
114	4573980	4574093	4531	4644	113	RIGHT	D69a.EDF	D69	1
114	4574505	4574598	5056	5149	93	RIGHT	D69a.EDF	D69	1
114	4574623	4574626	5174	5177	3	RIGHT	D69a.EDF	D69	1
114	4575002	4575146	5553	5697	144	RIGHT	D69a.EDF	D69	1
114	4575261	4575372	5812	5923	111	RIGHT	D69a.EDF	D69	1
115	4577331	4577436	57	162	105	RIGHT	D69a.EDF	D69	1
115	4577921	4577996	647	722	75	RIGHT	D69a.EDF	D69	1
115	4578018	4578019	744	745	1	RIGHT	D69a.EDF	D69	1
115	4578793	4578900	1519	1626	107	RIGHT	D69a.EDF	D69	1
115	4579897	4579901	2623	2627	4	RIGHT	D69a.EDF	D69	1
115	4579930	4579938	2656	2664	8	RIGHT	D69a.EDF	D69	1
115	4579959	4580099	2685	2825	140	RIGHT	D69a.EDF	D69	1
115	4580853	4581147	3579	3873	294	RIGHT	D69a.EDF	D69	1
115	4581968	4582073	4694	4799	105	RIGHT	D69a.EDF	D69	1
115	4582531	4582646	5257	5372	115	RIGHT	D69a.EDF	D69	1
115	4583373	4583486	6099	6212	113	RIGHT	D69a.EDF	D69	1
116	4585735	4585838	166	269	103	RIGHT	D69a.EDF	D69	1
116	4585868	4585873	299	304	5	RIGHT	D69a.EDF	D69	1
116	4585964	4586063	395	494	99	RIGHT	D69a.EDF	D69	1
116	4586780	4587010	1211	1441	230	RIGHT	D69a.EDF	D69	1
116	4588763	4588841	3194	3272	78	RIGHT	D69a.EDF	D69	1
116	4588866	4588866	3297	3297	0	RIGHT	D69a.EDF	D69	1
116	4589970	4590076	4401	4507	106	RIGHT	D69a.EDF	D69	1
117	4592901	4593029	88	216	128	RIGHT	D69a.EDF	D69	1
117	4593614	4593704	801	891	90	RIGHT	D69a.EDF	D69	1
117	4593961	4594074	1148	1261	113	RIGHT	D69a.EDF	D69	1
117	4594284	4594429	1471	1616	145	RIGHT	D69a.EDF	D69	1
117	4595698	4595788	2885	2975	90	RIGHT	D69a.EDF	D69	1
117	4596762	4596861	3949	4048	99	RIGHT	D69a.EDF	D69	1
117	4597082	4597196	4269	4383	114	RIGHT	D69a.EDF	D69	1
117	4597822	4597951	5009	5138	129	RIGHT	D69a.EDF	D69	1
117	4598131	4598247	5318	5434	116	RIGHT	D69a.EDF	D69	1
117	4599130	4599223	6317	6410	93	RIGHT	D69a.EDF	D69	1
118	4601666	4601766	297	397	100	RIGHT	D69a.EDF	D69	1
118	4602458	4602576	1089	1207	118	RIGHT	D69a.EDF	D69	1
118	4602726	4602848	1357	1479	122	RIGHT	D69a.EDF	D69	1
118	4604505	4604612	3136	3243	107	RIGHT	D69a.EDF	D69	1
118	4605170	4605279	3801	3910	109	RIGHT	D69a.EDF	D69	1
118	4605466	4605575	4097	4206	109	RIGHT	D69a.EDF	D69	1
118	4606107	4606384	4738	5015	277	RIGHT	D69a.EDF	D69	1
118	4607093	4607207	5724	5838	114	RIGHT	D69a.EDF	D69	1
119	4610807	4610807	916	916	0	RIGHT	D69a.EDF	D69	1
119	4610828	4610942	937	1051	114	RIGHT	D69a.EDF	D69	1
119	4611490	4611562	1599	1671	72	RIGHT	D69a.EDF	D69	1
119	4611588	4611588	1697	1697	0	RIGHT	D69a.EDF	D69	1
119	4612493	4612582	2602	2691	89	RIGHT	D69a.EDF	D69	1
119	4613277	4613349	3386	3458	72	RIGHT	D69a.EDF	D69	1
119	4614022	4614144	4131	4253	122	RIGHT	D69a.EDF	D69	1
119	4614777	4614866	4886	4975	89	RIGHT	D69a.EDF	D69	1
119	4615531	4615625	5640	5734	94	RIGHT	D69a.EDF	D69	1
119	4616289	4616376	6398	6485	87	RIGHT	D69a.EDF	D69	1
120	4619249	4619340	219	310	91	RIGHT	D69a.EDF	D69	1
120	4619716	4619852	686	822	136	RIGHT	D69a.EDF	D69	1
120	4620318	4620406	1288	1376	88	RIGHT	D69a.EDF	D69	1
120	4621444	4621538	2414	2508	94	RIGHT	D69a.EDF	D69	1
120	4622131	4622203	3101	3173	72	RIGHT	D69a.EDF	D69	1
120	4622463	4622565	3433	3535	102	RIGHT	D69a.EDF	D69	1
120	4622995	4623099	3965	4069	104	RIGHT	D69a.EDF	D69	1
120	4623494	4623605	4464	4575	111	RIGHT	D69a.EDF	D69	1
120	4623890	4623994	4860	4964	104	RIGHT	D69a.EDF	D69	1
120	4624359	4624482	5329	5452	123	RIGHT	D69a.EDF	D69	1
120	4624835	4624952	5805	5922	117	RIGHT	D69a.EDF	D69	1
120	4625499	4625594	6469	6564	95	RIGHT	D69a.EDF	D69	1
1	6034967	6035058	223	314	91	RIGHT	D69b.EDF	D69	2
1	6035835	6035982	1091	1238	147	RIGHT	D69b.EDF	D69	2
1	6036329	6036336	1585	1592	7	RIGHT	D69b.EDF	D69	2
1	6036360	6036458	1616	1714	98	RIGHT	D69b.EDF	D69	2
1	6037888	6037974	3144	3230	86	RIGHT	D69b.EDF	D69	2
1	6037998	6038038	3254	3294	40	RIGHT	D69b.EDF	D69	2
1	6038501	6038594	3757	3850	93	RIGHT	D69b.EDF	D69	2
1	6038631	6038634	3887	3890	3	RIGHT	D69b.EDF	D69	2
1	6038656	6038659	3912	3915	3	RIGHT	D69b.EDF	D69	2
1	6038725	6038834	3981	4090	109	RIGHT	D69b.EDF	D69	2
1	6038893	6038893	4149	4149	0	RIGHT	D69b.EDF	D69	2
1	6039072	6039162	4328	4418	90	RIGHT	D69b.EDF	D69	2
1	6039202	6039206	4458	4462	4	RIGHT	D69b.EDF	D69	2
1	6039334	6039428	4590	4684	94	RIGHT	D69b.EDF	D69	2
1	6039690	6039923	4946	5179	233	RIGHT	D69b.EDF	D69	2
1	6039952	6039974	5208	5230	22	RIGHT	D69b.EDF	D69	2
2	6041990	6042034	58	102	44	RIGHT	D69b.EDF	D69	2
2	6042063	6042120	131	188	57	RIGHT	D69b.EDF	D69	2
2	6042534	6042624	602	692	90	RIGHT	D69b.EDF	D69	2
2	6042848	6042849	916	917	1	RIGHT	D69b.EDF	D69	2
2	6042872	6042984	940	1052	112	RIGHT	D69b.EDF	D69	2
2	6043043	6043054	1111	1122	11	RIGHT	D69b.EDF	D69	2
2	6043279	6043490	1347	1558	211	RIGHT	D69b.EDF	D69	2
2	6043580	6043580	1648	1648	0	RIGHT	D69b.EDF	D69	2
2	6045263	6045362	3331	3430	99	RIGHT	D69b.EDF	D69	2
2	6045405	6045452	3473	3520	47	RIGHT	D69b.EDF	D69	2
2	6045702	6045798	3770	3866	96	RIGHT	D69b.EDF	D69	2
2	6045843	6045889	3911	3957	46	RIGHT	D69b.EDF	D69	2
2	6047092	6047175	5160	5243	83	RIGHT	D69b.EDF	D69	2
2	6047241	6047248	5309	5316	7	RIGHT	D69b.EDF	D69	2
3	6050284	6050304	146	166	20	RIGHT	D69b.EDF	D69	2
3	6050326	6050338	188	200	12	RIGHT	D69b.EDF	D69	2
3	6050361	6050462	223	324	101	RIGHT	D69b.EDF	D69	2
3	6050541	6050547	403	409	6	RIGHT	D69b.EDF	D69	2
3	6050581	6050586	443	448	5	RIGHT	D69b.EDF	D69	2
3	6050615	6050678	477	540	63	RIGHT	D69b.EDF	D69	2
3	6050879	6050879	741	741	0	RIGHT	D69b.EDF	D69	2
3	6050904	6051176	766	1038	272	RIGHT	D69b.EDF	D69	2
3	6051249	6051263	1111	1125	14	RIGHT	D69b.EDF	D69	2
3	6051592	6051703	1454	1565	111	RIGHT	D69b.EDF	D69	2
3	6052051	6052121	1913	1983	70	RIGHT	D69b.EDF	D69	2
3	6053447	6053541	3309	3403	94	RIGHT	D69b.EDF	D69	2
3	6053980	6054074	3842	3936	94	RIGHT	D69b.EDF	D69	2
3	6054502	6054595	4364	4457	93	RIGHT	D69b.EDF	D69	2
3	6054804	6055047	4666	4909	243	RIGHT	D69b.EDF	D69	2
3	6055997	6056095	5859	5957	98	RIGHT	D69b.EDF	D69	2
3	6056568	6056665	6430	6527	97	RIGHT	D69b.EDF	D69	2
4	6059358	6059449	316	407	91	RIGHT	D69b.EDF	D69	2
4	6059759	6059760	717	718	1	RIGHT	D69b.EDF	D69	2
4	6059788	6060051	746	1009	263	RIGHT	D69b.EDF	D69	2
4	6060103	6060103	1061	1061	0	RIGHT	D69b.EDF	D69	2
4	6060341	6060609	1299	1567	268	RIGHT	D69b.EDF	D69	2
4	6061646	6061727	2604	2685	81	RIGHT	D69b.EDF	D69	2
4	6061780	6061793	2738	2751	13	RIGHT	D69b.EDF	D69	2
4	6062520	6062620	3478	3578	100	RIGHT	D69b.EDF	D69	2
4	6062691	6062695	3649	3653	4	RIGHT	D69b.EDF	D69	2
4	6062840	6062943	3798	3901	103	RIGHT	D69b.EDF	D69	2
4	6063005	6063005	3963	3963	0	RIGHT	D69b.EDF	D69	2
4	6063118	6063231	4076	4189	113	RIGHT	D69b.EDF	D69	2
4	6063642	6063836	4600	4794	194	RIGHT	D69b.EDF	D69	2
4	6064263	6064560	5221	5518	297	RIGHT	D69b.EDF	D69	2
5	6067595	6067707	274	386	112	RIGHT	D69b.EDF	D69	2
5	6068168	6068335	847	1014	167	RIGHT	D69b.EDF	D69	2
5	6068583	6068699	1262	1378	116	RIGHT	D69b.EDF	D69	2
5	6070204	6070297	2883	2976	93	RIGHT	D69b.EDF	D69	2
5	6070964	6071197	3643	3876	233	RIGHT	D69b.EDF	D69	2
5	6071962	6072048	4641	4727	86	RIGHT	D69b.EDF	D69	2
5	6072589	6072681	5268	5360	92	RIGHT	D69b.EDF	D69	2
5	6073191	6073298	5870	5977	107	RIGHT	D69b.EDF	D69	2
5	6073678	6073769	6357	6448	91	RIGHT	D69b.EDF	D69	2
5	6074212	6074318	6891	6997	106	RIGHT	D69b.EDF	D69	2
6	6076423	6076531	57	165	108	RIGHT	D69b.EDF	D69	2
6	6077060	6077346	694	980	286	RIGHT	D69b.EDF	D69	2
6	6077445	6077447	1079	1081	2	RIGHT	D69b.EDF	D69	2
6	6077471	6077476	1105	1110	5	RIGHT	D69b.EDF	D69	2
6	6077726	6077840	1360	1474	114	RIGHT	D69b.EDF	D69	2
6	6079544	6079603	3178	3237	59	RIGHT	D69b.EDF	D69	2
6	6079768	6079866	3402	3500	98	RIGHT	D69b.EDF	D69	2
6	6080119	6080238	3753	3872	119	RIGHT	D69b.EDF	D69	2
6	6080345	6080466	3979	4100	121	RIGHT	D69b.EDF	D69	2
6	6080866	6080977	4500	4611	111	RIGHT	D69b.EDF	D69	2
6	6081054	6081153	4688	4787	99	RIGHT	D69b.EDF	D69	2
6	6081591	6081866	5225	5500	275	RIGHT	D69b.EDF	D69	2
6	6082290	6082428	5924	6062	138	RIGHT	D69b.EDF	D69	2
6	6082652	6082762	6286	6396	110	RIGHT	D69b.EDF	D69	2
7	6085073	6085168	172	267	95	RIGHT	D69b.EDF	D69	2
7	6085428	6085564	527	663	136	RIGHT	D69b.EDF	D69	2
7	6087423	6087500	2522	2599	77	RIGHT	D69b.EDF	D69	2
7	6087900	6087989	2999	3088	89	RIGHT	D69b.EDF	D69	2
7	6088492	6088580	3591	3679	88	RIGHT	D69b.EDF	D69	2
7	6088812	6088897	3911	3996	85	RIGHT	D69b.EDF	D69	2
7	6089576	6089663	4675	4762	87	RIGHT	D69b.EDF	D69	2
8	6091977	6091981	120	124	4	RIGHT	D69b.EDF	D69	2
8	6092096	6092096	239	239	0	RIGHT	D69b.EDF	D69	2
8	6092119	6092221	262	364	102	RIGHT	D69b.EDF	D69	2
8	6092746	6092848	889	991	102	RIGHT	D69b.EDF	D69	2
8	6093602	6093659	1745	1802	57	RIGHT	D69b.EDF	D69	2
8	6095808	6095886	3951	4029	78	RIGHT	D69b.EDF	D69	2
8	6096398	6096476	4541	4619	78	RIGHT	D69b.EDF	D69	2
8	6096650	6096756	4793	4899	106	RIGHT	D69b.EDF	D69	2
8	6097008	6097107	5151	5250	99	RIGHT	D69b.EDF	D69	2
9	6098789	6098835	58	104	46	RIGHT	D69b.EDF	D69	2
9	6099358	6099622	627	891	264	RIGHT	D69b.EDF	D69	2
9	6100923	6100994	2192	2263	71	RIGHT	D69b.EDF	D69	2
9	6101608	6101707	2877	2976	99	RIGHT	D69b.EDF	D69	2
9	6102413	6102501	3682	3770	88	RIGHT	D69b.EDF	D69	2
9	6102815	6102934	4084	4203	119	RIGHT	D69b.EDF	D69	2
9	6103081	6103187	4350	4456	106	RIGHT	D69b.EDF	D69	2
9	6103561	6103656	4830	4925	95	RIGHT	D69b.EDF	D69	2
10	6106554	6106659	469	574	105	RIGHT	D69b.EDF	D69	2
10	6106691	6106694	606	609	3	RIGHT	D69b.EDF	D69	2
10	6106734	6106735	649	650	1	RIGHT	D69b.EDF	D69	2
10	6106998	6107164	913	1079	166	RIGHT	D69b.EDF	D69	2
10	6107382	6107528	1297	1443	146	RIGHT	D69b.EDF	D69	2
10	6109801	6109881	3716	3796	80	RIGHT	D69b.EDF	D69	2
10	6110382	6110471	4297	4386	89	RIGHT	D69b.EDF	D69	2
10	6111211	6111299	5126	5214	88	RIGHT	D69b.EDF	D69	2
10	6111831	6111918	5746	5833	87	RIGHT	D69b.EDF	D69	2
10	6112107	6112193	6022	6108	86	RIGHT	D69b.EDF	D69	2
11	6115102	6115198	547	643	96	RIGHT	D69b.EDF	D69	2
11	6115250	6115250	695	695	0	RIGHT	D69b.EDF	D69	2
11	6115387	6115516	832	961	129	RIGHT	D69b.EDF	D69	2
11	6115871	6115974	1316	1419	103	RIGHT	D69b.EDF	D69	2
11	6117863	6117954	3308	3399	91	RIGHT	D69b.EDF	D69	2
11	6118713	6118791	4158	4236	78	RIGHT	D69b.EDF	D69	2
11	6119566	6119653	5011	5098	87	RIGHT	D69b.EDF	D69	2
11	6120218	6120310	5663	5755	92	RIGHT	D69b.EDF	D69	2
11	6120487	6120594	5932	6039	107	RIGHT	D69b.EDF	D69	2
11	6121004	6121088	6449	6533	84	RIGHT	D69b.EDF	D69	2
12	6123028	6123139	74	185	111	RIGHT	D69b.EDF	D69	2
12	6123485	6123603	531	649	118	RIGHT	D69b.EDF	D69	2
12	6123650	6123650	696	696	0	RIGHT	D69b.EDF	D69	2
12	6123671	6123675	717	721	4	RIGHT	D69b.EDF	D69	2
12	6123982	6124085	1028	1131	103	RIGHT	D69b.EDF	D69	2
12	6124495	6124594	1541	1640	99	RIGHT	D69b.EDF	D69	2
12	6125875	6125965	2921	3011	90	RIGHT	D69b.EDF	D69	2
12	6126355	6126487	3401	3533	132	RIGHT	D69b.EDF	D69	2
12	6126630	6126746	3676	3792	116	RIGHT	D69b.EDF	D69	2
12	6127093	6127364	4139	4410	271	RIGHT	D69b.EDF	D69	2
12	6127703	6127995	4749	5041	292	RIGHT	D69b.EDF	D69	2
13	6129958	6130037	59	138	79	RIGHT	D69b.EDF	D69	2
13	6130252	6130337	353	438	85	RIGHT	D69b.EDF	D69	2
13	6130834	6131142	935	1243	308	RIGHT	D69b.EDF	D69	2
13	6132810	6132907	2911	3008	97	RIGHT	D69b.EDF	D69	2
13	6133059	6133181	3160	3282	122	RIGHT	D69b.EDF	D69	2
13	6133525	6133642	3626	3743	117	RIGHT	D69b.EDF	D69	2
13	6133760	6133871	3861	3972	111	RIGHT	D69b.EDF	D69	2
13	6134196	6134308	4297	4409	112	RIGHT	D69b.EDF	D69	2
13	6134450	6134559	4551	4660	109	RIGHT	D69b.EDF	D69	2
13	6134687	6134804	4788	4905	117	RIGHT	D69b.EDF	D69	2
13	6135369	6135471	5470	5572	102	RIGHT	D69b.EDF	D69	2
13	6135803	6135893	5904	5994	90	RIGHT	D69b.EDF	D69	2
13	6136403	6136491	6504	6592	88	RIGHT	D69b.EDF	D69	2
14	6138203	6138242	57	96	39	RIGHT	D69b.EDF	D69	2
14	6138681	6138820	535	674	139	RIGHT	D69b.EDF	D69	2
14	6139064	6139196	918	1050	132	RIGHT	D69b.EDF	D69	2
14	6140495	6140580	2349	2434	85	RIGHT	D69b.EDF	D69	2
14	6141183	6141263	3037	3117	80	RIGHT	D69b.EDF	D69	2
14	6142070	6142156	3924	4010	86	RIGHT	D69b.EDF	D69	2
15	6145249	6145347	492	590	98	RIGHT	D69b.EDF	D69	2
15	6145414	6145415	657	658	1	RIGHT	D69b.EDF	D69	2
15	6145448	6145449	691	692	1	RIGHT	D69b.EDF	D69	2
15	6145812	6146075	1055	1318	263	RIGHT	D69b.EDF	D69	2
15	6146221	6146223	1464	1466	2	RIGHT	D69b.EDF	D69	2
15	6148161	6148235	3404	3478	74	RIGHT	D69b.EDF	D69	2
15	6149084	6149155	4327	4398	71	RIGHT	D69b.EDF	D69	2
15	6149902	6149974	5145	5217	72	RIGHT	D69b.EDF	D69	2
15	6150639	6150718	5882	5961	79	RIGHT	D69b.EDF	D69	2
15	6150825	6150826	6068	6069	1	RIGHT	D69b.EDF	D69	2
15	6151177	6151230	6420	6473	53	RIGHT	D69b.EDF	D69	2
16	6153871	6154134	651	914	263	RIGHT	D69b.EDF	D69	2
16	6154225	6154225	1005	1005	0	RIGHT	D69b.EDF	D69	2
16	6155258	6155353	2038	2133	95	RIGHT	D69b.EDF	D69	2
16	6155502	6155620	2282	2400	118	RIGHT	D69b.EDF	D69	2
16	6156312	6156403	3092	3183	91	RIGHT	D69b.EDF	D69	2
16	6156844	6157108	3624	3888	264	RIGHT	D69b.EDF	D69	2
16	6157892	6158152	4672	4932	260	RIGHT	D69b.EDF	D69	2
16	6158584	6158870	5364	5650	286	RIGHT	D69b.EDF	D69	2
17	6161458	6161574	541	657	116	RIGHT	D69b.EDF	D69	2
17	6162104	6162233	1187	1316	129	RIGHT	D69b.EDF	D69	2
17	6163992	6164091	3075	3174	99	RIGHT	D69b.EDF	D69	2
17	6164912	6164961	3995	4044	49	RIGHT	D69b.EDF	D69	2
17	6165168	6165268	4251	4351	100	RIGHT	D69b.EDF	D69	2
17	6166694	6166779	5777	5862	85	RIGHT	D69b.EDF	D69	2
17	6166946	6167056	6029	6139	110	RIGHT	D69b.EDF	D69	2
17	6167271	6167278	6354	6361	7	RIGHT	D69b.EDF	D69	2
18	6169516	6169541	58	83	25	RIGHT	D69b.EDF	D69	2
18	6170448	6170452	990	994	4	RIGHT	D69b.EDF	D69	2
18	6170482	6170736	1024	1278	254	RIGHT	D69b.EDF	D69	2
18	6172455	6172545	2997	3087	90	RIGHT	D69b.EDF	D69	2
18	6172582	6172607	3124	3149	25	RIGHT	D69b.EDF	D69	2
18	6172635	6172635	3177	3177	0	RIGHT	D69b.EDF	D69	2
18	6172696	6172825	3238	3367	129	RIGHT	D69b.EDF	D69	2
18	6173783	6173868	4325	4410	85	RIGHT	D69b.EDF	D69	2
18	6174415	6174512	4957	5054	97	RIGHT	D69b.EDF	D69	2
18	6174710	6174823	5252	5365	113	RIGHT	D69b.EDF	D69	2
18	6175359	6175475	5901	6017	116	RIGHT	D69b.EDF	D69	2
18	6175849	6175949	6391	6491	100	RIGHT	D69b.EDF	D69	2
18	6176037	6176037	6579	6579	0	RIGHT	D69b.EDF	D69	2
19	6178395	6178400	81	86	5	RIGHT	D69b.EDF	D69	2
19	6178423	6178544	109	230	121	RIGHT	D69b.EDF	D69	2
19	6179087	6179179	773	865	92	RIGHT	D69b.EDF	D69	2
19	6179539	6179656	1225	1342	117	RIGHT	D69b.EDF	D69	2
19	6180890	6180973	2576	2659	83	RIGHT	D69b.EDF	D69	2
19	6181766	6181851	3452	3537	85	RIGHT	D69b.EDF	D69	2
19	6182345	6182433	4031	4119	88	RIGHT	D69b.EDF	D69	2
19	6182529	6182542	4215	4228	13	RIGHT	D69b.EDF	D69	2
19	6182571	6182571	4257	4257	0	RIGHT	D69b.EDF	D69	2
20	6185517	6185801	654	938	284	RIGHT	D69b.EDF	D69	2
20	6185891	6185916	1028	1053	25	RIGHT	D69b.EDF	D69	2
20	6186394	6186534	1531	1671	140	RIGHT	D69b.EDF	D69	2
20	6186638	6186644	1775	1781	6	RIGHT	D69b.EDF	D69	2
20	6187266	6187490	2403	2627	224	RIGHT	D69b.EDF	D69	2
20	6187536	6187545	2673	2682	9	RIGHT	D69b.EDF	D69	2
20	6187701	6187863	2838	3000	162	RIGHT	D69b.EDF	D69	2
20	6187914	6187915	3051	3052	1	RIGHT	D69b.EDF	D69	2
20	6188082	6188406	3219	3543	324	RIGHT	D69b.EDF	D69	2
20	6188461	6188516	3598	3653	55	RIGHT	D69b.EDF	D69	2
20	6188543	6188545	3680	3682	2	RIGHT	D69b.EDF	D69	2
20	6188732	6188734	3869	3871	2	RIGHT	D69b.EDF	D69	2
20	6188761	6189012	3898	4149	251	RIGHT	D69b.EDF	D69	2
20	6189073	6189073	4210	4210	0	RIGHT	D69b.EDF	D69	2
20	6189473	6189474	4610	4611	1	RIGHT	D69b.EDF	D69	2
20	6189502	6189613	4639	4750	111	RIGHT	D69b.EDF	D69	2
21	6191531	6191828	105	402	297	RIGHT	D69b.EDF	D69	2
21	6191900	6191904	474	478	4	RIGHT	D69b.EDF	D69	2
21	6192322	6192440	896	1014	118	RIGHT	D69b.EDF	D69	2
21	6192494	6192496	1068	1070	2	RIGHT	D69b.EDF	D69	2
21	6192517	6192519	1091	1093	2	RIGHT	D69b.EDF	D69	2
21	6192738	6192740	1312	1314	2	RIGHT	D69b.EDF	D69	2
21	6192769	6192884	1343	1458	115	RIGHT	D69b.EDF	D69	2
21	6192906	6192906	1480	1480	0	RIGHT	D69b.EDF	D69	2
21	6192945	6192959	1519	1533	14	RIGHT	D69b.EDF	D69	2
21	6194314	6194408	2888	2982	94	RIGHT	D69b.EDF	D69	2
21	6195234	6195315	3808	3889	81	RIGHT	D69b.EDF	D69	2
21	6195528	6195630	4102	4204	102	RIGHT	D69b.EDF	D69	2
21	6195694	6195695	4268	4269	1	RIGHT	D69b.EDF	D69	2
21	6196336	6196435	4910	5009	99	RIGHT	D69b.EDF	D69	2
21	6196491	6196501	5065	5075	10	RIGHT	D69b.EDF	D69	2
21	6196774	6196882	5348	5456	108	RIGHT	D69b.EDF	D69	2
21	6196946	6196953	5520	5527	7	RIGHT	D69b.EDF	D69	2
21	6197243	6197342	5817	5916	99	RIGHT	D69b.EDF	D69	2
21	6197847	6197921	6421	6495	74	RIGHT	D69b.EDF	D69	2
21	6198552	6198554	7126	7128	2	RIGHT	D69b.EDF	D69	2
21	6198595	6198659	7169	7233	64	RIGHT	D69b.EDF	D69	2
22	6201252	6201367	625	740	115	RIGHT	D69b.EDF	D69	2
22	6201421	6201421	794	794	0	RIGHT	D69b.EDF	D69	2
22	6201448	6201502	821	875	54	RIGHT	D69b.EDF	D69	2
22	6201528	6201587	901	960	59	RIGHT	D69b.EDF	D69	2
22	6201615	6201635	988	1008	20	RIGHT	D69b.EDF	D69	2
22	6201691	6201782	1064	1155	91	RIGHT	D69b.EDF	D69	2
22	6202376	6202496	1749	1869	120	RIGHT	D69b.EDF	D69	2
22	6203089	6203419	2462	2792	330	RIGHT	D69b.EDF	D69	2
22	6204279	6204393	3652	3766	114	RIGHT	D69b.EDF	D69	2
22	6204455	6204491	3828	3864	36	RIGHT	D69b.EDF	D69	2
22	6204692	6204819	4065	4192	127	RIGHT	D69b.EDF	D69	2
22	6205027	6205125	4400	4498	98	RIGHT	D69b.EDF	D69	2
22	6205191	6205212	4564	4585	21	RIGHT	D69b.EDF	D69	2
22	6205245	6205246	4618	4619	1	RIGHT	D69b.EDF	D69	2
22	6205465	6205581	4838	4954	116	RIGHT	D69b.EDF	D69	2
22	6205672	6205674	5045	5047	2	RIGHT	D69b.EDF	D69	2
22	6206078	6206190	5451	5563	112	RIGHT	D69b.EDF	D69	2
22	6206421	6206543	5794	5916	122	RIGHT	D69b.EDF	D69	2
23	6208973	6209109	609	745	136	RIGHT	D69b.EDF	D69	2
23	6209168	6209221	804	857	53	RIGHT	D69b.EDF	D69	2
23	6209986	6210085	1622	1721	99	RIGHT	D69b.EDF	D69	2
23	6211371	6211495	3007	3131	124	RIGHT	D69b.EDF	D69	2
23	6212520	6212623	4156	4259	103	RIGHT	D69b.EDF	D69	2
23	6212676	6212794	4312	4430	118	RIGHT	D69b.EDF	D69	2
23	6212830	6212830	4466	4466	0	RIGHT	D69b.EDF	D69	2
23	6213446	6213568	5082	5204	122	RIGHT	D69b.EDF	D69	2
23	6214022	6214029	5658	5665	7	RIGHT	D69b.EDF	D69	2
24	6216009	6216097	58	146	88	RIGHT	D69b.EDF	D69	2
24	6216265	6216365	314	414	100	RIGHT	D69b.EDF	D69	2
24	6217200	6217300	1249	1349	100	RIGHT	D69b.EDF	D69	2
24	6217409	6217415	1458	1464	6	RIGHT	D69b.EDF	D69	2
24	6218575	6218653	2624	2702	78	RIGHT	D69b.EDF	D69	2
24	6218680	6218751	2729	2800	71	RIGHT	D69b.EDF	D69	2
24	6219153	6219154	3202	3203	1	RIGHT	D69b.EDF	D69	2
24	6219178	6219265	3227	3314	87	RIGHT	D69b.EDF	D69	2
24	6219330	6219396	3379	3445	66	RIGHT	D69b.EDF	D69	2
24	6219655	6219659	3704	3708	4	RIGHT	D69b.EDF	D69	2
24	6219687	6219788	3736	3837	101	RIGHT	D69b.EDF	D69	2
24	6219825	6219826	3874	3875	1	RIGHT	D69b.EDF	D69	2
24	6219882	6219938	3931	3987	56	RIGHT	D69b.EDF	D69	2
24	6220485	6220489	4534	4538	4	RIGHT	D69b.EDF	D69	2
24	6220512	6220619	4561	4668	107	RIGHT	D69b.EDF	D69	2
24	6220654	6220749	4703	4798	95	RIGHT	D69b.EDF	D69	2
24	6221036	6221036	5085	5085	0	RIGHT	D69b.EDF	D69	2
24	6221065	6221161	5114	5210	96	RIGHT	D69b.EDF	D69	2
24	6221198	6221213	5247	5262	15	RIGHT	D69b.EDF	D69	2
24	6221250	6221318	5299	5367	68	RIGHT	D69b.EDF	D69	2
24	6221670	6221674	5719	5723	4	RIGHT	D69b.EDF	D69	2
24	6221700	6221801	5749	5850	101	RIGHT	D69b.EDF	D69	2
24	6221871	6221871	5920	5920	0	RIGHT	D69b.EDF	D69	2
24	6221917	6221926	5966	5975	9	RIGHT	D69b.EDF	D69	2
24	6222322	6222323	6371	6372	1	RIGHT	D69b.EDF	D69	2
24	6222353	6222440	6402	6489	87	RIGHT	D69b.EDF	D69	2
25	6224764	6224784	58	78	20	RIGHT	D69b.EDF	D69	2
25	6225273	6225274	567	568	1	RIGHT	D69b.EDF	D69	2
25	6225297	6225423	591	717	126	RIGHT	D69b.EDF	D69	2
25	6225504	6225527	798	821	23	RIGHT	D69b.EDF	D69	2
25	6225763	6225891	1057	1185	128	RIGHT	D69b.EDF	D69	2
25	6226932	6227040	2226	2334	108	RIGHT	D69b.EDF	D69	2
25	6227095	6227142	2389	2436	47	RIGHT	D69b.EDF	D69	2
25	6227525	6227530	2819	2824	5	RIGHT	D69b.EDF	D69	2
25	6227554	6227693	2848	2987	139	RIGHT	D69b.EDF	D69	2
25	6227750	6227814	3044	3108	64	RIGHT	D69b.EDF	D69	2
25	6227835	6227853	3129	3147	18	RIGHT	D69b.EDF	D69	2
25	6228084	6228088	3378	3382	4	RIGHT	D69b.EDF	D69	2
25	6228114	6228206	3408	3500	92	RIGHT	D69b.EDF	D69	2
25	6228277	6228363	3571	3657	86	RIGHT	D69b.EDF	D69	2
25	6228567	6228697	3861	3991	130	RIGHT	D69b.EDF	D69	2
25	6228780	6228780	4074	4074	0	RIGHT	D69b.EDF	D69	2
25	6228802	6228835	4096	4129	33	RIGHT	D69b.EDF	D69	2
25	6228858	6228982	4152	4276	124	RIGHT	D69b.EDF	D69	2
25	6229040	6229082	4334	4376	42	RIGHT	D69b.EDF	D69	2
25	6229121	6229134	4415	4428	13	RIGHT	D69b.EDF	D69	2
25	6229171	6229173	4465	4467	2	RIGHT	D69b.EDF	D69	2
25	6229300	6229605	4594	4899	305	RIGHT	D69b.EDF	D69	2
25	6230179	6230316	5473	5610	137	RIGHT	D69b.EDF	D69	2
25	6230418	6230418	5712	5712	0	RIGHT	D69b.EDF	D69	2
25	6230885	6231003	6179	6297	118	RIGHT	D69b.EDF	D69	2
25	6231079	6231087	6373	6381	8	RIGHT	D69b.EDF	D69	2
26	6233636	6233645	604	613	9	RIGHT	D69b.EDF	D69	2
26	6233671	6233811	639	779	140	RIGHT	D69b.EDF	D69	2
26	6233957	6234093	925	1061	136	RIGHT	D69b.EDF	D69	2
26	6234168	6234168	1136	1136	0	RIGHT	D69b.EDF	D69	2
26	6234191	6234200	1159	1168	9	RIGHT	D69b.EDF	D69	2
26	6235491	6235598	2459	2566	107	RIGHT	D69b.EDF	D69	2
26	6236481	6236481	3449	3449	0	RIGHT	D69b.EDF	D69	2
26	6236506	6236604	3474	3572	98	RIGHT	D69b.EDF	D69	2
26	6236657	6236664	3625	3632	7	RIGHT	D69b.EDF	D69	2
26	6236695	6236699	3663	3667	4	RIGHT	D69b.EDF	D69	2
26	6237064	6237165	4032	4133	101	RIGHT	D69b.EDF	D69	2
26	6237219	6237260	4187	4228	41	RIGHT	D69b.EDF	D69	2
26	6237782	6237785	4750	4753	3	RIGHT	D69b.EDF	D69	2
26	6237814	6237901	4782	4869	87	RIGHT	D69b.EDF	D69	2
26	6237949	6237951	4917	4919	2	RIGHT	D69b.EDF	D69	2
26	6237972	6238023	4940	4991	51	RIGHT	D69b.EDF	D69	2
26	6238057	6238172	5025	5140	115	RIGHT	D69b.EDF	D69	2
26	6238245	6238248	5213	5216	3	RIGHT	D69b.EDF	D69	2
26	6238674	6238681	5642	5649	7	RIGHT	D69b.EDF	D69	2
26	6238704	6238808	5672	5776	104	RIGHT	D69b.EDF	D69	2
26	6238894	6238921	5862	5889	27	RIGHT	D69b.EDF	D69	2
26	6238955	6238971	5923	5939	16	RIGHT	D69b.EDF	D69	2
26	6239328	6239328	6296	6296	0	RIGHT	D69b.EDF	D69	2
26	6239352	6239451	6320	6419	99	RIGHT	D69b.EDF	D69	2
26	6239553	6239597	6521	6565	44	RIGHT	D69b.EDF	D69	2
27	6241758	6241759	131	132	1	RIGHT	D69b.EDF	D69	2
27	6241818	6241818	191	191	0	RIGHT	D69b.EDF	D69	2
27	6242216	6242322	589	695	106	RIGHT	D69b.EDF	D69	2
27	6242345	6242346	718	719	1	RIGHT	D69b.EDF	D69	2
27	6242982	6243064	1355	1437	82	RIGHT	D69b.EDF	D69	2
27	6243085	6243087	1458	1460	2	RIGHT	D69b.EDF	D69	2
27	6243136	6243136	1509	1509	0	RIGHT	D69b.EDF	D69	2
27	6243163	6243167	1536	1540	4	RIGHT	D69b.EDF	D69	2
27	6243639	6243657	2012	2030	18	RIGHT	D69b.EDF	D69	2
27	6244261	6244387	2634	2760	126	RIGHT	D69b.EDF	D69	2
27	6244424	6244494	2797	2867	70	RIGHT	D69b.EDF	D69	2
27	6244518	6244522	2891	2895	4	RIGHT	D69b.EDF	D69	2
27	6244930	6244938	3303	3311	8	RIGHT	D69b.EDF	D69	2
27	6244961	6245082	3334	3455	121	RIGHT	D69b.EDF	D69	2
27	6245125	6245128	3498	3501	3	RIGHT	D69b.EDF	D69	2
27	6245149	6245244	3522	3617	95	RIGHT	D69b.EDF	D69	2
27	6245268	6245391	3641	3764	123	RIGHT	D69b.EDF	D69	2
27	6245428	6245482	3801	3855	54	RIGHT	D69b.EDF	D69	2
27	6246010	6246016	4383	4389	6	RIGHT	D69b.EDF	D69	2
27	6246040	6246143	4413	4516	103	RIGHT	D69b.EDF	D69	2
27	6246222	6246267	4595	4640	45	RIGHT	D69b.EDF	D69	2
27	6246297	6246309	4670	4682	12	RIGHT	D69b.EDF	D69	2
27	6246560	6246560	4933	4933	0	RIGHT	D69b.EDF	D69	2
27	6246590	6246694	4963	5067	104	RIGHT	D69b.EDF	D69	2
27	6246791	6246865	5164	5238	74	RIGHT	D69b.EDF	D69	2
27	6247099	6247099	5472	5472	0	RIGHT	D69b.EDF	D69	2
27	6247126	6247259	5499	5632	133	RIGHT	D69b.EDF	D69	2
27	6247344	6247346	5717	5719	2	RIGHT	D69b.EDF	D69	2
27	6247370	6247410	5743	5783	40	RIGHT	D69b.EDF	D69	2
27	6247442	6247454	5815	5827	12	RIGHT	D69b.EDF	D69	2
27	6247492	6247561	5865	5934	69	RIGHT	D69b.EDF	D69	2
27	6247592	6247704	5965	6077	112	RIGHT	D69b.EDF	D69	2
27	6247802	6247802	6175	6175	0	RIGHT	D69b.EDF	D69	2
27	6247829	6247898	6202	6271	69	RIGHT	D69b.EDF	D69	2
27	6247923	6247980	6296	6353	57	RIGHT	D69b.EDF	D69	2
27	6248010	6248128	6383	6501	118	RIGHT	D69b.EDF	D69	2
27	6248197	6248199	6570	6572	2	RIGHT	D69b.EDF	D69	2
27	6248232	6248256	6605	6629	24	RIGHT	D69b.EDF	D69	2
27	6248308	6248308	6681	6681	0	RIGHT	D69b.EDF	D69	2
27	6248394	6248537	6767	6910	143	RIGHT	D69b.EDF	D69	2
27	6248629	6248632	7002	7005	3	RIGHT	D69b.EDF	D69	2
27	6248665	6248691	7038	7064	26	RIGHT	D69b.EDF	D69	2
28	6250514	6250515	103	104	1	RIGHT	D69b.EDF	D69	2
28	6250618	6250698	207	287	80	RIGHT	D69b.EDF	D69	2
28	6250756	6250756	345	345	0	RIGHT	D69b.EDF	D69	2
28	6251361	6251478	950	1067	117	RIGHT	D69b.EDF	D69	2
28	6251567	6251654	1156	1243	87	RIGHT	D69b.EDF	D69	2
28	6251928	6252048	1517	1637	120	RIGHT	D69b.EDF	D69	2
28	6252113	6252115	1702	1704	2	RIGHT	D69b.EDF	D69	2
28	6252144	6252165	1733	1754	21	RIGHT	D69b.EDF	D69	2
28	6252979	6253129	2568	2718	150	RIGHT	D69b.EDF	D69	2
28	6253179	6253195	2768	2784	16	RIGHT	D69b.EDF	D69	2
28	6253898	6253985	3487	3574	87	RIGHT	D69b.EDF	D69	2
28	6254029	6254095	3618	3684	66	RIGHT	D69b.EDF	D69	2
28	6254502	6254623	4091	4212	121	RIGHT	D69b.EDF	D69	2
28	6254644	6254648	4233	4237	4	RIGHT	D69b.EDF	D69	2
28	6254681	6254709	4270	4298	28	RIGHT	D69b.EDF	D69	2
28	6254731	6254746	4320	4335	15	RIGHT	D69b.EDF	D69	2
28	6255275	6255380	4864	4969	105	RIGHT	D69b.EDF	D69	2
28	6255406	6255496	4995	5085	90	RIGHT	D69b.EDF	D69	2
28	6255532	6255532	5121	5121	0	RIGHT	D69b.EDF	D69	2
28	6255969	6255970	5558	5559	1	RIGHT	D69b.EDF	D69	2
28	6255998	6256101	5587	5690	103	RIGHT	D69b.EDF	D69	2
28	6256219	6256273	5808	5862	54	RIGHT	D69b.EDF	D69	2
28	6256411	6256414	6000	6003	3	RIGHT	D69b.EDF	D69	2
28	6256448	6256559	6037	6148	111	RIGHT	D69b.EDF	D69	2
28	6256593	6256604	6182	6193	11	RIGHT	D69b.EDF	D69	2
28	6256658	6256764	6247	6353	106	RIGHT	D69b.EDF	D69	2
28	6256798	6256922	6387	6511	124	RIGHT	D69b.EDF	D69	2
28	6256953	6256954	6542	6543	1	RIGHT	D69b.EDF	D69	2
28	6256980	6256986	6569	6575	6	RIGHT	D69b.EDF	D69	2
28	6257057	6257137	6646	6726	80	RIGHT	D69b.EDF	D69	2
28	6257253	6257272	6842	6861	19	RIGHT	D69b.EDF	D69	2
28	6257299	6257433	6888	7022	134	RIGHT	D69b.EDF	D69	2
28	6257518	6257529	7107	7118	11	RIGHT	D69b.EDF	D69	2
28	6257574	6257690	7163	7279	116	RIGHT	D69b.EDF	D69	2
28	6257729	6257729	7318	7318	0	RIGHT	D69b.EDF	D69	2
28	6257803	6257847	7392	7436	44	RIGHT	D69b.EDF	D69	2
29	6259851	6259870	233	252	19	RIGHT	D69b.EDF	D69	2
29	6260241	6260244	623	626	3	RIGHT	D69b.EDF	D69	2
29	6260281	6260402	663	784	121	RIGHT	D69b.EDF	D69	2
29	6260424	6260459	806	841	35	RIGHT	D69b.EDF	D69	2
29	6260509	6260579	891	961	70	RIGHT	D69b.EDF	D69	2
29	6260749	6261052	1131	1434	303	RIGHT	D69b.EDF	D69	2
29	6261080	6261317	1462	1699	237	RIGHT	D69b.EDF	D69	2
29	6262455	6262575	2837	2957	120	RIGHT	D69b.EDF	D69	2
29	6262681	6262786	3063	3168	105	RIGHT	D69b.EDF	D69	2
29	6263812	6263813	4194	4195	1	RIGHT	D69b.EDF	D69	2
29	6263842	6263975	4224	4357	133	RIGHT	D69b.EDF	D69	2
29	6264024	6264110	4406	4492	86	RIGHT	D69b.EDF	D69	2
29	6264632	6264780	5014	5162	148	RIGHT	D69b.EDF	D69	2
29	6264876	6264963	5258	5345	87	RIGHT	D69b.EDF	D69	2
29	6265838	6265935	6220	6317	97	RIGHT	D69b.EDF	D69	2
29	6266024	6266090	6406	6472	66	RIGHT	D69b.EDF	D69	2
29	6266332	6266335	6714	6717	3	RIGHT	D69b.EDF	D69	2
29	6266361	6266478	6743	6860	117	RIGHT	D69b.EDF	D69	2
29	6266503	6266529	6885	6911	26	RIGHT	D69b.EDF	D69	2
29	6266552	6266641	6934	7023	89	RIGHT	D69b.EDF	D69	2
30	6269940	6270168	76	304	228	RIGHT	D69b.EDF	D69	2
30	6270197	6270252	333	388	55	RIGHT	D69b.EDF	D69	2
30	6270591	6270709	727	845	118	RIGHT	D69b.EDF	D69	2
30	6270753	6270826	889	962	73	RIGHT	D69b.EDF	D69	2
30	6271124	6271124	1260	1260	0	RIGHT	D69b.EDF	D69	2
30	6271157	6271278	1293	1414	121	RIGHT	D69b.EDF	D69	2
30	6271328	6271330	1464	1466	2	RIGHT	D69b.EDF	D69	2
30	6271351	6271436	1487	1572	85	RIGHT	D69b.EDF	D69	2
30	6271591	6271591	1727	1727	0	RIGHT	D69b.EDF	D69	2
30	6272804	6272919	2940	3055	115	RIGHT	D69b.EDF	D69	2
30	6272941	6273041	3077	3177	100	RIGHT	D69b.EDF	D69	2
30	6273871	6274005	4007	4141	134	RIGHT	D69b.EDF	D69	2
30	6274046	6274157	4182	4293	111	RIGHT	D69b.EDF	D69	2
30	6274180	6274183	4316	4319	3	RIGHT	D69b.EDF	D69	2
30	6274208	6274327	4344	4463	119	RIGHT	D69b.EDF	D69	2
30	6274414	6274435	4550	4571	21	RIGHT	D69b.EDF	D69	2
30	6274463	6274463	4599	4599	0	RIGHT	D69b.EDF	D69	2
31	6277092	6277553	725	1186	461	RIGHT	D69b.EDF	D69	2
31	6279581	6279581	3214	3214	0	RIGHT	D69b.EDF	D69	2
31	6279606	6279726	3239	3359	120	RIGHT	D69b.EDF	D69	2
31	6279784	6279828	3417	3461	44	RIGHT	D69b.EDF	D69	2
31	6280452	6280457	4085	4090	5	RIGHT	D69b.EDF	D69	2
31	6280483	6280560	4116	4193	77	RIGHT	D69b.EDF	D69	2
31	6280589	6280673	4222	4306	84	RIGHT	D69b.EDF	D69	2
31	6280818	6280952	4451	4585	134	RIGHT	D69b.EDF	D69	2
31	6280974	6281151	4607	4784	177	RIGHT	D69b.EDF	D69	2
31	6281190	6281303	4823	4936	113	RIGHT	D69b.EDF	D69	2
31	6282123	6282234	5756	5867	111	RIGHT	D69b.EDF	D69	2
31	6282275	6282293	5908	5926	18	RIGHT	D69b.EDF	D69	2
31	6282320	6282368	5953	6001	48	RIGHT	D69b.EDF	D69	2
31	6282793	6282796	6426	6429	3	RIGHT	D69b.EDF	D69	2
31	6282827	6282900	6460	6533	73	RIGHT	D69b.EDF	D69	2
31	6282927	6283010	6560	6643	83	RIGHT	D69b.EDF	D69	2
32	6285735	6285863	64	192	128	RIGHT	D69b.EDF	D69	2
32	6285920	6285921	249	250	1	RIGHT	D69b.EDF	D69	2
32	6285943	6285943	272	272	0	RIGHT	D69b.EDF	D69	2
32	6285997	6285997	326	326	0	RIGHT	D69b.EDF	D69	2
32	6286024	6286026	353	355	2	RIGHT	D69b.EDF	D69	2
32	6286507	6286634	836	963	127	RIGHT	D69b.EDF	D69	2
32	6286660	6286776	989	1105	116	RIGHT	D69b.EDF	D69	2
32	6287325	6287422	1654	1751	97	RIGHT	D69b.EDF	D69	2
32	6287450	6287575	1779	1904	125	RIGHT	D69b.EDF	D69	2
32	6288579	6288674	2908	3003	95	RIGHT	D69b.EDF	D69	2
32	6288751	6288781	3080	3110	30	RIGHT	D69b.EDF	D69	2
32	6289442	6289531	3771	3860	89	RIGHT	D69b.EDF	D69	2
32	6289572	6289645	3901	3974	73	RIGHT	D69b.EDF	D69	2
32	6290135	6290138	4464	4467	3	RIGHT	D69b.EDF	D69	2
32	6290169	6290271	4498	4600	102	RIGHT	D69b.EDF	D69	2
32	6290355	6290356	4684	4685	1	RIGHT	D69b.EDF	D69	2
32	6290380	6290455	4709	4784	75	RIGHT	D69b.EDF	D69	2
33	6292325	6292390	58	123	65	RIGHT	D69b.EDF	D69	2
33	6292431	6292509	164	242	78	RIGHT	D69b.EDF	D69	2
33	6292536	6292547	269	280	11	RIGHT	D69b.EDF	D69	2
33	6293073	6293078	806	811	5	RIGHT	D69b.EDF	D69	2
33	6293106	6293267	839	1000	161	RIGHT	D69b.EDF	D69	2
33	6293311	6293379	1044	1112	68	RIGHT	D69b.EDF	D69	2
33	6293630	6293739	1363	1472	109	RIGHT	D69b.EDF	D69	2
33	6293818	6293840	1551	1573	22	RIGHT	D69b.EDF	D69	2
33	6293869	6293874	1602	1607	5	RIGHT	D69b.EDF	D69	2
33	6293897	6293925	1630	1658	28	RIGHT	D69b.EDF	D69	2
33	6293949	6293951	1682	1684	2	RIGHT	D69b.EDF	D69	2
33	6293977	6293977	1710	1710	0	RIGHT	D69b.EDF	D69	2
33	6294235	6294240	1968	1973	5	RIGHT	D69b.EDF	D69	2
33	6294836	6294837	2569	2570	1	RIGHT	D69b.EDF	D69	2
33	6294859	6294963	2592	2696	104	RIGHT	D69b.EDF	D69	2
33	6295001	6295074	2734	2807	73	RIGHT	D69b.EDF	D69	2
33	6295692	6295792	3425	3525	100	RIGHT	D69b.EDF	D69	2
33	6295818	6295818	3551	3551	0	RIGHT	D69b.EDF	D69	2
33	6295840	6295964	3573	3697	124	RIGHT	D69b.EDF	D69	2
33	6296303	6296306	4036	4039	3	RIGHT	D69b.EDF	D69	2
33	6296333	6296416	4066	4149	83	RIGHT	D69b.EDF	D69	2
33	6296478	6296507	4211	4240	29	RIGHT	D69b.EDF	D69	2
33	6296681	6296686	4414	4419	5	RIGHT	D69b.EDF	D69	2
33	6296713	6296830	4446	4563	117	RIGHT	D69b.EDF	D69	2
33	6296908	6296953	4641	4686	45	RIGHT	D69b.EDF	D69	2
33	6297652	6297935	5385	5668	283	RIGHT	D69b.EDF	D69	2
33	6298005	6298388	5738	6121	383	RIGHT	D69b.EDF	D69	2
33	6298552	6298601	6285	6334	49	RIGHT	D69b.EDF	D69	2
34	6300270	6301110	57	897	840	RIGHT	D69b.EDF	D69	2
34	6301179	6302023	966	1810	844	RIGHT	D69b.EDF	D69	2
34	6302045	6302057	1832	1844	12	RIGHT	D69b.EDF	D69	2
34	6302082	6302137	1869	1924	55	RIGHT	D69b.EDF	D69	2
34	6302577	6302964	2364	2751	387	RIGHT	D69b.EDF	D69	2
34	6303026	6303040	2813	2827	14	RIGHT	D69b.EDF	D69	2
34	6303245	6303302	3032	3089	57	RIGHT	D69b.EDF	D69	2
34	6303443	6303877	3230	3664	434	RIGHT	D69b.EDF	D69	2
34	6304095	6304104	3882	3891	9	RIGHT	D69b.EDF	D69	2
34	6304128	6304279	3915	4066	151	RIGHT	D69b.EDF	D69	2
34	6304324	6304369	4111	4156	45	RIGHT	D69b.EDF	D69	2
34	6304412	6304551	4199	4338	139	RIGHT	D69b.EDF	D69	2
34	6304631	6304807	4418	4594	176	RIGHT	D69b.EDF	D69	2
34	6304852	6304854	4639	4641	2	RIGHT	D69b.EDF	D69	2
34	6305013	6305026	4800	4813	13	RIGHT	D69b.EDF	D69	2
34	6305055	6305208	4842	4995	153	RIGHT	D69b.EDF	D69	2
34	6305307	6305327	5094	5114	20	RIGHT	D69b.EDF	D69	2
34	6305371	6305506	5158	5293	135	RIGHT	D69b.EDF	D69	2
35	6307612	6307613	270	271	1	RIGHT	D69b.EDF	D69	2
35	6307832	6307865	490	523	33	RIGHT	D69b.EDF	D69	2
35	6307895	6307895	553	553	0	RIGHT	D69b.EDF	D69	2
35	6307917	6308096	575	754	179	RIGHT	D69b.EDF	D69	2
35	6308155	6308595	813	1253	440	RIGHT	D69b.EDF	D69	2
35	6308633	6308779	1291	1437	146	RIGHT	D69b.EDF	D69	2
35	6309074	6309113	1732	1771	39	RIGHT	D69b.EDF	D69	2
35	6309785	6309801	2443	2459	16	RIGHT	D69b.EDF	D69	2
35	6309835	6309846	2493	2504	11	RIGHT	D69b.EDF	D69	2
35	6309886	6309888	2544	2546	2	RIGHT	D69b.EDF	D69	2
35	6309909	6310027	2567	2685	118	RIGHT	D69b.EDF	D69	2
35	6310050	6310061	2708	2719	11	RIGHT	D69b.EDF	D69	2
35	6310317	6310594	2975	3252	277	RIGHT	D69b.EDF	D69	2
35	6311056	6311278	3714	3936	222	RIGHT	D69b.EDF	D69	2
35	6311809	6311887	4467	4545	78	RIGHT	D69b.EDF	D69	2
35	6311909	6312029	4567	4687	120	RIGHT	D69b.EDF	D69	2
36	6313999	6314109	58	168	110	RIGHT	D69b.EDF	D69	2
36	6314184	6314188	243	247	4	RIGHT	D69b.EDF	D69	2
36	6314462	6314558	521	617	96	RIGHT	D69b.EDF	D69	2
36	6314589	6314677	648	736	88	RIGHT	D69b.EDF	D69	2
36	6315191	6315429	1250	1488	238	RIGHT	D69b.EDF	D69	2
36	6316505	6316600	2564	2659	95	RIGHT	D69b.EDF	D69	2
36	6316659	6316669	2718	2728	10	RIGHT	D69b.EDF	D69	2
36	6317004	6317295	3063	3354	291	RIGHT	D69b.EDF	D69	2
36	6317879	6317883	3938	3942	4	RIGHT	D69b.EDF	D69	2
36	6317912	6317955	3971	4014	43	RIGHT	D69b.EDF	D69	2
36	6318122	6318249	4181	4308	127	RIGHT	D69b.EDF	D69	2
36	6318272	6318386	4331	4445	114	RIGHT	D69b.EDF	D69	2
36	6318409	6318440	4468	4499	31	RIGHT	D69b.EDF	D69	2
36	6318849	6319033	4908	5092	184	RIGHT	D69b.EDF	D69	2
36	6319057	6319173	5116	5232	116	RIGHT	D69b.EDF	D69	2
37	6321034	6321034	128	128	0	RIGHT	D69b.EDF	D69	2
37	6321135	6321137	229	231	2	RIGHT	D69b.EDF	D69	2
37	6321172	6321277	266	371	105	RIGHT	D69b.EDF	D69	2
37	6321307	6321402	401	496	95	RIGHT	D69b.EDF	D69	2
37	6321833	6321838	927	932	5	RIGHT	D69b.EDF	D69	2
37	6321866	6322076	960	1170	210	RIGHT	D69b.EDF	D69	2
37	6322119	6322136	1213	1230	17	RIGHT	D69b.EDF	D69	2
37	6322498	6322514	1592	1608	16	RIGHT	D69b.EDF	D69	2
37	6322536	6322736	1630	1830	200	RIGHT	D69b.EDF	D69	2
37	6323421	6323521	2515	2615	100	RIGHT	D69b.EDF	D69	2
37	6323545	6323610	2639	2704	65	RIGHT	D69b.EDF	D69	2
37	6323754	6323892	2848	2986	138	RIGHT	D69b.EDF	D69	2
37	6323916	6323919	3010	3013	3	RIGHT	D69b.EDF	D69	2
37	6323940	6323992	3034	3086	52	RIGHT	D69b.EDF	D69	2
37	6324346	6324598	3440	3692	252	RIGHT	D69b.EDF	D69	2
37	6324703	6324703	3797	3797	0	RIGHT	D69b.EDF	D69	2
37	6325054	6325056	4148	4150	2	RIGHT	D69b.EDF	D69	2
37	6325080	6325178	4174	4272	98	RIGHT	D69b.EDF	D69	2
37	6325201	6325486	4295	4580	285	RIGHT	D69b.EDF	D69	2
37	6325510	6325685	4604	4779	175	RIGHT	D69b.EDF	D69	2
37	6325710	6325772	4804	4866	62	RIGHT	D69b.EDF	D69	2
37	6325802	6325849	4896	4943	47	RIGHT	D69b.EDF	D69	2
37	6325958	6325964	5052	5058	6	RIGHT	D69b.EDF	D69	2
37	6325993	6326113	5087	5207	120	RIGHT	D69b.EDF	D69	2
37	6326136	6326201	5230	5295	65	RIGHT	D69b.EDF	D69	2
37	6326245	6326299	5339	5393	54	RIGHT	D69b.EDF	D69	2
37	6326788	6326950	5882	6044	162	RIGHT	D69b.EDF	D69	2
37	6326971	6326975	6065	6069	4	RIGHT	D69b.EDF	D69	2
37	6327027	6327043	6121	6137	16	RIGHT	D69b.EDF	D69	2
38	6329778	6329882	315	419	104	RIGHT	D69b.EDF	D69	2
38	6329910	6330018	447	555	108	RIGHT	D69b.EDF	D69	2
38	6330332	6330460	869	997	128	RIGHT	D69b.EDF	D69	2
38	6330483	6330546	1020	1083	63	RIGHT	D69b.EDF	D69	2
38	6330570	6330588	1107	1125	18	RIGHT	D69b.EDF	D69	2
38	6330979	6330982	1516	1519	3	RIGHT	D69b.EDF	D69	2
38	6331007	6331148	1544	1685	141	RIGHT	D69b.EDF	D69	2
38	6331195	6331235	1732	1772	40	RIGHT	D69b.EDF	D69	2
38	6331276	6331276	1813	1813	0	RIGHT	D69b.EDF	D69	2
38	6332181	6332457	2718	2994	276	RIGHT	D69b.EDF	D69	2
38	6333021	6333115	3558	3652	94	RIGHT	D69b.EDF	D69	2
38	6333138	6333260	3675	3797	122	RIGHT	D69b.EDF	D69	2
38	6333795	6333927	4332	4464	132	RIGHT	D69b.EDF	D69	2
38	6333970	6334102	4507	4639	132	RIGHT	D69b.EDF	D69	2
38	6334569	6334664	5106	5201	95	RIGHT	D69b.EDF	D69	2
38	6334701	6334703	5238	5240	2	RIGHT	D69b.EDF	D69	2
38	6334735	6334745	5272	5282	10	RIGHT	D69b.EDF	D69	2
38	6334784	6334815	5321	5352	31	RIGHT	D69b.EDF	D69	2
38	6334837	6334985	5374	5522	148	RIGHT	D69b.EDF	D69	2
38	6335060	6335200	5597	5737	140	RIGHT	D69b.EDF	D69	2
38	6335227	6335231	5764	5768	4	RIGHT	D69b.EDF	D69	2
38	6335857	6335975	6394	6512	118	RIGHT	D69b.EDF	D69	2
38	6336007	6336015	6544	6552	8	RIGHT	D69b.EDF	D69	2
38	6336074	6336220	6611	6757	146	RIGHT	D69b.EDF	D69	2
38	6336303	6336425	6840	6962	122	RIGHT	D69b.EDF	D69	2
38	6336475	6336504	7012	7041	29	RIGHT	D69b.EDF	D69	2
38	6336539	6336539	7076	7076	0	RIGHT	D69b.EDF	D69	2
39	6338925	6338973	58	106	48	RIGHT	D69b.EDF	D69	2
39	6339002	6339244	135	377	242	RIGHT	D69b.EDF	D69	2
39	6339547	6339805	680	938	258	RIGHT	D69b.EDF	D69	2
39	6340313	6340457	1446	1590	144	RIGHT	D69b.EDF	D69	2
39	6340480	6340522	1613	1655	42	RIGHT	D69b.EDF	D69	2
39	6341177	6341404	2310	2537	227	RIGHT	D69b.EDF	D69	2
39	6341777	6341784	2910	2917	7	RIGHT	D69b.EDF	D69	2
39	6341807	6342049	2940	3182	242	RIGHT	D69b.EDF	D69	2
39	6342070	6342097	3203	3230	27	RIGHT	D69b.EDF	D69	2
39	6342137	6342196	3270	3329	59	RIGHT	D69b.EDF	D69	2
39	6342800	6342800	3933	3933	0	RIGHT	D69b.EDF	D69	2
39	6342842	6343059	3975	4192	217	RIGHT	D69b.EDF	D69	2
39	6343658	6343803	4791	4936	145	RIGHT	D69b.EDF	D69	2
40	6345762	6345857	304	399	95	RIGHT	D69b.EDF	D69	2
40	6345882	6345953	424	495	71	RIGHT	D69b.EDF	D69	2
40	6346530	6346532	1072	1074	2	RIGHT	D69b.EDF	D69	2
40	6346565	6346675	1107	1217	110	RIGHT	D69b.EDF	D69	2
40	6346746	6346789	1288	1331	43	RIGHT	D69b.EDF	D69	2
40	6347104	6347189	1646	1731	85	RIGHT	D69b.EDF	D69	2
40	6347211	6347215	1753	1757	4	RIGHT	D69b.EDF	D69	2
40	6347277	6347310	1819	1852	33	RIGHT	D69b.EDF	D69	2
40	6347331	6347366	1873	1908	35	RIGHT	D69b.EDF	D69	2
40	6347908	6348007	2450	2549	99	RIGHT	D69b.EDF	D69	2
40	6348034	6348088	2576	2630	54	RIGHT	D69b.EDF	D69	2
40	6348169	6348319	2711	2861	150	RIGHT	D69b.EDF	D69	2
40	6348363	6348400	2905	2942	37	RIGHT	D69b.EDF	D69	2
40	6348908	6349034	3450	3576	126	RIGHT	D69b.EDF	D69	2
40	6349056	6349078	3598	3620	22	RIGHT	D69b.EDF	D69	2
40	6349123	6349141	3665	3683	18	RIGHT	D69b.EDF	D69	2
40	6349166	6349301	3708	3843	135	RIGHT	D69b.EDF	D69	2
40	6349335	6349341	3877	3883	6	RIGHT	D69b.EDF	D69	2
40	6349377	6349410	3919	3952	33	RIGHT	D69b.EDF	D69	2
40	6349545	6349546	4087	4088	1	RIGHT	D69b.EDF	D69	2
40	6349573	6349771	4115	4313	198	RIGHT	D69b.EDF	D69	2
40	6349814	6349820	4356	4362	6	RIGHT	D69b.EDF	D69	2
40	6349853	6349908	4395	4450	55	RIGHT	D69b.EDF	D69	2
40	6350029	6350207	4571	4749	178	RIGHT	D69b.EDF	D69	2
40	6350308	6350310	4850	4852	2	RIGHT	D69b.EDF	D69	2
40	6350381	6350383	4923	4925	2	RIGHT	D69b.EDF	D69	2
40	6350422	6350422	4964	4964	0	RIGHT	D69b.EDF	D69	2
40	6350504	6350517	5046	5059	13	RIGHT	D69b.EDF	D69	2
40	6350547	6350689	5089	5231	142	RIGHT	D69b.EDF	D69	2
40	6350922	6351040	5464	5582	118	RIGHT	D69b.EDF	D69	2
40	6351326	6351450	5868	5992	124	RIGHT	D69b.EDF	D69	2
41	6354495	6354514	69	88	19	RIGHT	D69b.EDF	D69	2
41	6354540	6354757	114	331	217	RIGHT	D69b.EDF	D69	2
41	6354815	6354840	389	414	25	RIGHT	D69b.EDF	D69	2
41	6355147	6355387	721	961	240	RIGHT	D69b.EDF	D69	2
41	6355515	6355645	1089	1219	130	RIGHT	D69b.EDF	D69	2
41	6355671	6355805	1245	1379	134	RIGHT	D69b.EDF	D69	2
41	6355891	6355916	1465	1490	25	RIGHT	D69b.EDF	D69	2
41	6356034	6356194	1608	1768	160	RIGHT	D69b.EDF	D69	2
41	6356768	6356877	2342	2451	109	RIGHT	D69b.EDF	D69	2
41	6357512	6357629	3086	3203	117	RIGHT	D69b.EDF	D69	2
41	6357654	6357658	3228	3232	4	RIGHT	D69b.EDF	D69	2
41	6357713	6357726	3287	3300	13	RIGHT	D69b.EDF	D69	2
41	6358055	6358056	3629	3630	1	RIGHT	D69b.EDF	D69	2
41	6358079	6358354	3653	3928	275	RIGHT	D69b.EDF	D69	2
41	6358378	6358383	3952	3957	5	RIGHT	D69b.EDF	D69	2
41	6358937	6359123	4511	4697	186	RIGHT	D69b.EDF	D69	2
41	6359155	6359157	4729	4731	2	RIGHT	D69b.EDF	D69	2
41	6359275	6359298	4849	4872	23	RIGHT	D69b.EDF	D69	2
42	6361663	6361703	75	115	40	RIGHT	D69b.EDF	D69	2
42	6362229	6362456	641	868	227	RIGHT	D69b.EDF	D69	2
42	6362494	6362500	906	912	6	RIGHT	D69b.EDF	D69	2
42	6363266	6363417	1678	1829	151	RIGHT	D69b.EDF	D69	2
42	6363486	6363500	1898	1912	14	RIGHT	D69b.EDF	D69	2
42	6364224	6364327	2636	2739	103	RIGHT	D69b.EDF	D69	2
42	6364357	6364398	2769	2810	41	RIGHT	D69b.EDF	D69	2
42	6364988	6365131	3400	3543	143	RIGHT	D69b.EDF	D69	2
42	6365217	6365248	3629	3660	31	RIGHT	D69b.EDF	D69	2
42	6365860	6365956	4272	4368	96	RIGHT	D69b.EDF	D69	2
42	6366019	6366053	4431	4465	34	RIGHT	D69b.EDF	D69	2
42	6366238	6366238	4650	4650	0	RIGHT	D69b.EDF	D69	2
42	6366270	6366412	4682	4824	142	RIGHT	D69b.EDF	D69	2
42	6366524	6366549	4936	4961	25	RIGHT	D69b.EDF	D69	2
42	6366919	6366926	5331	5338	7	RIGHT	D69b.EDF	D69	2
42	6366953	6367209	5365	5621	256	RIGHT	D69b.EDF	D69	2
42	6367230	6367253	5642	5665	23	RIGHT	D69b.EDF	D69	2
43	6369456	6369462	72	78	6	RIGHT	D69b.EDF	D69	2
43	6369484	6369848	100	464	364	RIGHT	D69b.EDF	D69	2
43	6370394	6370401	1010	1017	7	RIGHT	D69b.EDF	D69	2
43	6370434	6370592	1050	1208	158	RIGHT	D69b.EDF	D69	2
43	6370696	6371010	1312	1626	314	RIGHT	D69b.EDF	D69	2
43	6371857	6371959	2473	2575	102	RIGHT	D69b.EDF	D69	2
43	6372000	6372077	2616	2693	77	RIGHT	D69b.EDF	D69	2
43	6372656	6372664	3272	3280	8	RIGHT	D69b.EDF	D69	2
43	6372688	6372785	3304	3401	97	RIGHT	D69b.EDF	D69	2
43	6372827	6372906	3443	3522	79	RIGHT	D69b.EDF	D69	2
43	6373326	6373332	3942	3948	6	RIGHT	D69b.EDF	D69	2
43	6373355	6373471	3971	4087	116	RIGHT	D69b.EDF	D69	2
43	6373494	6373508	4110	4124	14	RIGHT	D69b.EDF	D69	2
43	6373552	6373833	4168	4449	281	RIGHT	D69b.EDF	D69	2
43	6373877	6373958	4493	4574	81	RIGHT	D69b.EDF	D69	2
43	6374415	6374418	5031	5034	3	RIGHT	D69b.EDF	D69	2
43	6374446	6374527	5062	5143	81	RIGHT	D69b.EDF	D69	2
43	6374596	6374669	5212	5285	73	RIGHT	D69b.EDF	D69	2
43	6375119	6375206	5735	5822	87	RIGHT	D69b.EDF	D69	2
43	6375279	6375327	5895	5943	48	RIGHT	D69b.EDF	D69	2
44	6377407	6377714	57	364	307	RIGHT	D69b.EDF	D69	2
44	6377779	6377849	429	499	70	RIGHT	D69b.EDF	D69	2
44	6377978	6378029	628	679	51	RIGHT	D69b.EDF	D69	2
44	6378373	6378387	1023	1037	14	RIGHT	D69b.EDF	D69	2
44	6378422	6378534	1072	1184	112	RIGHT	D69b.EDF	D69	2
44	6378580	6378652	1230	1302	72	RIGHT	D69b.EDF	D69	2
44	6378690	6378691	1340	1341	1	RIGHT	D69b.EDF	D69	2
44	6379484	6379633	2134	2283	149	RIGHT	D69b.EDF	D69	2
44	6380048	6380197	2698	2847	149	RIGHT	D69b.EDF	D69	2
44	6380219	6380322	2869	2972	103	RIGHT	D69b.EDF	D69	2
44	6380353	6380353	3003	3003	0	RIGHT	D69b.EDF	D69	2
44	6380810	6380815	3460	3465	5	RIGHT	D69b.EDF	D69	2
44	6380837	6380961	3487	3611	124	RIGHT	D69b.EDF	D69	2
44	6381027	6381052	3677	3702	25	RIGHT	D69b.EDF	D69	2
44	6381076	6381210	3726	3860	134	RIGHT	D69b.EDF	D69	2
44	6381239	6381239	3889	3889	0	RIGHT	D69b.EDF	D69	2
44	6381277	6381277	3927	3927	0	RIGHT	D69b.EDF	D69	2
44	6381301	6381310	3951	3960	9	RIGHT	D69b.EDF	D69	2
44	6381331	6381455	3981	4105	124	RIGHT	D69b.EDF	D69	2
44	6381478	6381479	4128	4129	1	RIGHT	D69b.EDF	D69	2
44	6381547	6381611	4197	4261	64	RIGHT	D69b.EDF	D69	2
44	6381811	6381931	4461	4581	120	RIGHT	D69b.EDF	D69	2
44	6381955	6381956	4605	4606	1	RIGHT	D69b.EDF	D69	2
44	6382035	6382115	4685	4765	80	RIGHT	D69b.EDF	D69	2
44	6382141	6382296	4791	4946	155	RIGHT	D69b.EDF	D69	2
44	6382318	6382322	4968	4972	4	RIGHT	D69b.EDF	D69	2
44	6382371	6382461	5021	5111	90	RIGHT	D69b.EDF	D69	2
44	6382496	6382612	5146	5262	116	RIGHT	D69b.EDF	D69	2
44	6382636	6382637	5286	5287	1	RIGHT	D69b.EDF	D69	2
44	6382752	6382771	5402	5421	19	RIGHT	D69b.EDF	D69	2
44	6382979	6382986	5629	5636	7	RIGHT	D69b.EDF	D69	2
44	6383007	6383146	5657	5796	139	RIGHT	D69b.EDF	D69	2
44	6383170	6383172	5820	5822	2	RIGHT	D69b.EDF	D69	2
44	6383276	6383297	5926	5947	21	RIGHT	D69b.EDF	D69	2
44	6383342	6383367	5992	6017	25	RIGHT	D69b.EDF	D69	2
44	6383391	6383553	6041	6203	162	RIGHT	D69b.EDF	D69	2
44	6383699	6383727	6349	6377	28	RIGHT	D69b.EDF	D69	2
44	6383769	6383769	6419	6419	0	RIGHT	D69b.EDF	D69	2
44	6383872	6383872	6522	6522	0	RIGHT	D69b.EDF	D69	2
44	6384134	6384324	6784	6974	190	RIGHT	D69b.EDF	D69	2
44	6384351	6384358	7001	7008	7	RIGHT	D69b.EDF	D69	2
45	6386414	6386575	142	303	161	RIGHT	D69b.EDF	D69	2
45	6386647	6386659	375	387	12	RIGHT	D69b.EDF	D69	2
45	6386722	6386722	450	450	0	RIGHT	D69b.EDF	D69	2
45	6386836	6386866	564	594	30	RIGHT	D69b.EDF	D69	2
45	6386998	6387007	726	735	9	RIGHT	D69b.EDF	D69	2
45	6387369	6387525	1097	1253	156	RIGHT	D69b.EDF	D69	2
45	6387620	6387620	1348	1348	0	RIGHT	D69b.EDF	D69	2
45	6387655	6387670	1383	1398	15	RIGHT	D69b.EDF	D69	2
45	6387695	6387695	1423	1423	0	RIGHT	D69b.EDF	D69	2
45	6388413	6388581	2141	2309	168	RIGHT	D69b.EDF	D69	2
45	6388658	6388672	2386	2400	14	RIGHT	D69b.EDF	D69	2
45	6388794	6388794	2522	2522	0	RIGHT	D69b.EDF	D69	2
45	6389490	6389500	3218	3228	10	RIGHT	D69b.EDF	D69	2
45	6389526	6389696	3254	3424	170	RIGHT	D69b.EDF	D69	2
45	6389750	6389917	3478	3645	167	RIGHT	D69b.EDF	D69	2
45	6390507	6390514	4235	4242	7	RIGHT	D69b.EDF	D69	2
45	6390544	6390693	4272	4421	149	RIGHT	D69b.EDF	D69	2
45	6390728	6390876	4456	4604	148	RIGHT	D69b.EDF	D69	2
45	6390904	6391139	4632	4867	235	RIGHT	D69b.EDF	D69	2
45	6391192	6391230	4920	4958	38	RIGHT	D69b.EDF	D69	2
45	6391271	6391336	4999	5064	65	RIGHT	D69b.EDF	D69	2
45	6391929	6392107	5657	5835	178	RIGHT	D69b.EDF	D69	2
45	6392211	6392223	5939	5951	12	RIGHT	D69b.EDF	D69	2
45	6392245	6392439	5973	6167	194	RIGHT	D69b.EDF	D69	2
45	6392460	6392495	6188	6223	35	RIGHT	D69b.EDF	D69	2
45	6392723	6392741	6451	6469	18	RIGHT	D69b.EDF	D69	2
45	6392772	6392868	6500	6596	96	RIGHT	D69b.EDF	D69	2
46	6395042	6395166	62	186	124	RIGHT	D69b.EDF	D69	2
46	6395198	6395203	218	223	5	RIGHT	D69b.EDF	D69	2
46	6395649	6395873	669	893	224	RIGHT	D69b.EDF	D69	2
46	6395918	6396032	938	1052	114	RIGHT	D69b.EDF	D69	2
46	6396121	6396160	1141	1180	39	RIGHT	D69b.EDF	D69	2
46	6396199	6396379	1219	1399	180	RIGHT	D69b.EDF	D69	2
46	6396451	6396487	1471	1507	36	RIGHT	D69b.EDF	D69	2
46	6396512	6396580	1532	1600	68	RIGHT	D69b.EDF	D69	2
46	6396601	6396639	1621	1659	38	RIGHT	D69b.EDF	D69	2
46	6396668	6396697	1688	1717	29	RIGHT	D69b.EDF	D69	2
46	6396840	6396865	1860	1885	25	RIGHT	D69b.EDF	D69	2
46	6397432	6397597	2452	2617	165	RIGHT	D69b.EDF	D69	2
46	6397640	6397752	2660	2772	112	RIGHT	D69b.EDF	D69	2
46	6397960	6397962	2980	2982	2	RIGHT	D69b.EDF	D69	2
46	6397991	6398307	3011	3327	316	RIGHT	D69b.EDF	D69	2
46	6398405	6398523	3425	3543	118	RIGHT	D69b.EDF	D69	2
46	6398546	6398589	3566	3609	43	RIGHT	D69b.EDF	D69	2
46	6398621	6398625	3641	3645	4	RIGHT	D69b.EDF	D69	2
46	6398694	6398694	3714	3714	0	RIGHT	D69b.EDF	D69	2
46	6398931	6398950	3951	3970	19	RIGHT	D69b.EDF	D69	2
46	6398976	6399128	3996	4148	152	RIGHT	D69b.EDF	D69	2
46	6399249	6399325	4269	4345	76	RIGHT	D69b.EDF	D69	2
46	6399368	6399734	4388	4754	366	RIGHT	D69b.EDF	D69	2
46	6399763	6399763	4783	4783	0	RIGHT	D69b.EDF	D69	2
46	6399822	6399928	4842	4948	106	RIGHT	D69b.EDF	D69	2
46	6399965	6399965	4985	4985	0	RIGHT	D69b.EDF	D69	2
47	6402037	6402038	115	116	1	RIGHT	D69b.EDF	D69	2
47	6402065	6402099	143	177	34	RIGHT	D69b.EDF	D69	2
47	6402122	6402178	200	256	56	RIGHT	D69b.EDF	D69	2
47	6402404	6402435	482	513	31	RIGHT	D69b.EDF	D69	2
47	6402654	6402659	732	737	5	RIGHT	D69b.EDF	D69	2
47	6402688	6402835	766	913	147	RIGHT	D69b.EDF	D69	2
47	6402917	6403014	995	1092	97	RIGHT	D69b.EDF	D69	2
47	6403036	6403073	1114	1151	37	RIGHT	D69b.EDF	D69	2
47	6403097	6403113	1175	1191	16	RIGHT	D69b.EDF	D69	2
47	6403187	6403235	1265	1313	48	RIGHT	D69b.EDF	D69	2
47	6403269	6403400	1347	1478	131	RIGHT	D69b.EDF	D69	2
47	6403459	6403500	1537	1578	41	RIGHT	D69b.EDF	D69	2
47	6404881	6405011	2959	3089	130	RIGHT	D69b.EDF	D69	2
47	6405061	6405174	3139	3252	113	RIGHT	D69b.EDF	D69	2
47	6405197	6405197	3275	3275	0	RIGHT	D69b.EDF	D69	2
47	6406372	6406380	4450	4458	8	RIGHT	D69b.EDF	D69	2
47	6406409	6406490	4487	4568	81	RIGHT	D69b.EDF	D69	2
47	6406574	6406694	4652	4772	120	RIGHT	D69b.EDF	D69	2
47	6407241	6407242	5319	5320	1	RIGHT	D69b.EDF	D69	2
47	6407273	6407377	5351	5455	104	RIGHT	D69b.EDF	D69	2
48	6409363	6409363	142	142	0	RIGHT	D69b.EDF	D69	2
48	6409393	6409553	172	332	160	RIGHT	D69b.EDF	D69	2
48	6409574	6409580	353	359	6	RIGHT	D69b.EDF	D69	2
48	6409601	6409678	380	457	77	RIGHT	D69b.EDF	D69	2
48	6409855	6409896	634	675	41	RIGHT	D69b.EDF	D69	2
48	6409922	6409936	701	715	14	RIGHT	D69b.EDF	D69	2
48	6409973	6410110	752	889	137	RIGHT	D69b.EDF	D69	2
48	6410175	6410216	954	995	41	RIGHT	D69b.EDF	D69	2
48	6411838	6412131	2617	2910	293	RIGHT	D69b.EDF	D69	2
48	6412179	6412248	2958	3027	69	RIGHT	D69b.EDF	D69	2
48	6412274	6412286	3053	3065	12	RIGHT	D69b.EDF	D69	2
48	6412971	6412973	3750	3752	2	RIGHT	D69b.EDF	D69	2
48	6412994	6413091	3773	3870	97	RIGHT	D69b.EDF	D69	2
48	6413125	6413186	3904	3965	61	RIGHT	D69b.EDF	D69	2
48	6413218	6413220	3997	3999	2	RIGHT	D69b.EDF	D69	2
48	6413385	6413392	4164	4171	7	RIGHT	D69b.EDF	D69	2
48	6413413	6413584	4192	4363	171	RIGHT	D69b.EDF	D69	2
48	6413610	6413614	4389	4393	4	RIGHT	D69b.EDF	D69	2
48	6413635	6413783	4414	4562	148	RIGHT	D69b.EDF	D69	2
48	6413807	6413829	4586	4608	22	RIGHT	D69b.EDF	D69	2
48	6413853	6413957	4632	4736	104	RIGHT	D69b.EDF	D69	2
48	6413983	6414480	4762	5259	497	RIGHT	D69b.EDF	D69	2
48	6414507	6414508	5286	5287	1	RIGHT	D69b.EDF	D69	2
48	6414554	6414556	5333	5335	2	RIGHT	D69b.EDF	D69	2
48	6414767	6414822	5546	5601	55	RIGHT	D69b.EDF	D69	2
49	6418123	6418123	87	87	0	RIGHT	D69b.EDF	D69	2
49	6418154	6418159	118	123	5	RIGHT	D69b.EDF	D69	2
49	6418189	6418335	153	299	146	RIGHT	D69b.EDF	D69	2
49	6418389	6418524	353	488	135	RIGHT	D69b.EDF	D69	2
49	6418701	6418937	665	901	236	RIGHT	D69b.EDF	D69	2
49	6419223	6419606	1187	1570	383	RIGHT	D69b.EDF	D69	2
49	6420495	6420581	2459	2545	86	RIGHT	D69b.EDF	D69	2
49	6420624	6420669	2588	2633	45	RIGHT	D69b.EDF	D69	2
49	6421076	6421359	3040	3323	283	RIGHT	D69b.EDF	D69	2
49	6421390	6421391	3354	3355	1	RIGHT	D69b.EDF	D69	2
49	6421739	6421892	3703	3856	153	RIGHT	D69b.EDF	D69	2
49	6421914	6421926	3878	3890	12	RIGHT	D69b.EDF	D69	2
49	6421980	6422172	3944	4136	192	RIGHT	D69b.EDF	D69	2
49	6422346	6422353	4310	4317	7	RIGHT	D69b.EDF	D69	2
49	6422378	6422653	4342	4617	275	RIGHT	D69b.EDF	D69	2
49	6422689	6422701	4653	4665	12	RIGHT	D69b.EDF	D69	2
49	6422728	6422730	4692	4694	2	RIGHT	D69b.EDF	D69	2
49	6422757	6422871	4721	4835	114	RIGHT	D69b.EDF	D69	2
49	6423157	6423399	5121	5363	242	RIGHT	D69b.EDF	D69	2
49	6423428	6423545	5392	5509	117	RIGHT	D69b.EDF	D69	2
49	6423571	6423579	5535	5543	8	RIGHT	D69b.EDF	D69	2
49	6423609	6423633	5573	5597	24	RIGHT	D69b.EDF	D69	2
49	6423731	6423742	5695	5706	11	RIGHT	D69b.EDF	D69	2
49	6423861	6423868	5825	5832	7	RIGHT	D69b.EDF	D69	2
50	6426079	6426227	57	205	148	RIGHT	D69b.EDF	D69	2
50	6426253	6426388	231	366	135	RIGHT	D69b.EDF	D69	2
50	6426433	6426511	411	489	78	RIGHT	D69b.EDF	D69	2
50	6426536	6426536	514	514	0	RIGHT	D69b.EDF	D69	2
50	6426570	6426891	548	869	321	RIGHT	D69b.EDF	D69	2
50	6426929	6426935	907	913	6	RIGHT	D69b.EDF	D69	2
50	6426956	6427126	934	1104	170	RIGHT	D69b.EDF	D69	2
50	6427156	6427270	1134	1248	114	RIGHT	D69b.EDF	D69	2
50	6427292	6427326	1270	1304	34	RIGHT	D69b.EDF	D69	2
50	6427363	6427366	1341	1344	3	RIGHT	D69b.EDF	D69	2
50	6427387	6427586	1365	1564	199	RIGHT	D69b.EDF	D69	2
50	6427628	6427629	1606	1607	1	RIGHT	D69b.EDF	D69	2
50	6427650	6427794	1628	1772	144	RIGHT	D69b.EDF	D69	2
50	6427815	6427820	1793	1798	5	RIGHT	D69b.EDF	D69	2
50	6427855	6427870	1833	1848	15	RIGHT	D69b.EDF	D69	2
50	6427893	6427893	1871	1871	0	RIGHT	D69b.EDF	D69	2
50	6427927	6427945	1905	1923	18	RIGHT	D69b.EDF	D69	2
50	6428632	6428947	2610	2925	315	RIGHT	D69b.EDF	D69	2
50	6428971	6428971	2949	2949	0	RIGHT	D69b.EDF	D69	2
50	6429322	6429544	3300	3522	222	RIGHT	D69b.EDF	D69	2
50	6429570	6429586	3548	3564	16	RIGHT	D69b.EDF	D69	2
50	6429610	6429783	3588	3761	173	RIGHT	D69b.EDF	D69	2
50	6429808	6429808	3786	3786	0	RIGHT	D69b.EDF	D69	2
50	6430185	6430726	4163	4704	541	RIGHT	D69b.EDF	D69	2
50	6430822	6430822	4800	4800	0	RIGHT	D69b.EDF	D69	2
50	6430862	6430888	4840	4866	26	RIGHT	D69b.EDF	D69	2
50	6430910	6431130	4888	5108	220	RIGHT	D69b.EDF	D69	2
50	6431153	6431582	5131	5560	429	RIGHT	D69b.EDF	D69	2
50	6431607	6431609	5585	5587	2	RIGHT	D69b.EDF	D69	2
50	6431637	6431639	5615	5617	2	RIGHT	D69b.EDF	D69	2
50	6431677	6431686	5655	5664	9	RIGHT	D69b.EDF	D69	2
50	6431738	6431739	5716	5717	1	RIGHT	D69b.EDF	D69	2
50	6431771	6431793	5749	5771	22	RIGHT	D69b.EDF	D69	2
51	6434020	6434589	238	807	569	RIGHT	D69b.EDF	D69	2
51	6434641	6434710	859	928	69	RIGHT	D69b.EDF	D69	2
51	6434735	6434776	953	994	41	RIGHT	D69b.EDF	D69	2
51	6434799	6434804	1017	1022	5	RIGHT	D69b.EDF	D69	2
51	6434920	6434920	1138	1138	0	RIGHT	D69b.EDF	D69	2
51	6434966	6435117	1184	1335	151	RIGHT	D69b.EDF	D69	2
51	6435220	6435588	1438	1806	368	RIGHT	D69b.EDF	D69	2
51	6436830	6436838	3048	3056	8	RIGHT	D69b.EDF	D69	2
51	6436861	6436998	3079	3216	137	RIGHT	D69b.EDF	D69	2
51	6437023	6437347	3241	3565	324	RIGHT	D69b.EDF	D69	2
51	6437376	6437376	3594	3594	0	RIGHT	D69b.EDF	D69	2
51	6437950	6437962	4168	4180	12	RIGHT	D69b.EDF	D69	2
51	6437986	6438149	4204	4367	163	RIGHT	D69b.EDF	D69	2
51	6438253	6438341	4471	4559	88	RIGHT	D69b.EDF	D69	2
51	6438372	6438382	4590	4600	10	RIGHT	D69b.EDF	D69	2
51	6438439	6438440	4657	4658	1	RIGHT	D69b.EDF	D69	2
51	6438466	6438494	4684	4712	28	RIGHT	D69b.EDF	D69	2
51	6438651	6438654	4869	4872	3	RIGHT	D69b.EDF	D69	2
51	6438695	6438863	4913	5081	168	RIGHT	D69b.EDF	D69	2
51	6438888	6438890	5106	5108	2	RIGHT	D69b.EDF	D69	2
52	6440864	6440976	57	169	112	RIGHT	D69b.EDF	D69	2
52	6441082	6441301	275	494	219	RIGHT	D69b.EDF	D69	2
52	6441335	6441350	528	543	15	RIGHT	D69b.EDF	D69	2
52	6441496	6441512	689	705	16	RIGHT	D69b.EDF	D69	2
52	6441534	6441850	727	1043	316	RIGHT	D69b.EDF	D69	2
52	6441917	6442043	1110	1236	126	RIGHT	D69b.EDF	D69	2
52	6442084	6442258	1277	1451	174	RIGHT	D69b.EDF	D69	2
52	6442297	6442364	1490	1557	67	RIGHT	D69b.EDF	D69	2
52	6442586	6442635	1779	1828	49	RIGHT	D69b.EDF	D69	2
52	6443688	6443697	2881	2890	9	RIGHT	D69b.EDF	D69	2
52	6443718	6443835	2911	3028	117	RIGHT	D69b.EDF	D69	2
52	6443883	6444004	3076	3197	121	RIGHT	D69b.EDF	D69	2
52	6444443	6444451	3636	3644	8	RIGHT	D69b.EDF	D69	2
52	6444474	6444732	3667	3925	258	RIGHT	D69b.EDF	D69	2
52	6444799	6445046	3992	4239	247	RIGHT	D69b.EDF	D69	2
52	6445196	6445211	4389	4404	15	RIGHT	D69b.EDF	D69	2
52	6445421	6445742	4614	4935	321	RIGHT	D69b.EDF	D69	2
52	6445810	6446072	5003	5265	262	RIGHT	D69b.EDF	D69	2
52	6446205	6446224	5398	5417	19	RIGHT	D69b.EDF	D69	2
52	6446253	6446515	5446	5708	262	RIGHT	D69b.EDF	D69	2
53	6448817	6448821	122	126	4	RIGHT	D69b.EDF	D69	2
53	6449367	6449368	672	673	1	RIGHT	D69b.EDF	D69	2
53	6449951	6450057	1256	1362	106	RIGHT	D69b.EDF	D69	2
53	6450078	6450079	1383	1384	1	RIGHT	D69b.EDF	D69	2
53	6450111	6450113	1416	1418	2	RIGHT	D69b.EDF	D69	2
53	6450153	6450157	1458	1462	4	RIGHT	D69b.EDF	D69	2
53	6450182	6450214	1487	1519	32	RIGHT	D69b.EDF	D69	2
53	6450377	6450427	1682	1732	50	RIGHT	D69b.EDF	D69	2
53	6450451	6450452	1756	1757	1	RIGHT	D69b.EDF	D69	2
53	6450501	6450501	1806	1806	0	RIGHT	D69b.EDF	D69	2
53	6451338	6451437	2643	2742	99	RIGHT	D69b.EDF	D69	2
53	6451467	6451509	2772	2814	42	RIGHT	D69b.EDF	D69	2
53	6452086	6452218	3391	3523	132	RIGHT	D69b.EDF	D69	2
53	6452241	6452241	3546	3546	0	RIGHT	D69b.EDF	D69	2
53	6452268	6452335	3573	3640	67	RIGHT	D69b.EDF	D69	2
53	6452445	6452454	3750	3759	9	RIGHT	D69b.EDF	D69	2
53	6452492	6452492	3797	3797	0	RIGHT	D69b.EDF	D69	2
53	6452838	6452987	4143	4292	149	RIGHT	D69b.EDF	D69	2
53	6453013	6453324	4318	4629	311	RIGHT	D69b.EDF	D69	2
53	6453346	6453594	4651	4899	248	RIGHT	D69b.EDF	D69	2
53	6453617	6453620	4922	4925	3	RIGHT	D69b.EDF	D69	2
53	6453878	6453889	5183	5194	11	RIGHT	D69b.EDF	D69	2
53	6453910	6454024	5215	5329	114	RIGHT	D69b.EDF	D69	2
53	6454056	6454065	5361	5370	9	RIGHT	D69b.EDF	D69	2
53	6454091	6454206	5396	5511	115	RIGHT	D69b.EDF	D69	2
53	6454245	6454245	5550	5550	0	RIGHT	D69b.EDF	D69	2
53	6454283	6454283	5588	5588	0	RIGHT	D69b.EDF	D69	2
53	6454524	6454541	5829	5846	17	RIGHT	D69b.EDF	D69	2
53	6454562	6454597	5867	5902	35	RIGHT	D69b.EDF	D69	2
54	6457112	6457235	433	556	123	RIGHT	D69b.EDF	D69	2
54	6457256	6457431	577	752	175	RIGHT	D69b.EDF	D69	2
54	6457775	6458008	1096	1329	233	RIGHT	D69b.EDF	D69	2
54	6458081	6458366	1402	1687	285	RIGHT	D69b.EDF	D69	2
54	6458673	6458740	1994	2061	67	RIGHT	D69b.EDF	D69	2
54	6459185	6459272	2506	2593	87	RIGHT	D69b.EDF	D69	2
54	6459313	6459382	2634	2703	69	RIGHT	D69b.EDF	D69	2
54	6459403	6459409	2724	2730	6	RIGHT	D69b.EDF	D69	2
54	6459908	6460046	3229	3367	138	RIGHT	D69b.EDF	D69	2
54	6460072	6460270	3393	3591	198	RIGHT	D69b.EDF	D69	2
54	6460784	6461151	4105	4472	367	RIGHT	D69b.EDF	D69	2
54	6461400	6461411	4721	4732	11	RIGHT	D69b.EDF	D69	2
54	6461435	6461584	4756	4905	149	RIGHT	D69b.EDF	D69	2
54	6461666	6461677	4987	4998	11	RIGHT	D69b.EDF	D69	2
54	6461698	6461831	5019	5152	133	RIGHT	D69b.EDF	D69	2
54	6461869	6461871	5190	5192	2	RIGHT	D69b.EDF	D69	2
54	6462074	6462083	5395	5404	9	RIGHT	D69b.EDF	D69	2
54	6462114	6462247	5435	5568	133	RIGHT	D69b.EDF	D69	2
54	6462307	6462311	5628	5632	4	RIGHT	D69b.EDF	D69	2
54	6462344	6462421	5665	5742	77	RIGHT	D69b.EDF	D69	2
54	6462606	6462801	5927	6122	195	RIGHT	D69b.EDF	D69	2
54	6462872	6462998	6193	6319	126	RIGHT	D69b.EDF	D69	2
54	6463031	6463043	6352	6364	12	RIGHT	D69b.EDF	D69	2
55	6464694	6464977	60	343	283	RIGHT	D69b.EDF	D69	2
55	6465060	6465060	426	426	0	RIGHT	D69b.EDF	D69	2
55	6465453	6465796	819	1162	343	RIGHT	D69b.EDF	D69	2
55	6465851	6465980	1217	1346	129	RIGHT	D69b.EDF	D69	2
55	6466002	6466002	1368	1368	0	RIGHT	D69b.EDF	D69	2
55	6466034	6466034	1400	1400	0	RIGHT	D69b.EDF	D69	2
55	6466078	6466082	1444	1448	4	RIGHT	D69b.EDF	D69	2
55	6466104	6466204	1470	1570	100	RIGHT	D69b.EDF	D69	2
55	6466226	6466336	1592	1702	110	RIGHT	D69b.EDF	D69	2
55	6466855	6466954	2221	2320	99	RIGHT	D69b.EDF	D69	2
55	6466995	6467027	2361	2393	32	RIGHT	D69b.EDF	D69	2
55	6467413	6467739	2779	3105	326	RIGHT	D69b.EDF	D69	2
55	6467761	6467942	3127	3308	181	RIGHT	D69b.EDF	D69	2
55	6467979	6467979	3345	3345	0	RIGHT	D69b.EDF	D69	2
55	6468296	6468444	3662	3810	148	RIGHT	D69b.EDF	D69	2
55	6468466	6468484	3832	3850	18	RIGHT	D69b.EDF	D69	2
55	6468534	6468570	3900	3936	36	RIGHT	D69b.EDF	D69	2
55	6468604	6468742	3970	4108	138	RIGHT	D69b.EDF	D69	2
55	6468772	6468870	4138	4236	98	RIGHT	D69b.EDF	D69	2
55	6469184	6469188	4550	4554	4	RIGHT	D69b.EDF	D69	2
55	6469209	6469470	4575	4836	261	RIGHT	D69b.EDF	D69	2
55	6469501	6469640	4867	5006	139	RIGHT	D69b.EDF	D69	2
55	6470189	6470346	5555	5712	157	RIGHT	D69b.EDF	D69	2
56	6471967	6472033	58	124	66	RIGHT	D69b.EDF	D69	2
56	6472058	6472229	149	320	171	RIGHT	D69b.EDF	D69	2
56	6472580	6472590	671	681	10	RIGHT	D69b.EDF	D69	2
56	6472611	6473083	702	1174	472	RIGHT	D69b.EDF	D69	2
56	6473110	6473276	1201	1367	166	RIGHT	D69b.EDF	D69	2
56	6473505	6473514	1596	1605	9	RIGHT	D69b.EDF	D69	2
56	6473725	6473725	1816	1816	0	RIGHT	D69b.EDF	D69	2
56	6474801	6474809	2892	2900	8	RIGHT	D69b.EDF	D69	2
56	6474831	6474921	2922	3012	90	RIGHT	D69b.EDF	D69	2
56	6474951	6475080	3042	3171	129	RIGHT	D69b.EDF	D69	2
56	6475800	6475803	3891	3894	3	RIGHT	D69b.EDF	D69	2
56	6475829	6475923	3920	4014	94	RIGHT	D69b.EDF	D69	2
56	6475975	6476030	4066	4121	55	RIGHT	D69b.EDF	D69	2
56	6476054	6476056	4145	4147	2	RIGHT	D69b.EDF	D69	2
56	6476461	6476604	4552	4695	143	RIGHT	D69b.EDF	D69	2
56	6476635	6476635	4726	4726	0	RIGHT	D69b.EDF	D69	2
56	6476661	6476721	4752	4812	60	RIGHT	D69b.EDF	D69	2
56	6476744	6476876	4835	4967	132	RIGHT	D69b.EDF	D69	2
56	6476913	6477106	5004	5197	193	RIGHT	D69b.EDF	D69	2
56	6477196	6477366	5287	5457	170	RIGHT	D69b.EDF	D69	2
56	6477394	6477430	5485	5521	36	RIGHT	D69b.EDF	D69	2
56	6477453	6477624	5544	5715	171	RIGHT	D69b.EDF	D69	2
56	6477653	6477671	5744	5762	18	RIGHT	D69b.EDF	D69	2
56	6477713	6477713	5804	5804	0	RIGHT	D69b.EDF	D69	2
56	6477757	6477759	5848	5850	2	RIGHT	D69b.EDF	D69	2
56	6477807	6477808	5898	5899	1	RIGHT	D69b.EDF	D69	2
56	6477830	6477833	5921	5924	3	RIGHT	D69b.EDF	D69	2
56	6477955	6477955	6046	6046	0	RIGHT	D69b.EDF	D69	2
56	6477983	6478110	6074	6201	127	RIGHT	D69b.EDF	D69	2
56	6478171	6478176	6262	6267	5	RIGHT	D69b.EDF	D69	2
56	6478199	6478213	6290	6304	14	RIGHT	D69b.EDF	D69	2
56	6478235	6478327	6326	6418	92	RIGHT	D69b.EDF	D69	2
57	6480593	6480697	58	162	104	RIGHT	D69b.EDF	D69	2
57	6480724	6480855	189	320	131	RIGHT	D69b.EDF	D69	2
57	6481234	6481241	699	706	7	RIGHT	D69b.EDF	D69	2
57	6481270	6481455	735	920	185	RIGHT	D69b.EDF	D69	2
57	6481496	6481894	961	1359	398	RIGHT	D69b.EDF	D69	2
57	6481920	6481936	1385	1401	16	RIGHT	D69b.EDF	D69	2
57	6481978	6481993	1443	1458	15	RIGHT	D69b.EDF	D69	2
57	6482022	6482037	1487	1502	15	RIGHT	D69b.EDF	D69	2
57	6482068	6482245	1533	1710	177	RIGHT	D69b.EDF	D69	2
57	6483582	6483698	3047	3163	116	RIGHT	D69b.EDF	D69	2
57	6483766	6483862	3231	3327	96	RIGHT	D69b.EDF	D69	2
57	6484106	6484140	3571	3605	34	RIGHT	D69b.EDF	D69	2
57	6484553	6484554	4018	4019	1	RIGHT	D69b.EDF	D69	2
57	6484579	6484718	4044	4183	139	RIGHT	D69b.EDF	D69	2
57	6484739	6484751	4204	4216	12	RIGHT	D69b.EDF	D69	2
57	6484820	6484898	4285	4363	78	RIGHT	D69b.EDF	D69	2
58	6487516	6487896	58	438	380	RIGHT	D69b.EDF	D69	2
58	6487937	6488039	479	581	102	RIGHT	D69b.EDF	D69	2
58	6488079	6488127	621	669	48	RIGHT	D69b.EDF	D69	2
58	6488158	6488398	700	940	240	RIGHT	D69b.EDF	D69	2
58	6488450	6488838	992	1380	388	RIGHT	D69b.EDF	D69	2
58	6488864	6488888	1406	1430	24	RIGHT	D69b.EDF	D69	2
58	6488929	6488931	1471	1473	2	RIGHT	D69b.EDF	D69	2
58	6489034	6489128	1576	1670	94	RIGHT	D69b.EDF	D69	2
58	6489156	6489156	1698	1698	0	RIGHT	D69b.EDF	D69	2
58	6489452	6489578	1994	2120	126	RIGHT	D69b.EDF	D69	2
58	6489606	6489706	2148	2248	100	RIGHT	D69b.EDF	D69	2
58	6489885	6489949	2427	2491	64	RIGHT	D69b.EDF	D69	2
58	6490121	6490646	2663	3188	525	RIGHT	D69b.EDF	D69	2
58	6490705	6490731	3247	3273	26	RIGHT	D69b.EDF	D69	2
58	6490780	6490826	3322	3368	46	RIGHT	D69b.EDF	D69	2
58	6491006	6491069	3548	3611	63	RIGHT	D69b.EDF	D69	2
58	6491261	6491264	3803	3806	3	RIGHT	D69b.EDF	D69	2
58	6491297	6492085	3839	4627	788	RIGHT	D69b.EDF	D69	2
58	6492199	6492274	4741	4816	75	RIGHT	D69b.EDF	D69	2
58	6492750	6493098	5292	5640	348	RIGHT	D69b.EDF	D69	2
58	6493197	6493216	5739	5758	19	RIGHT	D69b.EDF	D69	2
58	6493243	6493426	5785	5968	183	RIGHT	D69b.EDF	D69	2
58	6493499	6493662	6041	6204	163	RIGHT	D69b.EDF	D69	2
58	6493754	6493770	6296	6312	16	RIGHT	D69b.EDF	D69	2
58	6493795	6494034	6337	6576	239	RIGHT	D69b.EDF	D69	2
59	6496016	6496086	95	165	70	RIGHT	D69b.EDF	D69	2
59	6496107	6496157	186	236	50	RIGHT	D69b.EDF	D69	2
59	6496351	6496683	430	762	332	RIGHT	D69b.EDF	D69	2
59	6497086	6497090	1165	1169	4	RIGHT	D69b.EDF	D69	2
59	6497119	6497261	1198	1340	142	RIGHT	D69b.EDF	D69	2
59	6497290	6497291	1369	1370	1	RIGHT	D69b.EDF	D69	2
59	6497330	6497597	1409	1676	267	RIGHT	D69b.EDF	D69	2
59	6497618	6497669	1697	1748	51	RIGHT	D69b.EDF	D69	2
59	6497694	6497940	1773	2019	246	RIGHT	D69b.EDF	D69	2
59	6497967	6497968	2046	2047	1	RIGHT	D69b.EDF	D69	2
59	6497997	6497997	2076	2076	0	RIGHT	D69b.EDF	D69	2
59	6498023	6498036	2102	2115	13	RIGHT	D69b.EDF	D69	2
59	6499086	6499369	3165	3448	283	RIGHT	D69b.EDF	D69	2
59	6499696	6499892	3775	3971	196	RIGHT	D69b.EDF	D69	2
59	6499975	6500262	4054	4341	287	RIGHT	D69b.EDF	D69	2
59	6500915	6500924	4994	5003	9	RIGHT	D69b.EDF	D69	2
59	6500947	6501089	5026	5168	142	RIGHT	D69b.EDF	D69	2
59	6501165	6501282	5244	5361	117	RIGHT	D69b.EDF	D69	2
60	6504328	6504489	89	250	161	RIGHT	D69b.EDF	D69	2
60	6504546	6504869	307	630	323	RIGHT	D69b.EDF	D69	2
60	6504899	6505064	660	825	165	RIGHT	D69b.EDF	D69	2
60	6505111	6505112	872	873	1	RIGHT	D69b.EDF	D69	2
60	6505137	6505210	898	971	73	RIGHT	D69b.EDF	D69	2
60	6505360	6505464	1121	1225	104	RIGHT	D69b.EDF	D69	2
60	6505485	6506197	1246	1958	712	RIGHT	D69b.EDF	D69	2
60	6506995	6507133	2756	2894	138	RIGHT	D69b.EDF	D69	2
60	6507158	6507307	2919	3068	149	RIGHT	D69b.EDF	D69	2
60	6507357	6507377	3118	3138	20	RIGHT	D69b.EDF	D69	2
60	6507684	6507866	3445	3627	182	RIGHT	D69b.EDF	D69	2
60	6507935	6508020	3696	3781	85	RIGHT	D69b.EDF	D69	2
60	6508042	6508392	3803	4153	350	RIGHT	D69b.EDF	D69	2
60	6508740	6508886	4501	4647	146	RIGHT	D69b.EDF	D69	2
60	6508920	6508939	4681	4700	19	RIGHT	D69b.EDF	D69	2
60	6508994	6509322	4755	5083	328	RIGHT	D69b.EDF	D69	2
60	6509360	6509596	5121	5357	236	RIGHT	D69b.EDF	D69	2
60	6509721	6509735	5482	5496	14	RIGHT	D69b.EDF	D69	2
60	6509762	6509907	5523	5668	145	RIGHT	D69b.EDF	D69	2
60	6509990	6510152	5751	5913	162	RIGHT	D69b.EDF	D69	2
60	6510497	6510507	6258	6268	10	RIGHT	D69b.EDF	D69	2
60	6510537	6510646	6298	6407	109	RIGHT	D69b.EDF	D69	2
60	6510687	6510687	6448	6448	0	RIGHT	D69b.EDF	D69	2
60	6510764	6510831	6525	6592	67	RIGHT	D69b.EDF	D69	2
61	6513098	6513226	114	242	128	RIGHT	D69b.EDF	D69	2
61	6513250	6513459	266	475	209	RIGHT	D69b.EDF	D69	2
61	6513488	6513628	504	644	140	RIGHT	D69b.EDF	D69	2
61	6513685	6513764	701	780	79	RIGHT	D69b.EDF	D69	2
61	6513927	6513955	943	971	28	RIGHT	D69b.EDF	D69	2
61	6514023	6514023	1039	1039	0	RIGHT	D69b.EDF	D69	2
61	6514107	6514440	1123	1456	333	RIGHT	D69b.EDF	D69	2
61	6514762	6514821	1778	1837	59	RIGHT	D69b.EDF	D69	2
61	6514856	6514963	1872	1979	107	RIGHT	D69b.EDF	D69	2
61	6514984	6515164	2000	2180	180	RIGHT	D69b.EDF	D69	2
61	6515595	6515654	2611	2670	59	RIGHT	D69b.EDF	D69	2
61	6515680	6515684	2696	2700	4	RIGHT	D69b.EDF	D69	2
61	6515705	6515748	2721	2764	43	RIGHT	D69b.EDF	D69	2
61	6515821	6515829	2837	2845	8	RIGHT	D69b.EDF	D69	2
61	6515851	6515966	2867	2982	115	RIGHT	D69b.EDF	D69	2
61	6515989	6516126	3005	3142	137	RIGHT	D69b.EDF	D69	2
61	6516536	6516563	3552	3579	27	RIGHT	D69b.EDF	D69	2
61	6516821	6517254	3837	4270	433	RIGHT	D69b.EDF	D69	2
61	6517629	6517718	4645	4734	89	RIGHT	D69b.EDF	D69	2
61	6517793	6517793	4809	4809	0	RIGHT	D69b.EDF	D69	2
61	6517959	6518103	4975	5119	144	RIGHT	D69b.EDF	D69	2
61	6518239	6518245	5255	5261	6	RIGHT	D69b.EDF	D69	2
61	6518277	6518353	5293	5369	76	RIGHT	D69b.EDF	D69	2
61	6518376	6518377	5392	5393	1	RIGHT	D69b.EDF	D69	2
61	6518407	6518501	5423	5517	94	RIGHT	D69b.EDF	D69	2
61	6518766	6518776	5782	5792	10	RIGHT	D69b.EDF	D69	2
62	6520465	6520517	58	110	52	RIGHT	D69b.EDF	D69	2
62	6520880	6521157	473	750	277	RIGHT	D69b.EDF	D69	2
62	6521335	6521463	928	1056	128	RIGHT	D69b.EDF	D69	2
62	6521496	6521788	1089	1381	292	RIGHT	D69b.EDF	D69	2
62	6522653	6522790	2246	2383	137	RIGHT	D69b.EDF	D69	2
62	6522814	6522952	2407	2545	138	RIGHT	D69b.EDF	D69	2
62	6523033	6523066	2626	2659	33	RIGHT	D69b.EDF	D69	2
62	6523243	6523409	2836	3002	166	RIGHT	D69b.EDF	D69	2
62	6523437	6523449	3030	3042	12	RIGHT	D69b.EDF	D69	2
62	6523483	6523567	3076	3160	84	RIGHT	D69b.EDF	D69	2
62	6523595	6523736	3188	3329	141	RIGHT	D69b.EDF	D69	2
62	6523758	6523924	3351	3517	166	RIGHT	D69b.EDF	D69	2
62	6523946	6524050	3539	3643	104	RIGHT	D69b.EDF	D69	2
62	6524078	6524227	3671	3820	149	RIGHT	D69b.EDF	D69	2
62	6524249	6524351	3842	3944	102	RIGHT	D69b.EDF	D69	2
62	6524380	6524643	3973	4236	263	RIGHT	D69b.EDF	D69	2
62	6524668	6525006	4261	4599	338	RIGHT	D69b.EDF	D69	2
62	6525033	6525033	4626	4626	0	RIGHT	D69b.EDF	D69	2
62	6525129	6525152	4722	4745	23	RIGHT	D69b.EDF	D69	2
62	6525177	6525302	4770	4895	125	RIGHT	D69b.EDF	D69	2
62	6525330	6525532	4923	5125	202	RIGHT	D69b.EDF	D69	2
62	6525559	6525690	5152	5283	131	RIGHT	D69b.EDF	D69	2
62	6525730	6525931	5323	5524	201	RIGHT	D69b.EDF	D69	2
63	6528185	6528189	82	86	4	RIGHT	D69b.EDF	D69	2
63	6528212	6528215	109	112	3	RIGHT	D69b.EDF	D69	2
63	6528237	6528242	134	139	5	RIGHT	D69b.EDF	D69	2
63	6528263	6528390	160	287	127	RIGHT	D69b.EDF	D69	2
63	6528416	6528574	313	471	158	RIGHT	D69b.EDF	D69	2
63	6528682	6528707	579	604	25	RIGHT	D69b.EDF	D69	2
63	6528728	6528870	625	767	142	RIGHT	D69b.EDF	D69	2
63	6528892	6529239	789	1136	347	RIGHT	D69b.EDF	D69	2
63	6529264	6529419	1161	1316	155	RIGHT	D69b.EDF	D69	2
63	6529452	6529462	1349	1359	10	RIGHT	D69b.EDF	D69	2
63	6529518	6529751	1415	1648	233	RIGHT	D69b.EDF	D69	2
63	6530064	6530133	1961	2030	69	RIGHT	D69b.EDF	D69	2
63	6530164	6530179	2061	2076	15	RIGHT	D69b.EDF	D69	2
63	6531178	6531297	3075	3194	119	RIGHT	D69b.EDF	D69	2
63	6531322	6531479	3219	3376	157	RIGHT	D69b.EDF	D69	2
63	6531945	6532071	3842	3968	126	RIGHT	D69b.EDF	D69	2
63	6532095	6532278	3992	4175	183	RIGHT	D69b.EDF	D69	2
63	6532524	6532540	4421	4437	16	RIGHT	D69b.EDF	D69	2
63	6532565	6532662	4462	4559	97	RIGHT	D69b.EDF	D69	2
63	6532691	6532942	4588	4839	251	RIGHT	D69b.EDF	D69	2
63	6532965	6532967	4862	4864	2	RIGHT	D69b.EDF	D69	2
63	6532988	6533010	4885	4907	22	RIGHT	D69b.EDF	D69	2
63	6533204	6533324	5101	5221	120	RIGHT	D69b.EDF	D69	2
63	6533356	6533550	5253	5447	194	RIGHT	D69b.EDF	D69	2
63	6533574	6533894	5471	5791	320	RIGHT	D69b.EDF	D69	2
63	6533915	6533924	5812	5821	9	RIGHT	D69b.EDF	D69	2
63	6534042	6534055	5939	5952	13	RIGHT	D69b.EDF	D69	2
64	6536848	6536965	172	289	117	RIGHT	D69b.EDF	D69	2
64	6537216	6537223	540	547	7	RIGHT	D69b.EDF	D69	2
64	6537362	6537375	686	699	13	RIGHT	D69b.EDF	D69	2
64	6537404	6537666	728	990	262	RIGHT	D69b.EDF	D69	2
64	6537695	6537697	1019	1021	2	RIGHT	D69b.EDF	D69	2
64	6537764	6538007	1088	1331	243	RIGHT	D69b.EDF	D69	2
64	6538032	6538167	1356	1491	135	RIGHT	D69b.EDF	D69	2
64	6538194	6538240	1518	1564	46	RIGHT	D69b.EDF	D69	2
64	6538275	6538453	1599	1777	178	RIGHT	D69b.EDF	D69	2
64	6538475	6538507	1799	1831	32	RIGHT	D69b.EDF	D69	2
64	6539760	6539917	3084	3241	157	RIGHT	D69b.EDF	D69	2
64	6539958	6539958	3282	3282	0	RIGHT	D69b.EDF	D69	2
64	6539985	6540158	3309	3482	173	RIGHT	D69b.EDF	D69	2
64	6540641	6540650	3965	3974	9	RIGHT	D69b.EDF	D69	2
64	6540675	6540787	3999	4111	112	RIGHT	D69b.EDF	D69	2
64	6540808	6541030	4132	4354	222	RIGHT	D69b.EDF	D69	2
64	6541052	6541094	4376	4418	42	RIGHT	D69b.EDF	D69	2
64	6541116	6541241	4440	4565	125	RIGHT	D69b.EDF	D69	2
64	6541269	6541279	4593	4603	10	RIGHT	D69b.EDF	D69	2
64	6541345	6541505	4669	4829	160	RIGHT	D69b.EDF	D69	2
64	6541537	6541663	4861	4987	126	RIGHT	D69b.EDF	D69	2
64	6541699	6541889	5023	5213	190	RIGHT	D69b.EDF	D69	2
64	6541925	6542054	5249	5378	129	RIGHT	D69b.EDF	D69	2
64	6542085	6542175	5409	5499	90	RIGHT	D69b.EDF	D69	2
64	6542200	6542418	5524	5742	218	RIGHT	D69b.EDF	D69	2
64	6542442	6542626	5766	5950	184	RIGHT	D69b.EDF	D69	2
64	6542648	6542783	5972	6107	135	RIGHT	D69b.EDF	D69	2
64	6542812	6543040	6136	6364	228	RIGHT	D69b.EDF	D69	2
64	6543062	6543475	6386	6799	413	RIGHT	D69b.EDF	D69	2
64	6543508	6543629	6832	6953	121	RIGHT	D69b.EDF	D69	2
64	6543664	6543664	6988	6988	0	RIGHT	D69b.EDF	D69	2
64	6543687	6543717	7011	7041	30	RIGHT	D69b.EDF	D69	2
64	6543745	6543797	7069	7121	52	RIGHT	D69b.EDF	D69	2
64	6543845	6543902	7169	7226	57	RIGHT	D69b.EDF	D69	2
65	6545912	6546190	58	336	278	RIGHT	D69b.EDF	D69	2
65	6546485	6546505	631	651	20	RIGHT	D69b.EDF	D69	2
65	6546528	6546806	674	952	278	RIGHT	D69b.EDF	D69	2
65	6546827	6547137	973	1283	310	RIGHT	D69b.EDF	D69	2
65	6547238	6547269	1384	1415	31	RIGHT	D69b.EDF	D69	2
65	6547490	6547650	1636	1796	160	RIGHT	D69b.EDF	D69	2
65	6547678	6547992	1824	2138	314	RIGHT	D69b.EDF	D69	2
65	6549048	6549061	3194	3207	13	RIGHT	D69b.EDF	D69	2
65	6549086	6549177	3232	3323	91	RIGHT	D69b.EDF	D69	2
65	6549203	6549392	3349	3538	189	RIGHT	D69b.EDF	D69	2
65	6549901	6549909	4047	4055	8	RIGHT	D69b.EDF	D69	2
65	6550132	6550147	4278	4293	15	RIGHT	D69b.EDF	D69	2
65	6550173	6550269	4319	4415	96	RIGHT	D69b.EDF	D69	2
65	6550305	6550450	4451	4596	145	RIGHT	D69b.EDF	D69	2
65	6550789	6550876	4935	5022	87	RIGHT	D69b.EDF	D69	2
66	6552873	6552978	94	199	105	RIGHT	D69b.EDF	D69	2
66	6553006	6553023	227	244	17	RIGHT	D69b.EDF	D69	2
66	6553081	6553086	302	307	5	RIGHT	D69b.EDF	D69	2
66	6553189	6553219	410	440	30	RIGHT	D69b.EDF	D69	2
66	6553760	6553890	981	1111	130	RIGHT	D69b.EDF	D69	2
66	6553921	6554211	1142	1432	290	RIGHT	D69b.EDF	D69	2
66	6555052	6555323	2273	2544	271	RIGHT	D69b.EDF	D69	2
66	6555700	6555855	2921	3076	155	RIGHT	D69b.EDF	D69	2
66	6555883	6555899	3104	3120	16	RIGHT	D69b.EDF	D69	2
66	6555932	6556045	3153	3266	113	RIGHT	D69b.EDF	D69	2
66	6556401	6556429	3622	3650	28	RIGHT	D69b.EDF	D69	2
66	6556595	6556791	3816	4012	196	RIGHT	D69b.EDF	D69	2
66	6556814	6556852	4035	4073	38	RIGHT	D69b.EDF	D69	2
66	6556894	6557046	4115	4267	152	RIGHT	D69b.EDF	D69	2
66	6557077	6557096	4298	4317	19	RIGHT	D69b.EDF	D69	2
66	6557283	6557300	4504	4521	17	RIGHT	D69b.EDF	D69	2
66	6557324	6557498	4545	4719	174	RIGHT	D69b.EDF	D69	2
66	6557528	6557546	4749	4767	18	RIGHT	D69b.EDF	D69	2
66	6557645	6557915	4866	5136	270	RIGHT	D69b.EDF	D69	2
66	6557941	6557960	5162	5181	19	RIGHT	D69b.EDF	D69	2
67	6559919	6560249	156	486	330	RIGHT	D69b.EDF	D69	2
67	6560374	6560398	611	635	24	RIGHT	D69b.EDF	D69	2
67	6560426	6560747	663	984	321	RIGHT	D69b.EDF	D69	2
67	6560839	6561051	1076	1288	212	RIGHT	D69b.EDF	D69	2
67	6561141	6561275	1378	1512	134	RIGHT	D69b.EDF	D69	2
67	6561304	6562128	1541	2365	824	RIGHT	D69b.EDF	D69	2
67	6562368	6562585	2605	2822	217	RIGHT	D69b.EDF	D69	2
67	6562606	6562903	2843	3140	297	RIGHT	D69b.EDF	D69	2
67	6562957	6563249	3194	3486	292	RIGHT	D69b.EDF	D69	2
67	6563271	6563570	3508	3807	299	RIGHT	D69b.EDF	D69	2
67	6563607	6564324	3844	4561	717	RIGHT	D69b.EDF	D69	2
67	6564346	6564350	4583	4587	4	RIGHT	D69b.EDF	D69	2
67	6564385	6564407	4622	4644	22	RIGHT	D69b.EDF	D69	2
67	6564438	6564561	4675	4798	123	RIGHT	D69b.EDF	D69	2
67	6564651	6564957	4888	5194	306	RIGHT	D69b.EDF	D69	2
67	6564987	6565154	5224	5391	167	RIGHT	D69b.EDF	D69	2
67	6565186	6565198	5423	5435	12	RIGHT	D69b.EDF	D69	2
67	6565220	6565220	5457	5457	0	RIGHT	D69b.EDF	D69	2
67	6565269	6565723	5506	5960	454	RIGHT	D69b.EDF	D69	2
67	6565749	6565757	5986	5994	8	RIGHT	D69b.EDF	D69	2
67	6565867	6565873	6104	6110	6	RIGHT	D69b.EDF	D69	2
67	6565894	6565913	6131	6150	19	RIGHT	D69b.EDF	D69	2
67	6565945	6566071	6182	6308	126	RIGHT	D69b.EDF	D69	2
67	6566093	6566098	6330	6335	5	RIGHT	D69b.EDF	D69	2
68	6567806	6568004	58	256	198	RIGHT	D69b.EDF	D69	2
68	6568225	6568349	477	601	124	RIGHT	D69b.EDF	D69	2
68	6568380	6568561	632	813	181	RIGHT	D69b.EDF	D69	2
68	6568680	6568687	932	939	7	RIGHT	D69b.EDF	D69	2
68	6568880	6569020	1132	1272	140	RIGHT	D69b.EDF	D69	2
68	6569062	6569067	1314	1319	5	RIGHT	D69b.EDF	D69	2
68	6569133	6569345	1385	1597	212	RIGHT	D69b.EDF	D69	2
68	6569367	6569751	1619	2003	384	RIGHT	D69b.EDF	D69	2
68	6569851	6569865	2103	2117	14	RIGHT	D69b.EDF	D69	2
68	6570123	6570452	2375	2704	329	RIGHT	D69b.EDF	D69	2
68	6570477	6570477	2729	2729	0	RIGHT	D69b.EDF	D69	2
68	6570535	6570635	2787	2887	100	RIGHT	D69b.EDF	D69	2
68	6570818	6570924	3070	3176	106	RIGHT	D69b.EDF	D69	2
68	6571056	6571068	3308	3320	12	RIGHT	D69b.EDF	D69	2
68	6571098	6571409	3350	3661	311	RIGHT	D69b.EDF	D69	2
68	6571477	6571675	3729	3927	198	RIGHT	D69b.EDF	D69	2
68	6571696	6571698	3948	3950	2	RIGHT	D69b.EDF	D69	2
68	6571741	6571882	3993	4134	141	RIGHT	D69b.EDF	D69	2
68	6571915	6571930	4167	4182	15	RIGHT	D69b.EDF	D69	2
68	6572021	6572238	4273	4490	217	RIGHT	D69b.EDF	D69	2
68	6572266	6572575	4518	4827	309	RIGHT	D69b.EDF	D69	2
68	6572606	6572616	4858	4868	10	RIGHT	D69b.EDF	D69	2
68	6572709	6572896	4961	5148	187	RIGHT	D69b.EDF	D69	2
68	6572929	6573246	5181	5498	317	RIGHT	D69b.EDF	D69	2
68	6573274	6573319	5526	5571	45	RIGHT	D69b.EDF	D69	2
68	6573406	6573450	5658	5702	44	RIGHT	D69b.EDF	D69	2
69	6575481	6575618	58	195	137	RIGHT	D69b.EDF	D69	2
69	6575643	6575824	220	401	181	RIGHT	D69b.EDF	D69	2
69	6575888	6576176	465	753	288	RIGHT	D69b.EDF	D69	2
69	6576198	6576378	775	955	180	RIGHT	D69b.EDF	D69	2
69	6576403	6576409	980	986	6	RIGHT	D69b.EDF	D69	2
69	6576491	6576812	1068	1389	321	RIGHT	D69b.EDF	D69	2
69	6576848	6576989	1425	1566	141	RIGHT	D69b.EDF	D69	2
69	6577029	6577029	1606	1606	0	RIGHT	D69b.EDF	D69	2
69	6577168	6577193	1745	1770	25	RIGHT	D69b.EDF	D69	2
69	6577474	6577476	2051	2053	2	RIGHT	D69b.EDF	D69	2
69	6577673	6577697	2250	2274	24	RIGHT	D69b.EDF	D69	2
69	6578660	6578762	3237	3339	102	RIGHT	D69b.EDF	D69	2
69	6578786	6578798	3363	3375	12	RIGHT	D69b.EDF	D69	2
69	6578835	6578933	3412	3510	98	RIGHT	D69b.EDF	D69	2
69	6579941	6579944	4518	4521	3	RIGHT	D69b.EDF	D69	2
69	6579968	6580077	4545	4654	109	RIGHT	D69b.EDF	D69	2
69	6580111	6580131	4688	4708	20	RIGHT	D69b.EDF	D69	2
69	6580153	6580153	4730	4730	0	RIGHT	D69b.EDF	D69	2
69	6580177	6580323	4754	4900	146	RIGHT	D69b.EDF	D69	2
69	6580741	6580745	5318	5322	4	RIGHT	D69b.EDF	D69	2
69	6580770	6580899	5347	5476	129	RIGHT	D69b.EDF	D69	2
69	6581007	6581121	5584	5698	114	RIGHT	D69b.EDF	D69	2
69	6581880	6581969	6457	6546	89	RIGHT	D69b.EDF	D69	2
69	6582010	6582017	6587	6594	7	RIGHT	D69b.EDF	D69	2
70	6583503	6583633	58	188	130	RIGHT	D69b.EDF	D69	2
70	6584217	6584326	772	881	109	RIGHT	D69b.EDF	D69	2
70	6584356	6584381	911	936	25	RIGHT	D69b.EDF	D69	2
70	6584419	6584563	974	1118	144	RIGHT	D69b.EDF	D69	2
70	6584968	6584975	1523	1530	7	RIGHT	D69b.EDF	D69	2
70	6585004	6585107	1559	1662	103	RIGHT	D69b.EDF	D69	2
70	6585137	6585138	1692	1693	1	RIGHT	D69b.EDF	D69	2
70	6585212	6585358	1767	1913	146	RIGHT	D69b.EDF	D69	2
70	6586201	6586306	2756	2861	105	RIGHT	D69b.EDF	D69	2
70	6586330	6586427	2885	2982	97	RIGHT	D69b.EDF	D69	2
70	6587100	6587105	3655	3660	5	RIGHT	D69b.EDF	D69	2
70	6587126	6587217	3681	3772	91	RIGHT	D69b.EDF	D69	2
70	6587240	6587242	3795	3797	2	RIGHT	D69b.EDF	D69	2
70	6587275	6587370	3830	3925	95	RIGHT	D69b.EDF	D69	2
70	6587396	6587526	3951	4081	130	RIGHT	D69b.EDF	D69	2
70	6587607	6587717	4162	4272	110	RIGHT	D69b.EDF	D69	2
70	6587744	6587916	4299	4471	172	RIGHT	D69b.EDF	D69	2
70	6587969	6588207	4524	4762	238	RIGHT	D69b.EDF	D69	2
70	6588340	6588494	4895	5049	154	RIGHT	D69b.EDF	D69	2
70	6588527	6588532	5082	5087	5	RIGHT	D69b.EDF	D69	2
70	6588670	6588689	5225	5244	19	RIGHT	D69b.EDF	D69	2
71	6590737	6590857	145	265	120	RIGHT	D69b.EDF	D69	2
71	6590882	6590909	290	317	27	RIGHT	D69b.EDF	D69	2
71	6590938	6591070	346	478	132	RIGHT	D69b.EDF	D69	2
71	6591329	6591336	737	744	7	RIGHT	D69b.EDF	D69	2
71	6591362	6591506	770	914	144	RIGHT	D69b.EDF	D69	2
71	6591612	6591821	1020	1229	209	RIGHT	D69b.EDF	D69	2
71	6592047	6592053	1455	1461	6	RIGHT	D69b.EDF	D69	2
71	6592081	6592210	1489	1618	129	RIGHT	D69b.EDF	D69	2
71	6592315	6592315	1723	1723	0	RIGHT	D69b.EDF	D69	2
71	6592346	6592722	1754	2130	376	RIGHT	D69b.EDF	D69	2
71	6594000	6594091	3408	3499	91	RIGHT	D69b.EDF	D69	2
71	6594439	6594442	3847	3850	3	RIGHT	D69b.EDF	D69	2
71	6594891	6594972	4299	4380	81	RIGHT	D69b.EDF	D69	2
71	6595803	6595871	5211	5279	68	RIGHT	D69b.EDF	D69	2
71	6596760	6596864	6168	6272	104	RIGHT	D69b.EDF	D69	2
71	6596916	6597022	6324	6430	106	RIGHT	D69b.EDF	D69	2
71	6597485	6597557	6893	6965	72	RIGHT	D69b.EDF	D69	2
72	6599712	6599768	57	113	56	RIGHT	D69b.EDF	D69	2
72	6599836	6599908	181	253	72	RIGHT	D69b.EDF	D69	2
72	6600371	6600501	716	846	130	RIGHT	D69b.EDF	D69	2
72	6600561	6600565	906	910	4	RIGHT	D69b.EDF	D69	2
72	6600604	6600639	949	984	35	RIGHT	D69b.EDF	D69	2
72	6600671	6600701	1016	1046	30	RIGHT	D69b.EDF	D69	2
72	6600722	6600722	1067	1067	0	RIGHT	D69b.EDF	D69	2
72	6601364	6601385	1709	1730	21	RIGHT	D69b.EDF	D69	2
72	6601424	6601493	1769	1838	69	RIGHT	D69b.EDF	D69	2
72	6602349	6602350	2694	2695	1	RIGHT	D69b.EDF	D69	2
72	6602371	6602555	2716	2900	184	RIGHT	D69b.EDF	D69	2
72	6602685	6602699	3030	3044	14	RIGHT	D69b.EDF	D69	2
72	6602720	6602844	3065	3189	124	RIGHT	D69b.EDF	D69	2
72	6602883	6603009	3228	3354	126	RIGHT	D69b.EDF	D69	2
72	6603330	6603333	3675	3678	3	RIGHT	D69b.EDF	D69	2
72	6603358	6603458	3703	3803	100	RIGHT	D69b.EDF	D69	2
72	6603523	6603523	3868	3868	0	RIGHT	D69b.EDF	D69	2
72	6603546	6603626	3891	3971	80	RIGHT	D69b.EDF	D69	2
72	6604104	6604111	4449	4456	7	RIGHT	D69b.EDF	D69	2
72	6604136	6604235	4481	4580	99	RIGHT	D69b.EDF	D69	2
72	6604364	6604442	4709	4787	78	RIGHT	D69b.EDF	D69	2
72	6604493	6604544	4838	4889	51	RIGHT	D69b.EDF	D69	2
72	6605009	6605154	5354	5499	145	RIGHT	D69b.EDF	D69	2
72	6605302	6605378	5647	5723	76	RIGHT	D69b.EDF	D69	2
72	6605585	6605592	5930	5937	7	RIGHT	D69b.EDF	D69	2
72	6605620	6605718	5965	6063	98	RIGHT	D69b.EDF	D69	2
72	6605764	6605764	6109	6109	0	RIGHT	D69b.EDF	D69	2
72	6605792	6605963	6137	6308	171	RIGHT	D69b.EDF	D69	2
72	6606259	6606355	6604	6700	96	RIGHT	D69b.EDF	D69	2
72	6606481	6606521	6826	6866	40	RIGHT	D69b.EDF	D69	2
72	6606560	6606582	6905	6927	22	RIGHT	D69b.EDF	D69	2
73	6608788	6608788	105	105	0	RIGHT	D69b.EDF	D69	2
73	6608833	6608833	150	150	0	RIGHT	D69b.EDF	D69	2
73	6608856	6608860	173	177	4	RIGHT	D69b.EDF	D69	2
73	6609232	6609239	549	556	7	RIGHT	D69b.EDF	D69	2
73	6609379	6609508	696	825	129	RIGHT	D69b.EDF	D69	2
73	6609566	6609681	883	998	115	RIGHT	D69b.EDF	D69	2
73	6609709	6609795	1026	1112	86	RIGHT	D69b.EDF	D69	2
73	6609829	6609857	1146	1174	28	RIGHT	D69b.EDF	D69	2
73	6609885	6610007	1202	1324	122	RIGHT	D69b.EDF	D69	2
73	6610078	6610091	1395	1408	13	RIGHT	D69b.EDF	D69	2
73	6610172	6610180	1489	1497	8	RIGHT	D69b.EDF	D69	2
73	6610222	6610223	1539	1540	1	RIGHT	D69b.EDF	D69	2
73	6610280	6610375	1597	1692	95	RIGHT	D69b.EDF	D69	2
73	6611068	6611159	2385	2476	91	RIGHT	D69b.EDF	D69	2
73	6611218	6611288	2535	2605	70	RIGHT	D69b.EDF	D69	2
73	6611887	6611896	3204	3213	9	RIGHT	D69b.EDF	D69	2
73	6612106	6612114	3423	3431	8	RIGHT	D69b.EDF	D69	2
73	6612143	6612254	3460	3571	111	RIGHT	D69b.EDF	D69	2
73	6612280	6612285	3597	3602	5	RIGHT	D69b.EDF	D69	2
73	6612342	6612438	3659	3755	96	RIGHT	D69b.EDF	D69	2
73	6612642	6612648	3959	3965	6	RIGHT	D69b.EDF	D69	2
73	6612682	6612839	3999	4156	157	RIGHT	D69b.EDF	D69	2
73	6612908	6612912	4225	4229	4	RIGHT	D69b.EDF	D69	2
73	6612949	6612987	4266	4304	38	RIGHT	D69b.EDF	D69	2
73	6613018	6613146	4335	4463	128	RIGHT	D69b.EDF	D69	2
73	6613198	6613198	4515	4515	0	RIGHT	D69b.EDF	D69	2
73	6613224	6613238	4541	4555	14	RIGHT	D69b.EDF	D69	2
73	6613291	6613294	4608	4611	3	RIGHT	D69b.EDF	D69	2
73	6613321	6613339	4638	4656	18	RIGHT	D69b.EDF	D69	2
73	6613391	6613410	4708	4727	19	RIGHT	D69b.EDF	D69	2
73	6613435	6613564	4752	4881	129	RIGHT	D69b.EDF	D69	2
73	6613676	6613710	4993	5027	34	RIGHT	D69b.EDF	D69	2
73	6613758	6613813	5075	5130	55	RIGHT	D69b.EDF	D69	2
73	6614070	6614077	5387	5394	7	RIGHT	D69b.EDF	D69	2
73	6614102	6614205	5419	5522	103	RIGHT	D69b.EDF	D69	2
74	6616547	6616780	58	291	233	RIGHT	D69b.EDF	D69	2
74	6616965	6616983	476	494	18	RIGHT	D69b.EDF	D69	2
74	6617010	6617136	521	647	126	RIGHT	D69b.EDF	D69	2
74	6617164	6617164	675	675	0	RIGHT	D69b.EDF	D69	2
74	6617238	6617436	749	947	198	RIGHT	D69b.EDF	D69	2
74	6617459	6617605	970	1116	146	RIGHT	D69b.EDF	D69	2
74	6617644	6617644	1155	1155	0	RIGHT	D69b.EDF	D69	2
74	6617723	6617729	1234	1240	6	RIGHT	D69b.EDF	D69	2
74	6617753	6617850	1264	1361	97	RIGHT	D69b.EDF	D69	2
74	6617871	6617878	1382	1389	7	RIGHT	D69b.EDF	D69	2
74	6617944	6617968	1455	1479	24	RIGHT	D69b.EDF	D69	2
74	6618002	6618004	1513	1515	2	RIGHT	D69b.EDF	D69	2
74	6618051	6618051	1562	1562	0	RIGHT	D69b.EDF	D69	2
74	6618107	6618222	1618	1733	115	RIGHT	D69b.EDF	D69	2
74	6618300	6618301	1811	1812	1	RIGHT	D69b.EDF	D69	2
74	6618340	6618340	1851	1851	0	RIGHT	D69b.EDF	D69	2
74	6618361	6618463	1872	1974	102	RIGHT	D69b.EDF	D69	2
74	6618688	6618695	2199	2206	7	RIGHT	D69b.EDF	D69	2
74	6619340	6619484	2851	2995	144	RIGHT	D69b.EDF	D69	2
74	6619556	6619565	3067	3076	9	RIGHT	D69b.EDF	D69	2
74	6619590	6619590	3101	3101	0	RIGHT	D69b.EDF	D69	2
74	6619617	6619630	3128	3141	13	RIGHT	D69b.EDF	D69	2
74	6619761	6619763	3272	3274	2	RIGHT	D69b.EDF	D69	2
74	6619788	6619919	3299	3430	131	RIGHT	D69b.EDF	D69	2
74	6619983	6620079	3494	3590	96	RIGHT	D69b.EDF	D69	2
74	6620109	6620141	3620	3652	32	RIGHT	D69b.EDF	D69	2
74	6620432	6620443	3943	3954	11	RIGHT	D69b.EDF	D69	2
74	6620468	6620772	3979	4283	304	RIGHT	D69b.EDF	D69	2
74	6620935	6621082	4446	4593	147	RIGHT	D69b.EDF	D69	2
74	6621128	6621161	4639	4672	33	RIGHT	D69b.EDF	D69	2
74	6621183	6621185	4694	4696	2	RIGHT	D69b.EDF	D69	2
74	6621210	6621315	4721	4826	105	RIGHT	D69b.EDF	D69	2
74	6621370	6621371	4881	4882	1	RIGHT	D69b.EDF	D69	2
74	6621581	6621630	5092	5141	49	RIGHT	D69b.EDF	D69	2
75	6624329	6624473	248	392	144	RIGHT	D69b.EDF	D69	2
75	6624626	6624658	545	577	32	RIGHT	D69b.EDF	D69	2
75	6624706	6624875	625	794	169	RIGHT	D69b.EDF	D69	2
75	6624929	6624930	848	849	1	RIGHT	D69b.EDF	D69	2
75	6625013	6625121	932	1040	108	RIGHT	D69b.EDF	D69	2
75	6625230	6625231	1149	1150	1	RIGHT	D69b.EDF	D69	2
75	6625265	6625401	1184	1320	136	RIGHT	D69b.EDF	D69	2
75	6625430	6625453	1349	1372	23	RIGHT	D69b.EDF	D69	2
75	6625558	6625821	1477	1740	263	RIGHT	D69b.EDF	D69	2
75	6626161	6626275	2080	2194	114	RIGHT	D69b.EDF	D69	2
75	6626352	6626370	2271	2289	18	RIGHT	D69b.EDF	D69	2
75	6626804	6626809	2723	2728	5	RIGHT	D69b.EDF	D69	2
75	6626834	6626974	2753	2893	140	RIGHT	D69b.EDF	D69	2
75	6627015	6627311	2934	3230	296	RIGHT	D69b.EDF	D69	2
75	6627333	6627386	3252	3305	53	RIGHT	D69b.EDF	D69	2
75	6627477	6627500	3396	3419	23	RIGHT	D69b.EDF	D69	2
75	6627523	6627640	3442	3559	117	RIGHT	D69b.EDF	D69	2
75	6627718	6627861	3637	3780	143	RIGHT	D69b.EDF	D69	2
75	6627932	6627966	3851	3885	34	RIGHT	D69b.EDF	D69	2
75	6627991	6628129	3910	4048	138	RIGHT	D69b.EDF	D69	2
75	6628227	6628334	4146	4253	107	RIGHT	D69b.EDF	D69	2
75	6628359	6628412	4278	4331	53	RIGHT	D69b.EDF	D69	2
75	6628453	6628471	4372	4390	18	RIGHT	D69b.EDF	D69	2
75	6628503	6628639	4422	4558	136	RIGHT	D69b.EDF	D69	2
75	6628671	6628686	4590	4605	15	RIGHT	D69b.EDF	D69	2
75	6628725	6628726	4644	4645	1	RIGHT	D69b.EDF	D69	2
75	6628748	6628748	4667	4667	0	RIGHT	D69b.EDF	D69	2
75	6628794	6628812	4713	4731	18	RIGHT	D69b.EDF	D69	2
75	6628838	6628838	4757	4757	0	RIGHT	D69b.EDF	D69	2
75	6628866	6629003	4785	4922	137	RIGHT	D69b.EDF	D69	2
76	6631543	6631550	649	656	7	RIGHT	D69b.EDF	D69	2
76	6631664	6631682	770	788	18	RIGHT	D69b.EDF	D69	2
76	6631708	6631898	814	1004	190	RIGHT	D69b.EDF	D69	2
76	6631969	6631970	1075	1076	1	RIGHT	D69b.EDF	D69	2
76	6632034	6632210	1140	1316	176	RIGHT	D69b.EDF	D69	2
76	6632349	6632356	1455	1462	7	RIGHT	D69b.EDF	D69	2
76	6632397	6632554	1503	1660	157	RIGHT	D69b.EDF	D69	2
76	6632702	6632727	1808	1833	25	RIGHT	D69b.EDF	D69	2
76	6632755	6632847	1861	1953	92	RIGHT	D69b.EDF	D69	2
76	6634300	6634306	3406	3412	6	RIGHT	D69b.EDF	D69	2
76	6634330	6634428	3436	3534	98	RIGHT	D69b.EDF	D69	2
76	6634793	6634909	3899	4015	116	RIGHT	D69b.EDF	D69	2
76	6635006	6635006	4112	4112	0	RIGHT	D69b.EDF	D69	2
76	6635046	6635054	4152	4160	8	RIGHT	D69b.EDF	D69	2
76	6635094	6635193	4200	4299	99	RIGHT	D69b.EDF	D69	2
76	6635292	6635368	4398	4474	76	RIGHT	D69b.EDF	D69	2
76	6635410	6635486	4516	4592	76	RIGHT	D69b.EDF	D69	2
76	6635685	6635803	4791	4909	118	RIGHT	D69b.EDF	D69	2
76	6636190	6636190	5296	5296	0	RIGHT	D69b.EDF	D69	2
76	6636228	6636360	5334	5466	132	RIGHT	D69b.EDF	D69	2
76	6636828	6636944	5934	6050	116	RIGHT	D69b.EDF	D69	2
76	6637173	6637212	6279	6318	39	RIGHT	D69b.EDF	D69	2
76	6637290	6637357	6396	6463	67	RIGHT	D69b.EDF	D69	2
77	6639421	6639557	64	200	136	RIGHT	D69b.EDF	D69	2
77	6639625	6639686	268	329	61	RIGHT	D69b.EDF	D69	2
77	6639736	6639738	379	381	2	RIGHT	D69b.EDF	D69	2
77	6640056	6640057	699	700	1	RIGHT	D69b.EDF	D69	2
77	6640094	6640225	737	868	131	RIGHT	D69b.EDF	D69	2
77	6640396	6640396	1039	1039	0	RIGHT	D69b.EDF	D69	2
77	6640500	6640500	1143	1143	0	RIGHT	D69b.EDF	D69	2
77	6640882	6640954	1525	1597	72	RIGHT	D69b.EDF	D69	2
77	6640975	6640978	1618	1621	3	RIGHT	D69b.EDF	D69	2
77	6641185	6641219	1828	1862	34	RIGHT	D69b.EDF	D69	2
77	6641240	6641246	1883	1889	6	RIGHT	D69b.EDF	D69	2
77	6641333	6641430	1976	2073	97	RIGHT	D69b.EDF	D69	2
77	6642437	6642516	3080	3159	79	RIGHT	D69b.EDF	D69	2
77	6642601	6642601	3244	3244	0	RIGHT	D69b.EDF	D69	2
77	6643269	6643344	3912	3987	75	RIGHT	D69b.EDF	D69	2
77	6644080	6644082	4723	4725	2	RIGHT	D69b.EDF	D69	2
77	6644109	6644217	4752	4860	108	RIGHT	D69b.EDF	D69	2
77	6644301	6644363	4944	5006	62	RIGHT	D69b.EDF	D69	2
78	6646305	6646308	519	522	3	RIGHT	D69b.EDF	D69	2
78	6646337	6646567	551	781	230	RIGHT	D69b.EDF	D69	2
78	6646620	6646637	834	851	17	RIGHT	D69b.EDF	D69	2
78	6646673	6646718	887	932	45	RIGHT	D69b.EDF	D69	2
78	6647029	6647030	1243	1244	1	RIGHT	D69b.EDF	D69	2
78	6647058	6647179	1272	1393	121	RIGHT	D69b.EDF	D69	2
78	6647235	6647369	1449	1583	134	RIGHT	D69b.EDF	D69	2
78	6648547	6648664	2761	2878	117	RIGHT	D69b.EDF	D69	2
78	6648861	6649003	3075	3217	142	RIGHT	D69b.EDF	D69	2
78	6649170	6649172	3384	3386	2	RIGHT	D69b.EDF	D69	2
78	6649209	6649317	3423	3531	108	RIGHT	D69b.EDF	D69	2
78	6649434	6649435	3648	3649	1	RIGHT	D69b.EDF	D69	2
78	6649644	6649774	3858	3988	130	RIGHT	D69b.EDF	D69	2
78	6649867	6649868	4081	4082	1	RIGHT	D69b.EDF	D69	2
78	6649975	6650090	4189	4304	115	RIGHT	D69b.EDF	D69	2
78	6650567	6650567	4781	4781	0	RIGHT	D69b.EDF	D69	2
78	6650591	6650704	4805	4918	113	RIGHT	D69b.EDF	D69	2
78	6650874	6650997	5088	5211	123	RIGHT	D69b.EDF	D69	2
79	6653299	6653412	58	171	113	RIGHT	D69b.EDF	D69	2
79	6653463	6653463	222	222	0	RIGHT	D69b.EDF	D69	2
79	6653492	6653492	251	251	0	RIGHT	D69b.EDF	D69	2
79	6653617	6653625	376	384	8	RIGHT	D69b.EDF	D69	2
79	6653877	6653889	636	648	12	RIGHT	D69b.EDF	D69	2
79	6654144	6654148	903	907	4	RIGHT	D69b.EDF	D69	2
79	6654177	6654287	936	1046	110	RIGHT	D69b.EDF	D69	2
79	6654313	6654316	1072	1075	3	RIGHT	D69b.EDF	D69	2
79	6654416	6654421	1175	1180	5	RIGHT	D69b.EDF	D69	2
79	6654459	6654714	1218	1473	255	RIGHT	D69b.EDF	D69	2
79	6654863	6654964	1622	1723	101	RIGHT	D69b.EDF	D69	2
79	6655068	6655068	1827	1827	0	RIGHT	D69b.EDF	D69	2
79	6655129	6655129	1888	1888	0	RIGHT	D69b.EDF	D69	2
79	6656320	6656448	3079	3207	128	RIGHT	D69b.EDF	D69	2
79	6656477	6656477	3236	3236	0	RIGHT	D69b.EDF	D69	2
79	6656502	6656622	3261	3381	120	RIGHT	D69b.EDF	D69	2
79	6656648	6656649	3407	3408	1	RIGHT	D69b.EDF	D69	2
79	6656687	6656690	3446	3449	3	RIGHT	D69b.EDF	D69	2
79	6656959	6656961	3718	3720	2	RIGHT	D69b.EDF	D69	2
79	6657320	6657413	4079	4172	93	RIGHT	D69b.EDF	D69	2
79	6657434	6657446	4193	4205	12	RIGHT	D69b.EDF	D69	2
79	6657527	6657530	4286	4289	3	RIGHT	D69b.EDF	D69	2
79	6657628	6657889	4387	4648	261	RIGHT	D69b.EDF	D69	2
79	6658078	6658116	4837	4875	38	RIGHT	D69b.EDF	D69	2
79	6658139	6658240	4898	4999	101	RIGHT	D69b.EDF	D69	2
79	6658272	6658272	5031	5031	0	RIGHT	D69b.EDF	D69	2
79	6658321	6658500	5080	5259	179	RIGHT	D69b.EDF	D69	2
80	6660453	6660510	57	114	57	RIGHT	D69b.EDF	D69	2
80	6660541	6660584	145	188	43	RIGHT	D69b.EDF	D69	2
80	6660606	6660734	210	338	128	RIGHT	D69b.EDF	D69	2
80	6660771	6660786	375	390	15	RIGHT	D69b.EDF	D69	2
80	6661033	6661055	637	659	22	RIGHT	D69b.EDF	D69	2
80	6661431	6661554	1035	1158	123	RIGHT	D69b.EDF	D69	2
80	6661612	6661613	1216	1217	1	RIGHT	D69b.EDF	D69	2
80	6661634	6661778	1238	1382	144	RIGHT	D69b.EDF	D69	2
80	6661953	6662081	1557	1685	128	RIGHT	D69b.EDF	D69	2
80	6662124	6662124	1728	1728	0	RIGHT	D69b.EDF	D69	2
80	6662158	6662175	1762	1779	17	RIGHT	D69b.EDF	D69	2
80	6663459	6663580	3063	3184	121	RIGHT	D69b.EDF	D69	2
80	6663607	6663621	3211	3225	14	RIGHT	D69b.EDF	D69	2
80	6663683	6663815	3287	3419	132	RIGHT	D69b.EDF	D69	2
80	6664187	6664190	3791	3794	3	RIGHT	D69b.EDF	D69	2
80	6664216	6664327	3820	3931	111	RIGHT	D69b.EDF	D69	2
80	6664377	6664665	3981	4269	288	RIGHT	D69b.EDF	D69	2
80	6664911	6665043	4515	4647	132	RIGHT	D69b.EDF	D69	2
80	6665156	6665405	4760	5009	249	RIGHT	D69b.EDF	D69	2
81	6668025	6668113	58	146	88	RIGHT	D69b.EDF	D69	2
81	6668142	6668145	175	178	3	RIGHT	D69b.EDF	D69	2
81	6668266	6668409	299	442	143	RIGHT	D69b.EDF	D69	2
81	6668638	6668639	671	672	1	RIGHT	D69b.EDF	D69	2
81	6668668	6668777	701	810	109	RIGHT	D69b.EDF	D69	2
81	6668799	6668805	832	838	6	RIGHT	D69b.EDF	D69	2
81	6668983	6669090	1016	1123	107	RIGHT	D69b.EDF	D69	2
81	6671163	6671271	3196	3304	108	RIGHT	D69b.EDF	D69	2
81	6671334	6671430	3367	3463	96	RIGHT	D69b.EDF	D69	2
81	6671456	6671571	3489	3604	115	RIGHT	D69b.EDF	D69	2
81	6671760	6672072	3793	4105	312	RIGHT	D69b.EDF	D69	2
81	6672154	6672379	4187	4412	225	RIGHT	D69b.EDF	D69	2
81	6672406	6672453	4439	4486	47	RIGHT	D69b.EDF	D69	2
81	6672799	6672918	4832	4951	119	RIGHT	D69b.EDF	D69	2
81	6672954	6672954	4987	4987	0	RIGHT	D69b.EDF	D69	2
81	6672988	6673068	5021	5101	80	RIGHT	D69b.EDF	D69	2
81	6673107	6673136	5140	5169	29	RIGHT	D69b.EDF	D69	2
81	6673244	6673256	5277	5289	12	RIGHT	D69b.EDF	D69	2
81	6673284	6673409	5317	5442	125	RIGHT	D69b.EDF	D69	2
81	6673457	6673482	5490	5515	25	RIGHT	D69b.EDF	D69	2
82	6675993	6676100	189	296	107	RIGHT	D69b.EDF	D69	2
82	6676168	6676173	364	369	5	RIGHT	D69b.EDF	D69	2
82	6676198	6676229	394	425	31	RIGHT	D69b.EDF	D69	2
82	6676261	6676291	457	487	30	RIGHT	D69b.EDF	D69	2
82	6676317	6676444	513	640	127	RIGHT	D69b.EDF	D69	2
82	6676504	6676522	700	718	18	RIGHT	D69b.EDF	D69	2
82	6677149	6677256	1345	1452	107	RIGHT	D69b.EDF	D69	2
82	6677357	6677365	1553	1561	8	RIGHT	D69b.EDF	D69	2
82	6677401	6677408	1597	1604	7	RIGHT	D69b.EDF	D69	2
82	6677457	6677566	1653	1762	109	RIGHT	D69b.EDF	D69	2
82	6677616	6677659	1812	1855	43	RIGHT	D69b.EDF	D69	2
82	6677731	6677739	1927	1935	8	RIGHT	D69b.EDF	D69	2
82	6678772	6678889	2968	3085	117	RIGHT	D69b.EDF	D69	2
82	6679738	6679868	3934	4064	130	RIGHT	D69b.EDF	D69	2
82	6679967	6679967	4163	4163	0	RIGHT	D69b.EDF	D69	2
82	6680597	6680696	4793	4892	99	RIGHT	D69b.EDF	D69	2
82	6680850	6680866	5046	5062	16	RIGHT	D69b.EDF	D69	2
82	6680970	6680971	5166	5167	1	RIGHT	D69b.EDF	D69	2
82	6681349	6681353	5545	5549	4	RIGHT	D69b.EDF	D69	2
82	6681377	6681474	5573	5670	97	RIGHT	D69b.EDF	D69	2
82	6681504	6681506	5700	5702	2	RIGHT	D69b.EDF	D69	2
83	6683715	6683727	69	81	12	RIGHT	D69b.EDF	D69	2
83	6683795	6683878	149	232	83	RIGHT	D69b.EDF	D69	2
83	6683913	6683935	267	289	22	RIGHT	D69b.EDF	D69	2
83	6684321	6684335	675	689	14	RIGHT	D69b.EDF	D69	2
83	6684361	6684506	715	860	145	RIGHT	D69b.EDF	D69	2
83	6684533	6684569	887	923	36	RIGHT	D69b.EDF	D69	2
83	6684612	6684733	966	1087	121	RIGHT	D69b.EDF	D69	2
83	6684757	6684757	1111	1111	0	RIGHT	D69b.EDF	D69	2
83	6684838	6684838	1192	1192	0	RIGHT	D69b.EDF	D69	2
83	6684897	6685029	1251	1383	132	RIGHT	D69b.EDF	D69	2
83	6685078	6685108	1432	1462	30	RIGHT	D69b.EDF	D69	2
83	6685158	6685360	1512	1714	202	RIGHT	D69b.EDF	D69	2
83	6685381	6685386	1735	1740	5	RIGHT	D69b.EDF	D69	2
83	6685677	6685677	2031	2031	0	RIGHT	D69b.EDF	D69	2
83	6686502	6686504	2856	2858	2	RIGHT	D69b.EDF	D69	2
83	6686827	6686991	3181	3345	164	RIGHT	D69b.EDF	D69	2
83	6687034	6687167	3388	3521	133	RIGHT	D69b.EDF	D69	2
83	6687209	6687210	3563	3564	1	RIGHT	D69b.EDF	D69	2
83	6688058	6688060	4412	4414	2	RIGHT	D69b.EDF	D69	2
83	6688087	6688181	4441	4535	94	RIGHT	D69b.EDF	D69	2
83	6688239	6688367	4593	4721	128	RIGHT	D69b.EDF	D69	2
83	6688399	6688525	4753	4879	126	RIGHT	D69b.EDF	D69	2
83	6688593	6688644	4947	4998	51	RIGHT	D69b.EDF	D69	2
83	6688675	6688784	5029	5138	109	RIGHT	D69b.EDF	D69	2
83	6688818	6688867	5172	5221	49	RIGHT	D69b.EDF	D69	2
83	6688890	6689016	5244	5370	126	RIGHT	D69b.EDF	D69	2
83	6689072	6689092	5426	5446	20	RIGHT	D69b.EDF	D69	2
83	6689120	6689231	5474	5585	111	RIGHT	D69b.EDF	D69	2
83	6689257	6689258	5611	5612	1	RIGHT	D69b.EDF	D69	2
83	6689295	6689473	5649	5827	178	RIGHT	D69b.EDF	D69	2
83	6689898	6689904	6252	6258	6	RIGHT	D69b.EDF	D69	2
83	6689930	6690042	6284	6396	112	RIGHT	D69b.EDF	D69	2
84	6692335	6692450	131	246	115	RIGHT	D69b.EDF	D69	2
84	6692495	6692495	291	291	0	RIGHT	D69b.EDF	D69	2
84	6692532	6692560	328	356	28	RIGHT	D69b.EDF	D69	2
84	6692593	6692697	389	493	104	RIGHT	D69b.EDF	D69	2
84	6692805	6692843	601	639	38	RIGHT	D69b.EDF	D69	2
84	6692967	6693072	763	868	105	RIGHT	D69b.EDF	D69	2
84	6693143	6693164	939	960	21	RIGHT	D69b.EDF	D69	2
84	6693203	6693205	999	1001	2	RIGHT	D69b.EDF	D69	2
84	6693229	6693231	1025	1027	2	RIGHT	D69b.EDF	D69	2
84	6693310	6693320	1106	1116	10	RIGHT	D69b.EDF	D69	2
84	6694962	6695041	2758	2837	79	RIGHT	D69b.EDF	D69	2
84	6695085	6695147	2881	2943	62	RIGHT	D69b.EDF	D69	2
84	6695889	6695995	3685	3791	106	RIGHT	D69b.EDF	D69	2
84	6696050	6696138	3846	3934	88	RIGHT	D69b.EDF	D69	2
84	6696587	6696708	4383	4504	121	RIGHT	D69b.EDF	D69	2
84	6696746	6696915	4542	4711	169	RIGHT	D69b.EDF	D69	2
84	6697112	6697113	4908	4909	1	RIGHT	D69b.EDF	D69	2
84	6697148	6697258	4944	5054	110	RIGHT	D69b.EDF	D69	2
84	6697294	6697295	5090	5091	1	RIGHT	D69b.EDF	D69	2
84	6697316	6697351	5112	5147	35	RIGHT	D69b.EDF	D69	2
84	6697383	6697481	5179	5277	98	RIGHT	D69b.EDF	D69	2
84	6697588	6697598	5384	5394	10	RIGHT	D69b.EDF	D69	2
84	6697824	6697834	5620	5630	10	RIGHT	D69b.EDF	D69	2
84	6697861	6697967	5657	5763	106	RIGHT	D69b.EDF	D69	2
84	6698022	6698251	5818	6047	229	RIGHT	D69b.EDF	D69	2
85	6700117	6700236	61	180	119	RIGHT	D69b.EDF	D69	2
85	6700269	6700372	213	316	103	RIGHT	D69b.EDF	D69	2
85	6700736	6700740	680	684	4	RIGHT	D69b.EDF	D69	2
85	6700771	6701062	715	1006	291	RIGHT	D69b.EDF	D69	2
85	6701085	6701111	1029	1055	26	RIGHT	D69b.EDF	D69	2
85	6701154	6701286	1098	1230	132	RIGHT	D69b.EDF	D69	2
85	6701387	6701503	1331	1447	116	RIGHT	D69b.EDF	D69	2
85	6701528	6701640	1472	1584	112	RIGHT	D69b.EDF	D69	2
85	6701695	6701818	1639	1762	123	RIGHT	D69b.EDF	D69	2
85	6701851	6701966	1795	1910	115	RIGHT	D69b.EDF	D69	2
85	6702041	6702083	1985	2027	42	RIGHT	D69b.EDF	D69	2
85	6702109	6702127	2053	2071	18	RIGHT	D69b.EDF	D69	2
85	6702159	6702238	2103	2182	79	RIGHT	D69b.EDF	D69	2
85	6703336	6703336	3280	3280	0	RIGHT	D69b.EDF	D69	2
85	6703362	6703456	3306	3400	94	RIGHT	D69b.EDF	D69	2
85	6703479	6703598	3423	3542	119	RIGHT	D69b.EDF	D69	2
85	6703751	6703754	3695	3698	3	RIGHT	D69b.EDF	D69	2
85	6703779	6703907	3723	3851	128	RIGHT	D69b.EDF	D69	2
85	6703932	6704052	3876	3996	120	RIGHT	D69b.EDF	D69	2
85	6704616	6704617	4560	4561	1	RIGHT	D69b.EDF	D69	2
85	6704649	6704768	4593	4712	119	RIGHT	D69b.EDF	D69	2
85	6704792	6704949	4736	4893	157	RIGHT	D69b.EDF	D69	2
85	6705366	6705373	5310	5317	7	RIGHT	D69b.EDF	D69	2
85	6705399	6705500	5343	5444	101	RIGHT	D69b.EDF	D69	2
85	6705529	6705543	5473	5487	14	RIGHT	D69b.EDF	D69	2
85	6705594	6705767	5538	5711	173	RIGHT	D69b.EDF	D69	2
85	6706076	6706083	6020	6027	7	RIGHT	D69b.EDF	D69	2
85	6706110	6706215	6054	6159	105	RIGHT	D69b.EDF	D69	2
85	6706237	6706250	6181	6194	13	RIGHT	D69b.EDF	D69	2
85	6706295	6706423	6239	6367	128	RIGHT	D69b.EDF	D69	2
85	6706445	6706446	6389	6390	1	RIGHT	D69b.EDF	D69	2
85	6706838	6706848	6782	6792	10	RIGHT	D69b.EDF	D69	2
85	6706873	6706979	6817	6923	106	RIGHT	D69b.EDF	D69	2
85	6707003	6707026	6947	6970	23	RIGHT	D69b.EDF	D69	2
85	6707098	6707132	7042	7076	34	RIGHT	D69b.EDF	D69	2
86	6709202	6709302	87	187	100	RIGHT	D69b.EDF	D69	2
86	6709325	6709337	210	222	12	RIGHT	D69b.EDF	D69	2
86	6709406	6709514	291	399	108	RIGHT	D69b.EDF	D69	2
86	6709722	6709731	607	616	9	RIGHT	D69b.EDF	D69	2
86	6709758	6709889	643	774	131	RIGHT	D69b.EDF	D69	2
86	6709919	6709952	804	837	33	RIGHT	D69b.EDF	D69	2
86	6709981	6710105	866	990	124	RIGHT	D69b.EDF	D69	2
86	6710147	6710160	1032	1045	13	RIGHT	D69b.EDF	D69	2
86	6710192	6710355	1077	1240	163	RIGHT	D69b.EDF	D69	2
86	6710777	6710788	1662	1673	11	RIGHT	D69b.EDF	D69	2
86	6710818	6710894	1703	1779	76	RIGHT	D69b.EDF	D69	2
86	6710918	6710919	1803	1804	1	RIGHT	D69b.EDF	D69	2
86	6710968	6711045	1853	1930	77	RIGHT	D69b.EDF	D69	2
86	6711411	6711547	2296	2432	136	RIGHT	D69b.EDF	D69	2
86	6711611	6711662	2496	2547	51	RIGHT	D69b.EDF	D69	2
86	6712393	6712397	3278	3282	4	RIGHT	D69b.EDF	D69	2
86	6712425	6712537	3310	3422	112	RIGHT	D69b.EDF	D69	2
86	6712608	6712684	3493	3569	76	RIGHT	D69b.EDF	D69	2
86	6713050	6713144	3935	4029	94	RIGHT	D69b.EDF	D69	2
86	6713189	6713311	4074	4196	122	RIGHT	D69b.EDF	D69	2
86	6713915	6713917	4800	4802	2	RIGHT	D69b.EDF	D69	2
86	6713949	6714038	4834	4923	89	RIGHT	D69b.EDF	D69	2
86	6714073	6714264	4958	5149	191	RIGHT	D69b.EDF	D69	2
87	6716525	6716528	266	269	3	RIGHT	D69b.EDF	D69	2
87	6716839	6716966	580	707	127	RIGHT	D69b.EDF	D69	2
87	6716997	6717020	738	761	23	RIGHT	D69b.EDF	D69	2
87	6717044	6717133	785	874	89	RIGHT	D69b.EDF	D69	2
87	6718223	6718320	1964	2061	97	RIGHT	D69b.EDF	D69	2
87	6719415	6719528	3156	3269	113	RIGHT	D69b.EDF	D69	2
87	6719583	6719723	3324	3464	140	RIGHT	D69b.EDF	D69	2
87	6720019	6720185	3760	3926	166	RIGHT	D69b.EDF	D69	2
87	6720213	6720399	3954	4140	186	RIGHT	D69b.EDF	D69	2
87	6720681	6720689	4422	4430	8	RIGHT	D69b.EDF	D69	2
87	6720717	6720825	4458	4566	108	RIGHT	D69b.EDF	D69	2
87	6720887	6720977	4628	4718	90	RIGHT	D69b.EDF	D69	2
87	6721008	6721125	4749	4866	117	RIGHT	D69b.EDF	D69	2
87	6721156	6721199	4897	4940	43	RIGHT	D69b.EDF	D69	2
87	6721237	6721536	4978	5277	299	RIGHT	D69b.EDF	D69	2
87	6721567	6721681	5308	5422	114	RIGHT	D69b.EDF	D69	2
87	6721713	6721757	5454	5498	44	RIGHT	D69b.EDF	D69	2
87	6721787	6721980	5528	5721	193	RIGHT	D69b.EDF	D69	2
87	6722274	6722284	6015	6025	10	RIGHT	D69b.EDF	D69	2
87	6722322	6722436	6063	6177	114	RIGHT	D69b.EDF	D69	2
87	6722465	6722494	6206	6235	29	RIGHT	D69b.EDF	D69	2
87	6722520	6722520	6261	6261	0	RIGHT	D69b.EDF	D69	2
87	6722542	6722702	6283	6443	160	RIGHT	D69b.EDF	D69	2
88	6724743	6724852	70	179	109	RIGHT	D69b.EDF	D69	2
88	6724888	6724999	215	326	111	RIGHT	D69b.EDF	D69	2
88	6725220	6725220	547	547	0	RIGHT	D69b.EDF	D69	2
88	6725390	6725399	717	726	9	RIGHT	D69b.EDF	D69	2
88	6725435	6725711	762	1038	276	RIGHT	D69b.EDF	D69	2
88	6725735	6725750	1062	1077	15	RIGHT	D69b.EDF	D69	2
88	6725778	6725778	1105	1105	0	RIGHT	D69b.EDF	D69	2
88	6725821	6725906	1148	1233	85	RIGHT	D69b.EDF	D69	2
88	6725937	6725944	1264	1271	7	RIGHT	D69b.EDF	D69	2
88	6725967	6725967	1294	1294	0	RIGHT	D69b.EDF	D69	2
88	6725993	6726022	1320	1349	29	RIGHT	D69b.EDF	D69	2
88	6726055	6726144	1382	1471	89	RIGHT	D69b.EDF	D69	2
88	6726165	6726174	1492	1501	9	RIGHT	D69b.EDF	D69	2
88	6726239	6726288	1566	1615	49	RIGHT	D69b.EDF	D69	2
88	6726310	6726414	1637	1741	104	RIGHT	D69b.EDF	D69	2
88	6726593	6726674	1920	2001	81	RIGHT	D69b.EDF	D69	2
88	6727434	6727435	2761	2762	1	RIGHT	D69b.EDF	D69	2
88	6727459	6727575	2786	2902	116	RIGHT	D69b.EDF	D69	2
88	6727646	6727742	2973	3069	96	RIGHT	D69b.EDF	D69	2
88	6728170	6728185	3497	3512	15	RIGHT	D69b.EDF	D69	2
88	6728814	6728898	4141	4225	84	RIGHT	D69b.EDF	D69	2
88	6728941	6728949	4268	4276	8	RIGHT	D69b.EDF	D69	2
88	6728976	6729043	4303	4370	67	RIGHT	D69b.EDF	D69	2
88	6729752	6729754	5079	5081	2	RIGHT	D69b.EDF	D69	2
88	6729786	6729836	5113	5163	50	RIGHT	D69b.EDF	D69	2
89	6731906	6731944	57	95	38	RIGHT	D69b.EDF	D69	2
89	6731991	6732209	142	360	218	RIGHT	D69b.EDF	D69	2
89	6732623	6732757	774	908	134	RIGHT	D69b.EDF	D69	2
89	6732786	6733011	937	1162	225	RIGHT	D69b.EDF	D69	2
89	6733813	6733820	1964	1971	7	RIGHT	D69b.EDF	D69	2
89	6734479	6734579	2630	2730	100	RIGHT	D69b.EDF	D69	2
89	6734626	6734681	2777	2832	55	RIGHT	D69b.EDF	D69	2
89	6735488	6735494	3639	3645	6	RIGHT	D69b.EDF	D69	2
89	6735520	6735630	3671	3781	110	RIGHT	D69b.EDF	D69	2
89	6735656	6735741	3807	3892	85	RIGHT	D69b.EDF	D69	2
89	6735859	6735869	4010	4020	10	RIGHT	D69b.EDF	D69	2
89	6735893	6736025	4044	4176	132	RIGHT	D69b.EDF	D69	2
89	6736078	6736218	4229	4369	140	RIGHT	D69b.EDF	D69	2
89	6736677	6736689	4828	4840	12	RIGHT	D69b.EDF	D69	2
89	6736710	6736805	4861	4956	95	RIGHT	D69b.EDF	D69	2
89	6736834	6736852	4985	5003	18	RIGHT	D69b.EDF	D69	2
89	6736885	6737050	5036	5201	165	RIGHT	D69b.EDF	D69	2
90	6740034	6740173	80	219	139	RIGHT	D69b.EDF	D69	2
90	6740196	6740406	242	452	210	RIGHT	D69b.EDF	D69	2
90	6741350	6741439	1396	1485	89	RIGHT	D69b.EDF	D69	2
90	6742921	6743055	2967	3101	134	RIGHT	D69b.EDF	D69	2
90	6743162	6743271	3208	3317	109	RIGHT	D69b.EDF	D69	2
90	6743294	6743362	3340	3408	68	RIGHT	D69b.EDF	D69	2
90	6743524	6743531	3570	3577	7	RIGHT	D69b.EDF	D69	2
90	6743556	6743673	3602	3719	117	RIGHT	D69b.EDF	D69	2
90	6743796	6743856	3842	3902	60	RIGHT	D69b.EDF	D69	2
90	6743987	6743993	4033	4039	6	RIGHT	D69b.EDF	D69	2
90	6744022	6744151	4068	4197	129	RIGHT	D69b.EDF	D69	2
90	6744257	6744339	4303	4385	82	RIGHT	D69b.EDF	D69	2
90	6744378	6744409	4424	4455	31	RIGHT	D69b.EDF	D69	2
90	6744668	6744680	4714	4726	12	RIGHT	D69b.EDF	D69	2
90	6744703	6744812	4749	4858	109	RIGHT	D69b.EDF	D69	2
90	6744911	6745019	4957	5065	108	RIGHT	D69b.EDF	D69	2
90	6745124	6745135	5170	5181	11	RIGHT	D69b.EDF	D69	2
90	6745167	6745273	5213	5319	106	RIGHT	D69b.EDF	D69	2
90	6745352	6745356	5398	5402	4	RIGHT	D69b.EDF	D69	2
91	6747894	6748049	175	330	155	RIGHT	D69b.EDF	D69	2
91	6748111	6748150	392	431	39	RIGHT	D69b.EDF	D69	2
91	6748368	6748416	649	697	48	RIGHT	D69b.EDF	D69	2
91	6748448	6748558	729	839	110	RIGHT	D69b.EDF	D69	2
91	6748580	6748587	861	868	7	RIGHT	D69b.EDF	D69	2
91	6748646	6748734	927	1015	88	RIGHT	D69b.EDF	D69	2
91	6748964	6749010	1245	1291	46	RIGHT	D69b.EDF	D69	2
91	6749031	6749046	1312	1327	15	RIGHT	D69b.EDF	D69	2
91	6749111	6749212	1392	1493	101	RIGHT	D69b.EDF	D69	2
91	6749241	6749369	1522	1650	128	RIGHT	D69b.EDF	D69	2
91	6750425	6750552	2706	2833	127	RIGHT	D69b.EDF	D69	2
91	6750579	6750687	2860	2968	108	RIGHT	D69b.EDF	D69	2
91	6751272	6751280	3553	3561	8	RIGHT	D69b.EDF	D69	2
91	6751304	6751420	3585	3701	116	RIGHT	D69b.EDF	D69	2
91	6751475	6751670	3756	3951	195	RIGHT	D69b.EDF	D69	2
91	6751879	6751886	4160	4167	7	RIGHT	D69b.EDF	D69	2
91	6751911	6752030	4192	4311	119	RIGHT	D69b.EDF	D69	2
91	6752097	6752099	4378	4380	2	RIGHT	D69b.EDF	D69	2
91	6752134	6752381	4415	4662	247	RIGHT	D69b.EDF	D69	2
91	6752403	6752555	4684	4836	152	RIGHT	D69b.EDF	D69	2
91	6752637	6752792	4918	5073	155	RIGHT	D69b.EDF	D69	2
91	6752871	6753196	5152	5477	325	RIGHT	D69b.EDF	D69	2
91	6753303	6753488	5584	5769	185	RIGHT	D69b.EDF	D69	2
91	6753622	6753633	5903	5914	11	RIGHT	D69b.EDF	D69	2
91	6753657	6753799	5938	6080	142	RIGHT	D69b.EDF	D69	2
91	6753913	6753924	6194	6205	11	RIGHT	D69b.EDF	D69	2
91	6753951	6754021	6232	6302	70	RIGHT	D69b.EDF	D69	2
92	6757156	6757156	81	81	0	RIGHT	D69b.EDF	D69	2
92	6757250	6757374	175	299	124	RIGHT	D69b.EDF	D69	2
92	6757598	6757602	523	527	4	RIGHT	D69b.EDF	D69	2
92	6757636	6757771	561	696	135	RIGHT	D69b.EDF	D69	2
92	6757862	6758214	787	1139	352	RIGHT	D69b.EDF	D69	2
92	6758340	6758341	1265	1266	1	RIGHT	D69b.EDF	D69	2
92	6758369	6758501	1294	1426	132	RIGHT	D69b.EDF	D69	2
92	6759565	6759687	2490	2612	122	RIGHT	D69b.EDF	D69	2
92	6759753	6759806	2678	2731	53	RIGHT	D69b.EDF	D69	2
92	6760298	6760308	3223	3233	10	RIGHT	D69b.EDF	D69	2
92	6760339	6760445	3264	3370	106	RIGHT	D69b.EDF	D69	2
92	6760507	6760605	3432	3530	98	RIGHT	D69b.EDF	D69	2
92	6760901	6760908	3826	3833	7	RIGHT	D69b.EDF	D69	2
92	6760934	6761064	3859	3989	130	RIGHT	D69b.EDF	D69	2
92	6761115	6761126	4040	4051	11	RIGHT	D69b.EDF	D69	2
92	6761193	6761193	4118	4118	0	RIGHT	D69b.EDF	D69	2
92	6761219	6761367	4144	4292	148	RIGHT	D69b.EDF	D69	2
92	6761417	6761436	4342	4361	19	RIGHT	D69b.EDF	D69	2
92	6761479	6761534	4404	4459	55	RIGHT	D69b.EDF	D69	2
92	6761560	6761713	4485	4638	153	RIGHT	D69b.EDF	D69	2
92	6761736	6761742	4661	4667	6	RIGHT	D69b.EDF	D69	2
92	6761767	6761995	4692	4920	228	RIGHT	D69b.EDF	D69	2
92	6762034	6762172	4959	5097	138	RIGHT	D69b.EDF	D69	2
92	6762267	6762267	5192	5192	0	RIGHT	D69b.EDF	D69	2
92	6762300	6762321	5225	5246	21	RIGHT	D69b.EDF	D69	2
92	6762346	6762486	5271	5411	140	RIGHT	D69b.EDF	D69	2
92	6762558	6762559	5483	5484	1	RIGHT	D69b.EDF	D69	2
92	6762609	6762935	5534	5860	326	RIGHT	D69b.EDF	D69	2
92	6762960	6763093	5885	6018	133	RIGHT	D69b.EDF	D69	2
92	6763124	6763131	6049	6056	7	RIGHT	D69b.EDF	D69	2
92	6763259	6763458	6184	6383	199	RIGHT	D69b.EDF	D69	2
92	6763486	6763634	6411	6559	148	RIGHT	D69b.EDF	D69	2
92	6763712	6763713	6637	6638	1	RIGHT	D69b.EDF	D69	2
92	6763748	6763972	6673	6897	224	RIGHT	D69b.EDF	D69	2
92	6764061	6764077	6986	7002	16	RIGHT	D69b.EDF	D69	2
93	6766304	6766318	77	91	14	RIGHT	D69b.EDF	D69	2
93	6766368	6766742	141	515	374	RIGHT	D69b.EDF	D69	2
93	6766866	6766879	639	652	13	RIGHT	D69b.EDF	D69	2
93	6766903	6767226	676	999	323	RIGHT	D69b.EDF	D69	2
93	6767319	6767490	1092	1263	171	RIGHT	D69b.EDF	D69	2
93	6767528	6767692	1301	1465	164	RIGHT	D69b.EDF	D69	2
93	6767784	6767830	1557	1603	46	RIGHT	D69b.EDF	D69	2
93	6767914	6768031	1687	1804	117	RIGHT	D69b.EDF	D69	2
93	6768790	6768952	2563	2725	162	RIGHT	D69b.EDF	D69	2
93	6769016	6769103	2789	2876	87	RIGHT	D69b.EDF	D69	2
93	6770848	6770848	4621	4621	0	RIGHT	D69b.EDF	D69	2
93	6770873	6770999	4646	4772	126	RIGHT	D69b.EDF	D69	2
93	6771040	6771074	4813	4847	34	RIGHT	D69b.EDF	D69	2
93	6771100	6771111	4873	4884	11	RIGHT	D69b.EDF	D69	2
94	6773187	6773319	76	208	132	RIGHT	D69b.EDF	D69	2
94	6773435	6773518	324	407	83	RIGHT	D69b.EDF	D69	2
94	6773763	6773768	652	657	5	RIGHT	D69b.EDF	D69	2
94	6773798	6774102	687	991	304	RIGHT	D69b.EDF	D69	2
94	6774235	6774280	1124	1169	45	RIGHT	D69b.EDF	D69	2
94	6774309	6774311	1198	1200	2	RIGHT	D69b.EDF	D69	2
94	6774377	6774396	1266	1285	19	RIGHT	D69b.EDF	D69	2
94	6774426	6774430	1315	1319	4	RIGHT	D69b.EDF	D69	2
94	6774905	6774920	1794	1809	15	RIGHT	D69b.EDF	D69	2
94	6775577	6775685	2466	2574	108	RIGHT	D69b.EDF	D69	2
94	6775744	6775791	2633	2680	47	RIGHT	D69b.EDF	D69	2
94	6776697	6776809	3586	3698	112	RIGHT	D69b.EDF	D69	2
94	6776844	6777030	3733	3919	186	RIGHT	D69b.EDF	D69	2
94	6777101	6777291	3990	4180	190	RIGHT	D69b.EDF	D69	2
94	6777476	6777478	4365	4367	2	RIGHT	D69b.EDF	D69	2
94	6778143	6778245	5032	5134	102	RIGHT	D69b.EDF	D69	2
94	6778269	6778271	5158	5160	2	RIGHT	D69b.EDF	D69	2
94	6778311	6778326	5200	5215	15	RIGHT	D69b.EDF	D69	2
95	6780213	6780276	66	129	63	RIGHT	D69b.EDF	D69	2
95	6780625	6780645	478	498	20	RIGHT	D69b.EDF	D69	2
95	6780987	6780998	840	851	11	RIGHT	D69b.EDF	D69	2
95	6781024	6781154	877	1007	130	RIGHT	D69b.EDF	D69	2
95	6781272	6781373	1125	1226	101	RIGHT	D69b.EDF	D69	2
95	6781451	6781472	1304	1325	21	RIGHT	D69b.EDF	D69	2
95	6781496	6781610	1349	1463	114	RIGHT	D69b.EDF	D69	2
95	6781727	6781728	1580	1581	1	RIGHT	D69b.EDF	D69	2
95	6781750	6781881	1603	1734	131	RIGHT	D69b.EDF	D69	2
95	6783251	6783261	3104	3114	10	RIGHT	D69b.EDF	D69	2
95	6783285	6783417	3138	3270	132	RIGHT	D69b.EDF	D69	2
95	6783467	6783923	3320	3776	456	RIGHT	D69b.EDF	D69	2
95	6783952	6784077	3805	3930	125	RIGHT	D69b.EDF	D69	2
95	6784122	6784131	3975	3984	9	RIGHT	D69b.EDF	D69	2
95	6784183	6784226	4036	4079	43	RIGHT	D69b.EDF	D69	2
95	6784262	6784422	4115	4275	160	RIGHT	D69b.EDF	D69	2
95	6784488	6784503	4341	4356	15	RIGHT	D69b.EDF	D69	2
95	6784531	6784790	4384	4643	259	RIGHT	D69b.EDF	D69	2
96	6787127	6787228	303	404	101	RIGHT	D69b.EDF	D69	2
96	6787259	6787377	435	553	118	RIGHT	D69b.EDF	D69	2
96	6787422	6787441	598	617	19	RIGHT	D69b.EDF	D69	2
96	6787467	6787623	643	799	156	RIGHT	D69b.EDF	D69	2
96	6787880	6787896	1056	1072	16	RIGHT	D69b.EDF	D69	2
96	6787922	6788187	1098	1363	265	RIGHT	D69b.EDF	D69	2
96	6788221	6788280	1397	1456	59	RIGHT	D69b.EDF	D69	2
96	6788301	6788622	1477	1798	321	RIGHT	D69b.EDF	D69	2
96	6788648	6788657	1824	1833	9	RIGHT	D69b.EDF	D69	2
96	6789544	6789659	2720	2835	115	RIGHT	D69b.EDF	D69	2
96	6790745	6790832	3921	4008	87	RIGHT	D69b.EDF	D69	2
96	6790876	6790984	4052	4160	108	RIGHT	D69b.EDF	D69	2
96	6791516	6791625	4692	4801	109	RIGHT	D69b.EDF	D69	2
96	6791678	6791788	4854	4964	110	RIGHT	D69b.EDF	D69	2
97	6794105	6794222	57	174	117	RIGHT	D69b.EDF	D69	2
97	6794246	6794443	198	395	197	RIGHT	D69b.EDF	D69	2
97	6794767	6794954	719	906	187	RIGHT	D69b.EDF	D69	2
97	6795003	6795057	955	1009	54	RIGHT	D69b.EDF	D69	2
97	6795081	6795235	1033	1187	154	RIGHT	D69b.EDF	D69	2
97	6795262	6795453	1214	1405	191	RIGHT	D69b.EDF	D69	2
97	6795478	6795535	1430	1487	57	RIGHT	D69b.EDF	D69	2
97	6795944	6795958	1896	1910	14	RIGHT	D69b.EDF	D69	2
97	6797161	6797201	3113	3153	40	RIGHT	D69b.EDF	D69	2
97	6797231	6797391	3183	3343	160	RIGHT	D69b.EDF	D69	2
97	6797449	6797475	3401	3427	26	RIGHT	D69b.EDF	D69	2
97	6797538	6797596	3490	3548	58	RIGHT	D69b.EDF	D69	2
97	6797721	6797738	3673	3690	17	RIGHT	D69b.EDF	D69	2
97	6797992	6798003	3944	3955	11	RIGHT	D69b.EDF	D69	2
97	6798024	6798159	3976	4111	135	RIGHT	D69b.EDF	D69	2
97	6798180	6798403	4132	4355	223	RIGHT	D69b.EDF	D69	2
97	6798430	6798440	4382	4392	10	RIGHT	D69b.EDF	D69	2
97	6798462	6798622	4414	4574	160	RIGHT	D69b.EDF	D69	2
97	6798892	6798892	4844	4844	0	RIGHT	D69b.EDF	D69	2
97	6798921	6799048	4873	5000	127	RIGHT	D69b.EDF	D69	2
97	6799076	6799276	5028	5228	200	RIGHT	D69b.EDF	D69	2
97	6799304	6799308	5256	5260	4	RIGHT	D69b.EDF	D69	2
97	6799334	6799462	5286	5414	128	RIGHT	D69b.EDF	D69	2
97	6799503	6799509	5455	5461	6	RIGHT	D69b.EDF	D69	2
98	6801631	6801748	290	407	117	RIGHT	D69b.EDF	D69	2
98	6801864	6801889	523	548	25	RIGHT	D69b.EDF	D69	2
98	6801916	6802020	575	679	104	RIGHT	D69b.EDF	D69	2
98	6802043	6802046	702	705	3	RIGHT	D69b.EDF	D69	2
98	6802108	6802144	767	803	36	RIGHT	D69b.EDF	D69	2
98	6802362	6802494	1021	1153	132	RIGHT	D69b.EDF	D69	2
98	6802529	6802774	1188	1433	245	RIGHT	D69b.EDF	D69	2
98	6802846	6802872	1505	1531	26	RIGHT	D69b.EDF	D69	2
98	6802895	6802896	1554	1555	1	RIGHT	D69b.EDF	D69	2
98	6803017	6803040	1676	1699	23	RIGHT	D69b.EDF	D69	2
98	6803066	6803161	1725	1820	95	RIGHT	D69b.EDF	D69	2
98	6803183	6803308	1842	1967	125	RIGHT	D69b.EDF	D69	2
98	6803461	6803479	2120	2138	18	RIGHT	D69b.EDF	D69	2
98	6803823	6804161	2482	2820	338	RIGHT	D69b.EDF	D69	2
98	6804238	6804302	2897	2961	64	RIGHT	D69b.EDF	D69	2
98	6805184	6805198	3843	3857	14	RIGHT	D69b.EDF	D69	2
98	6805226	6805330	3885	3989	104	RIGHT	D69b.EDF	D69	2
98	6805352	6805712	4011	4371	360	RIGHT	D69b.EDF	D69	2
98	6805754	6805902	4413	4561	148	RIGHT	D69b.EDF	D69	2
98	6806054	6806067	4713	4726	13	RIGHT	D69b.EDF	D69	2
98	6806104	6806233	4763	4892	129	RIGHT	D69b.EDF	D69	2
98	6806269	6806270	4928	4929	1	RIGHT	D69b.EDF	D69	2
98	6806305	6806405	4964	5064	100	RIGHT	D69b.EDF	D69	2
98	6806439	6806462	5098	5121	23	RIGHT	D69b.EDF	D69	2
98	6806493	6806613	5152	5272	120	RIGHT	D69b.EDF	D69	2
98	6806646	6806651	5305	5310	5	RIGHT	D69b.EDF	D69	2
98	6806672	6806793	5331	5452	121	RIGHT	D69b.EDF	D69	2
99	6809421	6809546	103	228	125	RIGHT	D69b.EDF	D69	2
99	6809573	6809716	255	398	143	RIGHT	D69b.EDF	D69	2
99	6809801	6809819	483	501	18	RIGHT	D69b.EDF	D69	2
99	6809889	6809899	571	581	10	RIGHT	D69b.EDF	D69	2
99	6809947	6809983	629	665	36	RIGHT	D69b.EDF	D69	2
99	6810217	6810231	899	913	14	RIGHT	D69b.EDF	D69	2
99	6810256	6810571	938	1253	315	RIGHT	D69b.EDF	D69	2
99	6810648	6810891	1330	1573	243	RIGHT	D69b.EDF	D69	2
99	6811794	6811804	2476	2486	10	RIGHT	D69b.EDF	D69	2
99	6811827	6812205	2509	2887	378	RIGHT	D69b.EDF	D69	2
99	6812333	6812352	3015	3034	19	RIGHT	D69b.EDF	D69	2
99	6812756	6812934	3438	3616	178	RIGHT	D69b.EDF	D69	2
99	6812996	6813083	3678	3765	87	RIGHT	D69b.EDF	D69	2
99	6813106	6813252	3788	3934	146	RIGHT	D69b.EDF	D69	2
99	6813319	6813470	4001	4152	151	RIGHT	D69b.EDF	D69	2
99	6813785	6813794	4467	4476	9	RIGHT	D69b.EDF	D69	2
99	6813817	6813935	4499	4617	118	RIGHT	D69b.EDF	D69	2
99	6813959	6813975	4641	4657	16	RIGHT	D69b.EDF	D69	2
99	6814007	6814010	4689	4692	3	RIGHT	D69b.EDF	D69	2
99	6814045	6814154	4727	4836	109	RIGHT	D69b.EDF	D69	2
99	6814318	6814330	5000	5012	12	RIGHT	D69b.EDF	D69	2
99	6814352	6814665	5034	5347	313	RIGHT	D69b.EDF	D69	2
99	6814720	6814959	5402	5641	239	RIGHT	D69b.EDF	D69	2
100	6816836	6817161	75	400	325	RIGHT	D69b.EDF	D69	2
100	6817186	6817305	425	544	119	RIGHT	D69b.EDF	D69	2
100	6817506	6817619	745	858	113	RIGHT	D69b.EDF	D69	2
100	6817656	6817656	895	895	0	RIGHT	D69b.EDF	D69	2
100	6817686	6817893	925	1132	207	RIGHT	D69b.EDF	D69	2
100	6817940	6817942	1179	1181	2	RIGHT	D69b.EDF	D69	2
100	6818278	6818293	1517	1532	15	RIGHT	D69b.EDF	D69	2
100	6818323	6818426	1562	1665	103	RIGHT	D69b.EDF	D69	2
100	6818449	6818453	1688	1692	4	RIGHT	D69b.EDF	D69	2
100	6818490	6818669	1729	1908	179	RIGHT	D69b.EDF	D69	2
100	6818844	6818859	2083	2098	15	RIGHT	D69b.EDF	D69	2
100	6819378	6819380	2617	2619	2	RIGHT	D69b.EDF	D69	2
100	6819402	6819513	2641	2752	111	RIGHT	D69b.EDF	D69	2
100	6819554	6819616	2793	2855	62	RIGHT	D69b.EDF	D69	2
100	6819790	6819807	3029	3046	17	RIGHT	D69b.EDF	D69	2
100	6820622	6820642	3861	3881	20	RIGHT	D69b.EDF	D69	2
100	6820664	6820800	3903	4039	136	RIGHT	D69b.EDF	D69	2
100	6820826	6821230	4065	4469	404	RIGHT	D69b.EDF	D69	2
100	6821302	6821334	4541	4573	32	RIGHT	D69b.EDF	D69	2
100	6821362	6822019	4601	5258	657	RIGHT	D69b.EDF	D69	2
100	6822045	6822156	5284	5395	111	RIGHT	D69b.EDF	D69	2
100	6822244	6822625	5483	5864	381	RIGHT	D69b.EDF	D69	2
100	6822655	6822782	5894	6021	127	RIGHT	D69b.EDF	D69	2
100	6822806	6823341	6045	6580	535	RIGHT	D69b.EDF	D69	2
100	6823367	6823368	6606	6607	1	RIGHT	D69b.EDF	D69	2
100	6823448	6823448	6687	6687	0	RIGHT	D69b.EDF	D69	2
100	6823491	6823795	6730	7034	304	RIGHT	D69b.EDF	D69	2
101	6825606	6825723	59	176	117	RIGHT	D69b.EDF	D69	2
101	6825748	6825773	201	226	25	RIGHT	D69b.EDF	D69	2
101	6825801	6825920	254	373	119	RIGHT	D69b.EDF	D69	2
101	6826325	6826337	778	790	12	RIGHT	D69b.EDF	D69	2
101	6826363	6826658	816	1111	295	RIGHT	D69b.EDF	D69	2
101	6826702	6826703	1155	1156	1	RIGHT	D69b.EDF	D69	2
101	6826793	6826837	1246	1290	44	RIGHT	D69b.EDF	D69	2
101	6826867	6826895	1320	1348	28	RIGHT	D69b.EDF	D69	2
101	6827020	6827036	1473	1489	16	RIGHT	D69b.EDF	D69	2
101	6827061	6827193	1514	1646	132	RIGHT	D69b.EDF	D69	2
101	6827295	6827312	1748	1765	17	RIGHT	D69b.EDF	D69	2
101	6827492	6827493	1945	1946	1	RIGHT	D69b.EDF	D69	2
101	6827533	6827534	1986	1987	1	RIGHT	D69b.EDF	D69	2
101	6827558	6827577	2011	2030	19	RIGHT	D69b.EDF	D69	2
101	6827788	6827875	2241	2328	87	RIGHT	D69b.EDF	D69	2
101	6828790	6828887	3243	3340	97	RIGHT	D69b.EDF	D69	2
101	6828949	6828950	3402	3403	1	RIGHT	D69b.EDF	D69	2
101	6829050	6829054	3503	3507	4	RIGHT	D69b.EDF	D69	2
101	6829222	6829229	3675	3682	7	RIGHT	D69b.EDF	D69	2
101	6829254	6829665	3707	4118	411	RIGHT	D69b.EDF	D69	2
101	6829693	6829850	4146	4303	157	RIGHT	D69b.EDF	D69	2
101	6829991	6829991	4444	4444	0	RIGHT	D69b.EDF	D69	2
101	6830505	6830512	4958	4965	7	RIGHT	D69b.EDF	D69	2
101	6830540	6830679	4993	5132	139	RIGHT	D69b.EDF	D69	2
101	6830761	6830980	5214	5433	219	RIGHT	D69b.EDF	D69	2
101	6831059	6831059	5512	5512	0	RIGHT	D69b.EDF	D69	2
101	6831151	6831153	5604	5606	2	RIGHT	D69b.EDF	D69	2
101	6831441	6831442	5894	5895	1	RIGHT	D69b.EDF	D69	2
101	6831483	6831601	5936	6054	118	RIGHT	D69b.EDF	D69	2
101	6831762	6831762	6215	6215	0	RIGHT	D69b.EDF	D69	2
101	6831791	6831803	6244	6256	12	RIGHT	D69b.EDF	D69	2
101	6831857	6831865	6310	6318	8	RIGHT	D69b.EDF	D69	2
101	6831897	6832059	6350	6512	162	RIGHT	D69b.EDF	D69	2
101	6832156	6832156	6609	6609	0	RIGHT	D69b.EDF	D69	2
101	6832180	6832239	6633	6692	59	RIGHT	D69b.EDF	D69	2
102	6834263	6834401	61	199	138	RIGHT	D69b.EDF	D69	2
102	6834432	6834490	230	288	58	RIGHT	D69b.EDF	D69	2
102	6834524	6834693	322	491	169	RIGHT	D69b.EDF	D69	2
102	6834867	6835116	665	914	249	RIGHT	D69b.EDF	D69	2
102	6835288	6835408	1086	1206	120	RIGHT	D69b.EDF	D69	2
102	6835463	6835465	1261	1263	2	RIGHT	D69b.EDF	D69	2
102	6835511	6835589	1309	1387	78	RIGHT	D69b.EDF	D69	2
102	6835640	6835807	1438	1605	167	RIGHT	D69b.EDF	D69	2
102	6835829	6835830	1627	1628	1	RIGHT	D69b.EDF	D69	2
102	6836784	6836926	2582	2724	142	RIGHT	D69b.EDF	D69	2
102	6836966	6837221	2764	3019	255	RIGHT	D69b.EDF	D69	2
102	6837548	6837548	3346	3346	0	RIGHT	D69b.EDF	D69	2
102	6837581	6837984	3379	3782	403	RIGHT	D69b.EDF	D69	2
102	6838042	6838185	3840	3983	143	RIGHT	D69b.EDF	D69	2
102	6838601	6838603	4399	4401	2	RIGHT	D69b.EDF	D69	2
102	6838629	6838750	4427	4548	121	RIGHT	D69b.EDF	D69	2
102	6838777	6838778	4575	4576	1	RIGHT	D69b.EDF	D69	2
102	6838836	6838941	4634	4739	105	RIGHT	D69b.EDF	D69	2
102	6839130	6839133	4928	4931	3	RIGHT	D69b.EDF	D69	2
102	6839163	6839299	4961	5097	136	RIGHT	D69b.EDF	D69	2
102	6839329	6839330	5127	5128	1	RIGHT	D69b.EDF	D69	2
102	6839354	6839354	5152	5152	0	RIGHT	D69b.EDF	D69	2
102	6839413	6839482	5211	5280	69	RIGHT	D69b.EDF	D69	2
102	6839513	6839625	5311	5423	112	RIGHT	D69b.EDF	D69	2
102	6839738	6839833	5536	5631	95	RIGHT	D69b.EDF	D69	2
102	6839962	6839970	5760	5768	8	RIGHT	D69b.EDF	D69	2
102	6839998	6840137	5796	5935	139	RIGHT	D69b.EDF	D69	2
102	6840251	6840374	6049	6172	123	RIGHT	D69b.EDF	D69	2
103	6842544	6842769	258	483	225	RIGHT	D69b.EDF	D69	2
103	6842791	6842874	505	588	83	RIGHT	D69b.EDF	D69	2
103	6843384	6843520	1098	1234	136	RIGHT	D69b.EDF	D69	2
103	6843550	6843760	1264	1474	210	RIGHT	D69b.EDF	D69	2
103	6843783	6843783	1497	1497	0	RIGHT	D69b.EDF	D69	2
103	6845041	6845165	2755	2879	124	RIGHT	D69b.EDF	D69	2
103	6845218	6845305	2932	3019	87	RIGHT	D69b.EDF	D69	2
103	6845843	6845853	3557	3567	10	RIGHT	D69b.EDF	D69	2
103	6845875	6846265	3589	3979	390	RIGHT	D69b.EDF	D69	2
103	6846287	6846430	4001	4144	143	RIGHT	D69b.EDF	D69	2
103	6846453	6846459	4167	4173	6	RIGHT	D69b.EDF	D69	2
103	6846486	6846592	4200	4306	106	RIGHT	D69b.EDF	D69	2
103	6846614	6846948	4328	4662	334	RIGHT	D69b.EDF	D69	2
103	6846978	6846979	4692	4693	1	RIGHT	D69b.EDF	D69	2
103	6847031	6847049	4745	4763	18	RIGHT	D69b.EDF	D69	2
103	6847074	6847277	4788	4991	203	RIGHT	D69b.EDF	D69	2
103	6847538	6847552	5252	5266	14	RIGHT	D69b.EDF	D69	2
103	6847578	6847736	5292	5450	158	RIGHT	D69b.EDF	D69	2
103	6847762	6847763	5476	5477	1	RIGHT	D69b.EDF	D69	2
103	6847835	6848028	5549	5742	193	RIGHT	D69b.EDF	D69	2
103	6848127	6848145	5841	5859	18	RIGHT	D69b.EDF	D69	2
103	6848168	6848319	5882	6033	151	RIGHT	D69b.EDF	D69	2
103	6848462	6848466	6176	6180	4	RIGHT	D69b.EDF	D69	2
103	6848504	6848656	6218	6370	152	RIGHT	D69b.EDF	D69	2
103	6848760	6848858	6474	6572	98	RIGHT	D69b.EDF	D69	2
103	6848885	6849016	6599	6730	131	RIGHT	D69b.EDF	D69	2
103	6849119	6849325	6833	7039	206	RIGHT	D69b.EDF	D69	2
103	6849348	6849510	7062	7224	162	RIGHT	D69b.EDF	D69	2
104	6851643	6851886	80	323	243	RIGHT	D69b.EDF	D69	2
104	6851909	6851921	346	358	12	RIGHT	D69b.EDF	D69	2
104	6851952	6851952	389	389	0	RIGHT	D69b.EDF	D69	2
104	6851986	6852116	423	553	130	RIGHT	D69b.EDF	D69	2
104	6852450	6852459	887	896	9	RIGHT	D69b.EDF	D69	2
104	6852491	6852787	928	1224	296	RIGHT	D69b.EDF	D69	2
104	6852816	6852818	1253	1255	2	RIGHT	D69b.EDF	D69	2
104	6852879	6852880	1316	1317	1	RIGHT	D69b.EDF	D69	2
104	6852919	6853223	1356	1660	304	RIGHT	D69b.EDF	D69	2
104	6853284	6853285	1721	1722	1	RIGHT	D69b.EDF	D69	2
104	6854509	6854686	2946	3123	177	RIGHT	D69b.EDF	D69	2
104	6854737	6854929	3174	3366	192	RIGHT	D69b.EDF	D69	2
104	6855134	6855155	3571	3592	21	RIGHT	D69b.EDF	D69	2
104	6855183	6855329	3620	3766	146	RIGHT	D69b.EDF	D69	2
104	6855367	6855649	3804	4086	282	RIGHT	D69b.EDF	D69	2
104	6855761	6855784	4198	4221	23	RIGHT	D69b.EDF	D69	2
104	6855814	6855939	4251	4376	125	RIGHT	D69b.EDF	D69	2
104	6855972	6856082	4409	4519	110	RIGHT	D69b.EDF	D69	2
104	6856109	6856245	4546	4682	136	RIGHT	D69b.EDF	D69	2
104	6856268	6856582	4705	5019	314	RIGHT	D69b.EDF	D69	2
105	6858962	6859086	162	286	124	RIGHT	D69b.EDF	D69	2
105	6859111	6859257	311	457	146	RIGHT	D69b.EDF	D69	2
105	6859395	6859405	595	605	10	RIGHT	D69b.EDF	D69	2
105	6859430	6859563	630	763	133	RIGHT	D69b.EDF	D69	2
105	6859615	6859628	815	828	13	RIGHT	D69b.EDF	D69	2
105	6859796	6859918	996	1118	122	RIGHT	D69b.EDF	D69	2
105	6859964	6859973	1164	1173	9	RIGHT	D69b.EDF	D69	2
105	6859994	6860165	1194	1365	171	RIGHT	D69b.EDF	D69	2
105	6860239	6860329	1439	1529	90	RIGHT	D69b.EDF	D69	2
105	6861611	6861721	2811	2921	110	RIGHT	D69b.EDF	D69	2
105	6861751	6861936	2951	3136	185	RIGHT	D69b.EDF	D69	2
105	6862306	6862318	3506	3518	12	RIGHT	D69b.EDF	D69	2
105	6862341	6862460	3541	3660	119	RIGHT	D69b.EDF	D69	2
105	6862519	6862730	3719	3930	211	RIGHT	D69b.EDF	D69	2
105	6862760	6862761	3960	3961	1	RIGHT	D69b.EDF	D69	2
105	6863220	6863227	4420	4427	7	RIGHT	D69b.EDF	D69	2
105	6863251	6863365	4451	4565	114	RIGHT	D69b.EDF	D69	2
105	6863407	6863802	4607	5002	395	RIGHT	D69b.EDF	D69	2
105	6864178	6864189	5378	5389	11	RIGHT	D69b.EDF	D69	2
105	6864221	6864312	5421	5512	91	RIGHT	D69b.EDF	D69	2
105	6864361	6864601	5561	5801	240	RIGHT	D69b.EDF	D69	2
105	6864886	6864903	6086	6103	17	RIGHT	D69b.EDF	D69	2
105	6864929	6865038	6129	6238	109	RIGHT	D69b.EDF	D69	2
105	6865117	6865510	6317	6710	393	RIGHT	D69b.EDF	D69	2
106	6867339	6867423	58	142	84	RIGHT	D69b.EDF	D69	2
106	6867449	6867734	168	453	285	RIGHT	D69b.EDF	D69	2
106	6867963	6868017	682	736	54	RIGHT	D69b.EDF	D69	2
106	6868042	6868061	761	780	19	RIGHT	D69b.EDF	D69	2
106	6868094	6868221	813	940	127	RIGHT	D69b.EDF	D69	2
106	6868258	6868427	977	1146	169	RIGHT	D69b.EDF	D69	2
106	6868699	6868706	1418	1425	7	RIGHT	D69b.EDF	D69	2
106	6868735	6868852	1454	1571	117	RIGHT	D69b.EDF	D69	2
106	6868922	6869020	1641	1739	98	RIGHT	D69b.EDF	D69	2
106	6869503	6869830	2222	2549	327	RIGHT	D69b.EDF	D69	2
106	6869883	6869952	2602	2671	69	RIGHT	D69b.EDF	D69	2
106	6870201	6870529	2920	3248	328	RIGHT	D69b.EDF	D69	2
106	6870597	6870743	3316	3462	146	RIGHT	D69b.EDF	D69	2
106	6871074	6871086	3793	3805	12	RIGHT	D69b.EDF	D69	2
106	6871110	6871238	3829	3957	128	RIGHT	D69b.EDF	D69	2
106	6871308	6871409	4027	4128	101	RIGHT	D69b.EDF	D69	2
106	6871431	6871623	4150	4342	192	RIGHT	D69b.EDF	D69	2
106	6871690	6871748	4409	4467	58	RIGHT	D69b.EDF	D69	2
106	6871771	6871904	4490	4623	133	RIGHT	D69b.EDF	D69	2
106	6871937	6871940	4656	4659	3	RIGHT	D69b.EDF	D69	2
106	6871968	6872328	4687	5047	360	RIGHT	D69b.EDF	D69	2
106	6872383	6872469	5102	5188	86	RIGHT	D69b.EDF	D69	2
106	6872506	6872644	5225	5363	138	RIGHT	D69b.EDF	D69	2
107	6874489	6874643	91	245	154	RIGHT	D69b.EDF	D69	2
107	6874690	6874830	292	432	140	RIGHT	D69b.EDF	D69	2
107	6874973	6874973	575	575	0	RIGHT	D69b.EDF	D69	2
107	6875146	6875267	748	869	121	RIGHT	D69b.EDF	D69	2
107	6875324	6875331	926	933	7	RIGHT	D69b.EDF	D69	2
107	6875354	6875524	956	1126	170	RIGHT	D69b.EDF	D69	2
107	6875803	6875803	1405	1405	0	RIGHT	D69b.EDF	D69	2
107	6875968	6876083	1570	1685	115	RIGHT	D69b.EDF	D69	2
107	6876114	6876114	1716	1716	0	RIGHT	D69b.EDF	D69	2
107	6876144	6876246	1746	1848	102	RIGHT	D69b.EDF	D69	2
107	6876782	6876913	2384	2515	131	RIGHT	D69b.EDF	D69	2
107	6877095	6877221	2697	2823	126	RIGHT	D69b.EDF	D69	2
107	6877289	6877475	2891	3077	186	RIGHT	D69b.EDF	D69	2
107	6877889	6878033	3491	3635	144	RIGHT	D69b.EDF	D69	2
107	6878086	6878349	3688	3951	263	RIGHT	D69b.EDF	D69	2
107	6878386	6878421	3988	4023	35	RIGHT	D69b.EDF	D69	2
107	6878444	6878455	4046	4057	11	RIGHT	D69b.EDF	D69	2
107	6878730	6878866	4332	4468	136	RIGHT	D69b.EDF	D69	2
107	6878993	6879034	4595	4636	41	RIGHT	D69b.EDF	D69	2
107	6879067	6879067	4669	4669	0	RIGHT	D69b.EDF	D69	2
107	6879362	6879496	4964	5098	134	RIGHT	D69b.EDF	D69	2
107	6879519	6879520	5121	5122	1	RIGHT	D69b.EDF	D69	2
107	6879633	6879642	5235	5244	9	RIGHT	D69b.EDF	D69	2
107	6879676	6879778	5278	5380	102	RIGHT	D69b.EDF	D69	2
107	6879814	6879814	5416	5416	0	RIGHT	D69b.EDF	D69	2
107	6880069	6880107	5671	5709	38	RIGHT	D69b.EDF	D69	2
107	6880138	6880178	5740	5780	40	RIGHT	D69b.EDF	D69	2
107	6880202	6880255	5804	5857	53	RIGHT	D69b.EDF	D69	2
107	6880516	6880629	6118	6231	113	RIGHT	D69b.EDF	D69	2
108	6882212	6882256	154	198	44	RIGHT	D69b.EDF	D69	2
108	6882579	6882593	521	535	14	RIGHT	D69b.EDF	D69	2
108	6882621	6883076	563	1018	455	RIGHT	D69b.EDF	D69	2
108	6883100	6883109	1042	1051	9	RIGHT	D69b.EDF	D69	2
108	6883137	6883137	1079	1079	0	RIGHT	D69b.EDF	D69	2
108	6883160	6883286	1102	1228	126	RIGHT	D69b.EDF	D69	2
108	6883485	6883618	1427	1560	133	RIGHT	D69b.EDF	D69	2
108	6883655	6884129	1597	2071	474	RIGHT	D69b.EDF	D69	2
108	6885201	6885341	3143	3283	140	RIGHT	D69b.EDF	D69	2
108	6885371	6885492	3313	3434	121	RIGHT	D69b.EDF	D69	2
108	6886326	6886330	4268	4272	4	RIGHT	D69b.EDF	D69	2
108	6886352	6886484	4294	4426	132	RIGHT	D69b.EDF	D69	2
108	6886517	6886806	4459	4748	289	RIGHT	D69b.EDF	D69	2
108	6887136	6887160	5078	5102	24	RIGHT	D69b.EDF	D69	2
108	6887184	6887274	5126	5216	90	RIGHT	D69b.EDF	D69	2
108	6887301	6887522	5243	5464	221	RIGHT	D69b.EDF	D69	2
108	6887969	6887985	5911	5927	16	RIGHT	D69b.EDF	D69	2
108	6888015	6888109	5957	6051	94	RIGHT	D69b.EDF	D69	2
108	6888150	6888412	6092	6354	262	RIGHT	D69b.EDF	D69	2
108	6888732	6888776	6674	6718	44	RIGHT	D69b.EDF	D69	2
108	6888801	6888911	6743	6853	110	RIGHT	D69b.EDF	D69	2
108	6888961	6889285	6903	7227	324	RIGHT	D69b.EDF	D69	2
108	6889333	6889344	7275	7286	11	RIGHT	D69b.EDF	D69	2
109	6891145	6891197	58	110	52	RIGHT	D69b.EDF	D69	2
109	6891221	6891351	134	264	130	RIGHT	D69b.EDF	D69	2
109	6891411	6891599	324	512	188	RIGHT	D69b.EDF	D69	2
109	6891627	6891701	540	614	74	RIGHT	D69b.EDF	D69	2
109	6891725	6891873	638	786	148	RIGHT	D69b.EDF	D69	2
109	6891894	6892260	807	1173	366	RIGHT	D69b.EDF	D69	2
109	6892536	6892554	1449	1467	18	RIGHT	D69b.EDF	D69	2
109	6892585	6892686	1498	1599	101	RIGHT	D69b.EDF	D69	2
109	6892713	6892918	1626	1831	205	RIGHT	D69b.EDF	D69	2
109	6893002	6893043	1915	1956	41	RIGHT	D69b.EDF	D69	2
109	6893611	6893670	2524	2583	59	RIGHT	D69b.EDF	D69	2
109	6893757	6893879	2670	2792	122	RIGHT	D69b.EDF	D69	2
109	6893944	6893973	2857	2886	29	RIGHT	D69b.EDF	D69	2
109	6895001	6895104	3914	4017	103	RIGHT	D69b.EDF	D69	2
109	6895134	6895361	4047	4274	227	RIGHT	D69b.EDF	D69	2
109	6895870	6896010	4783	4923	140	RIGHT	D69b.EDF	D69	2
109	6896051	6896189	4964	5102	138	RIGHT	D69b.EDF	D69	2
109	6896658	6896667	5571	5580	9	RIGHT	D69b.EDF	D69	2
109	6896689	6896827	5602	5740	138	RIGHT	D69b.EDF	D69	2
109	6896869	6897097	5782	6010	228	RIGHT	D69b.EDF	D69	2
109	6897128	6897362	6041	6275	234	RIGHT	D69b.EDF	D69	2
109	6897491	6897503	6404	6416	12	RIGHT	D69b.EDF	D69	2
109	6897535	6897559	6448	6472	24	RIGHT	D69b.EDF	D69	2
110	6899502	6899605	189	292	103	RIGHT	D69b.EDF	D69	2
110	6899778	6899783	465	470	5	RIGHT	D69b.EDF	D69	2
110	6899925	6900056	612	743	131	RIGHT	D69b.EDF	D69	2
110	6900116	6900257	803	944	141	RIGHT	D69b.EDF	D69	2
110	6900616	6900630	1303	1317	14	RIGHT	D69b.EDF	D69	2
110	6900730	6900731	1417	1418	1	RIGHT	D69b.EDF	D69	2
110	6900768	6900878	1455	1565	110	RIGHT	D69b.EDF	D69	2
110	6900963	6900970	1650	1657	7	RIGHT	D69b.EDF	D69	2
110	6901010	6901033	1697	1720	23	RIGHT	D69b.EDF	D69	2
110	6901067	6901068	1754	1755	1	RIGHT	D69b.EDF	D69	2
110	6901103	6901206	1790	1893	103	RIGHT	D69b.EDF	D69	2
110	6901789	6901918	2476	2605	129	RIGHT	D69b.EDF	D69	2
110	6902012	6902048	2699	2735	36	RIGHT	D69b.EDF	D69	2
110	6902080	6902080	2767	2767	0	RIGHT	D69b.EDF	D69	2
110	6902323	6902361	3010	3048	38	RIGHT	D69b.EDF	D69	2
110	6902391	6902547	3078	3234	156	RIGHT	D69b.EDF	D69	2
110	6902604	6902949	3291	3636	345	RIGHT	D69b.EDF	D69	2
110	6902976	6902986	3663	3673	10	RIGHT	D69b.EDF	D69	2
110	6903269	6903295	3956	3982	26	RIGHT	D69b.EDF	D69	2
110	6903317	6903428	4004	4115	111	RIGHT	D69b.EDF	D69	2
110	6903462	6903811	4149	4498	349	RIGHT	D69b.EDF	D69	2
110	6903841	6903990	4528	4677	149	RIGHT	D69b.EDF	D69	2
110	6904030	6904347	4717	5034	317	RIGHT	D69b.EDF	D69	2
110	6904373	6904514	5060	5201	141	RIGHT	D69b.EDF	D69	2
110	6904548	6904999	5235	5686	451	RIGHT	D69b.EDF	D69	2
110	6905020	6905034	5707	5721	14	RIGHT	D69b.EDF	D69	2
111	6907074	6907190	57	173	116	RIGHT	D69b.EDF	D69	2
111	6907683	6907691	666	674	8	RIGHT	D69b.EDF	D69	2
111	6907725	6908008	708	991	283	RIGHT	D69b.EDF	D69	2
111	6908045	6908285	1028	1268	240	RIGHT	D69b.EDF	D69	2
111	6908310	6908310	1293	1293	0	RIGHT	D69b.EDF	D69	2
111	6908447	6908470	1430	1453	23	RIGHT	D69b.EDF	D69	2
111	6908498	6908630	1481	1613	132	RIGHT	D69b.EDF	D69	2
111	6908657	6909000	1640	1983	343	RIGHT	D69b.EDF	D69	2
111	6909845	6910001	2828	2984	156	RIGHT	D69b.EDF	D69	2
111	6910031	6910224	3014	3207	193	RIGHT	D69b.EDF	D69	2
111	6910256	6910266	3239	3249	10	RIGHT	D69b.EDF	D69	2
111	6910354	6910377	3337	3360	23	RIGHT	D69b.EDF	D69	2
111	6910506	6910530	3489	3513	24	RIGHT	D69b.EDF	D69	2
111	6910551	6910683	3534	3666	132	RIGHT	D69b.EDF	D69	2
111	6910708	6910816	3691	3799	108	RIGHT	D69b.EDF	D69	2
111	6910845	6910984	3828	3967	139	RIGHT	D69b.EDF	D69	2
111	6911012	6911232	3995	4215	220	RIGHT	D69b.EDF	D69	2
111	6911269	6911572	4252	4555	303	RIGHT	D69b.EDF	D69	2
111	6911656	6911762	4639	4745	106	RIGHT	D69b.EDF	D69	2
111	6911786	6912076	4769	5059	290	RIGHT	D69b.EDF	D69	2
111	6912112	6912349	5095	5332	237	RIGHT	D69b.EDF	D69	2
112	6914690	6914801	528	639	111	RIGHT	D69b.EDF	D69	2
112	6914826	6915041	664	879	215	RIGHT	D69b.EDF	D69	2
112	6915260	6915276	1098	1114	16	RIGHT	D69b.EDF	D69	2
112	6915304	6915611	1142	1449	307	RIGHT	D69b.EDF	D69	2
112	6915655	6915667	1493	1505	12	RIGHT	D69b.EDF	D69	2
112	6915692	6916016	1530	1854	324	RIGHT	D69b.EDF	D69	2
112	6917670	6917680	3508	3518	10	RIGHT	D69b.EDF	D69	2
112	6917717	6917781	3555	3619	64	RIGHT	D69b.EDF	D69	2
112	6917822	6918012	3660	3850	190	RIGHT	D69b.EDF	D69	2
112	6918323	6918335	4161	4173	12	RIGHT	D69b.EDF	D69	2
112	6918371	6918476	4209	4314	105	RIGHT	D69b.EDF	D69	2
112	6918507	6918848	4345	4686	341	RIGHT	D69b.EDF	D69	2
112	6919057	6919074	4895	4912	17	RIGHT	D69b.EDF	D69	2
112	6919113	6919226	4951	5064	113	RIGHT	D69b.EDF	D69	2
112	6919265	6919571	5103	5409	306	RIGHT	D69b.EDF	D69	2
112	6919607	6919640	5445	5478	33	RIGHT	D69b.EDF	D69	2
112	6919665	6919883	5503	5721	218	RIGHT	D69b.EDF	D69	2
112	6919964	6919988	5802	5826	24	RIGHT	D69b.EDF	D69	2
112	6920021	6920105	5859	5943	84	RIGHT	D69b.EDF	D69	2
112	6920126	6920140	5964	5978	14	RIGHT	D69b.EDF	D69	2
112	6920169	6920442	6007	6280	273	RIGHT	D69b.EDF	D69	2
112	6920588	6920597	6426	6435	9	RIGHT	D69b.EDF	D69	2
112	6920633	6920723	6471	6561	90	RIGHT	D69b.EDF	D69	2
113	6923438	6923632	95	289	194	RIGHT	D69b.EDF	D69	2
113	6924081	6924093	738	750	12	RIGHT	D69b.EDF	D69	2
113	6924123	6924405	780	1062	282	RIGHT	D69b.EDF	D69	2
113	6924442	6924444	1099	1101	2	RIGHT	D69b.EDF	D69	2
113	6924494	6924637	1151	1294	143	RIGHT	D69b.EDF	D69	2
113	6924719	6924721	1376	1378	2	RIGHT	D69b.EDF	D69	2
113	6924947	6924997	1604	1654	50	RIGHT	D69b.EDF	D69	2
113	6926248	6926510	2905	3167	262	RIGHT	D69b.EDF	D69	2
113	6926752	6926805	3409	3462	53	RIGHT	D69b.EDF	D69	2
113	6927246	6927525	3903	4182	279	RIGHT	D69b.EDF	D69	2
113	6927654	6927654	4311	4311	0	RIGHT	D69b.EDF	D69	2
113	6927767	6927934	4424	4591	167	RIGHT	D69b.EDF	D69	2
113	6928121	6928148	4778	4805	27	RIGHT	D69b.EDF	D69	2
114	6930106	6930152	74	120	46	RIGHT	D69b.EDF	D69	2
114	6930479	6930495	447	463	16	RIGHT	D69b.EDF	D69	2
114	6930526	6930532	494	500	6	RIGHT	D69b.EDF	D69	2
114	6930622	6930630	590	598	8	RIGHT	D69b.EDF	D69	2
114	6930662	6930801	630	769	139	RIGHT	D69b.EDF	D69	2
114	6930832	6931273	800	1241	441	RIGHT	D69b.EDF	D69	2
114	6931310	6931311	1278	1279	1	RIGHT	D69b.EDF	D69	2
114	6931332	6931526	1300	1494	194	RIGHT	D69b.EDF	D69	2
114	6932370	6932545	2338	2513	175	RIGHT	D69b.EDF	D69	2
114	6932600	6932738	2568	2706	138	RIGHT	D69b.EDF	D69	2
114	6933047	6933059	3015	3027	12	RIGHT	D69b.EDF	D69	2
114	6933080	6933214	3048	3182	134	RIGHT	D69b.EDF	D69	2
114	6933238	6933631	3206	3599	393	RIGHT	D69b.EDF	D69	2
114	6933664	6933939	3632	3907	275	RIGHT	D69b.EDF	D69	2
114	6934123	6934143	4091	4111	20	RIGHT	D69b.EDF	D69	2
114	6934171	6934457	4139	4425	286	RIGHT	D69b.EDF	D69	2
114	6934501	6934501	4469	4469	0	RIGHT	D69b.EDF	D69	2
114	6934544	6934912	4512	4880	368	RIGHT	D69b.EDF	D69	2
114	6934933	6935080	4901	5048	147	RIGHT	D69b.EDF	D69	2
114	6935113	6935278	5081	5246	165	RIGHT	D69b.EDF	D69	2
114	6935299	6935444	5267	5412	145	RIGHT	D69b.EDF	D69	2
114	6935516	6935670	5484	5638	154	RIGHT	D69b.EDF	D69	2
114	6935698	6935836	5666	5804	138	RIGHT	D69b.EDF	D69	2
114	6935868	6935923	5836	5891	55	RIGHT	D69b.EDF	D69	2
115	6937904	6937980	69	145	76	RIGHT	D69b.EDF	D69	2
115	6938011	6938155	176	320	144	RIGHT	D69b.EDF	D69	2
115	6938233	6938441	398	606	208	RIGHT	D69b.EDF	D69	2
115	6938470	6938788	635	953	318	RIGHT	D69b.EDF	D69	2
115	6938847	6939181	1012	1346	334	RIGHT	D69b.EDF	D69	2
115	6939208	6939361	1373	1526	153	RIGHT	D69b.EDF	D69	2
115	6939383	6939398	1548	1563	15	RIGHT	D69b.EDF	D69	2
115	6939451	6939475	1616	1640	24	RIGHT	D69b.EDF	D69	2
115	6939525	6939734	1690	1899	209	RIGHT	D69b.EDF	D69	2
115	6940600	6940615	2765	2780	15	RIGHT	D69b.EDF	D69	2
115	6940640	6940751	2805	2916	111	RIGHT	D69b.EDF	D69	2
115	6940774	6941056	2939	3221	282	RIGHT	D69b.EDF	D69	2
115	6941103	6941199	3268	3364	96	RIGHT	D69b.EDF	D69	2
115	6941448	6941459	3613	3624	11	RIGHT	D69b.EDF	D69	2
115	6941600	6941756	3765	3921	156	RIGHT	D69b.EDF	D69	2
115	6941787	6941840	3952	4005	53	RIGHT	D69b.EDF	D69	2
115	6941920	6942031	4085	4196	111	RIGHT	D69b.EDF	D69	2
115	6942146	6942203	4311	4368	57	RIGHT	D69b.EDF	D69	2
115	6942244	6942377	4409	4542	133	RIGHT	D69b.EDF	D69	2
115	6942425	6942448	4590	4613	23	RIGHT	D69b.EDF	D69	2
115	6942490	6942497	4655	4662	7	RIGHT	D69b.EDF	D69	2
115	6942545	6942689	4710	4854	144	RIGHT	D69b.EDF	D69	2
115	6942721	6942767	4886	4932	46	RIGHT	D69b.EDF	D69	2
116	6945120	6945253	110	243	133	RIGHT	D69b.EDF	D69	2
116	6945292	6945451	282	441	159	RIGHT	D69b.EDF	D69	2
116	6945539	6945627	529	617	88	RIGHT	D69b.EDF	D69	2
116	6945671	6945701	661	691	30	RIGHT	D69b.EDF	D69	2
116	6945910	6946000	900	990	90	RIGHT	D69b.EDF	D69	2
116	6946032	6946342	1022	1332	310	RIGHT	D69b.EDF	D69	2
116	6946367	6946456	1357	1446	89	RIGHT	D69b.EDF	D69	2
116	6946480	6947009	1470	1999	529	RIGHT	D69b.EDF	D69	2
116	6947528	6947669	2518	2659	141	RIGHT	D69b.EDF	D69	2
116	6947738	6947871	2728	2861	133	RIGHT	D69b.EDF	D69	2
116	6948241	6948242	3231	3232	1	RIGHT	D69b.EDF	D69	2
116	6948679	6948781	3669	3771	102	RIGHT	D69b.EDF	D69	2
116	6948807	6948996	3797	3986	189	RIGHT	D69b.EDF	D69	2
116	6949020	6949169	4010	4159	149	RIGHT	D69b.EDF	D69	2
116	6949206	6949512	4196	4502	306	RIGHT	D69b.EDF	D69	2
116	6949644	6949659	4634	4649	15	RIGHT	D69b.EDF	D69	2
116	6949832	6949841	4822	4831	9	RIGHT	D69b.EDF	D69	2
117	6952178	6952204	536	562	26	RIGHT	D69b.EDF	D69	2
117	6952236	6952260	594	618	24	RIGHT	D69b.EDF	D69	2
117	6952353	6952373	711	731	20	RIGHT	D69b.EDF	D69	2
117	6952627	6952633	985	991	6	RIGHT	D69b.EDF	D69	2
117	6952698	6952896	1056	1254	198	RIGHT	D69b.EDF	D69	2
117	6952930	6953208	1288	1566	278	RIGHT	D69b.EDF	D69	2
117	6953229	6953313	1587	1671	84	RIGHT	D69b.EDF	D69	2
117	6954243	6954248	2601	2606	5	RIGHT	D69b.EDF	D69	2
117	6954442	6954839	2800	3197	397	RIGHT	D69b.EDF	D69	2
117	6955501	6955532	3859	3890	31	RIGHT	D69b.EDF	D69	2
117	6955555	6956404	3913	4762	849	RIGHT	D69b.EDF	D69	2
117	6956431	6956447	4789	4805	16	RIGHT	D69b.EDF	D69	2
117	6957328	6957371	5686	5729	43	RIGHT	D69b.EDF	D69	2
117	6957402	6957509	5760	5867	107	RIGHT	D69b.EDF	D69	2
117	6957532	6957818	5890	6176	286	RIGHT	D69b.EDF	D69	2
117	6957933	6957953	6291	6311	20	RIGHT	D69b.EDF	D69	2
117	6957992	6958098	6350	6456	106	RIGHT	D69b.EDF	D69	2
117	6958122	6958453	6480	6811	331	RIGHT	D69b.EDF	D69	2
117	6958496	6958538	6854	6896	42	RIGHT	D69b.EDF	D69	2
117	6958576	6958717	6934	7075	141	RIGHT	D69b.EDF	D69	2
118	6960868	6961364	58	554	496	RIGHT	D69b.EDF	D69	2
118	6961544	6961657	734	847	113	RIGHT	D69b.EDF	D69	2
118	6961679	6961689	869	879	10	RIGHT	D69b.EDF	D69	2
118	6961712	6962051	902	1241	339	RIGHT	D69b.EDF	D69	2
118	6962192	6962192	1382	1382	0	RIGHT	D69b.EDF	D69	2
118	6963180	6963268	2370	2458	88	RIGHT	D69b.EDF	D69	2
118	6963469	6963472	2659	2662	3	RIGHT	D69b.EDF	D69	2
118	6964115	6964153	3305	3343	38	RIGHT	D69b.EDF	D69	2
118	6964186	6964249	3376	3439	63	RIGHT	D69b.EDF	D69	2
118	6964598	6964675	3788	3865	77	RIGHT	D69b.EDF	D69	2
118	6965407	6965484	4597	4674	77	RIGHT	D69b.EDF	D69	2
118	6965510	6965521	4700	4711	11	RIGHT	D69b.EDF	D69	2
118	6965581	6965962	4771	5152	381	RIGHT	D69b.EDF	D69	2
119	6967860	6967919	57	116	59	RIGHT	D69b.EDF	D69	2
119	6968160	6968165	357	362	5	RIGHT	D69b.EDF	D69	2
119	6968194	6968305	391	502	111	RIGHT	D69b.EDF	D69	2
119	6968329	6968509	526	706	180	RIGHT	D69b.EDF	D69	2
119	6968533	6968586	730	783	53	RIGHT	D69b.EDF	D69	2
119	6968626	6968627	823	824	1	RIGHT	D69b.EDF	D69	2
119	6968795	6968826	992	1023	31	RIGHT	D69b.EDF	D69	2
119	6968849	6969111	1046	1308	262	RIGHT	D69b.EDF	D69	2
119	6969132	6969149	1329	1346	17	RIGHT	D69b.EDF	D69	2
119	6969176	6969651	1373	1848	475	RIGHT	D69b.EDF	D69	2
119	6970722	6970832	2919	3029	110	RIGHT	D69b.EDF	D69	2
119	6970857	6970966	3054	3163	109	RIGHT	D69b.EDF	D69	2
119	6971057	6971057	3254	3254	0	RIGHT	D69b.EDF	D69	2
119	6971310	6971322	3507	3519	12	RIGHT	D69b.EDF	D69	2
119	6971346	6971467	3543	3664	121	RIGHT	D69b.EDF	D69	2
119	6971543	6971776	3740	3973	233	RIGHT	D69b.EDF	D69	2
119	6971831	6971831	4028	4028	0	RIGHT	D69b.EDF	D69	2
119	6972116	6972212	4313	4409	96	RIGHT	D69b.EDF	D69	2
119	6972242	6972250	4439	4447	8	RIGHT	D69b.EDF	D69	2
119	6972302	6972401	4499	4598	99	RIGHT	D69b.EDF	D69	2
119	6972430	6972568	4627	4765	138	RIGHT	D69b.EDF	D69	2
119	6972891	6972896	5088	5093	5	RIGHT	D69b.EDF	D69	2
120	6975053	6975384	58	389	331	RIGHT	D69b.EDF	D69	2
120	6975561	6975625	566	630	64	RIGHT	D69b.EDF	D69	2
120	6975717	6976030	722	1035	313	RIGHT	D69b.EDF	D69	2
120	6976116	6976154	1121	1159	38	RIGHT	D69b.EDF	D69	2
120	6976189	6976207	1194	1212	18	RIGHT	D69b.EDF	D69	2
120	6976245	6976246	1250	1251	1	RIGHT	D69b.EDF	D69	2
120	6976278	6976379	1283	1384	101	RIGHT	D69b.EDF	D69	2
120	6976409	6976541	1414	1546	132	RIGHT	D69b.EDF	D69	2
120	6977435	6977571	2440	2576	136	RIGHT	D69b.EDF	D69	2
120	6977603	6977680	2608	2685	77	RIGHT	D69b.EDF	D69	2
120	6978118	6978122	3123	3127	4	RIGHT	D69b.EDF	D69	2
120	6978153	6978419	3158	3424	266	RIGHT	D69b.EDF	D69	2
120	6978458	6978609	3463	3614	151	RIGHT	D69b.EDF	D69	2
120	6978804	6978811	3809	3816	7	RIGHT	D69b.EDF	D69	2
120	6978847	6978988	3852	3993	141	RIGHT	D69b.EDF	D69	2
120	6979034	6979174	4039	4179	140	RIGHT	D69b.EDF	D69	2
120	6979236	6979236	4241	4241	0	RIGHT	D69b.EDF	D69	2
120	6979262	6979285	4267	4290	23	RIGHT	D69b.EDF	D69	2
120	6979316	6979447	4321	4452	131	RIGHT	D69b.EDF	D69	2
120	6979507	6979602	4512	4607	95	RIGHT	D69b.EDF	D69	2
120	6979634	6979787	4639	4792	153	RIGHT	D69b.EDF	D69	2
120	6979828	6980020	4833	5025	192	RIGHT	D69b.EDF	D69	2
1	7805336	7805403	207	274	67	RIGHT	D69c.EDF	D69	3
1	7806007	7806249	878	1120	242	RIGHT	D69c.EDF	D69	3
1	7806630	7806714	1501	1585	84	RIGHT	D69c.EDF	D69	3
1	7808164	7808228	3035	3099	64	RIGHT	D69c.EDF	D69	3
1	7808333	7808417	3204	3288	84	RIGHT	D69c.EDF	D69	3
1	7809160	7809242	4031	4113	82	RIGHT	D69c.EDF	D69	3
1	7809431	7809536	4302	4407	105	RIGHT	D69c.EDF	D69	3
1	7809725	7809821	4596	4692	96	RIGHT	D69c.EDF	D69	3
1	7810350	7810362	5221	5233	12	RIGHT	D69c.EDF	D69	3
2	7812708	7812785	319	396	77	RIGHT	D69c.EDF	D69	3
2	7813248	7813359	859	970	111	RIGHT	D69c.EDF	D69	3
2	7813609	7813715	1220	1326	106	RIGHT	D69c.EDF	D69	3
2	7815347	7815453	2958	3064	106	RIGHT	D69c.EDF	D69	3
2	7815970	7816073	3581	3684	103	RIGHT	D69c.EDF	D69	3
2	7816100	7816227	3711	3838	127	RIGHT	D69c.EDF	D69	3
2	7816440	7816725	4051	4336	285	RIGHT	D69c.EDF	D69	3
3	7819527	7819614	191	278	87	RIGHT	D69c.EDF	D69	3
3	7819935	7820031	599	695	96	RIGHT	D69c.EDF	D69	3
3	7820208	7820333	872	997	125	RIGHT	D69c.EDF	D69	3
3	7820756	7820857	1420	1521	101	RIGHT	D69c.EDF	D69	3
3	7822269	7822355	2933	3019	86	RIGHT	D69c.EDF	D69	3
3	7822950	7823051	3614	3715	101	RIGHT	D69c.EDF	D69	3
3	7823233	7823341	3897	4005	108	RIGHT	D69c.EDF	D69	3
3	7823705	7823820	4369	4484	115	RIGHT	D69c.EDF	D69	3
3	7824008	7824118	4672	4782	110	RIGHT	D69c.EDF	D69	3
4	7826108	7826212	57	161	104	RIGHT	D69c.EDF	D69	3
4	7826650	7826922	599	871	272	RIGHT	D69c.EDF	D69	3
4	7827332	7827450	1281	1399	118	RIGHT	D69c.EDF	D69	3
4	7828794	7828880	2743	2829	86	RIGHT	D69c.EDF	D69	3
4	7829308	7829408	3257	3357	100	RIGHT	D69c.EDF	D69	3
4	7829591	7829700	3540	3649	109	RIGHT	D69c.EDF	D69	3
4	7830352	7830437	4301	4386	85	RIGHT	D69c.EDF	D69	3
4	7830716	7830821	4665	4770	105	RIGHT	D69c.EDF	D69	3
4	7831385	7831492	5334	5441	107	RIGHT	D69c.EDF	D69	3
4	7832141	7832241	6090	6190	100	RIGHT	D69c.EDF	D69	3
4	7832676	7832758	6625	6707	82	RIGHT	D69c.EDF	D69	3
5	7835490	7835570	280	360	80	RIGHT	D69c.EDF	D69	3
5	7835784	7835909	574	699	125	RIGHT	D69c.EDF	D69	3
5	7836378	7836491	1168	1281	113	RIGHT	D69c.EDF	D69	3
5	7836709	7836829	1499	1619	120	RIGHT	D69c.EDF	D69	3
5	7838462	7838535	3252	3325	73	RIGHT	D69c.EDF	D69	3
5	7838718	7838802	3508	3592	84	RIGHT	D69c.EDF	D69	3
5	7839303	7839391	4093	4181	88	RIGHT	D69c.EDF	D69	3
5	7840130	7840230	4920	5020	100	RIGHT	D69c.EDF	D69	3
5	7840879	7840971	5669	5761	92	RIGHT	D69c.EDF	D69	3
5	7841480	7841581	6270	6371	101	RIGHT	D69c.EDF	D69	3
6	7843852	7843945	169	262	93	RIGHT	D69c.EDF	D69	3
6	7844296	7844413	613	730	117	RIGHT	D69c.EDF	D69	3
6	7844570	7844696	887	1013	126	RIGHT	D69c.EDF	D69	3
6	7844872	7844986	1189	1303	114	RIGHT	D69c.EDF	D69	3
6	7845900	7845991	2217	2308	91	RIGHT	D69c.EDF	D69	3
6	7846781	7846853	3098	3170	72	RIGHT	D69c.EDF	D69	3
6	7847014	7847130	3331	3447	116	RIGHT	D69c.EDF	D69	3
6	7847941	7848016	4258	4333	75	RIGHT	D69c.EDF	D69	3
6	7848233	7848349	4550	4666	116	RIGHT	D69c.EDF	D69	3
6	7848769	7849010	5086	5327	241	RIGHT	D69c.EDF	D69	3
6	7849609	7849839	5926	6156	230	RIGHT	D69c.EDF	D69	3
6	7850301	7850304	6618	6621	3	RIGHT	D69c.EDF	D69	3
7	7852483	7852762	503	782	279	RIGHT	D69c.EDF	D69	3
7	7853095	7853234	1115	1254	139	RIGHT	D69c.EDF	D69	3
7	7854644	7854753	2664	2773	109	RIGHT	D69c.EDF	D69	3
7	7855424	7855526	3444	3546	102	RIGHT	D69c.EDF	D69	3
7	7856133	7856244	4153	4264	111	RIGHT	D69c.EDF	D69	3
7	7856915	7857033	4935	5053	118	RIGHT	D69c.EDF	D69	3
7	7857337	7857448	5357	5468	111	RIGHT	D69c.EDF	D69	3
8	7859836	7859967	554	685	131	RIGHT	D69c.EDF	D69	3
8	7860304	7860427	1022	1145	123	RIGHT	D69c.EDF	D69	3
8	7860906	7860985	1624	1703	79	RIGHT	D69c.EDF	D69	3
8	7861834	7861926	2552	2644	92	RIGHT	D69c.EDF	D69	3
8	7862063	7862194	2781	2912	131	RIGHT	D69c.EDF	D69	3
8	7862650	7862772	3368	3490	122	RIGHT	D69c.EDF	D69	3
8	7862814	7862943	3532	3661	129	RIGHT	D69c.EDF	D69	3
8	7863317	7863417	4035	4135	100	RIGHT	D69c.EDF	D69	3
8	7863720	7863823	4438	4541	103	RIGHT	D69c.EDF	D69	3
9	7866507	7866630	571	694	123	RIGHT	D69c.EDF	D69	3
9	7866976	7867102	1040	1166	126	RIGHT	D69c.EDF	D69	3
9	7867542	7867641	1606	1705	99	RIGHT	D69c.EDF	D69	3
9	7868959	7869215	3023	3279	256	RIGHT	D69c.EDF	D69	3
9	7869681	7869789	3745	3853	108	RIGHT	D69c.EDF	D69	3
9	7869953	7870074	4017	4138	121	RIGHT	D69c.EDF	D69	3
9	7870594	7870706	4658	4770	112	RIGHT	D69c.EDF	D69	3
9	7870933	7871048	4997	5112	115	RIGHT	D69c.EDF	D69	3
10	7872928	7873036	198	306	108	RIGHT	D69c.EDF	D69	3
10	7873399	7873556	669	826	157	RIGHT	D69c.EDF	D69	3
10	7874178	7874284	1448	1554	106	RIGHT	D69c.EDF	D69	3
10	7875230	7875308	2500	2578	78	RIGHT	D69c.EDF	D69	3
10	7876064	7876172	3334	3442	108	RIGHT	D69c.EDF	D69	3
10	7876774	7876879	4044	4149	105	RIGHT	D69c.EDF	D69	3
10	7877038	7877156	4308	4426	118	RIGHT	D69c.EDF	D69	3
10	7877475	7877586	4745	4856	111	RIGHT	D69c.EDF	D69	3
10	7877807	7877929	5077	5199	122	RIGHT	D69c.EDF	D69	3
10	7878565	7878663	5835	5933	98	RIGHT	D69c.EDF	D69	3
10	7878797	7878904	6067	6174	107	RIGHT	D69c.EDF	D69	3
10	7879567	7879664	6837	6934	97	RIGHT	D69c.EDF	D69	3
11	7882155	7882258	249	352	103	RIGHT	D69c.EDF	D69	3
11	7882620	7882954	714	1048	334	RIGHT	D69c.EDF	D69	3
11	7884150	7884403	2244	2497	253	RIGHT	D69c.EDF	D69	3
11	7885701	7885769	3795	3863	68	RIGHT	D69c.EDF	D69	3
11	7886686	7886767	4780	4861	81	RIGHT	D69c.EDF	D69	3
11	7888308	7888395	6402	6489	87	RIGHT	D69c.EDF	D69	3
12	7891095	7891204	78	187	109	RIGHT	D69c.EDF	D69	3
12	7891801	7891920	784	903	119	RIGHT	D69c.EDF	D69	3
12	7893385	7893491	2368	2474	106	RIGHT	D69c.EDF	D69	3
12	7894105	7894198	3088	3181	93	RIGHT	D69c.EDF	D69	3
12	7894482	7894584	3465	3567	102	RIGHT	D69c.EDF	D69	3
12	7895062	7895153	4045	4136	91	RIGHT	D69c.EDF	D69	3
12	7895631	7895717	4614	4700	86	RIGHT	D69c.EDF	D69	3
12	7895761	7895894	4744	4877	133	RIGHT	D69c.EDF	D69	3
13	7898195	7898302	440	547	107	RIGHT	D69c.EDF	D69	3
13	7898844	7898943	1089	1188	99	RIGHT	D69c.EDF	D69	3
13	7900313	7900411	2558	2656	98	RIGHT	D69c.EDF	D69	3
13	7901293	7901360	3538	3605	67	RIGHT	D69c.EDF	D69	3
13	7901564	7901683	3809	3928	119	RIGHT	D69c.EDF	D69	3
13	7902433	7902518	4678	4763	85	RIGHT	D69c.EDF	D69	3
14	7904740	7904747	77	84	7	RIGHT	D69c.EDF	D69	3
14	7905476	7905599	813	936	123	RIGHT	D69c.EDF	D69	3
14	7905974	7906090	1311	1427	116	RIGHT	D69c.EDF	D69	3
14	7907198	7907286	2535	2623	88	RIGHT	D69c.EDF	D69	3
14	7908298	7908396	3635	3733	98	RIGHT	D69c.EDF	D69	3
14	7909270	7909332	4607	4669	62	RIGHT	D69c.EDF	D69	3
14	7909941	7909989	5278	5326	48	RIGHT	D69c.EDF	D69	3
14	7910678	7910750	6015	6087	72	RIGHT	D69c.EDF	D69	3
15	7914123	7914277	548	702	154	RIGHT	D69c.EDF	D69	3
15	7914629	7914750	1054	1175	121	RIGHT	D69c.EDF	D69	3
15	7915091	7915231	1516	1656	140	RIGHT	D69c.EDF	D69	3
15	7916459	7916548	2884	2973	89	RIGHT	D69c.EDF	D69	3
15	7916969	7917091	3394	3516	122	RIGHT	D69c.EDF	D69	3
15	7917722	7917812	4147	4237	90	RIGHT	D69c.EDF	D69	3
15	7918448	7918563	4873	4988	115	RIGHT	D69c.EDF	D69	3
15	7918812	7918909	5237	5334	97	RIGHT	D69c.EDF	D69	3
15	7919482	7919579	5907	6004	97	RIGHT	D69c.EDF	D69	3
16	7922564	7922851	716	1003	287	RIGHT	D69c.EDF	D69	3
16	7923474	7923572	1626	1724	98	RIGHT	D69c.EDF	D69	3
16	7924353	7924464	2505	2616	111	RIGHT	D69c.EDF	D69	3
16	7924924	7925178	3076	3330	254	RIGHT	D69c.EDF	D69	3
16	7925752	7926042	3904	4194	290	RIGHT	D69c.EDF	D69	3
16	7926610	7926860	4762	5012	250	RIGHT	D69c.EDF	D69	3
16	7927625	7927735	5777	5887	110	RIGHT	D69c.EDF	D69	3
16	7928135	7928232	6287	6384	97	RIGHT	D69c.EDF	D69	3
17	7930387	7930507	102	222	120	RIGHT	D69c.EDF	D69	3
17	7930932	7931047	647	762	115	RIGHT	D69c.EDF	D69	3
17	7931427	7931752	1142	1467	325	RIGHT	D69c.EDF	D69	3
17	7932897	7933142	2612	2857	245	RIGHT	D69c.EDF	D69	3
17	7934083	7934185	3798	3900	102	RIGHT	D69c.EDF	D69	3
17	7934847	7934944	4562	4659	97	RIGHT	D69c.EDF	D69	3
17	7935446	7935566	5161	5281	120	RIGHT	D69c.EDF	D69	3
18	7938031	7938151	172	292	120	RIGHT	D69c.EDF	D69	3
18	7938618	7938717	759	858	99	RIGHT	D69c.EDF	D69	3
18	7939659	7939767	1800	1908	108	RIGHT	D69c.EDF	D69	3
18	7940956	7941053	3097	3194	97	RIGHT	D69c.EDF	D69	3
19	7944850	7944930	336	416	80	RIGHT	D69c.EDF	D69	3
19	7945681	7945769	1167	1255	88	RIGHT	D69c.EDF	D69	3
19	7946077	7946196	1563	1682	119	RIGHT	D69c.EDF	D69	3
19	7947458	7947540	2944	3026	82	RIGHT	D69c.EDF	D69	3
19	7947744	7947859	3230	3345	115	RIGHT	D69c.EDF	D69	3
19	7948385	7948659	3871	4145	274	RIGHT	D69c.EDF	D69	3
19	7949370	7949500	4856	4986	130	RIGHT	D69c.EDF	D69	3
19	7949768	7949892	5254	5378	124	RIGHT	D69c.EDF	D69	3
19	7950271	7950385	5757	5871	114	RIGHT	D69c.EDF	D69	3
19	7951131	7951195	6617	6681	64	RIGHT	D69c.EDF	D69	3
20	7953847	7953972	678	803	125	RIGHT	D69c.EDF	D69	3
20	7954296	7954434	1127	1265	138	RIGHT	D69c.EDF	D69	3
20	7954817	7954920	1648	1751	103	RIGHT	D69c.EDF	D69	3
20	7956307	7956411	3138	3242	104	RIGHT	D69c.EDF	D69	3
20	7956992	7957113	3823	3944	121	RIGHT	D69c.EDF	D69	3
20	7957869	7957942	4700	4773	73	RIGHT	D69c.EDF	D69	3
20	7958190	7958295	5021	5126	105	RIGHT	D69c.EDF	D69	3
21	7960449	7960544	76	171	95	RIGHT	D69c.EDF	D69	3
21	7960969	7961106	596	733	137	RIGHT	D69c.EDF	D69	3
21	7961649	7961767	1276	1394	118	RIGHT	D69c.EDF	D69	3
21	7962742	7962866	2369	2493	124	RIGHT	D69c.EDF	D69	3
21	7963790	7963894	3417	3521	104	RIGHT	D69c.EDF	D69	3
21	7964399	7964533	4026	4160	134	RIGHT	D69c.EDF	D69	3
21	7965226	7965322	4853	4949	96	RIGHT	D69c.EDF	D69	3
22	7967316	7967345	58	87	29	RIGHT	D69c.EDF	D69	3
22	7967937	7968059	679	801	122	RIGHT	D69c.EDF	D69	3
22	7968515	7968623	1257	1365	108	RIGHT	D69c.EDF	D69	3
22	7969687	7969787	2429	2529	100	RIGHT	D69c.EDF	D69	3
22	7970316	7970424	3058	3166	108	RIGHT	D69c.EDF	D69	3
22	7971067	7971174	3809	3916	107	RIGHT	D69c.EDF	D69	3
22	7971416	7971522	4158	4264	106	RIGHT	D69c.EDF	D69	3
22	7971908	7971998	4650	4740	90	RIGHT	D69c.EDF	D69	3
22	7972372	7972496	5114	5238	124	RIGHT	D69c.EDF	D69	3
22	7972862	7973004	5604	5746	142	RIGHT	D69c.EDF	D69	3
22	7973404	7973521	6146	6263	117	RIGHT	D69c.EDF	D69	3
22	7973817	7973942	6559	6684	125	RIGHT	D69c.EDF	D69	3
23	7975720	7975850	125	255	130	RIGHT	D69c.EDF	D69	3
23	7975998	7976119	403	524	121	RIGHT	D69c.EDF	D69	3
23	7976467	7976623	872	1028	156	RIGHT	D69c.EDF	D69	3
23	7977003	7977140	1408	1545	137	RIGHT	D69c.EDF	D69	3
23	7978344	7978628	2749	3033	284	RIGHT	D69c.EDF	D69	3
23	7979767	7979865	4172	4270	98	RIGHT	D69c.EDF	D69	3
23	7980446	7980550	4851	4955	104	RIGHT	D69c.EDF	D69	3
24	7983033	7983146	96	209	113	RIGHT	D69c.EDF	D69	3
24	7983564	7983697	627	760	133	RIGHT	D69c.EDF	D69	3
24	7984546	7984624	1609	1687	78	RIGHT	D69c.EDF	D69	3
24	7985231	7985339	2294	2402	108	RIGHT	D69c.EDF	D69	3
24	7985956	7986091	3019	3154	135	RIGHT	D69c.EDF	D69	3
24	7986627	7986746	3690	3809	119	RIGHT	D69c.EDF	D69	3
24	7986769	7986770	3832	3833	1	RIGHT	D69c.EDF	D69	3
24	7987231	7987346	4294	4409	115	RIGHT	D69c.EDF	D69	3
24	7987374	7987375	4437	4438	1	RIGHT	D69c.EDF	D69	3
24	7987955	7988069	5018	5132	114	RIGHT	D69c.EDF	D69	3
25	7989699	7989826	68	195	127	RIGHT	D69c.EDF	D69	3
25	7990328	7990426	697	795	98	RIGHT	D69c.EDF	D69	3
25	7991568	7991631	1937	2000	63	RIGHT	D69c.EDF	D69	3
25	7992869	7992964	3238	3333	95	RIGHT	D69c.EDF	D69	3
25	7993630	7993695	3999	4064	65	RIGHT	D69c.EDF	D69	3
25	7994380	7994451	4749	4820	71	RIGHT	D69c.EDF	D69	3
26	7997788	7998044	522	778	256	RIGHT	D69c.EDF	D69	3
26	7998604	7998707	1338	1441	103	RIGHT	D69c.EDF	D69	3
26	8000103	8000190	2837	2924	87	RIGHT	D69c.EDF	D69	3
26	8000743	8000876	3477	3610	133	RIGHT	D69c.EDF	D69	3
26	8001438	8001543	4172	4277	105	RIGHT	D69c.EDF	D69	3
26	8002212	8002318	4946	5052	106	RIGHT	D69c.EDF	D69	3
26	8002771	8002873	5505	5607	102	RIGHT	D69c.EDF	D69	3
27	8005594	8005826	503	735	232	RIGHT	D69c.EDF	D69	3
27	8006217	8006319	1126	1228	102	RIGHT	D69c.EDF	D69	3
27	8007863	8007977	2772	2886	114	RIGHT	D69c.EDF	D69	3
27	8008754	8008840	3663	3749	86	RIGHT	D69c.EDF	D69	3
27	8009016	8009150	3925	4059	134	RIGHT	D69c.EDF	D69	3
27	8009386	8009506	4295	4415	120	RIGHT	D69c.EDF	D69	3
27	8009686	8009794	4595	4703	108	RIGHT	D69c.EDF	D69	3
28	8012051	8012240	58	247	189	RIGHT	D69c.EDF	D69	3
28	8014478	8014574	2485	2581	96	RIGHT	D69c.EDF	D69	3
28	8015663	8015745	3670	3752	82	RIGHT	D69c.EDF	D69	3
28	8016706	8016819	4713	4826	113	RIGHT	D69c.EDF	D69	3
28	8017562	8017633	5569	5640	71	RIGHT	D69c.EDF	D69	3
29	8020130	8020206	58	134	76	RIGHT	D69c.EDF	D69	3
29	8020680	8020819	608	747	139	RIGHT	D69c.EDF	D69	3
29	8022940	8023004	2868	2932	64	RIGHT	D69c.EDF	D69	3
29	8023445	8023576	3373	3504	131	RIGHT	D69c.EDF	D69	3
29	8024236	8024325	4164	4253	89	RIGHT	D69c.EDF	D69	3
29	8024683	8024775	4611	4703	92	RIGHT	D69c.EDF	D69	3
29	8025037	8025158	4965	5086	121	RIGHT	D69c.EDF	D69	3
29	8025401	8025508	5329	5436	107	RIGHT	D69c.EDF	D69	3
29	8026105	8026182	6033	6110	77	RIGHT	D69c.EDF	D69	3
29	8026588	8026701	6516	6629	113	RIGHT	D69c.EDF	D69	3
29	8026879	8026898	6807	6826	19	RIGHT	D69c.EDF	D69	3
30	8028779	8028815	58	94	36	RIGHT	D69c.EDF	D69	3
30	8029632	8029712	911	991	80	RIGHT	D69c.EDF	D69	3
30	8030514	8030566	1793	1845	52	RIGHT	D69c.EDF	D69	3
30	8032114	8032191	3393	3470	77	RIGHT	D69c.EDF	D69	3
30	8032984	8033066	4263	4345	82	RIGHT	D69c.EDF	D69	3
30	8033616	8033692	4895	4971	76	RIGHT	D69c.EDF	D69	3
31	8036528	8036651	158	281	123	RIGHT	D69c.EDF	D69	3
31	8037192	8037305	822	935	113	RIGHT	D69c.EDF	D69	3
31	8038846	8038934	2476	2564	88	RIGHT	D69c.EDF	D69	3
31	8039522	8039602	3152	3232	80	RIGHT	D69c.EDF	D69	3
31	8039938	8040074	3568	3704	136	RIGHT	D69c.EDF	D69	3
31	8040608	8040749	4238	4379	141	RIGHT	D69c.EDF	D69	3
31	8040780	8040918	4410	4548	138	RIGHT	D69c.EDF	D69	3
31	8041463	8041558	5093	5188	95	RIGHT	D69c.EDF	D69	3
31	8042118	8042229	5748	5859	111	RIGHT	D69c.EDF	D69	3
31	8042536	8042657	6166	6287	121	RIGHT	D69c.EDF	D69	3
31	8042862	8042863	6492	6493	1	RIGHT	D69c.EDF	D69	3
32	8045397	8045511	962	1076	114	RIGHT	D69c.EDF	D69	3
32	8045936	8046066	1501	1631	130	RIGHT	D69c.EDF	D69	3
32	8047803	8047866	3368	3431	63	RIGHT	D69c.EDF	D69	3
32	8048067	8048188	3632	3753	121	RIGHT	D69c.EDF	D69	3
32	8048842	8048865	4407	4430	23	RIGHT	D69c.EDF	D69	3
32	8048941	8049084	4506	4649	143	RIGHT	D69c.EDF	D69	3
32	8049981	8050073	5546	5638	92	RIGHT	D69c.EDF	D69	3
32	8050755	8050848	6320	6413	93	RIGHT	D69c.EDF	D69	3
33	8053029	8053203	58	232	174	RIGHT	D69c.EDF	D69	3
33	8054303	8054400	1332	1429	97	RIGHT	D69c.EDF	D69	3
33	8055865	8055954	2894	2983	89	RIGHT	D69c.EDF	D69	3
33	8056574	8056686	3603	3715	112	RIGHT	D69c.EDF	D69	3
33	8057336	8057454	4365	4483	118	RIGHT	D69c.EDF	D69	3
33	8057801	8057912	4830	4941	111	RIGHT	D69c.EDF	D69	3
34	8061897	8062019	575	697	122	RIGHT	D69c.EDF	D69	3
34	8062612	8062685	1290	1363	73	RIGHT	D69c.EDF	D69	3
34	8063456	8063679	2134	2357	223	RIGHT	D69c.EDF	D69	3
34	8064944	8065195	3622	3873	251	RIGHT	D69c.EDF	D69	3
34	8065982	8066167	4660	4845	185	RIGHT	D69c.EDF	D69	3
34	8066712	8066845	5390	5523	133	RIGHT	D69c.EDF	D69	3
35	8069701	8070017	527	843	316	RIGHT	D69c.EDF	D69	3
35	8070638	8070927	1464	1753	289	RIGHT	D69c.EDF	D69	3
35	8072195	8072321	3021	3147	126	RIGHT	D69c.EDF	D69	3
35	8073014	8073114	3840	3940	100	RIGHT	D69c.EDF	D69	3
35	8073623	8073769	4449	4595	146	RIGHT	D69c.EDF	D69	3
35	8073900	8074046	4726	4872	146	RIGHT	D69c.EDF	D69	3
35	8074295	8074436	5121	5262	141	RIGHT	D69c.EDF	D69	3
35	8074766	8074894	5592	5720	128	RIGHT	D69c.EDF	D69	3
36	8077453	8077620	58	225	167	RIGHT	D69c.EDF	D69	3
36	8078633	8078733	1238	1338	100	RIGHT	D69c.EDF	D69	3
36	8079415	8079555	2020	2160	140	RIGHT	D69c.EDF	D69	3
36	8080128	8080403	2733	3008	275	RIGHT	D69c.EDF	D69	3
36	8080938	8081182	3543	3787	244	RIGHT	D69c.EDF	D69	3
36	8081493	8081808	4098	4413	315	RIGHT	D69c.EDF	D69	3
36	8082225	8082533	4830	5138	308	RIGHT	D69c.EDF	D69	3
36	8082870	8083021	5475	5626	151	RIGHT	D69c.EDF	D69	3
36	8083194	8083330	5799	5935	136	RIGHT	D69c.EDF	D69	3
37	8086043	8086172	113	242	129	RIGHT	D69c.EDF	D69	3
37	8086608	8086732	678	802	124	RIGHT	D69c.EDF	D69	3
37	8087359	8087455	1429	1525	96	RIGHT	D69c.EDF	D69	3
37	8087712	8087809	1782	1879	97	RIGHT	D69c.EDF	D69	3
37	8088697	8089009	2767	3079	312	RIGHT	D69c.EDF	D69	3
37	8089537	8089791	3607	3861	254	RIGHT	D69c.EDF	D69	3
37	8090323	8090591	4393	4661	268	RIGHT	D69c.EDF	D69	3
37	8091090	8091345	5160	5415	255	RIGHT	D69c.EDF	D69	3
37	8091807	8092087	5877	6157	280	RIGHT	D69c.EDF	D69	3
38	8094938	8095056	672	790	118	RIGHT	D69c.EDF	D69	3
38	8095569	8095719	1303	1453	150	RIGHT	D69c.EDF	D69	3
38	8097038	8097148	2772	2882	110	RIGHT	D69c.EDF	D69	3
38	8097754	8097866	3488	3600	112	RIGHT	D69c.EDF	D69	3
38	8098692	8098811	4426	4545	119	RIGHT	D69c.EDF	D69	3
38	8099063	8099107	4797	4841	44	RIGHT	D69c.EDF	D69	3
39	8101439	8101550	57	168	111	RIGHT	D69c.EDF	D69	3
39	8102142	8102263	760	881	121	RIGHT	D69c.EDF	D69	3
39	8102763	8102874	1381	1492	111	RIGHT	D69c.EDF	D69	3
39	8103965	8104068	2583	2686	103	RIGHT	D69c.EDF	D69	3
39	8104792	8104909	3410	3527	117	RIGHT	D69c.EDF	D69	3
39	8105513	8105799	4131	4417	286	RIGHT	D69c.EDF	D69	3
39	8106312	8106607	4930	5225	295	RIGHT	D69c.EDF	D69	3
39	8107255	8107462	5873	6080	207	RIGHT	D69c.EDF	D69	3
40	8110234	8110347	400	513	113	RIGHT	D69c.EDF	D69	3
40	8110990	8111079	1156	1245	89	RIGHT	D69c.EDF	D69	3
40	8112025	8112247	2191	2413	222	RIGHT	D69c.EDF	D69	3
40	8112764	8112898	2930	3064	134	RIGHT	D69c.EDF	D69	3
40	8113303	8113584	3469	3750	281	RIGHT	D69c.EDF	D69	3
40	8114224	8114343	4390	4509	119	RIGHT	D69c.EDF	D69	3
40	8114575	8114694	4741	4860	119	RIGHT	D69c.EDF	D69	3
41	8117698	8117835	512	649	137	RIGHT	D69c.EDF	D69	3
41	8118323	8118428	1137	1242	105	RIGHT	D69c.EDF	D69	3
41	8119438	8119702	2252	2516	264	RIGHT	D69c.EDF	D69	3
41	8120864	8120971	3678	3785	107	RIGHT	D69c.EDF	D69	3
41	8121179	8121281	3993	4095	102	RIGHT	D69c.EDF	D69	3
41	8121457	8121575	4271	4389	118	RIGHT	D69c.EDF	D69	3
41	8122193	8122433	5007	5247	240	RIGHT	D69c.EDF	D69	3
41	8122907	8123037	5721	5851	130	RIGHT	D69c.EDF	D69	3
41	8123168	8123259	5982	6073	91	RIGHT	D69c.EDF	D69	3
42	8126044	8126280	58	294	236	RIGHT	D69c.EDF	D69	3
42	8126768	8126882	782	896	114	RIGHT	D69c.EDF	D69	3
42	8127487	8127806	1501	1820	319	RIGHT	D69c.EDF	D69	3
42	8129519	8129632	3533	3646	113	RIGHT	D69c.EDF	D69	3
42	8130500	8130593	4514	4607	93	RIGHT	D69c.EDF	D69	3
42	8131561	8131647	5575	5661	86	RIGHT	D69c.EDF	D69	3
42	8132471	8132478	6485	6492	7	RIGHT	D69c.EDF	D69	3
43	8134970	8135120	516	666	150	RIGHT	D69c.EDF	D69	3
43	8135702	8135785	1248	1331	83	RIGHT	D69c.EDF	D69	3
43	8137656	8137770	3202	3316	114	RIGHT	D69c.EDF	D69	3
43	8138608	8138717	4154	4263	109	RIGHT	D69c.EDF	D69	3
43	8138870	8138988	4416	4534	118	RIGHT	D69c.EDF	D69	3
43	8139663	8139770	5209	5316	107	RIGHT	D69c.EDF	D69	3
44	8142680	8142823	484	627	143	RIGHT	D69c.EDF	D69	3
44	8143484	8143570	1288	1374	86	RIGHT	D69c.EDF	D69	3
44	8144885	8144981	2689	2785	96	RIGHT	D69c.EDF	D69	3
44	8146096	8146169	3900	3973	73	RIGHT	D69c.EDF	D69	3
44	8146802	8146898	4606	4702	96	RIGHT	D69c.EDF	D69	3
44	8147602	8147693	5406	5497	91	RIGHT	D69c.EDF	D69	3
44	8147853	8148207	5657	6011	354	RIGHT	D69c.EDF	D69	3
45	8150656	8150776	156	276	120	RIGHT	D69c.EDF	D69	3
45	8151552	8151686	1052	1186	134	RIGHT	D69c.EDF	D69	3
45	8152672	8152808	2172	2308	136	RIGHT	D69c.EDF	D69	3
45	8152966	8153088	2466	2588	122	RIGHT	D69c.EDF	D69	3
45	8154223	8154344	3723	3844	121	RIGHT	D69c.EDF	D69	3
45	8154797	8154956	4297	4456	159	RIGHT	D69c.EDF	D69	3
46	8157974	8158144	660	830	170	RIGHT	D69c.EDF	D69	3
46	8158318	8158498	1004	1184	180	RIGHT	D69c.EDF	D69	3
46	8158955	8159075	1641	1761	120	RIGHT	D69c.EDF	D69	3
46	8160443	8160516	3129	3202	73	RIGHT	D69c.EDF	D69	3
46	8161224	8161326	3910	4012	102	RIGHT	D69c.EDF	D69	3
46	8161917	8162063	4603	4749	146	RIGHT	D69c.EDF	D69	3
46	8162725	8162854	5411	5540	129	RIGHT	D69c.EDF	D69	3
46	8163277	8163570	5963	6256	293	RIGHT	D69c.EDF	D69	3
47	8166495	8166604	977	1086	109	RIGHT	D69c.EDF	D69	3
47	8167099	8167172	1581	1654	73	RIGHT	D69c.EDF	D69	3
47	8168083	8168185	2565	2667	102	RIGHT	D69c.EDF	D69	3
47	8169030	8169151	3512	3633	121	RIGHT	D69c.EDF	D69	3
47	8170136	8170239	4618	4721	103	RIGHT	D69c.EDF	D69	3
47	8170788	8170939	5270	5421	151	RIGHT	D69c.EDF	D69	3
47	8171719	8171864	6201	6346	145	RIGHT	D69c.EDF	D69	3
47	8172137	8172258	6619	6740	121	RIGHT	D69c.EDF	D69	3
48	8175025	8175151	671	797	126	RIGHT	D69c.EDF	D69	3
48	8175358	8175494	1004	1140	136	RIGHT	D69c.EDF	D69	3
48	8175950	8176046	1596	1692	96	RIGHT	D69c.EDF	D69	3
48	8177758	8177852	3404	3498	94	RIGHT	D69c.EDF	D69	3
48	8178292	8178432	3938	4078	140	RIGHT	D69c.EDF	D69	3
48	8179158	8179233	4804	4879	75	RIGHT	D69c.EDF	D69	3
48	8179512	8179631	5158	5277	119	RIGHT	D69c.EDF	D69	3
48	8180336	8180432	5982	6078	96	RIGHT	D69c.EDF	D69	3
49	8183669	8183803	537	671	134	RIGHT	D69c.EDF	D69	3
49	8184359	8184474	1227	1342	115	RIGHT	D69c.EDF	D69	3
49	8184687	8184833	1555	1701	146	RIGHT	D69c.EDF	D69	3
49	8186282	8186395	3150	3263	113	RIGHT	D69c.EDF	D69	3
49	8187371	8187671	4239	4539	300	RIGHT	D69c.EDF	D69	3
49	8188244	8188554	5112	5422	310	RIGHT	D69c.EDF	D69	3
49	8189209	8189319	6077	6187	110	RIGHT	D69c.EDF	D69	3
49	8189588	8189713	6456	6581	125	RIGHT	D69c.EDF	D69	3
50	8192321	8192466	158	303	145	RIGHT	D69c.EDF	D69	3
50	8192965	8193078	802	915	113	RIGHT	D69c.EDF	D69	3
50	8195032	8195129	2869	2966	97	RIGHT	D69c.EDF	D69	3
50	8196232	8196328	4069	4165	96	RIGHT	D69c.EDF	D69	3
50	8196768	8196886	4605	4723	118	RIGHT	D69c.EDF	D69	3
50	8197363	8197453	5200	5290	90	RIGHT	D69c.EDF	D69	3
50	8197629	8197729	5466	5566	100	RIGHT	D69c.EDF	D69	3
50	8198407	8198514	6244	6351	107	RIGHT	D69c.EDF	D69	3
50	8199109	8199218	6946	7055	109	RIGHT	D69c.EDF	D69	3
50	8199334	8199494	7171	7331	160	RIGHT	D69c.EDF	D69	3
51	8202307	8202413	845	951	106	RIGHT	D69c.EDF	D69	3
51	8202635	8202766	1173	1304	131	RIGHT	D69c.EDF	D69	3
51	8204272	8204412	2810	2950	140	RIGHT	D69c.EDF	D69	3
51	8205083	8205195	3621	3733	112	RIGHT	D69c.EDF	D69	3
51	8205488	8205618	4026	4156	130	RIGHT	D69c.EDF	D69	3
51	8206431	8206538	4969	5076	107	RIGHT	D69c.EDF	D69	3
51	8207384	8207492	5922	6030	108	RIGHT	D69c.EDF	D69	3
52	8209716	8210001	143	428	285	RIGHT	D69c.EDF	D69	3
52	8210290	8210446	717	873	156	RIGHT	D69c.EDF	D69	3
52	8212176	8212279	2603	2706	103	RIGHT	D69c.EDF	D69	3
52	8212823	8212935	3250	3362	112	RIGHT	D69c.EDF	D69	3
52	8213416	8213527	3843	3954	111	RIGHT	D69c.EDF	D69	3
52	8213793	8213932	4220	4359	139	RIGHT	D69c.EDF	D69	3
52	8214533	8214638	4960	5065	105	RIGHT	D69c.EDF	D69	3
53	8216816	8216955	534	673	139	RIGHT	D69c.EDF	D69	3
53	8217876	8217960	1594	1678	84	RIGHT	D69c.EDF	D69	3
53	8218877	8218977	2595	2695	100	RIGHT	D69c.EDF	D69	3
53	8219563	8219686	3281	3404	123	RIGHT	D69c.EDF	D69	3
53	8220326	8220444	4044	4162	118	RIGHT	D69c.EDF	D69	3
53	8220666	8220815	4384	4533	149	RIGHT	D69c.EDF	D69	3
54	8224325	8224461	744	880	136	RIGHT	D69c.EDF	D69	3
54	8225919	8225992	2338	2411	73	RIGHT	D69c.EDF	D69	3
54	8226358	8226514	2777	2933	156	RIGHT	D69c.EDF	D69	3
54	8227174	8227300	3593	3719	126	RIGHT	D69c.EDF	D69	3
54	8227461	8227609	3880	4028	148	RIGHT	D69c.EDF	D69	3
54	8228041	8228165	4460	4584	124	RIGHT	D69c.EDF	D69	3
54	8228358	8228649	4777	5068	291	RIGHT	D69c.EDF	D69	3
54	8229185	8229318	5604	5737	133	RIGHT	D69c.EDF	D69	3
54	8229438	8229586	5857	6005	148	RIGHT	D69c.EDF	D69	3
54	8230070	8230188	6489	6607	118	RIGHT	D69c.EDF	D69	3
55	8232595	8232717	250	372	122	RIGHT	D69c.EDF	D69	3
55	8233097	8233242	752	897	145	RIGHT	D69c.EDF	D69	3
55	8233641	8233798	1296	1453	157	RIGHT	D69c.EDF	D69	3
55	8234092	8234212	1747	1867	120	RIGHT	D69c.EDF	D69	3
55	8235711	8235816	3366	3471	105	RIGHT	D69c.EDF	D69	3
55	8236525	8236629	4180	4284	104	RIGHT	D69c.EDF	D69	3
55	8237208	8237315	4863	4970	107	RIGHT	D69c.EDF	D69	3
55	8237886	8238156	5541	5811	270	RIGHT	D69c.EDF	D69	3
55	8238800	8238909	6455	6564	109	RIGHT	D69c.EDF	D69	3
55	8239126	8239253	6781	6908	127	RIGHT	D69c.EDF	D69	3
56	8241229	8241235	73	79	6	RIGHT	D69c.EDF	D69	3
56	8241875	8242032	719	876	157	RIGHT	D69c.EDF	D69	3
56	8243702	8243982	2546	2826	280	RIGHT	D69c.EDF	D69	3
56	8244997	8245097	3841	3941	100	RIGHT	D69c.EDF	D69	3
56	8245359	8245466	4203	4310	107	RIGHT	D69c.EDF	D69	3
56	8245745	8245859	4589	4703	114	RIGHT	D69c.EDF	D69	3
56	8246043	8246179	4887	5023	136	RIGHT	D69c.EDF	D69	3
57	8248871	8249015	519	663	144	RIGHT	D69c.EDF	D69	3
57	8249596	8249723	1244	1371	127	RIGHT	D69c.EDF	D69	3
57	8251487	8251607	3135	3255	120	RIGHT	D69c.EDF	D69	3
57	8252145	8252273	3793	3921	128	RIGHT	D69c.EDF	D69	3
57	8252741	8252863	4389	4511	122	RIGHT	D69c.EDF	D69	3
57	8253234	8253357	4882	5005	123	RIGHT	D69c.EDF	D69	3
58	8256588	8256738	812	962	150	RIGHT	D69c.EDF	D69	3
58	8257318	8257429	1542	1653	111	RIGHT	D69c.EDF	D69	3
58	8259161	8259262	3385	3486	101	RIGHT	D69c.EDF	D69	3
58	8259810	8259928	4034	4152	118	RIGHT	D69c.EDF	D69	3
58	8260124	8260250	4348	4474	126	RIGHT	D69c.EDF	D69	3
58	8260275	8260275	4499	4499	0	RIGHT	D69c.EDF	D69	3
58	8260480	8260581	4704	4805	101	RIGHT	D69c.EDF	D69	3
58	8260769	8260891	4993	5115	122	RIGHT	D69c.EDF	D69	3
58	8261580	8261708	5804	5932	128	RIGHT	D69c.EDF	D69	3
58	8262122	8262258	6346	6482	136	RIGHT	D69c.EDF	D69	3
58	8262280	8262285	6504	6509	5	RIGHT	D69c.EDF	D69	3
59	8265514	8265609	1092	1187	95	RIGHT	D69c.EDF	D69	3
59	8265806	8265930	1384	1508	124	RIGHT	D69c.EDF	D69	3
59	8266191	8266303	1769	1881	112	RIGHT	D69c.EDF	D69	3
59	8267032	8267330	2610	2908	298	RIGHT	D69c.EDF	D69	3
59	8267982	8268088	3560	3666	106	RIGHT	D69c.EDF	D69	3
59	8268116	8268280	3694	3858	164	RIGHT	D69c.EDF	D69	3
59	8268649	8268784	4227	4362	135	RIGHT	D69c.EDF	D69	3
59	8269040	8269159	4618	4737	119	RIGHT	D69c.EDF	D69	3
59	8269427	8269538	5005	5116	111	RIGHT	D69c.EDF	D69	3
60	8272302	8272413	566	677	111	RIGHT	D69c.EDF	D69	3
60	8272763	8272896	1027	1160	133	RIGHT	D69c.EDF	D69	3
60	8274396	8274527	2660	2791	131	RIGHT	D69c.EDF	D69	3
60	8275471	8275564	3735	3828	93	RIGHT	D69c.EDF	D69	3
60	8276084	8276370	4348	4634	286	RIGHT	D69c.EDF	D69	3
60	8276796	8276899	5060	5163	103	RIGHT	D69c.EDF	D69	3
60	8277120	8277223	5384	5487	103	RIGHT	D69c.EDF	D69	3
60	8277504	8277617	5768	5881	113	RIGHT	D69c.EDF	D69	3
60	8277831	8277957	6095	6221	126	RIGHT	D69c.EDF	D69	3
60	8278433	8278554	6697	6818	121	RIGHT	D69c.EDF	D69	3
61	8281160	8281266	58	164	106	RIGHT	D69c.EDF	D69	3
61	8281292	8281294	190	192	2	RIGHT	D69c.EDF	D69	3
61	8281402	8281521	300	419	119	RIGHT	D69c.EDF	D69	3
61	8282226	8282347	1124	1245	121	RIGHT	D69c.EDF	D69	3
61	8284598	8284694	3496	3592	96	RIGHT	D69c.EDF	D69	3
61	8285461	8285582	4359	4480	121	RIGHT	D69c.EDF	D69	3
61	8285866	8286051	4764	4949	185	RIGHT	D69c.EDF	D69	3
61	8287270	8287397	6168	6295	127	RIGHT	D69c.EDF	D69	3
62	8291202	8291352	485	635	150	RIGHT	D69c.EDF	D69	3
62	8291444	8291578	727	861	134	RIGHT	D69c.EDF	D69	3
62	8291935	8292058	1218	1341	123	RIGHT	D69c.EDF	D69	3
62	8293785	8293896	3068	3179	111	RIGHT	D69c.EDF	D69	3
62	8294593	8294706	3876	3989	113	RIGHT	D69c.EDF	D69	3
62	8295380	8295501	4663	4784	121	RIGHT	D69c.EDF	D69	3
62	8295770	8295908	5053	5191	138	RIGHT	D69c.EDF	D69	3
63	8298272	8298334	59	121	62	RIGHT	D69c.EDF	D69	3
63	8298757	8298875	544	662	118	RIGHT	D69c.EDF	D69	3
63	8299133	8299259	920	1046	126	RIGHT	D69c.EDF	D69	3
63	8300936	8301024	2723	2811	88	RIGHT	D69c.EDF	D69	3
63	8301929	8302049	3716	3836	120	RIGHT	D69c.EDF	D69	3
63	8302813	8302903	4600	4690	90	RIGHT	D69c.EDF	D69	3
63	8302927	8302927	4714	4714	0	RIGHT	D69c.EDF	D69	3
63	8303971	8304070	5758	5857	99	RIGHT	D69c.EDF	D69	3
64	8306414	8306542	61	189	128	RIGHT	D69c.EDF	D69	3
64	8307354	8307446	1001	1093	92	RIGHT	D69c.EDF	D69	3
64	8307735	8307866	1382	1513	131	RIGHT	D69c.EDF	D69	3
64	8308658	8308827	2305	2474	169	RIGHT	D69c.EDF	D69	3
64	8309024	8309155	2671	2802	131	RIGHT	D69c.EDF	D69	3
64	8309714	8309978	3361	3625	264	RIGHT	D69c.EDF	D69	3
64	8310495	8310762	4142	4409	267	RIGHT	D69c.EDF	D69	3
64	8311322	8311456	4969	5103	134	RIGHT	D69c.EDF	D69	3
64	8311718	8311738	5365	5385	20	RIGHT	D69c.EDF	D69	3
65	8314105	8314226	407	528	121	RIGHT	D69c.EDF	D69	3
65	8314672	8314799	974	1101	127	RIGHT	D69c.EDF	D69	3
65	8315958	8316270	2260	2572	312	RIGHT	D69c.EDF	D69	3
65	8316794	8316920	3096	3222	126	RIGHT	D69c.EDF	D69	3
65	8317292	8317428	3594	3730	136	RIGHT	D69c.EDF	D69	3
65	8317577	8317708	3879	4010	131	RIGHT	D69c.EDF	D69	3
65	8318036	8318163	4338	4465	127	RIGHT	D69c.EDF	D69	3
65	8318504	8318632	4806	4934	128	RIGHT	D69c.EDF	D69	3
65	8318941	8319054	5243	5356	113	RIGHT	D69c.EDF	D69	3
65	8319115	8319255	5417	5557	140	RIGHT	D69c.EDF	D69	3
65	8319879	8320179	6181	6481	300	RIGHT	D69c.EDF	D69	3
66	8323754	8323902	89	237	148	RIGHT	D69c.EDF	D69	3
66	8324731	8324827	1066	1162	96	RIGHT	D69c.EDF	D69	3
66	8325961	8326096	2296	2431	135	RIGHT	D69c.EDF	D69	3
66	8326687	8327001	3022	3336	314	RIGHT	D69c.EDF	D69	3
66	8327769	8328040	4104	4375	271	RIGHT	D69c.EDF	D69	3
66	8328884	8328989	5219	5324	105	RIGHT	D69c.EDF	D69	3
67	8331081	8331218	459	596	137	RIGHT	D69c.EDF	D69	3
67	8331743	8331861	1121	1239	118	RIGHT	D69c.EDF	D69	3
67	8333855	8333963	3233	3341	108	RIGHT	D69c.EDF	D69	3
67	8334478	8334603	3856	3981	125	RIGHT	D69c.EDF	D69	3
67	8334762	8334941	4140	4319	179	RIGHT	D69c.EDF	D69	3
68	8337837	8337971	649	783	134	RIGHT	D69c.EDF	D69	3
68	8338631	8338744	1443	1556	113	RIGHT	D69c.EDF	D69	3
68	8339843	8339938	2655	2750	95	RIGHT	D69c.EDF	D69	3
68	8340677	8340815	3489	3627	138	RIGHT	D69c.EDF	D69	3
68	8341167	8341319	3979	4131	152	RIGHT	D69c.EDF	D69	3
68	8342238	8342350	5050	5162	112	RIGHT	D69c.EDF	D69	3
68	8343054	8343168	5866	5980	114	RIGHT	D69c.EDF	D69	3
69	8346468	8346599	142	273	131	RIGHT	D69c.EDF	D69	3
69	8347030	8347150	704	824	120	RIGHT	D69c.EDF	D69	3
69	8347499	8347680	1173	1354	181	RIGHT	D69c.EDF	D69	3
69	8349334	8349432	3008	3106	98	RIGHT	D69c.EDF	D69	3
69	8350282	8350384	3956	4058	102	RIGHT	D69c.EDF	D69	3
69	8350977	8351063	4651	4737	86	RIGHT	D69c.EDF	D69	3
69	8351644	8351739	5318	5413	95	RIGHT	D69c.EDF	D69	3
69	8352094	8352193	5768	5867	99	RIGHT	D69c.EDF	D69	3
70	8354716	8354852	98	234	136	RIGHT	D69c.EDF	D69	3
70	8355311	8355469	693	851	158	RIGHT	D69c.EDF	D69	3
70	8355980	8356116	1362	1498	136	RIGHT	D69c.EDF	D69	3
70	8356139	8356140	1521	1522	1	RIGHT	D69c.EDF	D69	3
70	8356864	8357012	2246	2394	148	RIGHT	D69c.EDF	D69	3
70	8357562	8357673	2944	3055	111	RIGHT	D69c.EDF	D69	3
70	8358090	8358434	3472	3816	344	RIGHT	D69c.EDF	D69	3
70	8358955	8359246	4337	4628	291	RIGHT	D69c.EDF	D69	3
70	8359695	8359830	5077	5212	135	RIGHT	D69c.EDF	D69	3
70	8360029	8360164	5411	5546	135	RIGHT	D69c.EDF	D69	3
71	8362981	8363109	641	769	128	RIGHT	D69c.EDF	D69	3
71	8363687	8363817	1347	1477	130	RIGHT	D69c.EDF	D69	3
71	8364205	8364430	1865	2090	225	RIGHT	D69c.EDF	D69	3
71	8365640	8365769	3300	3429	129	RIGHT	D69c.EDF	D69	3
71	8365969	8366115	3629	3775	146	RIGHT	D69c.EDF	D69	3
71	8367273	8367409	4933	5069	136	RIGHT	D69c.EDF	D69	3
72	8369742	8369875	167	300	133	RIGHT	D69c.EDF	D69	3
72	8370267	8370406	692	831	139	RIGHT	D69c.EDF	D69	3
72	8371979	8372075	2404	2500	96	RIGHT	D69c.EDF	D69	3
72	8373412	8373495	3837	3920	83	RIGHT	D69c.EDF	D69	3
72	8374054	8374156	4479	4581	102	RIGHT	D69c.EDF	D69	3
72	8374701	8374788	5126	5213	87	RIGHT	D69c.EDF	D69	3
72	8375098	8375234	5523	5659	136	RIGHT	D69c.EDF	D69	3
72	8375443	8375577	5868	6002	134	RIGHT	D69c.EDF	D69	3
72	8376285	8376328	6710	6753	43	RIGHT	D69c.EDF	D69	3
73	8378516	8378562	58	104	46	RIGHT	D69c.EDF	D69	3
73	8379016	8379168	558	710	152	RIGHT	D69c.EDF	D69	3
73	8379867	8379954	1409	1496	87	RIGHT	D69c.EDF	D69	3
73	8381215	8381330	2757	2872	115	RIGHT	D69c.EDF	D69	3
73	8381860	8382148	3402	3690	288	RIGHT	D69c.EDF	D69	3
73	8382587	8382880	4129	4422	293	RIGHT	D69c.EDF	D69	3
73	8383237	8383371	4779	4913	134	RIGHT	D69c.EDF	D69	3
73	8383556	8383692	5098	5234	136	RIGHT	D69c.EDF	D69	3
74	8385869	8385987	343	461	118	RIGHT	D69c.EDF	D69	3
74	8386303	8386416	777	890	113	RIGHT	D69c.EDF	D69	3
74	8387090	8387220	1564	1694	130	RIGHT	D69c.EDF	D69	3
74	8388527	8388628	3001	3102	101	RIGHT	D69c.EDF	D69	3
74	8389323	8389424	3797	3898	101	RIGHT	D69c.EDF	D69	3
74	8389862	8390163	4336	4637	301	RIGHT	D69c.EDF	D69	3
74	8390816	8390969	5290	5443	153	RIGHT	D69c.EDF	D69	3
74	8391014	8391153	5488	5627	139	RIGHT	D69c.EDF	D69	3
74	8391605	8391711	6079	6185	106	RIGHT	D69c.EDF	D69	3
75	8393996	8394137	196	337	141	RIGHT	D69c.EDF	D69	3
75	8394632	8394764	832	964	132	RIGHT	D69c.EDF	D69	3
75	8396473	8396592	2673	2792	119	RIGHT	D69c.EDF	D69	3
75	8397286	8397405	3486	3605	119	RIGHT	D69c.EDF	D69	3
75	8398102	8398275	4302	4475	173	RIGHT	D69c.EDF	D69	3
75	8398749	8398884	4949	5084	135	RIGHT	D69c.EDF	D69	3
75	8399492	8399611	5692	5811	119	RIGHT	D69c.EDF	D69	3
75	8400082	8400236	6282	6436	154	RIGHT	D69c.EDF	D69	3
76	8403191	8403320	669	798	129	RIGHT	D69c.EDF	D69	3
76	8403836	8403967	1314	1445	131	RIGHT	D69c.EDF	D69	3
76	8405613	8405715	3091	3193	102	RIGHT	D69c.EDF	D69	3
76	8406552	8406630	4030	4108	78	RIGHT	D69c.EDF	D69	3
76	8407601	8407704	5079	5182	103	RIGHT	D69c.EDF	D69	3
76	8408190	8408320	5668	5798	130	RIGHT	D69c.EDF	D69	3
77	8411249	8411360	459	570	111	RIGHT	D69c.EDF	D69	3
77	8411824	8411941	1034	1151	117	RIGHT	D69c.EDF	D69	3
77	8413452	8413653	2662	2863	201	RIGHT	D69c.EDF	D69	3
77	8414379	8414485	3589	3695	106	RIGHT	D69c.EDF	D69	3
77	8414660	8414789	3870	3999	129	RIGHT	D69c.EDF	D69	3
77	8415314	8415442	4524	4652	128	RIGHT	D69c.EDF	D69	3
77	8415976	8416104	5186	5314	128	RIGHT	D69c.EDF	D69	3
78	8418893	8419026	708	841	133	RIGHT	D69c.EDF	D69	3
78	8419409	8419528	1224	1343	119	RIGHT	D69c.EDF	D69	3
78	8421770	8421849	3585	3664	79	RIGHT	D69c.EDF	D69	3
78	8422826	8422868	4641	4683	42	RIGHT	D69c.EDF	D69	3
78	8423483	8423558	5298	5373	75	RIGHT	D69c.EDF	D69	3
78	8423712	8423842	5527	5657	130	RIGHT	D69c.EDF	D69	3
79	8426184	8426304	213	333	120	RIGHT	D69c.EDF	D69	3
79	8426958	8427079	987	1108	121	RIGHT	D69c.EDF	D69	3
79	8427891	8427938	1920	1967	47	RIGHT	D69c.EDF	D69	3
79	8428999	8429099	3028	3128	100	RIGHT	D69c.EDF	D69	3
79	8430246	8430364	4275	4393	118	RIGHT	D69c.EDF	D69	3
79	8430710	8430829	4739	4858	119	RIGHT	D69c.EDF	D69	3
79	8431381	8431581	5410	5610	200	RIGHT	D69c.EDF	D69	3
79	8431747	8431812	5776	5841	65	RIGHT	D69c.EDF	D69	3
80	8433912	8434013	238	339	101	RIGHT	D69c.EDF	D69	3
80	8434287	8434426	613	752	139	RIGHT	D69c.EDF	D69	3
80	8435116	8435212	1442	1538	96	RIGHT	D69c.EDF	D69	3
80	8436464	8436611	2790	2937	147	RIGHT	D69c.EDF	D69	3
80	8437721	8437812	4047	4138	91	RIGHT	D69c.EDF	D69	3
80	8438272	8438427	4598	4753	155	RIGHT	D69c.EDF	D69	3
81	8441371	8441485	105	219	114	RIGHT	D69c.EDF	D69	3
81	8442004	8442164	738	898	160	RIGHT	D69c.EDF	D69	3
81	8442628	8442774	1362	1508	146	RIGHT	D69c.EDF	D69	3
81	8442880	8443027	1614	1761	147	RIGHT	D69c.EDF	D69	3
81	8444102	8444217	2836	2951	115	RIGHT	D69c.EDF	D69	3
81	8445024	8445157	3758	3891	133	RIGHT	D69c.EDF	D69	3
81	8445340	8445467	4074	4201	127	RIGHT	D69c.EDF	D69	3
81	8445599	8445707	4333	4441	108	RIGHT	D69c.EDF	D69	3
81	8446135	8446259	4869	4993	124	RIGHT	D69c.EDF	D69	3
81	8446354	8446496	5088	5230	142	RIGHT	D69c.EDF	D69	3
81	8446822	8446951	5556	5685	129	RIGHT	D69c.EDF	D69	3
81	8447089	8447232	5823	5966	143	RIGHT	D69c.EDF	D69	3
82	8449756	8449893	662	799	137	RIGHT	D69c.EDF	D69	3
82	8450234	8450361	1140	1267	127	RIGHT	D69c.EDF	D69	3
82	8451695	8451806	2601	2712	111	RIGHT	D69c.EDF	D69	3
82	8452132	8452286	3038	3192	154	RIGHT	D69c.EDF	D69	3
82	8452433	8452569	3339	3475	136	RIGHT	D69c.EDF	D69	3
82	8453469	8453746	4375	4652	277	RIGHT	D69c.EDF	D69	3
82	8454144	8454283	5050	5189	139	RIGHT	D69c.EDF	D69	3
82	8454531	8454658	5437	5564	127	RIGHT	D69c.EDF	D69	3
82	8455217	8455358	6123	6264	141	RIGHT	D69c.EDF	D69	3
82	8455485	8455619	6391	6525	134	RIGHT	D69c.EDF	D69	3
83	8457685	8457839	58	212	154	RIGHT	D69c.EDF	D69	3
83	8458593	8458723	966	1096	130	RIGHT	D69c.EDF	D69	3
83	8459164	8459247	1537	1620	83	RIGHT	D69c.EDF	D69	3
83	8460166	8460281	2539	2654	115	RIGHT	D69c.EDF	D69	3
83	8460684	8460795	3057	3168	111	RIGHT	D69c.EDF	D69	3
83	8461175	8461295	3548	3668	120	RIGHT	D69c.EDF	D69	3
83	8461550	8461672	3923	4045	122	RIGHT	D69c.EDF	D69	3
83	8462142	8462267	4515	4640	125	RIGHT	D69c.EDF	D69	3
83	8462876	8463002	5249	5375	126	RIGHT	D69c.EDF	D69	3
83	8463148	8463270	5521	5643	122	RIGHT	D69c.EDF	D69	3
83	8464029	8464093	6402	6466	64	RIGHT	D69c.EDF	D69	3
84	8467240	8467325	1285	1370	85	RIGHT	D69c.EDF	D69	3
84	8468314	8468424	2359	2469	110	RIGHT	D69c.EDF	D69	3
84	8469116	8469247	3161	3292	131	RIGHT	D69c.EDF	D69	3
84	8469475	8469588	3520	3633	113	RIGHT	D69c.EDF	D69	3
84	8470123	8470246	4168	4291	123	RIGHT	D69c.EDF	D69	3
84	8470467	8470590	4512	4635	123	RIGHT	D69c.EDF	D69	3
84	8470717	8470847	4762	4892	130	RIGHT	D69c.EDF	D69	3
84	8471329	8471468	5374	5513	139	RIGHT	D69c.EDF	D69	3
84	8471771	8471834	5816	5879	63	RIGHT	D69c.EDF	D69	3
84	8471888	8472030	5933	6075	142	RIGHT	D69c.EDF	D69	3
84	8472052	8472053	6097	6098	1	RIGHT	D69c.EDF	D69	3
85	8474694	8474810	515	631	116	RIGHT	D69c.EDF	D69	3
85	8474831	8474832	652	653	1	RIGHT	D69c.EDF	D69	3
85	8476524	8476637	2345	2458	113	RIGHT	D69c.EDF	D69	3
85	8477579	8477673	3400	3494	94	RIGHT	D69c.EDF	D69	3
85	8478566	8478672	4387	4493	106	RIGHT	D69c.EDF	D69	3
85	8479633	8479735	5454	5556	102	RIGHT	D69c.EDF	D69	3
85	8480255	8480364	6076	6185	109	RIGHT	D69c.EDF	D69	3
85	8480743	8480835	6564	6656	92	RIGHT	D69c.EDF	D69	3
86	8483242	8483468	795	1021	226	RIGHT	D69c.EDF	D69	3
86	8485433	8485512	2986	3065	79	RIGHT	D69c.EDF	D69	3
86	8486023	8486124	3576	3677	101	RIGHT	D69c.EDF	D69	3
86	8487122	8487210	4675	4763	88	RIGHT	D69c.EDF	D69	3
86	8488049	8488114	5602	5667	65	RIGHT	D69c.EDF	D69	3
87	8490949	8491063	199	313	114	RIGHT	D69c.EDF	D69	3
87	8491342	8491511	592	761	169	RIGHT	D69c.EDF	D69	3
87	8491922	8492026	1172	1276	104	RIGHT	D69c.EDF	D69	3
87	8492444	8492562	1694	1812	118	RIGHT	D69c.EDF	D69	3
87	8493437	8493753	2687	3003	316	RIGHT	D69c.EDF	D69	3
87	8494892	8495004	4142	4254	112	RIGHT	D69c.EDF	D69	3
87	8495269	8495400	4519	4650	131	RIGHT	D69c.EDF	D69	3
87	8495524	8495652	4774	4902	128	RIGHT	D69c.EDF	D69	3
87	8495959	8496086	5209	5336	127	RIGHT	D69c.EDF	D69	3
87	8496590	8496662	5840	5912	72	RIGHT	D69c.EDF	D69	3
88	8499334	8499500	948	1114	166	RIGHT	D69c.EDF	D69	3
88	8500295	8500405	1909	2019	110	RIGHT	D69c.EDF	D69	3
88	8501702	8501787	3316	3401	85	RIGHT	D69c.EDF	D69	3
88	8502553	8502680	4167	4294	127	RIGHT	D69c.EDF	D69	3
88	8503680	8503787	5294	5401	107	RIGHT	D69c.EDF	D69	3
88	8504068	8504173	5682	5787	105	RIGHT	D69c.EDF	D69	3
88	8504680	8504793	6294	6407	113	RIGHT	D69c.EDF	D69	3
88	8505527	8505608	7141	7222	81	RIGHT	D69c.EDF	D69	3
89	8507788	8507875	58	145	87	RIGHT	D69c.EDF	D69	3
89	8508834	8508966	1104	1236	132	RIGHT	D69c.EDF	D69	3
89	8510299	8510545	2569	2815	246	RIGHT	D69c.EDF	D69	3
89	8510723	8510964	2993	3234	241	RIGHT	D69c.EDF	D69	3
89	8512285	8512392	4555	4662	107	RIGHT	D69c.EDF	D69	3
89	8512554	8512690	4824	4960	136	RIGHT	D69c.EDF	D69	3
89	8513206	8513509	5476	5779	303	RIGHT	D69c.EDF	D69	3
90	8515860	8515990	58	188	130	RIGHT	D69c.EDF	D69	3
90	8516914	8517056	1112	1254	142	RIGHT	D69c.EDF	D69	3
90	8518778	8519052	2976	3250	274	RIGHT	D69c.EDF	D69	3
90	8519784	8520065	3982	4263	281	RIGHT	D69c.EDF	D69	3
90	8520800	8521078	4998	5276	278	RIGHT	D69c.EDF	D69	3
91	8524504	8524637	704	837	133	RIGHT	D69c.EDF	D69	3
91	8525161	8525287	1361	1487	126	RIGHT	D69c.EDF	D69	3
91	8527049	8527166	3249	3366	117	RIGHT	D69c.EDF	D69	3
91	8528091	8528175	4291	4375	84	RIGHT	D69c.EDF	D69	3
91	8528753	8528841	4953	5041	88	RIGHT	D69c.EDF	D69	3
91	8529284	8529412	5484	5612	128	RIGHT	D69c.EDF	D69	3
92	8531791	8531920	554	683	129	RIGHT	D69c.EDF	D69	3
92	8532027	8532306	790	1069	279	RIGHT	D69c.EDF	D69	3
92	8534244	8534329	3007	3092	85	RIGHT	D69c.EDF	D69	3
92	8535129	8535218	3892	3981	89	RIGHT	D69c.EDF	D69	3
92	8535863	8535948	4626	4711	85	RIGHT	D69c.EDF	D69	3
92	8536440	8536566	5203	5329	126	RIGHT	D69c.EDF	D69	3
92	8536702	8536865	5465	5628	163	RIGHT	D69c.EDF	D69	3
93	8539539	8539540	99	100	1	RIGHT	D69c.EDF	D69	3
93	8539701	8539826	261	386	125	RIGHT	D69c.EDF	D69	3
93	8540169	8540355	729	915	186	RIGHT	D69c.EDF	D69	3
93	8541777	8541881	2337	2441	104	RIGHT	D69c.EDF	D69	3
93	8542568	8542751	3128	3311	183	RIGHT	D69c.EDF	D69	3
93	8543611	8543741	4171	4301	130	RIGHT	D69c.EDF	D69	3
93	8544295	8544399	4855	4959	104	RIGHT	D69c.EDF	D69	3
94	8547030	8547182	117	269	152	RIGHT	D69c.EDF	D69	3
94	8547891	8548016	978	1103	125	RIGHT	D69c.EDF	D69	3
94	8548744	8548813	1831	1900	69	RIGHT	D69c.EDF	D69	3
94	8550246	8550316	3333	3403	70	RIGHT	D69c.EDF	D69	3
94	8551488	8551573	4575	4660	85	RIGHT	D69c.EDF	D69	3
94	8552365	8552471	5452	5558	106	RIGHT	D69c.EDF	D69	3
94	8553243	8553536	6330	6623	293	RIGHT	D69c.EDF	D69	3
95	8555960	8556087	557	684	127	RIGHT	D69c.EDF	D69	3
95	8556812	8556959	1409	1556	147	RIGHT	D69c.EDF	D69	3
95	8557962	8558052	2559	2649	90	RIGHT	D69c.EDF	D69	3
95	8559923	8560020	4520	4617	97	RIGHT	D69c.EDF	D69	3
96	8562479	8562622	116	259	143	RIGHT	D69c.EDF	D69	3
96	8563440	8563587	1077	1224	147	RIGHT	D69c.EDF	D69	3
96	8565546	8565643	3183	3280	97	RIGHT	D69c.EDF	D69	3
96	8566095	8566187	3732	3824	92	RIGHT	D69c.EDF	D69	3
96	8566681	8566759	4318	4396	78	RIGHT	D69c.EDF	D69	3
96	8567089	8567180	4726	4817	91	RIGHT	D69c.EDF	D69	3
96	8567415	8567519	5052	5156	104	RIGHT	D69c.EDF	D69	3
96	8568314	8568405	5951	6042	91	RIGHT	D69c.EDF	D69	3
97	8571315	8571420	575	680	105	RIGHT	D69c.EDF	D69	3
97	8571656	8571824	916	1084	168	RIGHT	D69c.EDF	D69	3
97	8572480	8572614	1740	1874	134	RIGHT	D69c.EDF	D69	3
97	8573953	8574026	3213	3286	73	RIGHT	D69c.EDF	D69	3
97	8574656	8574761	3916	4021	105	RIGHT	D69c.EDF	D69	3
97	8575416	8575529	4676	4789	113	RIGHT	D69c.EDF	D69	3
97	8575780	8575906	5040	5166	126	RIGHT	D69c.EDF	D69	3
97	8576797	8576891	6057	6151	94	RIGHT	D69c.EDF	D69	3
98	8580236	8580359	482	605	123	RIGHT	D69c.EDF	D69	3
98	8581147	8581223	1393	1469	76	RIGHT	D69c.EDF	D69	3
98	8581248	8581251	1494	1497	3	RIGHT	D69c.EDF	D69	3
98	8581688	8581820	1934	2066	132	RIGHT	D69c.EDF	D69	3
98	8581996	8582139	2242	2385	143	RIGHT	D69c.EDF	D69	3
98	8582767	8582898	3013	3144	131	RIGHT	D69c.EDF	D69	3
98	8583426	8583583	3672	3829	157	RIGHT	D69c.EDF	D69	3
98	8583929	8584087	4175	4333	158	RIGHT	D69c.EDF	D69	3
98	8584613	8584769	4859	5015	156	RIGHT	D69c.EDF	D69	3
98	8585136	8585255	5382	5501	119	RIGHT	D69c.EDF	D69	3
98	8585281	8585282	5527	5528	1	RIGHT	D69c.EDF	D69	3
98	8585858	8585969	6104	6215	111	RIGHT	D69c.EDF	D69	3
98	8586444	8586487	6690	6733	43	RIGHT	D69c.EDF	D69	3
99	8588742	8588877	562	697	135	RIGHT	D69c.EDF	D69	3
99	8589332	8589474	1152	1294	142	RIGHT	D69c.EDF	D69	3
99	8589887	8590033	1707	1853	146	RIGHT	D69c.EDF	D69	3
99	8590962	8591076	2782	2896	114	RIGHT	D69c.EDF	D69	3
99	8591277	8591405	3097	3225	128	RIGHT	D69c.EDF	D69	3
99	8592175	8592316	3995	4136	141	RIGHT	D69c.EDF	D69	3
99	8592843	8593014	4663	4834	171	RIGHT	D69c.EDF	D69	3
99	8593039	8593050	4859	4870	11	RIGHT	D69c.EDF	D69	3
99	8593210	8593362	5030	5182	152	RIGHT	D69c.EDF	D69	3
100	8596028	8596222	855	1049	194	RIGHT	D69c.EDF	D69	3
100	8596746	8596867	1573	1694	121	RIGHT	D69c.EDF	D69	3
100	8597821	8597943	2648	2770	122	RIGHT	D69c.EDF	D69	3
100	8598486	8598635	3313	3462	149	RIGHT	D69c.EDF	D69	3
100	8598810	8598936	3637	3763	126	RIGHT	D69c.EDF	D69	3
100	8599319	8599440	4146	4267	121	RIGHT	D69c.EDF	D69	3
100	8599590	8599722	4417	4549	132	RIGHT	D69c.EDF	D69	3
100	8599932	8600060	4759	4887	128	RIGHT	D69c.EDF	D69	3
100	8600357	8600491	5184	5318	134	RIGHT	D69c.EDF	D69	3
100	8600825	8600957	5652	5784	132	RIGHT	D69c.EDF	D69	3
100	8601269	8601357	6096	6184	88	RIGHT	D69c.EDF	D69	3
101	8603683	8603833	684	834	150	RIGHT	D69c.EDF	D69	3
101	8604188	8604317	1189	1318	129	RIGHT	D69c.EDF	D69	3
101	8605591	8605666	2592	2667	75	RIGHT	D69c.EDF	D69	3
101	8606270	8606366	3271	3367	96	RIGHT	D69c.EDF	D69	3
101	8606732	8606864	3733	3865	132	RIGHT	D69c.EDF	D69	3
101	8606977	8607111	3978	4112	134	RIGHT	D69c.EDF	D69	3
101	8607667	8607971	4668	4972	304	RIGHT	D69c.EDF	D69	3
102	8611297	8611430	512	645	133	RIGHT	D69c.EDF	D69	3
102	8611756	8611887	971	1102	131	RIGHT	D69c.EDF	D69	3
102	8613193	8613313	2408	2528	120	RIGHT	D69c.EDF	D69	3
102	8614336	8614457	3551	3672	121	RIGHT	D69c.EDF	D69	3
102	8615159	8615260	4374	4475	101	RIGHT	D69c.EDF	D69	3
102	8615900	8616050	5115	5265	150	RIGHT	D69c.EDF	D69	3
102	8616847	8616934	6062	6149	87	RIGHT	D69c.EDF	D69	3
103	8619127	8619273	103	249	146	RIGHT	D69c.EDF	D69	3
103	8619804	8620120	780	1096	316	RIGHT	D69c.EDF	D69	3
103	8620677	8620801	1653	1777	124	RIGHT	D69c.EDF	D69	3
103	8621952	8622057	2928	3033	105	RIGHT	D69c.EDF	D69	3
103	8622986	8623098	3962	4074	112	RIGHT	D69c.EDF	D69	3
103	8623638	8623712	4614	4688	74	RIGHT	D69c.EDF	D69	3
103	8623957	8624080	4933	5056	123	RIGHT	D69c.EDF	D69	3
104	8626865	8626986	474	595	121	RIGHT	D69c.EDF	D69	3
104	8628208	8628297	1817	1906	89	RIGHT	D69c.EDF	D69	3
104	8629386	8629652	2995	3261	266	RIGHT	D69c.EDF	D69	3
104	8630569	8630665	4178	4274	96	RIGHT	D69c.EDF	D69	3
104	8631868	8631952	5477	5561	84	RIGHT	D69c.EDF	D69	3
105	8634893	8634994	1156	1257	101	RIGHT	D69c.EDF	D69	3
105	8636109	8636237	2372	2500	128	RIGHT	D69c.EDF	D69	3
105	8636882	8636974	3145	3237	92	RIGHT	D69c.EDF	D69	3
105	8637535	8637644	3798	3907	109	RIGHT	D69c.EDF	D69	3
105	8638206	8638282	4469	4545	76	RIGHT	D69c.EDF	D69	3
105	8638808	8638950	5071	5213	142	RIGHT	D69c.EDF	D69	3
106	8641580	8641818	807	1045	238	RIGHT	D69c.EDF	D69	3
106	8642208	8642345	1435	1572	137	RIGHT	D69c.EDF	D69	3
106	8643603	8643694	2830	2921	91	RIGHT	D69c.EDF	D69	3
106	8644529	8644616	3756	3843	87	RIGHT	D69c.EDF	D69	3
106	8645522	8645613	4749	4840	91	RIGHT	D69c.EDF	D69	3
107	8648127	8648261	549	683	134	RIGHT	D69c.EDF	D69	3
107	8648435	8648614	857	1036	179	RIGHT	D69c.EDF	D69	3
107	8649315	8649411	1737	1833	96	RIGHT	D69c.EDF	D69	3
107	8651006	8651087	3428	3509	81	RIGHT	D69c.EDF	D69	3
107	8652727	8652817	5149	5239	90	RIGHT	D69c.EDF	D69	3
108	8655606	8655689	305	388	83	RIGHT	D69c.EDF	D69	3
108	8655878	8655988	577	687	110	RIGHT	D69c.EDF	D69	3
108	8657078	8657141	1777	1840	63	RIGHT	D69c.EDF	D69	3
108	8658174	8658267	2873	2966	93	RIGHT	D69c.EDF	D69	3
108	8659464	8659564	4163	4263	100	RIGHT	D69c.EDF	D69	3
108	8660320	8660460	5019	5159	140	RIGHT	D69c.EDF	D69	3
108	8660595	8660748	5294	5447	153	RIGHT	D69c.EDF	D69	3
109	8662970	8663128	142	300	158	RIGHT	D69c.EDF	D69	3
109	8663981	8664122	1153	1294	141	RIGHT	D69c.EDF	D69	3
109	8666377	8666460	3549	3632	83	RIGHT	D69c.EDF	D69	3
109	8666934	8667035	4106	4207	101	RIGHT	D69c.EDF	D69	3
109	8667766	8667848	4938	5020	82	RIGHT	D69c.EDF	D69	3
109	8668257	8668370	5429	5542	113	RIGHT	D69c.EDF	D69	3
109	8669015	8669094	6187	6266	79	RIGHT	D69c.EDF	D69	3
109	8669518	8669625	6690	6797	107	RIGHT	D69c.EDF	D69	3
110	8673135	8673266	475	606	131	RIGHT	D69c.EDF	D69	3
110	8673769	8673889	1109	1229	120	RIGHT	D69c.EDF	D69	3
110	8675168	8675270	2508	2610	102	RIGHT	D69c.EDF	D69	3
110	8675977	8676025	3317	3365	48	RIGHT	D69c.EDF	D69	3
110	8676242	8676366	3582	3706	124	RIGHT	D69c.EDF	D69	3
110	8676933	8677053	4273	4393	120	RIGHT	D69c.EDF	D69	3
110	8677287	8677414	4627	4754	127	RIGHT	D69c.EDF	D69	3
110	8677929	8678037	5269	5377	108	RIGHT	D69c.EDF	D69	3
111	8680083	8680246	92	255	163	RIGHT	D69c.EDF	D69	3
111	8681074	8681228	1083	1237	154	RIGHT	D69c.EDF	D69	3
111	8681947	8681991	1956	2000	44	RIGHT	D69c.EDF	D69	3
111	8683304	8683400	3313	3409	96	RIGHT	D69c.EDF	D69	3
111	8683635	8683752	3644	3761	117	RIGHT	D69c.EDF	D69	3
111	8684309	8684403	4318	4412	94	RIGHT	D69c.EDF	D69	3
111	8684588	8684708	4597	4717	120	RIGHT	D69c.EDF	D69	3
111	8685563	8685652	5572	5661	89	RIGHT	D69c.EDF	D69	3
111	8686370	8686459	6379	6468	89	RIGHT	D69c.EDF	D69	3
112	8690320	8690453	738	871	133	RIGHT	D69c.EDF	D69	3
112	8690477	8690481	895	899	4	RIGHT	D69c.EDF	D69	3
112	8691320	8691439	1738	1857	119	RIGHT	D69c.EDF	D69	3
112	8692503	8692600	2921	3018	97	RIGHT	D69c.EDF	D69	3
112	8693508	8693657	3926	4075	149	RIGHT	D69c.EDF	D69	3
112	8694278	8694402	4696	4820	124	RIGHT	D69c.EDF	D69	3
112	8694858	8694997	5276	5415	139	RIGHT	D69c.EDF	D69	3
112	8695536	8695673	5954	6091	137	RIGHT	D69c.EDF	D69	3
112	8695799	8695930	6217	6348	131	RIGHT	D69c.EDF	D69	3
112	8695952	8695960	6370	6378	8	RIGHT	D69c.EDF	D69	3
113	8698348	8698461	358	471	113	RIGHT	D69c.EDF	D69	3
113	8698928	8699051	938	1061	123	RIGHT	D69c.EDF	D69	3
113	8699398	8699497	1408	1507	99	RIGHT	D69c.EDF	D69	3
113	8700588	8700704	2598	2714	116	RIGHT	D69c.EDF	D69	3
113	8701307	8701418	3317	3428	111	RIGHT	D69c.EDF	D69	3
113	8701623	8701743	3633	3753	120	RIGHT	D69c.EDF	D69	3
113	8702472	8702575	4482	4585	103	RIGHT	D69c.EDF	D69	3
113	8702759	8702869	4769	4879	110	RIGHT	D69c.EDF	D69	3
113	8703031	8703155	5041	5165	124	RIGHT	D69c.EDF	D69	3
113	8703180	8703185	5190	5195	5	RIGHT	D69c.EDF	D69	3
113	8703292	8703420	5302	5430	128	RIGHT	D69c.EDF	D69	3
114	8706203	8706351	115	263	148	RIGHT	D69c.EDF	D69	3
114	8706983	8707123	895	1035	140	RIGHT	D69c.EDF	D69	3
114	8707334	8707521	1246	1433	187	RIGHT	D69c.EDF	D69	3
114	8708603	8708732	2515	2644	129	RIGHT	D69c.EDF	D69	3
114	8709528	8709668	3440	3580	140	RIGHT	D69c.EDF	D69	3
114	8710017	8710146	3929	4058	129	RIGHT	D69c.EDF	D69	3
114	8710258	8710367	4170	4279	109	RIGHT	D69c.EDF	D69	3
114	8710808	8710918	4720	4830	110	RIGHT	D69c.EDF	D69	3
114	8710939	8710939	4851	4851	0	RIGHT	D69c.EDF	D69	3
114	8711050	8711167	4962	5079	117	RIGHT	D69c.EDF	D69	3
115	8713417	8713441	59	83	24	RIGHT	D69c.EDF	D69	3
115	8713470	8713470	112	112	0	RIGHT	D69c.EDF	D69	3
115	8714431	8714618	1073	1260	187	RIGHT	D69c.EDF	D69	3
115	8715371	8715495	2013	2137	124	RIGHT	D69c.EDF	D69	3
115	8716396	8716501	3038	3143	105	RIGHT	D69c.EDF	D69	3
115	8717252	8717391	3894	4033	139	RIGHT	D69c.EDF	D69	3
115	8718206	8718325	4848	4967	119	RIGHT	D69c.EDF	D69	3
115	8718463	8718606	5105	5248	143	RIGHT	D69c.EDF	D69	3
115	8719070	8719223	5712	5865	153	RIGHT	D69c.EDF	D69	3
116	8722358	8722487	1120	1249	129	RIGHT	D69c.EDF	D69	3
116	8723816	8723919	2578	2681	103	RIGHT	D69c.EDF	D69	3
116	8724109	8724227	2871	2989	118	RIGHT	D69c.EDF	D69	3
116	8724397	8724526	3159	3288	129	RIGHT	D69c.EDF	D69	3
116	8724802	8724976	3564	3738	174	RIGHT	D69c.EDF	D69	3
116	8725625	8725915	4387	4677	290	RIGHT	D69c.EDF	D69	3
116	8726513	8726534	5275	5296	21	RIGHT	D69c.EDF	D69	3
117	8728876	8728975	59	158	99	RIGHT	D69c.EDF	D69	3
117	8729783	8729894	966	1077	111	RIGHT	D69c.EDF	D69	3
117	8730215	8730337	1398	1520	122	RIGHT	D69c.EDF	D69	3
117	8730364	8730365	1547	1548	1	RIGHT	D69c.EDF	D69	3
117	8732164	8732252	3347	3435	88	RIGHT	D69c.EDF	D69	3
117	8733170	8733271	4353	4454	101	RIGHT	D69c.EDF	D69	3
117	8733962	8734037	5145	5220	75	RIGHT	D69c.EDF	D69	3
117	8734603	8734731	5786	5914	128	RIGHT	D69c.EDF	D69	3
117	8734753	8734762	5936	5945	9	RIGHT	D69c.EDF	D69	3
118	8736969	8737076	57	164	107	RIGHT	D69c.EDF	D69	3
118	8737861	8737988	949	1076	127	RIGHT	D69c.EDF	D69	3
118	8739647	8739739	2735	2827	92	RIGHT	D69c.EDF	D69	3
118	8740262	8740386	3350	3474	124	RIGHT	D69c.EDF	D69	3
118	8740741	8740868	3829	3956	127	RIGHT	D69c.EDF	D69	3
118	8741448	8741572	4536	4660	124	RIGHT	D69c.EDF	D69	3
118	8742130	8742203	5218	5291	73	RIGHT	D69c.EDF	D69	3
118	8742385	8742478	5473	5566	93	RIGHT	D69c.EDF	D69	3
118	8743224	8743332	6312	6420	108	RIGHT	D69c.EDF	D69	3
118	8743362	8743362	6450	6450	0	RIGHT	D69c.EDF	D69	3
118	8743460	8743557	6548	6645	97	RIGHT	D69c.EDF	D69	3
119	8746154	8746163	69	78	9	RIGHT	D69c.EDF	D69	3
119	8747338	8747442	1253	1357	104	RIGHT	D69c.EDF	D69	3
119	8749224	8749327	3139	3242	103	RIGHT	D69c.EDF	D69	3
119	8750219	8750306	4134	4221	87	RIGHT	D69c.EDF	D69	3
119	8750966	8751071	4881	4986	105	RIGHT	D69c.EDF	D69	3
119	8751827	8751935	5742	5850	108	RIGHT	D69c.EDF	D69	3
120	8754099	8754099	87	87	0	RIGHT	D69c.EDF	D69	3
120	8754912	8755115	900	1103	203	RIGHT	D69c.EDF	D69	3
120	8756884	8756988	2872	2976	104	RIGHT	D69c.EDF	D69	3
120	8757905	8757992	3893	3980	87	RIGHT	D69c.EDF	D69	3
120	8758637	8758751	4625	4739	114	RIGHT	D69c.EDF	D69	3
120	8759029	8759190	5017	5178	161	RIGHT	D69c.EDF	D69	3
120	8759859	8759989	5847	5977	130	RIGHT	D69c.EDF	D69	3
121	10869897	10870056	1041	1200	159	RIGHT	D69c.EDF	D69	3
121	10872061	10872185	3205	3329	124	RIGHT	D69c.EDF	D69	3
121	10873890	10874018	5034	5162	128	RIGHT	D69c.EDF	D69	3
121	10880129	10880211	11273	11355	82	RIGHT	D69c.EDF	D69	3
121	10881173	10881297	12317	12441	124	RIGHT	D69c.EDF	D69	3
121	10881401	10881575	12545	12719	174	RIGHT	D69c.EDF	D69	3
121	10881829	10881955	12973	13099	126	RIGHT	D69c.EDF	D69	3
121	10884991	10885241	16135	16385	250	RIGHT	D69c.EDF	D69	3
121	10887512	10887853	18656	18997	341	RIGHT	D69c.EDF	D69	3
121	10887922	10887976	19066	19120	54	RIGHT	D69c.EDF	D69	3
121	10888297	10888309	19441	19453	12	RIGHT	D69c.EDF	D69	3
121	10888345	10888362	19489	19506	17	RIGHT	D69c.EDF	D69	3
121	10889516	10889691	20660	20835	175	RIGHT	D69c.EDF	D69	3
121	10889766	10889956	20910	21100	190	RIGHT	D69c.EDF	D69	3
121	10889985	10890553	21129	21697	568	RIGHT	D69c.EDF	D69	3
121	10890911	10891051	22055	22195	140	RIGHT	D69c.EDF	D69	3
121	10891114	10891243	22258	22387	129	RIGHT	D69c.EDF	D69	3
121	10891270	10891502	22414	22646	232	RIGHT	D69c.EDF	D69	3
121	10891549	10891682	22693	22826	133	RIGHT	D69c.EDF	D69	3
121	10893552	10893686	24696	24830	134	RIGHT	D69c.EDF	D69	3
121	10895303	10895468	26447	26612	165	RIGHT	D69c.EDF	D69	3
121	10895820	10896232	26964	27376	412	RIGHT	D69c.EDF	D69	3
121	10896439	10896538	27583	27682	99	RIGHT	D69c.EDF	D69	3
121	10898304	10898562	29448	29706	258	RIGHT	D69c.EDF	D69	3
121	10899235	10899579	30379	30723	344	RIGHT	D69c.EDF	D69	3
121	10899801	10899855	30945	30999	54	RIGHT	D69c.EDF	D69	3
121	10902069	10902284	33213	33428	215	RIGHT	D69c.EDF	D69	3
121	10904079	10904154	35223	35298	75	RIGHT	D69c.EDF	D69	3
121	10904214	10904558	35358	35702	344	RIGHT	D69c.EDF	D69	3
121	10904679	10904729	35823	35873	50	RIGHT	D69c.EDF	D69	3
121	10904791	10905034	35935	36178	243	RIGHT	D69c.EDF	D69	3
121	10905657	10905689	36801	36833	32	RIGHT	D69c.EDF	D69	3
121	10906173	10906277	37317	37421	104	RIGHT	D69c.EDF	D69	3
121	10906810	10907154	37954	38298	344	RIGHT	D69c.EDF	D69	3
121	10909007	10909045	40151	40189	38	RIGHT	D69c.EDF	D69	3
121	10909260	10909406	40404	40550	146	RIGHT	D69c.EDF	D69	3
121	10910903	10911359	42047	42503	456	RIGHT	D69c.EDF	D69	3
121	10913650	10913689	44794	44833	39	RIGHT	D69c.EDF	D69	3
121	10913951	10914049	45095	45193	98	RIGHT	D69c.EDF	D69	3
121	10915551	10915584	46695	46728	33	RIGHT	D69c.EDF	D69	3
121	10918984	10919081	50128	50225	97	RIGHT	D69c.EDF	D69	3
121	10920371	10920481	51515	51625	110	RIGHT	D69c.EDF	D69	3
121	10922359	10922416	53503	53560	57	RIGHT	D69c.EDF	D69	3
121	10926402	10926538	57546	57682	136	RIGHT	D69c.EDF	D69	3
121	10930412	10930514	61556	61658	102	RIGHT	D69c.EDF	D69	3
121	10931700	10931790	62844	62934	90	RIGHT	D69c.EDF	D69	3
121	10932877	10932997	64021	64141	120	RIGHT	D69c.EDF	D69	3
121	10934824	10934935	65968	66079	111	RIGHT	D69c.EDF	D69	3
121	10935050	10935388	66194	66532	338	RIGHT	D69c.EDF	D69	3
121	10935418	10935494	66562	66638	76	RIGHT	D69c.EDF	D69	3
121	10935549	10935573	66693	66717	24	RIGHT	D69c.EDF	D69	3
121	10935774	10935785	66918	66929	11	RIGHT	D69c.EDF	D69	3
121	10935822	10935848	66966	66992	26	RIGHT	D69c.EDF	D69	3
121	10935898	10936005	67042	67149	107	RIGHT	D69c.EDF	D69	3
121	10936059	10936074	67203	67218	15	RIGHT	D69c.EDF	D69	3
121	10936423	10936430	67567	67574	7	RIGHT	D69c.EDF	D69	3
121	10936459	10936819	67603	67963	360	RIGHT	D69c.EDF	D69	3
121	10937489	10937542	68633	68686	53	RIGHT	D69c.EDF	D69	3
121	10937603	10937717	68747	68861	114	RIGHT	D69c.EDF	D69	3
121	10937744	10937766	68888	68910	22	RIGHT	D69c.EDF	D69	3
121	10938111	10938358	69255	69502	247	RIGHT	D69c.EDF	D69	3
121	10941515	10941526	72659	72670	11	RIGHT	D69c.EDF	D69	3
121	10943642	10943755	74786	74899	113	RIGHT	D69c.EDF	D69	3
121	10944599	10944686	75743	75830	87	RIGHT	D69c.EDF	D69	3
121	10946870	10947150	78014	78294	280	RIGHT	D69c.EDF	D69	3
121	10949284	10949459	80428	80603	175	RIGHT	D69c.EDF	D69	3
121	10949542	10949736	80686	80880	194	RIGHT	D69c.EDF	D69	3
121	10949829	10949859	80973	81003	30	RIGHT	D69c.EDF	D69	3
121	10949903	10949953	81047	81097	50	RIGHT	D69c.EDF	D69	3
121	10956569	10957059	87713	88203	490	RIGHT	D69c.EDF	D69	3
121	10957439	10957884	88583	89028	445	RIGHT	D69c.EDF	D69	3
121	10960511	10960571	91655	91715	60	RIGHT	D69c.EDF	D69	3
121	10964350	10964694	95494	95838	344	RIGHT	D69c.EDF	D69	3
121	10968289	10968404	99433	99548	115	RIGHT	D69c.EDF	D69	3
121	10969778	10969890	100922	101034	112	RIGHT	D69c.EDF	D69	3
121	10971424	10971531	102568	102675	107	RIGHT	D69c.EDF	D69	3
121	10976070	10976215	107214	107359	145	RIGHT	D69c.EDF	D69	3
121	10977756	10977855	108900	108999	99	RIGHT	D69c.EDF	D69	3
121	10979502	10979668	110646	110812	166	RIGHT	D69c.EDF	D69	3
121	10982527	10982570	113671	113714	43	RIGHT	D69c.EDF	D69	3
121	10982666	10982751	113810	113895	85	RIGHT	D69c.EDF	D69	3
121	10982792	10982955	113936	114099	163	RIGHT	D69c.EDF	D69	3
121	10983463	10983723	114607	114867	260	RIGHT	D69c.EDF	D69	3
121	10986949	10987078	118093	118222	129	RIGHT	D69c.EDF	D69	3
121	10989698	10989812	120842	120956	114	RIGHT	D69c.EDF	D69	3
121	10994281	10994413	125425	125557	132	RIGHT	D69c.EDF	D69	3
121	10995725	10995804	126869	126948	79	RIGHT	D69c.EDF	D69	3
121	10997193	10997327	128337	128471	134	RIGHT	D69c.EDF	D69	3
121	10999485	10999609	130629	130753	124	RIGHT	D69c.EDF	D69	3
121	11002298	11002417	133442	133561	119	RIGHT	D69c.EDF	D69	3
121	11004352	11004620	135496	135764	268	RIGHT	D69c.EDF	D69	3
121	11007635	11007685	138779	138829	50	RIGHT	D69c.EDF	D69	3
121	11007782	11008044	138926	139188	262	RIGHT	D69c.EDF	D69	3
121	11009436	11009558	140580	140702	122	RIGHT	D69c.EDF	D69	3
121	11012791	11013553	143935	144697	762	RIGHT	D69c.EDF	D69	3
121	11018189	11018318	149333	149462	129	RIGHT	D69c.EDF	D69	3
121	11018593	11018831	149737	149975	238	RIGHT	D69c.EDF	D69	3
121	11020055	11020242	151199	151386	187	RIGHT	D69c.EDF	D69	3
121	11020878	11021478	152022	152622	600	RIGHT	D69c.EDF	D69	3
121	11021941	11022413	153085	153557	472	RIGHT	D69c.EDF	D69	3
121	11022501	11023229	153645	154373	728	RIGHT	D69c.EDF	D69	3
121	11023406	11024503	154550	155647	1097	RIGHT	D69c.EDF	D69	3
121	11024822	11025611	155966	156755	789	RIGHT	D69c.EDF	D69	3
121	11026232	11028848	157376	159992	2616	RIGHT	D69c.EDF	D69	3
121	11029194	11030562	160338	161706	1368	RIGHT	D69c.EDF	D69	3
121	11032972	11033009	164116	164153	37	RIGHT	D69c.EDF	D69	3
121	11033035	11033079	164179	164223	44	RIGHT	D69c.EDF	D69	3
121	11033109	11033438	164253	164582	329	RIGHT	D69c.EDF	D69	3
121	11034184	11034410	165328	165554	226	RIGHT	D69c.EDF	D69	3
121	11034642	11034653	165786	165797	11	RIGHT	D69c.EDF	D69	3
121	11036278	11036560	167422	167704	282	RIGHT	D69c.EDF	D69	3
121	11037693	11037853	168837	168997	160	RIGHT	D69c.EDF	D69	3
121	11042581	11042756	173725	173900	175	RIGHT	D69c.EDF	D69	3
121	11042883	11043104	174027	174248	221	RIGHT	D69c.EDF	D69	3
121	11044647	11044716	175791	175860	69	RIGHT	D69c.EDF	D69	3
121	11045296	11045992	176440	177136	696	RIGHT	D69c.EDF	D69	3
121	11046308	11047804	177452	178948	1496	RIGHT	D69c.EDF	D69	3
121	11048179	11048507	179323	179651	328	RIGHT	D69c.EDF	D69	3
121	11048741	11048984	179885	180128	243	RIGHT	D69c.EDF	D69	3
121	11049219	11049563	180363	180707	344	RIGHT	D69c.EDF	D69	3
121	11049763	11049956	180907	181100	193	RIGHT	D69c.EDF	D69	3
121	11050145	11050294	181289	181438	149	RIGHT	D69c.EDF	D69	3
121	11050471	11050495	181615	181639	24	RIGHT	D69c.EDF	D69	3
121	11052329	11052498	183473	183642	169	RIGHT	D69c.EDF	D69	3
121	11053903	11054048	185047	185192	145	RIGHT	D69c.EDF	D69	3
121	11058577	11058702	189721	189846	125	RIGHT	D69c.EDF	D69	3
121	11060298	11060418	191442	191562	120	RIGHT	D69c.EDF	D69	3
121	11062639	11062775	193783	193919	136	RIGHT	D69c.EDF	D69	3
121	11062858	11063004	194002	194148	146	RIGHT	D69c.EDF	D69	3
121	11063063	11073401	194207	204545	10338	RIGHT	D69c.EDF	D69	3
122	11162020	11162102	260	342	82	RIGHT	D69c.EDF	D69	3
122	11163624	11163778	1864	2018	154	RIGHT	D69c.EDF	D69	3
122	11168184	11168345	6424	6585	161	RIGHT	D69c.EDF	D69	3
122	11174456	11174630	12696	12870	174	RIGHT	D69c.EDF	D69	3
122	11175724	11175812	13964	14052	88	RIGHT	D69c.EDF	D69	3
122	11175852	11175854	14092	14094	2	RIGHT	D69c.EDF	D69	3
122	11175878	11175878	14118	14118	0	RIGHT	D69c.EDF	D69	3
122	11176092	11176364	14332	14604	272	RIGHT	D69c.EDF	D69	3
122	11176643	11176926	14883	15166	283	RIGHT	D69c.EDF	D69	3
122	11178121	11178224	16361	16464	103	RIGHT	D69c.EDF	D69	3
122	11182300	11182358	20540	20598	58	RIGHT	D69c.EDF	D69	3
122	11182881	11183174	21121	21414	293	RIGHT	D69c.EDF	D69	3
122	11186017	11186138	24257	24378	121	RIGHT	D69c.EDF	D69	3
122	11190109	11190188	28349	28428	79	RIGHT	D69c.EDF	D69	3
122	11191688	11191832	29928	30072	144	RIGHT	D69c.EDF	D69	3
122	11192821	11192881	31061	31121	60	RIGHT	D69c.EDF	D69	3
122	11194403	11194480	32643	32720	77	RIGHT	D69c.EDF	D69	3
122	11196028	11196111	34268	34351	83	RIGHT	D69c.EDF	D69	3
122	11200107	11200188	38347	38428	81	RIGHT	D69c.EDF	D69	3
122	11201583	11201975	39823	40215	392	RIGHT	D69c.EDF	D69	3
122	11208430	11208526	46670	46766	96	RIGHT	D69c.EDF	D69	3
122	11209428	11209434	47668	47674	6	RIGHT	D69c.EDF	D69	3
122	11211148	11211305	49388	49545	157	RIGHT	D69c.EDF	D69	3
122	11214279	11214380	52519	52620	101	RIGHT	D69c.EDF	D69	3
122	11218917	11219032	57157	57272	115	RIGHT	D69c.EDF	D69	3
122	11220765	11220864	59005	59104	99	RIGHT	D69c.EDF	D69	3
122	11222690	11222806	60930	61046	116	RIGHT	D69c.EDF	D69	3
122	11224463	11224611	62703	62851	148	RIGHT	D69c.EDF	D69	3
122	11227052	11227058	65292	65298	6	RIGHT	D69c.EDF	D69	3
122	11227087	11227888	65327	66128	801	RIGHT	D69c.EDF	D69	3
122	11228409	11228502	66649	66742	93	RIGHT	D69c.EDF	D69	3
122	11229450	11229468	67690	67708	18	RIGHT	D69c.EDF	D69	3
122	11232420	11232519	70660	70759	99	RIGHT	D69c.EDF	D69	3
122	11235387	11235498	73627	73738	111	RIGHT	D69c.EDF	D69	3
122	11238517	11238630	76757	76870	113	RIGHT	D69c.EDF	D69	3
122	11243251	11243414	81491	81654	163	RIGHT	D69c.EDF	D69	3
122	11250679	11250794	88919	89034	115	RIGHT	D69c.EDF	D69	3
122	11251330	11251344	89570	89584	14	RIGHT	D69c.EDF	D69	3
122	11251458	11251501	89698	89741	43	RIGHT	D69c.EDF	D69	3
122	11251538	11251557	89778	89797	19	RIGHT	D69c.EDF	D69	3
122	11251948	11252026	90188	90266	78	RIGHT	D69c.EDF	D69	3
122	11253053	11253171	91293	91411	118	RIGHT	D69c.EDF	D69	3
122	11257684	11257786	95924	96026	102	RIGHT	D69c.EDF	D69	3
122	11259987	11260028	98227	98268	41	RIGHT	D69c.EDF	D69	3
122	11260050	11260053	98290	98293	3	RIGHT	D69c.EDF	D69	3
122	11260180	11260181	98420	98421	1	RIGHT	D69c.EDF	D69	3
122	11261457	11261561	99697	99801	104	RIGHT	D69c.EDF	D69	3
122	11262580	11262711	100820	100951	131	RIGHT	D69c.EDF	D69	3
122	11265865	11265867	104105	104107	2	RIGHT	D69c.EDF	D69	3
122	11265903	11266070	104143	104310	167	RIGHT	D69c.EDF	D69	3
122	11266111	11266134	104351	104374	23	RIGHT	D69c.EDF	D69	3
122	11266157	11266173	104397	104413	16	RIGHT	D69c.EDF	D69	3
122	11266202	11266234	104442	104474	32	RIGHT	D69c.EDF	D69	3
122	11266488	11266707	104728	104947	219	RIGHT	D69c.EDF	D69	3
122	11270405	11270464	108645	108704	59	RIGHT	D69c.EDF	D69	3
122	11272753	11272899	110993	111139	146	RIGHT	D69c.EDF	D69	3
122	11278973	11279110	117213	117350	137	RIGHT	D69c.EDF	D69	3
122	11281109	11281250	119349	119490	141	RIGHT	D69c.EDF	D69	3
122	11283855	11283876	122095	122116	21	RIGHT	D69c.EDF	D69	3
122	11284303	11284303	122543	122543	0	RIGHT	D69c.EDF	D69	3
122	11284724	11284725	122964	122965	1	RIGHT	D69c.EDF	D69	3
122	11286283	11286368	124523	124608	85	RIGHT	D69c.EDF	D69	3
122	11287442	11287576	125682	125816	134	RIGHT	D69c.EDF	D69	3
122	11289513	11289609	127753	127849	96	RIGHT	D69c.EDF	D69	3
122	11290030	11290034	128270	128274	4	RIGHT	D69c.EDF	D69	3
122	11290063	11290111	128303	128351	48	RIGHT	D69c.EDF	D69	3
122	11290443	11290652	128683	128892	209	RIGHT	D69c.EDF	D69	3
122	11291471	11291568	129711	129808	97	RIGHT	D69c.EDF	D69	3
122	11291708	11291752	129948	129992	44	RIGHT	D69c.EDF	D69	3
122	11291815	11291847	130055	130087	32	RIGHT	D69c.EDF	D69	3
122	11291893	11291947	130133	130187	54	RIGHT	D69c.EDF	D69	3
122	11293218	11293377	131458	131617	159	RIGHT	D69c.EDF	D69	3
122	11295983	11296017	134223	134257	34	RIGHT	D69c.EDF	D69	3
122	11297568	11297861	135808	136101	293	RIGHT	D69c.EDF	D69	3
122	11297934	11298060	136174	136300	126	RIGHT	D69c.EDF	D69	3
122	11298208	11298215	136448	136455	7	RIGHT	D69c.EDF	D69	3
122	11298258	11298679	136498	136919	421	RIGHT	D69c.EDF	D69	3
122	11298700	11298895	136940	137135	195	RIGHT	D69c.EDF	D69	3
122	11299100	11299245	137340	137485	145	RIGHT	D69c.EDF	D69	3
122	11299979	11300147	138219	138387	168	RIGHT	D69c.EDF	D69	3
122	11301648	11301686	139888	139926	38	RIGHT	D69c.EDF	D69	3
122	11302212	11302218	140452	140458	6	RIGHT	D69c.EDF	D69	3
122	11303395	11303395	141635	141635	0	RIGHT	D69c.EDF	D69	3
122	11303542	11303543	141782	141783	1	RIGHT	D69c.EDF	D69	3
122	11303996	11304092	142236	142332	96	RIGHT	D69c.EDF	D69	3
122	11305984	11306059	144224	144299	75	RIGHT	D69c.EDF	D69	3
122	11306504	11306898	144744	145138	394	RIGHT	D69c.EDF	D69	3
122	11306925	11306997	145165	145237	72	RIGHT	D69c.EDF	D69	3
122	11307028	11307135	145268	145375	107	RIGHT	D69c.EDF	D69	3
122	11307345	11307460	145585	145700	115	RIGHT	D69c.EDF	D69	3
122	11307541	11307541	145781	145781	0	RIGHT	D69c.EDF	D69	3
122	11307684	11307691	145924	145931	7	RIGHT	D69c.EDF	D69	3
122	11307730	11307774	145970	146014	44	RIGHT	D69c.EDF	D69	3
122	11307861	11308557	146101	146797	696	RIGHT	D69c.EDF	D69	3
122	11308974	11309130	147214	147370	156	RIGHT	D69c.EDF	D69	3
122	11309801	11314377	148041	152617	4576	RIGHT	D69c.EDF	D69	3
5	1861085	1861171	892	978	86	RIGHT	E30.EDF	E30	.
7	1875233	1875313	732	812	80	RIGHT	E30.EDF	E30	.
9	1892792	1892862	790	860	70	RIGHT	E30.EDF	E30	.
12	1917761	1917885	1775	1899	124	RIGHT	E30.EDF	E30	.
13	1925439	1925479	1441	1481	40	RIGHT	E30.EDF	E30	.
15	1940571	1940676	830	935	105	RIGHT	E30.EDF	E30	.
16	1948441	1948534	918	1011	93	RIGHT	E30.EDF	E30	.
19	1970553	1970594	898	939	41	RIGHT	E30.EDF	E30	.
20	1979137	1979207	1337	1407	70	RIGHT	E30.EDF	E30	.
21	1984616	1984756	88	228	140	RIGHT	E30.EDF	E30	.
22	1992645	1992718	931	1004	73	RIGHT	E30.EDF	E30	.
23	1999742	1999801	1088	1147	59	RIGHT	E30.EDF	E30	.
24	2007312	2007450	620	758	138	RIGHT	E30.EDF	E30	.
26	2024971	2025093	2500	2622	122	RIGHT	E30.EDF	E30	.
27	2031776	2031861	159	244	85	RIGHT	E30.EDF	E30	.
28	2038558	2038660	526	628	102	RIGHT	E30.EDF	E30	.
30	2060497	2060553	5949	6005	56	RIGHT	E30.EDF	E30	.
32	2071192	2071328	795	931	136	RIGHT	E30.EDF	E30	.
35	2092888	2092994	807	913	106	RIGHT	E30.EDF	E30	.
36	2101162	2101318	862	1018	156	RIGHT	E30.EDF	E30	.
37	2109433	2109514	889	970	81	RIGHT	E30.EDF	E30	.
37	2114116	2114219	5572	5675	103	RIGHT	E30.EDF	E30	.
38	2117398	2117500	339	441	102	RIGHT	E30.EDF	E30	.
38	2118757	2118806	1698	1747	49	RIGHT	E30.EDF	E30	.
39	2124454	2124492	541	579	38	RIGHT	E30.EDF	E30	.
41	2141285	2141290	303	308	5	RIGHT	E30.EDF	E30	.
41	2141513	2141628	531	646	115	RIGHT	E30.EDF	E30	.
42	2148580	2148645	380	445	65	RIGHT	E30.EDF	E30	.
42	2148693	2148742	493	542	49	RIGHT	E30.EDF	E30	.
42	2148922	2149051	722	851	129	RIGHT	E30.EDF	E30	.
43	2156733	2156822	289	378	89	RIGHT	E30.EDF	E30	.
44	2167700	2167750	2860	2910	50	RIGHT	E30.EDF	E30	.
48	2200535	2200669	1195	1329	134	RIGHT	E30.EDF	E30	.
49	2207549	2207653	804	908	104	RIGHT	E30.EDF	E30	.
50	2216764	2216876	203	315	112	RIGHT	E30.EDF	E30	.
51	2224908	2225018	366	476	110	RIGHT	E30.EDF	E30	.
52	2234056	2234118	1486	1548	62	RIGHT	E30.EDF	E30	.
53	2240901	2241049	996	1144	148	RIGHT	E30.EDF	E30	.
54	2249904	2250016	932	1044	112	RIGHT	E30.EDF	E30	.
55	2257060	2257131	1215	1286	71	RIGHT	E30.EDF	E30	.
56	2265588	2265697	3219	3328	109	RIGHT	E30.EDF	E30	.
57	2272937	2273056	241	360	119	RIGHT	E30.EDF	E30	.
59	2290729	2290836	785	892	107	RIGHT	E30.EDF	E30	.
60	2301307	2301392	2849	2934	85	RIGHT	E30.EDF	E30	.
62	2315900	2315926	58	84	26	RIGHT	E30.EDF	E30	.
63	2324087	2324273	599	785	186	RIGHT	E30.EDF	E30	.
63	2324298	2324309	810	821	11	RIGHT	E30.EDF	E30	.
67	2357652	2357762	799	909	110	RIGHT	E30.EDF	E30	.
71	2391613	2391785	3071	3243	172	RIGHT	E30.EDF	E30	.
73	2404998	2405100	890	992	102	RIGHT	E30.EDF	E30	.
76	2431525	2431623	3607	3705	98	RIGHT	E30.EDF	E30	.
79	2456170	2456261	1412	1503	91	RIGHT	E30.EDF	E30	.
80	2463383	2463493	1139	1249	110	RIGHT	E30.EDF	E30	.
86	2510857	2510969	994	1106	112	RIGHT	E30.EDF	E30	.
87	2518167	2518249	860	942	82	RIGHT	E30.EDF	E30	.
88	2525046	2525138	1087	1179	92	RIGHT	E30.EDF	E30	.
90	2544437	2544535	2836	2934	98	RIGHT	E30.EDF	E30	.
97	2597763	2597776	104	117	13	RIGHT	E30.EDF	E30	.
98	2605960	2606106	932	1078	146	RIGHT	E30.EDF	E30	.
99	2616325	2616405	4048	4128	80	RIGHT	E30.EDF	E30	.
103	2646024	2646117	1063	1156	93	RIGHT	E30.EDF	E30	.
105	2662939	2663070	668	799	131	RIGHT	E30.EDF	E30	.
105	2665341	2665395	3070	3124	54	RIGHT	E30.EDF	E30	.
106	2674793	2674814	5381	5402	21	RIGHT	E30.EDF	E30	.
110	2705715	2705842	921	1048	127	RIGHT	E30.EDF	E30	.
111	2713625	2713766	987	1128	141	RIGHT	E30.EDF	E30	.
113	2734534	2734593	4933	4992	59	RIGHT	E30.EDF	E30	.
119	2781344	2781499	2120	2275	155	RIGHT	E30.EDF	E30	.
120	2785973	2785973	90	90	0	RIGHT	E30.EDF	E30	.
120	2787241	2787317	1358	1434	76	RIGHT	E30.EDF	E30	.
17	3798266	3798341	763	838	75	RIGHT	E302.EDF	E30	2
28	3891075	3891157	5000	5082	82	RIGHT	E302.EDF	E30	2
29	3897720	3897739	4157	4176	19	RIGHT	E302.EDF	E30	2
34	3932653	3932795	1050	1192	142	RIGHT	E302.EDF	E30	2
35	3940864	3940922	1296	1354	58	RIGHT	E302.EDF	E30	2
36	3948348	3948354	95	101	6	RIGHT	E302.EDF	E30	2
39	3973575	3973663	2888	2976	88	RIGHT	E302.EDF	E30	2
43	4007572	4007677	3312	3417	105	RIGHT	E302.EDF	E30	2
44	4012072	4012192	489	609	120	RIGHT	E302.EDF	E30	2
46	4028185	4028282	1121	1218	97	RIGHT	E302.EDF	E30	2
49	4052883	4052959	3506	3582	76	RIGHT	E302.EDF	E30	2
52	4078256	4078342	1031	1117	86	RIGHT	E302.EDF	E30	2
54	4093658	4093759	925	1026	101	RIGHT	E302.EDF	E30	2
60	4139650	4139697	1112	1159	47	RIGHT	E302.EDF	E30	2
61	4147133	4147263	179	309	130	RIGHT	E302.EDF	E30	2
62	4155828	4155874	67	113	46	RIGHT	E302.EDF	E30	2
62	4161357	4161468	5596	5707	111	RIGHT	E302.EDF	E30	2
63	4163982	4164158	555	731	176	RIGHT	E302.EDF	E30	2
77	4275064	4275138	268	342	74	RIGHT	E302.EDF	E30	2
83	4324006	4324030	58	82	24	RIGHT	E302.EDF	E30	2
84	4331007	4331008	77	78	1	RIGHT	E302.EDF	E30	2
90	4379263	4379272	323	332	9	RIGHT	E302.EDF	E30	2
90	4379293	4379316	353	376	23	RIGHT	E302.EDF	E30	2
93	4406870	4406962	1274	1366	92	RIGHT	E302.EDF	E30	2
94	4412807	4412900	64	157	93	RIGHT	E302.EDF	E30	2
95	4420361	4420415	58	112	54	RIGHT	E302.EDF	E30	2
95	4420466	4420468	163	165	2	RIGHT	E302.EDF	E30	2
95	4421009	4421106	706	803	97	RIGHT	E302.EDF	E30	2
95	4423586	4423664	3283	3361	78	RIGHT	E302.EDF	E30	2
95	4423696	4423705	3393	3402	9	RIGHT	E302.EDF	E30	2
96	4428929	4428930	77	78	1	RIGHT	E302.EDF	E30	2
99	4454887	4455053	742	908	166	RIGHT	E302.EDF	E30	2
99	4455128	4455219	983	1074	91	RIGHT	E302.EDF	E30	2
101	4472197	4472265	2611	2679	68	RIGHT	E302.EDF	E30	2
102	4476702	4476745	92	135	43	RIGHT	E302.EDF	E30	2
103	4483302	4483371	57	126	69	RIGHT	E302.EDF	E30	2
103	4483465	4483466	220	221	1	RIGHT	E302.EDF	E30	2
105	4498670	4498846	845	1021	176	RIGHT	E302.EDF	E30	2
105	4498868	4498936	1043	1111	68	RIGHT	E302.EDF	E30	2
106	4506353	4506473	870	990	120	RIGHT	E302.EDF	E30	2
109	4529932	4529932	100	100	0	RIGHT	E302.EDF	E30	2
111	4544651	4544695	57	101	44	RIGHT	E302.EDF	E30	2
111	4544766	4544790	172	196	24	RIGHT	E302.EDF	E30	2
114	4568044	4568135	1613	1704	91	RIGHT	E302.EDF	E30	2
117	4592459	4592639	57	237	180	RIGHT	E302.EDF	E30	2
118	4601163	4601303	325	465	140	RIGHT	E302.EDF	E30	2
7	5297628	5297673	3704	3749	45	RIGHT	E303.EDF	E30	3
10	5321067	5321154	3447	3534	87	RIGHT	E303.EDF	E30	3
15	5358861	5358923	1113	1175	62	RIGHT	E303.EDF	E30	3
16	5366915	5366924	1060	1069	9	RIGHT	E303.EDF	E30	3
23	5418422	5418485	1272	1335	63	RIGHT	E303.EDF	E30	3
25	5438724	5438786	4506	4568	62	RIGHT	E303.EDF	E30	3
28	5458857	5458983	1181	1307	126	RIGHT	E303.EDF	E30	3
36	5520897	5520955	855	913	58	RIGHT	E303.EDF	E30	3
41	5564910	5564958	6384	6432	48	RIGHT	E303.EDF	E30	3
46	5604496	5604529	3207	3240	33	RIGHT	E303.EDF	E30	3
48	5617835	5617964	763	892	129	RIGHT	E303.EDF	E30	3
48	5619235	5619323	2163	2251	88	RIGHT	E303.EDF	E30	3
49	5628994	5629022	3957	3985	28	RIGHT	E303.EDF	E30	3
50	5632533	5632653	1091	1211	120	RIGHT	E303.EDF	E30	3
51	5643914	5644052	2952	3090	138	RIGHT	E303.EDF	E30	3
54	5667273	5667314	4853	4894	41	RIGHT	E303.EDF	E30	3
54	5667339	5667351	4919	4931	12	RIGHT	E303.EDF	E30	3
62	5730750	5730853	4410	4513	103	RIGHT	E303.EDF	E30	3
63	5737580	5737668	2756	2844	88	RIGHT	E303.EDF	E30	3
63	5738823	5738947	3999	4123	124	RIGHT	E303.EDF	E30	3
68	5772541	5772658	244	361	117	RIGHT	E303.EDF	E30	3
69	5779516	5779597	57	138	81	RIGHT	E303.EDF	E30	3
69	5779618	5779643	159	184	25	RIGHT	E303.EDF	E30	3
70	5787389	5787470	1235	1316	81	RIGHT	E303.EDF	E30	3
71	5796408	5796484	3857	3933	76	RIGHT	E303.EDF	E30	3
72	5800880	5800990	1519	1629	110	RIGHT	E303.EDF	E30	3
76	5834825	5834928	4333	4436	103	RIGHT	E303.EDF	E30	3
78	5848938	5849032	2924	3018	94	RIGHT	E303.EDF	E30	3
81	5872937	5873057	2650	2770	120	RIGHT	E303.EDF	E30	3
82	5879002	5879051	1032	1081	49	RIGHT	E303.EDF	E30	3
89	5933029	5933133	171	275	104	RIGHT	E303.EDF	E30	3
91	5951592	5951723	4548	4679	131	RIGHT	E303.EDF	E30	3
92	5958377	5958490	2716	2829	113	RIGHT	E303.EDF	E30	3
95	5978895	5979152	202	459	257	RIGHT	E303.EDF	E30	3
97	5998360	5998428	3069	3137	68	RIGHT	E303.EDF	E30	3
98	6005314	6005427	1164	1277	113	RIGHT	E303.EDF	E30	3
101	6028806	6028900	2952	3046	94	RIGHT	E303.EDF	E30	3
102	6032926	6033014	57	145	88	RIGHT	E303.EDF	E30	3
104	6052724	6052806	4336	4418	82	RIGHT	E303.EDF	E30	3
106	6069839	6069928	5344	5433	89	RIGHT	E303.EDF	E30	3
114	6132166	6132215	1787	1836	49	RIGHT	E303.EDF	E30	3
115	6139898	6139909	1758	1769	11	RIGHT	E303.EDF	E30	3
116	6147854	6147962	3377	3485	108	RIGHT	E303.EDF	E30	3
117	6151725	6151786	504	565	61	RIGHT	E303.EDF	E30	3
118	6160348	6160415	1852	1919	67	RIGHT	E303.EDF	E30	3
119	6169180	6169248	2111	2179	68	RIGHT	E303.EDF	E30	3
120	6175947	6175975	989	1017	28	RIGHT	E303.EDF	E30	3
120	6177962	6178039	3004	3081	77	RIGHT	E303.EDF	E30	3
1	1345870	1345944	1117	1191	74	RIGHT	E401.EDF	E40	1
2	1358899	1358944	2030	2075	45	RIGHT	E401.EDF	E40	1
3	1372225	1372275	6070	6120	50	RIGHT	E401.EDF	E40	1
6	1393784	1393885	102	203	101	RIGHT	E401.EDF	E40	1
6	1398793	1398825	5111	5143	32	RIGHT	E401.EDF	E40	1
6	1399463	1399547	5781	5865	84	RIGHT	E401.EDF	E40	1
7	1406274	1406344	3705	3775	70	RIGHT	E401.EDF	E40	1
7	1406727	1406812	4158	4243	85	RIGHT	E401.EDF	E40	1
8	1411214	1411327	60	173	113	RIGHT	E401.EDF	E40	1
9	1419731	1419844	863	976	113	RIGHT	E401.EDF	E40	1
10	1428501	1428589	1018	1106	88	RIGHT	E401.EDF	E40	1
10	1429731	1429850	2248	2367	119	RIGHT	E401.EDF	E40	1
10	1433086	1433218	5603	5735	132	RIGHT	E401.EDF	E40	1
11	1437359	1437459	1679	1779	100	RIGHT	E401.EDF	E40	1
12	1446170	1446213	1208	1251	43	RIGHT	E401.EDF	E40	1
12	1446379	1446479	1417	1517	100	RIGHT	E401.EDF	E40	1
12	1447674	1447720	2712	2758	46	RIGHT	E401.EDF	E40	1
12	1448398	1448552	3436	3590	154	RIGHT	E401.EDF	E40	1
13	1454722	1454735	2323	2336	13	RIGHT	E401.EDF	E40	1
13	1454761	1454768	2362	2369	7	RIGHT	E401.EDF	E40	1
13	1457624	1457686	5225	5287	62	RIGHT	E401.EDF	E40	1
14	1463007	1463077	1963	2033	70	RIGHT	E401.EDF	E40	1
14	1463106	1463110	2062	2066	4	RIGHT	E401.EDF	E40	1
15	1468504	1468629	58	183	125	RIGHT	E401.EDF	E40	1
18	1492150	1492249	58	157	99	RIGHT	E401.EDF	E40	1
18	1492662	1492807	570	715	145	RIGHT	E401.EDF	E40	1
19	1501573	1501643	1608	1678	70	RIGHT	E401.EDF	E40	1
19	1503694	1503721	3729	3756	27	RIGHT	E401.EDF	E40	1
19	1503938	1504037	3973	4072	99	RIGHT	E401.EDF	E40	1
19	1504942	1504991	4977	5026	49	RIGHT	E401.EDF	E40	1
20	1508622	1508723	1341	1442	101	RIGHT	E401.EDF	E40	1
22	1524168	1524201	1629	1662	33	RIGHT	E401.EDF	E40	1
22	1524942	1524996	2403	2457	54	RIGHT	E401.EDF	E40	1
23	1531240	1531374	472	606	134	RIGHT	E401.EDF	E40	1
23	1531395	1531401	627	633	6	RIGHT	E401.EDF	E40	1
24	1541310	1541392	1962	2044	82	RIGHT	E401.EDF	E40	1
26	1556585	1556662	1016	1093	77	RIGHT	E401.EDF	E40	1
26	1558063	1558182	2494	2613	119	RIGHT	E401.EDF	E40	1
26	1560686	1560786	5117	5217	100	RIGHT	E401.EDF	E40	1
26	1561336	1561440	5767	5871	104	RIGHT	E401.EDF	E40	1
27	1564014	1564075	57	118	61	RIGHT	E401.EDF	E40	1
27	1564942	1565010	985	1053	68	RIGHT	E401.EDF	E40	1
27	1565191	1565298	1234	1341	107	RIGHT	E401.EDF	E40	1
27	1565648	1565735	1691	1778	87	RIGHT	E401.EDF	E40	1
27	1566205	1566310	2248	2353	105	RIGHT	E401.EDF	E40	1
27	1569818	1569842	5861	5885	24	RIGHT	E401.EDF	E40	1
28	1573201	1573219	1007	1025	18	RIGHT	E401.EDF	E40	1
28	1574329	1574423	2135	2229	94	RIGHT	E401.EDF	E40	1
28	1574807	1574919	2613	2725	112	RIGHT	E401.EDF	E40	1
29	1586123	1586173	5790	5840	50	RIGHT	E401.EDF	E40	1
29	1586195	1586201	5862	5868	6	RIGHT	E401.EDF	E40	1
30	1591514	1591578	2283	2347	64	RIGHT	E401.EDF	E40	1
30	1595552	1595641	6321	6410	89	RIGHT	E401.EDF	E40	1
31	1597645	1597775	57	187	130	RIGHT	E401.EDF	E40	1
31	1603099	1603156	5511	5568	57	RIGHT	E401.EDF	E40	1
32	1611806	1611837	5381	5412	31	RIGHT	E401.EDF	E40	1
32	1611865	1611872	5440	5447	7	RIGHT	E401.EDF	E40	1
33	1615831	1615854	483	506	23	RIGHT	E401.EDF	E40	1
33	1617290	1617385	1942	2037	95	RIGHT	E401.EDF	E40	1
34	1625605	1625708	2524	2627	103	RIGHT	E401.EDF	E40	1
34	1629534	1629605	6453	6524	71	RIGHT	E401.EDF	E40	1
34	1630079	1630176	6998	7095	97	RIGHT	E401.EDF	E40	1
37	1649789	1649922	529	662	133	RIGHT	E401.EDF	E40	1
37	1653671	1653725	4411	4465	54	RIGHT	E401.EDF	E40	1
37	1654220	1654348	4960	5088	128	RIGHT	E401.EDF	E40	1
38	1659321	1659322	2054	2055	1	RIGHT	E401.EDF	E40	1
38	1659357	1659368	2090	2101	11	RIGHT	E401.EDF	E40	1
38	1659554	1659712	2287	2445	158	RIGHT	E401.EDF	E40	1
38	1662626	1662728	5359	5461	102	RIGHT	E401.EDF	E40	1
39	1669971	1670083	4776	4888	112	RIGHT	E401.EDF	E40	1
40	1673283	1673345	736	798	62	RIGHT	E401.EDF	E40	1
43	1694739	1694785	473	519	46	RIGHT	E401.EDF	E40	1
43	1696351	1696422	2085	2156	71	RIGHT	E401.EDF	E40	1
43	1696576	1696728	2310	2462	152	RIGHT	E401.EDF	E40	1
43	1698119	1698215	3853	3949	96	RIGHT	E401.EDF	E40	1
43	1699995	1700119	5729	5853	124	RIGHT	E401.EDF	E40	1
45	1712217	1712307	1962	2052	90	RIGHT	E401.EDF	E40	1
45	1712546	1712686	2291	2431	140	RIGHT	E401.EDF	E40	1
47	1726909	1726936	1885	1912	27	RIGHT	E401.EDF	E40	1
47	1727574	1727685	2550	2661	111	RIGHT	E401.EDF	E40	1
49	1741957	1741982	1915	1940	25	RIGHT	E401.EDF	E40	1
49	1742123	1742212	2081	2170	89	RIGHT	E401.EDF	E40	1
49	1742426	1742588	2384	2546	162	RIGHT	E401.EDF	E40	1
49	1745117	1745229	5075	5187	112	RIGHT	E401.EDF	E40	1
50	1751068	1751138	1399	1469	70	RIGHT	E401.EDF	E40	1
50	1754998	1755080	5329	5411	82	RIGHT	E401.EDF	E40	1
51	1766725	1766831	6816	6922	106	RIGHT	E401.EDF	E40	1
52	1770390	1770494	895	999	104	RIGHT	E401.EDF	E40	1
52	1771368	1771505	1873	2010	137	RIGHT	E401.EDF	E40	1
52	1774281	1774350	4786	4855	69	RIGHT	E401.EDF	E40	1
52	1775673	1775751	6178	6256	78	RIGHT	E401.EDF	E40	1
53	1778155	1778216	57	118	61	RIGHT	E401.EDF	E40	1
53	1778509	1778867	411	769	358	RIGHT	E401.EDF	E40	1
53	1782635	1782637	4537	4539	2	RIGHT	E401.EDF	E40	1
53	1782671	1782681	4573	4583	10	RIGHT	E401.EDF	E40	1
54	1791581	1791639	4269	4327	58	RIGHT	E401.EDF	E40	1
55	1796747	1796881	158	292	134	RIGHT	E401.EDF	E40	1
55	1802114	1802224	5525	5635	110	RIGHT	E401.EDF	E40	1
56	1804795	1804890	59	154	95	RIGHT	E401.EDF	E40	1
56	1805499	1805627	763	891	128	RIGHT	E401.EDF	E40	1
56	1806025	1806087	1289	1351	62	RIGHT	E401.EDF	E40	1
56	1806859	1806988	2123	2252	129	RIGHT	E401.EDF	E40	1
57	1815045	1815119	1067	1141	74	RIGHT	E401.EDF	E40	1
57	1815666	1815805	1688	1827	139	RIGHT	E401.EDF	E40	1
58	1822893	1822953	60	120	60	RIGHT	E401.EDF	E40	1
58	1825044	1825156	2211	2323	112	RIGHT	E401.EDF	E40	1
58	1825648	1825801	2815	2968	153	RIGHT	E401.EDF	E40	1
58	1827369	1827497	4536	4664	128	RIGHT	E401.EDF	E40	1
60	1840861	1840985	2438	2562	124	RIGHT	E401.EDF	E40	1
60	1842101	1842195	3678	3772	94	RIGHT	E401.EDF	E40	1
61	1846479	1846556	661	738	77	RIGHT	E401.EDF	E40	1
61	1847306	1847416	1488	1598	110	RIGHT	E401.EDF	E40	1
61	1848409	1848499	2591	2681	90	RIGHT	E401.EDF	E40	1
61	1849307	1849392	3489	3574	85	RIGHT	E401.EDF	E40	1
61	1852765	1852863	6947	7045	98	RIGHT	E401.EDF	E40	1
63	1865244	1865369	435	560	125	RIGHT	E401.EDF	E40	1
64	1877392	1877522	3524	3654	130	RIGHT	E401.EDF	E40	1
65	1884827	1884907	2424	2504	80	RIGHT	E401.EDF	E40	1
66	1892683	1892687	3379	3383	4	RIGHT	E401.EDF	E40	1
66	1892728	1892734	3424	3430	6	RIGHT	E401.EDF	E40	1
66	1895156	1895271	5852	5967	115	RIGHT	E401.EDF	E40	1
66	1895294	1895301	5990	5997	7	RIGHT	E401.EDF	E40	1
67	1903264	1903354	5273	5363	90	RIGHT	E401.EDF	E40	1
68	1907267	1907394	942	1069	127	RIGHT	E401.EDF	E40	1
68	1908424	1908543	2099	2218	119	RIGHT	E401.EDF	E40	1
69	1917058	1917147	1726	1815	89	RIGHT	E401.EDF	E40	1
69	1917674	1917843	2342	2511	169	RIGHT	E401.EDF	E40	1
70	1924941	1925022	1332	1413	81	RIGHT	E401.EDF	E40	1
70	1925571	1925703	1962	2094	132	RIGHT	E401.EDF	E40	1
70	1926974	1927057	3365	3448	83	RIGHT	E401.EDF	E40	1
70	1928437	1928543	4828	4934	106	RIGHT	E401.EDF	E40	1
71	1932114	1932157	1118	1161	43	RIGHT	E401.EDF	E40	1
71	1933109	1933215	2113	2219	106	RIGHT	E401.EDF	E40	1
71	1935252	1935326	4256	4330	74	RIGHT	E401.EDF	E40	1
71	1935915	1936045	4919	5049	130	RIGHT	E401.EDF	E40	1
72	1938937	1939194	691	948	257	RIGHT	E401.EDF	E40	1
73	1946476	1946608	774	906	132	RIGHT	E401.EDF	E40	1
73	1947864	1947948	2162	2246	84	RIGHT	E401.EDF	E40	1
73	1947969	1947988	2267	2286	19	RIGHT	E401.EDF	E40	1
74	1955114	1955436	705	1027	322	RIGHT	E401.EDF	E40	1
76	1971570	1971658	722	810	88	RIGHT	E401.EDF	E40	1
77	1985141	1985292	5595	5746	151	RIGHT	E401.EDF	E40	1
78	1989871	1989895	1524	1548	24	RIGHT	E401.EDF	E40	1
78	1990147	1990347	1800	2000	200	RIGHT	E401.EDF	E40	1
79	1997392	1997428	597	633	36	RIGHT	E401.EDF	E40	1
80	2005327	2005478	751	902	151	RIGHT	E401.EDF	E40	1
80	2007095	2007189	2519	2613	94	RIGHT	E401.EDF	E40	1
81	2015400	2015561	2094	2255	161	RIGHT	E401.EDF	E40	1
82	2023096	2023102	88	94	6	RIGHT	E401.EDF	E40	1
82	2023790	2023926	782	918	136	RIGHT	E401.EDF	E40	1
83	2034320	2034456	790	926	136	RIGHT	E401.EDF	E40	1
85	2050541	2050638	2270	2367	97	RIGHT	E401.EDF	E40	1
85	2053136	2053198	4865	4927	62	RIGHT	E401.EDF	E40	1
85	2053627	2053707	5356	5436	80	RIGHT	E401.EDF	E40	1
86	2059245	2059313	2194	2262	68	RIGHT	E401.EDF	E40	1
86	2061048	2061183	3997	4132	135	RIGHT	E401.EDF	E40	1
87	2065877	2065984	488	595	107	RIGHT	E401.EDF	E40	1
87	2069092	2069156	3703	3767	64	RIGHT	E401.EDF	E40	1
87	2070027	2070364	4638	4975	337	RIGHT	E401.EDF	E40	1
88	2073513	2073589	470	546	76	RIGHT	E401.EDF	E40	1
89	2080262	2080298	58	94	36	RIGHT	E401.EDF	E40	1
89	2080319	2080323	115	119	4	RIGHT	E401.EDF	E40	1
89	2080692	2080858	488	654	166	RIGHT	E401.EDF	E40	1
89	2082037	2082039	1833	1835	2	RIGHT	E401.EDF	E40	1
89	2082060	2082066	1856	1862	6	RIGHT	E401.EDF	E40	1
89	2082226	2082306	2022	2102	80	RIGHT	E401.EDF	E40	1
90	2087579	2087659	469	549	80	RIGHT	E401.EDF	E40	1
90	2087682	2087691	572	581	9	RIGHT	E401.EDF	E40	1
90	2089361	2089615	2251	2505	254	RIGHT	E401.EDF	E40	1
91	2096879	2096986	475	582	107	RIGHT	E401.EDF	E40	1
91	2098673	2098681	2269	2277	8	RIGHT	E401.EDF	E40	1
91	2099603	2099605	3199	3201	2	RIGHT	E401.EDF	E40	1
91	2099645	2099654	3241	3250	9	RIGHT	E401.EDF	E40	1
91	2100168	2100280	3764	3876	112	RIGHT	E401.EDF	E40	1
92	2104348	2104535	58	245	187	RIGHT	E401.EDF	E40	1
92	2106370	2106446	2080	2156	76	RIGHT	E401.EDF	E40	1
93	2114871	2115214	554	897	343	RIGHT	E401.EDF	E40	1
94	2124159	2124278	2212	2331	119	RIGHT	E401.EDF	E40	1
94	2125116	2125192	3169	3245	76	RIGHT	E401.EDF	E40	1
94	2125679	2125766	3732	3819	87	RIGHT	E401.EDF	E40	1
94	2125976	2126070	4029	4123	94	RIGHT	E401.EDF	E40	1
95	2130649	2130686	111	148	37	RIGHT	E401.EDF	E40	1
95	2131010	2131104	472	566	94	RIGHT	E401.EDF	E40	1
95	2132573	2132658	2035	2120	85	RIGHT	E401.EDF	E40	1
95	2132981	2133052	2443	2514	71	RIGHT	E401.EDF	E40	1
95	2134006	2134083	3468	3545	77	RIGHT	E401.EDF	E40	1
96	2145140	2145354	6362	6576	214	RIGHT	E401.EDF	E40	1
97	2148482	2148519	523	560	37	RIGHT	E401.EDF	E40	1
97	2148544	2148548	585	589	4	RIGHT	E401.EDF	E40	1
97	2150067	2150204	2108	2245	137	RIGHT	E401.EDF	E40	1
98	2157081	2157091	935	945	10	RIGHT	E401.EDF	E40	1
98	2158078	2158155	1932	2009	77	RIGHT	E401.EDF	E40	1
98	2160222	2160354	4076	4208	132	RIGHT	E401.EDF	E40	1
99	2163871	2163982	629	740	111	RIGHT	E401.EDF	E40	1
99	2165371	2165596	2129	2354	225	RIGHT	E401.EDF	E40	1
102	2190772	2190869	2894	2991	97	RIGHT	E401.EDF	E40	1
102	2194253	2194254	6375	6376	1	RIGHT	E401.EDF	E40	1
102	2194304	2194316	6426	6438	12	RIGHT	E401.EDF	E40	1
103	2197701	2197804	757	860	103	RIGHT	E401.EDF	E40	1
103	2198774	2198944	1830	2000	170	RIGHT	E401.EDF	E40	1
103	2199604	2199713	2660	2769	109	RIGHT	E401.EDF	E40	1
104	2206095	2206175	753	833	80	RIGHT	E401.EDF	E40	1
105	2213564	2213673	851	960	109	RIGHT	E401.EDF	E40	1
105	2215353	2215491	2640	2778	138	RIGHT	E401.EDF	E40	1
105	2216278	2216406	3565	3693	128	RIGHT	E401.EDF	E40	1
105	2217168	2217363	4455	4650	195	RIGHT	E401.EDF	E40	1
105	2218588	2218744	5875	6031	156	RIGHT	E401.EDF	E40	1
106	2222713	2222874	1422	1583	161	RIGHT	E401.EDF	E40	1
106	2223377	2223464	2086	2173	87	RIGHT	E401.EDF	E40	1
106	2224386	2224454	3095	3163	68	RIGHT	E401.EDF	E40	1
107	2229605	2229732	1207	1334	127	RIGHT	E401.EDF	E40	1
107	2234716	2234788	6318	6390	72	RIGHT	E401.EDF	E40	1
108	2237309	2237471	749	911	162	RIGHT	E401.EDF	E40	1
108	2242126	2242227	5566	5667	101	RIGHT	E401.EDF	E40	1
109	2246518	2246617	1496	1595	99	RIGHT	E401.EDF	E40	1
109	2247590	2247762	2568	2740	172	RIGHT	E401.EDF	E40	1
110	2256468	2256645	489	666	177	RIGHT	E401.EDF	E40	1
110	2257462	2257626	1483	1647	164	RIGHT	E401.EDF	E40	1
110	2262352	2262428	6373	6449	76	RIGHT	E401.EDF	E40	1
111	2265271	2265366	736	831	95	RIGHT	E401.EDF	E40	1
111	2266361	2266474	1826	1939	113	RIGHT	E401.EDF	E40	1
111	2266800	2266936	2265	2401	136	RIGHT	E401.EDF	E40	1
111	2267403	2267638	2868	3103	235	RIGHT	E401.EDF	E40	1
111	2268092	2268404	3557	3869	312	RIGHT	E401.EDF	E40	1
111	2269780	2269864	5245	5329	84	RIGHT	E401.EDF	E40	1
112	2272792	2272820	537	565	28	RIGHT	E401.EDF	E40	1
112	2274385	2274524	2130	2269	139	RIGHT	E401.EDF	E40	1
113	2280241	2280342	273	374	101	RIGHT	E401.EDF	E40	1
113	2282169	2282282	2201	2314	113	RIGHT	E401.EDF	E40	1
113	2283141	2283324	3173	3356	183	RIGHT	E401.EDF	E40	1
114	2288482	2288580	1063	1161	98	RIGHT	E401.EDF	E40	1
114	2293461	2293466	6042	6047	5	RIGHT	E401.EDF	E40	1
114	2293501	2293526	6082	6107	25	RIGHT	E401.EDF	E40	1
115	2303533	2303636	5447	5550	103	RIGHT	E401.EDF	E40	1
116	2307018	2307191	442	615	173	RIGHT	E401.EDF	E40	1
116	2308787	2308940	2211	2364	153	RIGHT	E401.EDF	E40	1
116	2312913	2313047	6337	6471	134	RIGHT	E401.EDF	E40	1
117	2316770	2316899	1743	1872	129	RIGHT	E401.EDF	E40	1
117	2319874	2319994	4847	4967	120	RIGHT	E401.EDF	E40	1
118	2324096	2324664	1866	2434	568	RIGHT	E401.EDF	E40	1
119	2330836	2330931	805	900	95	RIGHT	E401.EDF	E40	1
119	2332274	2332385	2243	2354	111	RIGHT	E401.EDF	E40	1
119	2335881	2336016	5850	5985	135	RIGHT	E401.EDF	E40	1
120	2344497	2344522	5112	5137	25	RIGHT	E401.EDF	E40	1
120	2344550	2344560	5165	5175	10	RIGHT	E401.EDF	E40	1
1	3052209	3052240	870	901	31	RIGHT	E402.EDF	E40	2
1	3052772	3052863	1433	1524	91	RIGHT	E402.EDF	E40	2
2	3060579	3060643	904	968	64	RIGHT	E402.EDF	E40	2
2	3061494	3061549	1819	1874	55	RIGHT	E402.EDF	E40	2
2	3061974	3062042	2299	2367	68	RIGHT	E402.EDF	E40	2
2	3062394	3062519	2719	2844	125	RIGHT	E402.EDF	E40	2
2	3063093	3063183	3418	3508	90	RIGHT	E402.EDF	E40	2
3	3068602	3068681	1078	1157	79	RIGHT	E402.EDF	E40	2
4	3077988	3077997	2808	2817	9	RIGHT	E402.EDF	E40	2
4	3078021	3078037	2841	2857	16	RIGHT	E402.EDF	E40	2
4	3078420	3078600	3240	3420	180	RIGHT	E402.EDF	E40	2
5	3084766	3084880	978	1092	114	RIGHT	E402.EDF	E40	2
6	3097342	3097394	5501	5553	52	RIGHT	E402.EDF	E40	2
7	3105671	3105784	6019	6132	113	RIGHT	E402.EDF	E40	2
8	3108622	3108862	514	754	240	RIGHT	E402.EDF	E40	2
8	3109804	3109890	1696	1782	86	RIGHT	E402.EDF	E40	2
9	3116860	3116915	714	769	55	RIGHT	E402.EDF	E40	2
9	3122470	3122482	6324	6336	12	RIGHT	E402.EDF	E40	2
10	3125673	3125811	710	848	138	RIGHT	E402.EDF	E40	2
10	3128760	3128840	3797	3877	80	RIGHT	E402.EDF	E40	2
10	3130245	3130285	5282	5322	40	RIGHT	E402.EDF	E40	2
11	3135577	3135656	849	928	79	RIGHT	E402.EDF	E40	2
11	3136856	3137004	2128	2276	148	RIGHT	E402.EDF	E40	2
12	3144010	3144097	1324	1411	87	RIGHT	E402.EDF	E40	2
12	3144592	3144711	1906	2025	119	RIGHT	E402.EDF	E40	2
12	3146216	3146239	3530	3553	23	RIGHT	E402.EDF	E40	2
12	3146892	3146958	4206	4272	66	RIGHT	E402.EDF	E40	2
12	3147578	3147677	4892	4991	99	RIGHT	E402.EDF	E40	2
13	3150980	3151143	803	966	163	RIGHT	E402.EDF	E40	2
13	3152396	3152473	2219	2296	77	RIGHT	E402.EDF	E40	2
13	3153246	3153346	3069	3169	100	RIGHT	E402.EDF	E40	2
13	3155581	3155644	5404	5467	63	RIGHT	E402.EDF	E40	2
14	3158409	3158464	469	524	55	RIGHT	E402.EDF	E40	2
14	3158874	3159016	934	1076	142	RIGHT	E402.EDF	E40	2
15	3165005	3165066	57	118	61	RIGHT	E402.EDF	E40	2
15	3165816	3165947	868	999	131	RIGHT	E402.EDF	E40	2
15	3167127	3167180	2179	2232	53	RIGHT	E402.EDF	E40	2
15	3167201	3167214	2253	2266	13	RIGHT	E402.EDF	E40	2
16	3172850	3173024	57	231	174	RIGHT	E402.EDF	E40	2
16	3173550	3173693	757	900	143	RIGHT	E402.EDF	E40	2
16	3174181	3174335	1388	1542	154	RIGHT	E402.EDF	E40	2
17	3182766	3182851	1549	1634	85	RIGHT	E402.EDF	E40	2
17	3182876	3182877	1659	1660	1	RIGHT	E402.EDF	E40	2
17	3183177	3183278	1960	2061	101	RIGHT	E402.EDF	E40	2
17	3183702	3183819	2485	2602	117	RIGHT	E402.EDF	E40	2
17	3184323	3184418	3106	3201	95	RIGHT	E402.EDF	E40	2
17	3185372	3185528	4155	4311	156	RIGHT	E402.EDF	E40	2
17	3186692	3186764	5475	5547	72	RIGHT	E402.EDF	E40	2
19	3196585	3196711	659	785	126	RIGHT	E402.EDF	E40	2
19	3197094	3197189	1168	1263	95	RIGHT	E402.EDF	E40	2
19	3198696	3198800	2770	2874	104	RIGHT	E402.EDF	E40	2
19	3201834	3201835	5908	5909	1	RIGHT	E402.EDF	E40	2
19	3201875	3201881	5949	5955	6	RIGHT	E402.EDF	E40	2
20	3206726	3206886	466	626	160	RIGHT	E402.EDF	E40	2
20	3207696	3207831	1436	1571	135	RIGHT	E402.EDF	E40	2
21	3213756	3213890	612	746	134	RIGHT	E402.EDF	E40	2
21	3218013	3218080	4869	4936	67	RIGHT	E402.EDF	E40	2
22	3221847	3221874	1031	1058	27	RIGHT	E402.EDF	E40	2
22	3221895	3221896	1079	1080	1	RIGHT	E402.EDF	E40	2
22	3224510	3224547	3694	3731	37	RIGHT	E402.EDF	E40	2
22	3224571	3224574	3755	3758	3	RIGHT	E402.EDF	E40	2
23	3231835	3231910	3644	3719	75	RIGHT	E402.EDF	E40	2
23	3234864	3234934	6673	6743	70	RIGHT	E402.EDF	E40	2
24	3237347	3237470	81	204	123	RIGHT	E402.EDF	E40	2
24	3237787	3237973	521	707	186	RIGHT	E402.EDF	E40	2
24	3238776	3238892	1510	1626	116	RIGHT	E402.EDF	E40	2
24	3239306	3239470	2040	2204	164	RIGHT	E402.EDF	E40	2
24	3239751	3239914	2485	2648	163	RIGHT	E402.EDF	E40	2
24	3240875	3240958	3609	3692	83	RIGHT	E402.EDF	E40	2
24	3242049	3242132	4783	4866	83	RIGHT	E402.EDF	E40	2
25	3244825	3244930	465	570	105	RIGHT	E402.EDF	E40	2
25	3249271	3249295	4911	4935	24	RIGHT	E402.EDF	E40	2
26	3257056	3257062	4591	4597	6	RIGHT	E402.EDF	E40	2
26	3257816	3257911	5351	5446	95	RIGHT	E402.EDF	E40	2
27	3260855	3260859	342	346	4	RIGHT	E402.EDF	E40	2
27	3260895	3260899	382	386	4	RIGHT	E402.EDF	E40	2
27	3261063	3261193	550	680	130	RIGHT	E402.EDF	E40	2
27	3261535	3261680	1022	1167	145	RIGHT	E402.EDF	E40	2
27	3262239	3262285	1726	1772	46	RIGHT	E402.EDF	E40	2
27	3262593	3262666	2080	2153	73	RIGHT	E402.EDF	E40	2
27	3262894	3263032	2381	2519	138	RIGHT	E402.EDF	E40	2
27	3263813	3263894	3300	3381	81	RIGHT	E402.EDF	E40	2
27	3264549	3264633	4036	4120	84	RIGHT	E402.EDF	E40	2
28	3268367	3268451	58	142	84	RIGHT	E402.EDF	E40	2
28	3268903	3269172	594	863	269	RIGHT	E402.EDF	E40	2
28	3270401	3270519	2092	2210	118	RIGHT	E402.EDF	E40	2
28	3272553	3272750	4244	4441	197	RIGHT	E402.EDF	E40	2
29	3276792	3276869	962	1039	77	RIGHT	E402.EDF	E40	2
29	3278307	3278434	2477	2604	127	RIGHT	E402.EDF	E40	2
29	3279618	3279723	3788	3893	105	RIGHT	E402.EDF	E40	2
30	3285863	3285935	508	580	72	RIGHT	E402.EDF	E40	2
31	3294602	3294755	1995	2148	153	RIGHT	E402.EDF	E40	2
32	3301311	3301313	347	349	2	RIGHT	E402.EDF	E40	2
32	3301369	3301384	405	420	15	RIGHT	E402.EDF	E40	2
32	3301748	3301876	784	912	128	RIGHT	E402.EDF	E40	2
32	3302946	3303024	1982	2060	78	RIGHT	E402.EDF	E40	2
32	3303696	3303828	2732	2864	132	RIGHT	E402.EDF	E40	2
32	3304785	3304886	3821	3922	101	RIGHT	E402.EDF	E40	2
32	3305916	3305952	4952	4988	36	RIGHT	E402.EDF	E40	2
33	3310860	3310984	3140	3264	124	RIGHT	E402.EDF	E40	2
33	3313673	3313715	5953	5995	42	RIGHT	E402.EDF	E40	2
34	3316773	3316835	524	586	62	RIGHT	E402.EDF	E40	2
34	3316860	3316873	611	624	13	RIGHT	E402.EDF	E40	2
34	3317119	3317237	870	988	118	RIGHT	E402.EDF	E40	2
34	3318431	3318529	2182	2280	98	RIGHT	E402.EDF	E40	2
34	3322210	3322300	5961	6051	90	RIGHT	E402.EDF	E40	2
35	3325915	3326055	745	885	140	RIGHT	E402.EDF	E40	2
35	3326558	3326700	1388	1530	142	RIGHT	E402.EDF	E40	2
35	3326722	3326732	1552	1562	10	RIGHT	E402.EDF	E40	2
35	3327385	3327587	2215	2417	202	RIGHT	E402.EDF	E40	2
35	3327997	3328127	2827	2957	130	RIGHT	E402.EDF	E40	2
35	3329979	3330090	4809	4920	111	RIGHT	E402.EDF	E40	2
36	3333292	3333428	703	839	136	RIGHT	E402.EDF	E40	2
36	3334007	3334145	1418	1556	138	RIGHT	E402.EDF	E40	2
36	3334795	3334893	2206	2304	98	RIGHT	E402.EDF	E40	2
36	3336701	3336892	4112	4303	191	RIGHT	E402.EDF	E40	2
36	3336938	3336989	4349	4400	51	RIGHT	E402.EDF	E40	2
37	3340310	3340443	746	879	133	RIGHT	E402.EDF	E40	2
37	3342242	3342354	2678	2790	112	RIGHT	E402.EDF	E40	2
37	3344129	3344345	4565	4781	216	RIGHT	E402.EDF	E40	2
38	3347142	3347379	724	961	237	RIGHT	E402.EDF	E40	2
38	3348392	3348578	1974	2160	186	RIGHT	E402.EDF	E40	2
39	3356104	3356163	1786	1845	59	RIGHT	E402.EDF	E40	2
39	3357610	3357785	3292	3467	175	RIGHT	E402.EDF	E40	2
39	3358463	3358600	4145	4282	137	RIGHT	E402.EDF	E40	2
40	3363041	3363130	333	422	89	RIGHT	E402.EDF	E40	2
40	3363646	3363800	938	1092	154	RIGHT	E402.EDF	E40	2
40	3364490	3364598	1782	1890	108	RIGHT	E402.EDF	E40	2
41	3372740	3372835	2445	2540	95	RIGHT	E402.EDF	E40	2
41	3377678	3377744	7383	7449	66	RIGHT	E402.EDF	E40	2
42	3383090	3383223	3283	3416	133	RIGHT	E402.EDF	E40	2
43	3387289	3387382	135	228	93	RIGHT	E402.EDF	E40	2
43	3388801	3388890	1647	1736	89	RIGHT	E402.EDF	E40	2
43	3389269	3389422	2115	2268	153	RIGHT	E402.EDF	E40	2
43	3389785	3389931	2631	2777	146	RIGHT	E402.EDF	E40	2
43	3390839	3390944	3685	3790	105	RIGHT	E402.EDF	E40	2
43	3392127	3392303	4973	5149	176	RIGHT	E402.EDF	E40	2
44	3396653	3396834	805	986	181	RIGHT	E402.EDF	E40	2
44	3397903	3398035	2055	2187	132	RIGHT	E402.EDF	E40	2
45	3403790	3403997	58	265	207	RIGHT	E402.EDF	E40	2
46	3412219	3412337	732	850	118	RIGHT	E402.EDF	E40	2
46	3413421	3413579	1934	2092	158	RIGHT	E402.EDF	E40	2
47	3419818	3419847	313	342	29	RIGHT	E402.EDF	E40	2
47	3420063	3420174	558	669	111	RIGHT	E402.EDF	E40	2
47	3420542	3420813	1037	1308	271	RIGHT	E402.EDF	E40	2
48	3427431	3427645	745	959	214	RIGHT	E402.EDF	E40	2
48	3427685	3427700	999	1014	15	RIGHT	E402.EDF	E40	2
48	3428551	3428691	1865	2005	140	RIGHT	E402.EDF	E40	2
48	3428945	3429086	2259	2400	141	RIGHT	E402.EDF	E40	2
48	3429943	3430020	3257	3334	77	RIGHT	E402.EDF	E40	2
48	3431722	3431810	5036	5124	88	RIGHT	E402.EDF	E40	2
49	3434600	3434766	718	884	166	RIGHT	E402.EDF	E40	2
49	3435413	3435558	1531	1676	145	RIGHT	E402.EDF	E40	2
49	3436177	3436314	2295	2432	137	RIGHT	E402.EDF	E40	2
49	3436630	3436778	2748	2896	148	RIGHT	E402.EDF	E40	2
49	3437220	3437376	3338	3494	156	RIGHT	E402.EDF	E40	2
49	3438273	3438371	4391	4489	98	RIGHT	E402.EDF	E40	2
50	3442898	3443034	657	793	136	RIGHT	E402.EDF	E40	2
50	3444244	3444378	2003	2137	134	RIGHT	E402.EDF	E40	2
50	3445769	3445855	3528	3614	86	RIGHT	E402.EDF	E40	2
51	3450787	3450910	680	803	123	RIGHT	E402.EDF	E40	2
51	3451242	3451505	1135	1398	263	RIGHT	E402.EDF	E40	2
51	3451814	3451929	1707	1822	115	RIGHT	E402.EDF	E40	2
51	3454870	3454932	4763	4825	62	RIGHT	E402.EDF	E40	2
51	3456292	3456354	6185	6247	62	RIGHT	E402.EDF	E40	2
52	3458972	3459066	124	218	94	RIGHT	E402.EDF	E40	2
52	3459698	3459763	850	915	65	RIGHT	E402.EDF	E40	2
52	3460795	3460881	1947	2033	86	RIGHT	E402.EDF	E40	2
53	3466951	3467066	278	393	115	RIGHT	E402.EDF	E40	2
53	3473212	3473255	6539	6582	43	RIGHT	E402.EDF	E40	2
54	3477375	3477485	1972	2082	110	RIGHT	E402.EDF	E40	2
54	3477926	3478000	2523	2597	74	RIGHT	E402.EDF	E40	2
54	3478511	3478611	3108	3208	100	RIGHT	E402.EDF	E40	2
54	3479235	3479343	3832	3940	108	RIGHT	E402.EDF	E40	2
54	3480382	3480506	4979	5103	124	RIGHT	E402.EDF	E40	2
56	3490871	3490922	1047	1098	51	RIGHT	E402.EDF	E40	2
56	3490947	3490956	1123	1132	9	RIGHT	E402.EDF	E40	2
56	3491597	3491730	1773	1906	133	RIGHT	E402.EDF	E40	2
56	3491956	3492080	2132	2256	124	RIGHT	E402.EDF	E40	2
56	3492430	3492610	2606	2786	180	RIGHT	E402.EDF	E40	2
56	3493131	3493286	3307	3462	155	RIGHT	E402.EDF	E40	2
56	3493539	3493668	3715	3844	129	RIGHT	E402.EDF	E40	2
56	3494000	3494120	4176	4296	120	RIGHT	E402.EDF	E40	2
56	3494980	3495080	5156	5256	100	RIGHT	E402.EDF	E40	2
57	3499848	3499936	893	981	88	RIGHT	E402.EDF	E40	2
57	3500835	3500965	1880	2010	130	RIGHT	E402.EDF	E40	2
57	3502466	3502563	3511	3608	97	RIGHT	E402.EDF	E40	2
57	3502798	3502962	3843	4007	164	RIGHT	E402.EDF	E40	2
58	3507941	3508088	57	204	147	RIGHT	E402.EDF	E40	2
58	3508860	3508960	976	1076	100	RIGHT	E402.EDF	E40	2
59	3519024	3519095	2579	2650	71	RIGHT	E402.EDF	E40	2
59	3519678	3519809	3233	3364	131	RIGHT	E402.EDF	E40	2
59	3521801	3521908	5356	5463	107	RIGHT	E402.EDF	E40	2
59	3522970	3523052	6525	6607	82	RIGHT	E402.EDF	E40	2
60	3527134	3527205	1281	1352	71	RIGHT	E402.EDF	E40	2
60	3529683	3529751	3830	3898	68	RIGHT	E402.EDF	E40	2
60	3531505	3531593	5652	5740	88	RIGHT	E402.EDF	E40	2
60	3531614	3531632	5761	5779	18	RIGHT	E402.EDF	E40	2
61	3537269	3537318	2291	2340	49	RIGHT	E402.EDF	E40	2
61	3538775	3538920	3797	3942	145	RIGHT	E402.EDF	E40	2
62	3544468	3544638	1704	1874	170	RIGHT	E402.EDF	E40	2
62	3547720	3547766	4956	5002	46	RIGHT	E402.EDF	E40	2
62	3548092	3548191	5328	5427	99	RIGHT	E402.EDF	E40	2
62	3548490	3548605	5726	5841	115	RIGHT	E402.EDF	E40	2
62	3548870	3548983	6106	6219	113	RIGHT	E402.EDF	E40	2
63	3553476	3553575	1827	1926	99	RIGHT	E402.EDF	E40	2
63	3555145	3555191	3496	3542	46	RIGHT	E402.EDF	E40	2
63	3555213	3555225	3564	3576	12	RIGHT	E402.EDF	E40	2
63	3556436	3556548	4787	4899	112	RIGHT	E402.EDF	E40	2
64	3559907	3560073	737	903	166	RIGHT	E402.EDF	E40	2
64	3564886	3564931	5716	5761	45	RIGHT	E402.EDF	E40	2
64	3564954	3564964	5784	5794	10	RIGHT	E402.EDF	E40	2
65	3568434	3568842	715	1123	408	RIGHT	E402.EDF	E40	2
65	3569893	3570011	2174	2292	118	RIGHT	E402.EDF	E40	2
66	3575793	3575883	58	148	90	RIGHT	E402.EDF	E40	2
66	3576457	3576592	722	857	135	RIGHT	E402.EDF	E40	2
66	3576998	3577132	1263	1397	134	RIGHT	E402.EDF	E40	2
66	3577526	3577659	1791	1924	133	RIGHT	E402.EDF	E40	2
66	3578121	3578238	2386	2503	117	RIGHT	E402.EDF	E40	2
66	3578933	3579017	3198	3282	84	RIGHT	E402.EDF	E40	2
66	3579282	3579439	3547	3704	157	RIGHT	E402.EDF	E40	2
66	3579599	3579698	3864	3963	99	RIGHT	E402.EDF	E40	2
66	3580407	3580489	4672	4754	82	RIGHT	E402.EDF	E40	2
66	3580998	3581102	5263	5367	104	RIGHT	E402.EDF	E40	2
66	3582225	3582382	6490	6647	157	RIGHT	E402.EDF	E40	2
67	3586536	3586628	716	808	92	RIGHT	E402.EDF	E40	2
67	3587789	3587870	1969	2050	81	RIGHT	E402.EDF	E40	2
67	3587891	3587901	2071	2081	10	RIGHT	E402.EDF	E40	2
68	3593442	3593557	844	959	115	RIGHT	E402.EDF	E40	2
68	3594276	3594430	1678	1832	154	RIGHT	E402.EDF	E40	2
69	3600916	3601018	455	557	102	RIGHT	E402.EDF	E40	2
69	3602842	3602957	2381	2496	115	RIGHT	E402.EDF	E40	2
69	3604092	3604135	3631	3674	43	RIGHT	E402.EDF	E40	2
69	3604156	3604165	3695	3704	9	RIGHT	E402.EDF	E40	2
70	3609043	3609154	58	169	111	RIGHT	E402.EDF	E40	2
70	3609675	3609841	690	856	166	RIGHT	E402.EDF	E40	2
70	3610407	3610504	1422	1519	97	RIGHT	E402.EDF	E40	2
70	3610896	3610999	1911	2014	103	RIGHT	E402.EDF	E40	2
70	3611474	3611592	2489	2607	118	RIGHT	E402.EDF	E40	2
70	3612671	3612801	3686	3816	130	RIGHT	E402.EDF	E40	2
70	3612978	3613067	3993	4082	89	RIGHT	E402.EDF	E40	2
70	3614431	3614459	5446	5474	28	RIGHT	E402.EDF	E40	2
71	3618868	3619134	708	974	266	RIGHT	E402.EDF	E40	2
71	3622341	3622400	4181	4240	59	RIGHT	E402.EDF	E40	2
72	3626367	3626472	58	163	105	RIGHT	E402.EDF	E40	2
72	3627199	3627306	890	997	107	RIGHT	E402.EDF	E40	2
72	3628205	3628296	1896	1987	91	RIGHT	E402.EDF	E40	2
72	3628609	3628732	2300	2423	123	RIGHT	E402.EDF	E40	2
72	3629322	3629423	3013	3114	101	RIGHT	E402.EDF	E40	2
72	3630311	3630401	4002	4092	90	RIGHT	E402.EDF	E40	2
72	3630425	3630436	4116	4127	11	RIGHT	E402.EDF	E40	2
72	3631828	3631978	5519	5669	150	RIGHT	E402.EDF	E40	2
72	3632005	3632030	5696	5721	25	RIGHT	E402.EDF	E40	2
73	3636067	3636212	926	1071	145	RIGHT	E402.EDF	E40	2
73	3637031	3637135	1890	1994	104	RIGHT	E402.EDF	E40	2
73	3637160	3637182	2019	2041	22	RIGHT	E402.EDF	E40	2
74	3643597	3643668	1798	1869	71	RIGHT	E402.EDF	E40	2
74	3644700	3644801	2901	3002	101	RIGHT	E402.EDF	E40	2
74	3645892	3645996	4093	4197	104	RIGHT	E402.EDF	E40	2
74	3647735	3647821	5936	6022	86	RIGHT	E402.EDF	E40	2
75	3651730	3651792	1886	1948	62	RIGHT	E402.EDF	E40	2
75	3651814	3651816	1970	1972	2	RIGHT	E402.EDF	E40	2
75	3654321	3654325	4477	4481	4	RIGHT	E402.EDF	E40	2
75	3654348	3654354	4504	4510	6	RIGHT	E402.EDF	E40	2
76	3658336	3658384	58	106	48	RIGHT	E402.EDF	E40	2
76	3659444	3659584	1166	1306	140	RIGHT	E402.EDF	E40	2
76	3659608	3659618	1330	1340	10	RIGHT	E402.EDF	E40	2
76	3660543	3660645	2265	2367	102	RIGHT	E402.EDF	E40	2
76	3661609	3661744	3331	3466	135	RIGHT	E402.EDF	E40	2
76	3661767	3661778	3489	3500	11	RIGHT	E402.EDF	E40	2
77	3667062	3667211	758	907	149	RIGHT	E402.EDF	E40	2
77	3668250	3668403	1946	2099	153	RIGHT	E402.EDF	E40	2
78	3674604	3674642	58	96	38	RIGHT	E402.EDF	E40	2
78	3675355	3675468	809	922	113	RIGHT	E402.EDF	E40	2
79	3684689	3685121	658	1090	432	RIGHT	E402.EDF	E40	2
79	3689171	3689274	5140	5243	103	RIGHT	E402.EDF	E40	2
80	3693685	3693784	490	589	99	RIGHT	E402.EDF	E40	2
81	3700740	3700930	665	855	190	RIGHT	E402.EDF	E40	2
81	3701870	3701933	1795	1858	63	RIGHT	E402.EDF	E40	2
82	3708711	3708776	57	122	65	RIGHT	E402.EDF	E40	2
82	3709384	3709493	730	839	109	RIGHT	E402.EDF	E40	2
82	3710139	3710252	1485	1598	113	RIGHT	E402.EDF	E40	2
82	3710778	3710879	2124	2225	101	RIGHT	E402.EDF	E40	2
82	3711070	3711183	2416	2529	113	RIGHT	E402.EDF	E40	2
82	3711871	3711986	3217	3332	115	RIGHT	E402.EDF	E40	2
82	3713322	3713485	4668	4831	163	RIGHT	E402.EDF	E40	2
82	3714596	3714767	5942	6113	171	RIGHT	E402.EDF	E40	2
83	3718766	3718888	1910	2032	122	RIGHT	E402.EDF	E40	2
84	3725931	3726017	2205	2291	86	RIGHT	E402.EDF	E40	2
84	3730440	3730457	6714	6731	17	RIGHT	E402.EDF	E40	2
84	3730482	3730485	6756	6759	3	RIGHT	E402.EDF	E40	2
85	3734126	3734300	464	638	174	RIGHT	E402.EDF	E40	2
85	3734642	3734937	980	1275	295	RIGHT	E402.EDF	E40	2
85	3735118	3735362	1456	1700	244	RIGHT	E402.EDF	E40	2
85	3735828	3735975	2166	2313	147	RIGHT	E402.EDF	E40	2
85	3738952	3739141	5290	5479	189	RIGHT	E402.EDF	E40	2
85	3739493	3739659	5831	5997	166	RIGHT	E402.EDF	E40	2
85	3739928	3740161	6266	6499	233	RIGHT	E402.EDF	E40	2
86	3742420	3742443	57	80	23	RIGHT	E402.EDF	E40	2
86	3742995	3743151	632	788	156	RIGHT	E402.EDF	E40	2
86	3744583	3744718	2220	2355	135	RIGHT	E402.EDF	E40	2
86	3747899	3748121	5536	5758	222	RIGHT	E402.EDF	E40	2
87	3753720	3753790	2397	2467	70	RIGHT	E402.EDF	E40	2
88	3760663	3760736	1115	1188	73	RIGHT	E402.EDF	E40	2
88	3761568	3761608	2020	2060	40	RIGHT	E402.EDF	E40	2
88	3761630	3761641	2082	2093	11	RIGHT	E402.EDF	E40	2
89	3768016	3768160	712	856	144	RIGHT	E402.EDF	E40	2
89	3769262	3769522	1958	2218	260	RIGHT	E402.EDF	E40	2
89	3770424	3770541	3120	3237	117	RIGHT	E402.EDF	E40	2
89	3771199	3771429	3895	4125	230	RIGHT	E402.EDF	E40	2
90	3774504	3774633	58	187	129	RIGHT	E402.EDF	E40	2
90	3775311	3775453	865	1007	142	RIGHT	E402.EDF	E40	2
90	3776816	3776943	2370	2497	127	RIGHT	E402.EDF	E40	2
90	3778200	3778291	3754	3845	91	RIGHT	E402.EDF	E40	2
91	3785008	3785029	1786	1807	21	RIGHT	E402.EDF	E40	2
91	3785055	3785058	1833	1836	3	RIGHT	E402.EDF	E40	2
91	3785578	3785676	2356	2454	98	RIGHT	E402.EDF	E40	2
91	3785915	3786036	2693	2814	121	RIGHT	E402.EDF	E40	2
91	3786721	3786822	3499	3600	101	RIGHT	E402.EDF	E40	2
91	3787477	3787542	4255	4320	65	RIGHT	E402.EDF	E40	2
91	3787849	3787922	4627	4700	73	RIGHT	E402.EDF	E40	2
92	3794012	3794047	3902	3937	35	RIGHT	E402.EDF	E40	2
92	3794072	3794081	3962	3971	9	RIGHT	E402.EDF	E40	2
93	3798523	3798657	501	635	134	RIGHT	E402.EDF	E40	2
95	3817227	3817343	627	743	116	RIGHT	E402.EDF	E40	2
95	3818908	3819010	2308	2410	102	RIGHT	E402.EDF	E40	2
95	3821163	3821195	4563	4595	32	RIGHT	E402.EDF	E40	2
95	3821219	3821223	4619	4623	4	RIGHT	E402.EDF	E40	2
96	3825476	3825588	957	1069	112	RIGHT	E402.EDF	E40	2
96	3825611	3825616	1092	1097	5	RIGHT	E402.EDF	E40	2
96	3826931	3827048	2412	2529	117	RIGHT	E402.EDF	E40	2
97	3834354	3834470	751	867	116	RIGHT	E402.EDF	E40	2
97	3834492	3834501	889	898	9	RIGHT	E402.EDF	E40	2
97	3835292	3835404	1689	1801	112	RIGHT	E402.EDF	E40	2
97	3836437	3836563	2834	2960	126	RIGHT	E402.EDF	E40	2
97	3838133	3838254	4530	4651	121	RIGHT	E402.EDF	E40	2
97	3838305	3838320	4702	4717	15	RIGHT	E402.EDF	E40	2
98	3841304	3841352	57	105	48	RIGHT	E402.EDF	E40	2
98	3843305	3843489	2058	2242	184	RIGHT	E402.EDF	E40	2
99	3849165	3849284	449	568	119	RIGHT	E402.EDF	E40	2
99	3849782	3849921	1066	1205	139	RIGHT	E402.EDF	E40	2
99	3850780	3850892	2064	2176	112	RIGHT	E402.EDF	E40	2
100	3856220	3856307	57	144	87	RIGHT	E402.EDF	E40	2
100	3856647	3856756	484	593	109	RIGHT	E402.EDF	E40	2
100	3857322	3857435	1159	1272	113	RIGHT	E402.EDF	E40	2
100	3858206	3858340	2043	2177	134	RIGHT	E402.EDF	E40	2
100	3862315	3862317	6152	6154	2	RIGHT	E402.EDF	E40	2
100	3862385	3862388	6222	6225	3	RIGHT	E402.EDF	E40	2
100	3863337	3863443	7174	7280	106	RIGHT	E402.EDF	E40	2
101	3865431	3865553	58	180	122	RIGHT	E402.EDF	E40	2
101	3866713	3866792	1340	1419	79	RIGHT	E402.EDF	E40	2
101	3867917	3867994	2544	2621	77	RIGHT	E402.EDF	E40	2
101	3869991	3870090	4618	4717	99	RIGHT	E402.EDF	E40	2
102	3873336	3873382	58	104	46	RIGHT	E402.EDF	E40	2
102	3873764	3873909	486	631	145	RIGHT	E402.EDF	E40	2
102	3874367	3874533	1089	1255	166	RIGHT	E402.EDF	E40	2
102	3875306	3875464	2028	2186	158	RIGHT	E402.EDF	E40	2
102	3879916	3879956	6638	6678	40	RIGHT	E402.EDF	E40	2
102	3879980	3879987	6702	6709	7	RIGHT	E402.EDF	E40	2
103	3883590	3883743	796	949	153	RIGHT	E402.EDF	E40	2
103	3883766	3883778	972	984	12	RIGHT	E402.EDF	E40	2
103	3884795	3884902	2001	2108	107	RIGHT	E402.EDF	E40	2
104	3890580	3890653	58	131	73	RIGHT	E402.EDF	E40	2
104	3891233	3891353	711	831	120	RIGHT	E402.EDF	E40	2
104	3891692	3891840	1170	1318	148	RIGHT	E402.EDF	E40	2
104	3891861	3891865	1339	1343	4	RIGHT	E402.EDF	E40	2
104	3892629	3892778	2107	2256	149	RIGHT	E402.EDF	E40	2
104	3893708	3893827	3186	3305	119	RIGHT	E402.EDF	E40	2
104	3893853	3893870	3331	3348	17	RIGHT	E402.EDF	E40	2
104	3894472	3894592	3950	4070	120	RIGHT	E402.EDF	E40	2
105	3897994	3898069	698	773	75	RIGHT	E402.EDF	E40	2
105	3898361	3898809	1065	1513	448	RIGHT	E402.EDF	E40	2
105	3899395	3899500	2099	2204	105	RIGHT	E402.EDF	E40	2
105	3902676	3902792	5380	5496	116	RIGHT	E402.EDF	E40	2
106	3905856	3905992	478	614	136	RIGHT	E402.EDF	E40	2
106	3907179	3907310	1801	1932	131	RIGHT	E402.EDF	E40	2
107	3914752	3914821	478	547	69	RIGHT	E402.EDF	E40	2
107	3914843	3914846	569	572	3	RIGHT	E402.EDF	E40	2
107	3915157	3915267	883	993	110	RIGHT	E402.EDF	E40	2
107	3915303	3915308	1029	1034	5	RIGHT	E402.EDF	E40	2
108	3921489	3921586	742	839	97	RIGHT	E402.EDF	E40	2
108	3922743	3922770	1996	2023	27	RIGHT	E402.EDF	E40	2
108	3922794	3922810	2047	2063	16	RIGHT	E402.EDF	E40	2
109	3928520	3928623	494	597	103	RIGHT	E402.EDF	E40	2
109	3928788	3928956	762	930	168	RIGHT	E402.EDF	E40	2
110	3936108	3936239	561	692	131	RIGHT	E402.EDF	E40	2
110	3936417	3936573	870	1026	156	RIGHT	E402.EDF	E40	2
110	3936601	3936610	1054	1063	9	RIGHT	E402.EDF	E40	2
110	3937224	3937603	1677	2056	379	RIGHT	E402.EDF	E40	2
110	3937869	3938040	2322	2493	171	RIGHT	E402.EDF	E40	2
110	3939012	3939114	3465	3567	102	RIGHT	E402.EDF	E40	2
111	3945198	3945304	1856	1962	106	RIGHT	E402.EDF	E40	2
112	3951421	3951677	841	1097	256	RIGHT	E402.EDF	E40	2
112	3952337	3952507	1757	1927	170	RIGHT	E402.EDF	E40	2
112	3953103	3953223	2523	2643	120	RIGHT	E402.EDF	E40	2
112	3956722	3956838	6142	6258	116	RIGHT	E402.EDF	E40	2
112	3956888	3956902	6308	6322	14	RIGHT	E402.EDF	E40	2
113	3960510	3960644	1846	1980	134	RIGHT	E402.EDF	E40	2
113	3962561	3962603	3897	3939	42	RIGHT	E402.EDF	E40	2
113	3962635	3962638	3971	3974	3	RIGHT	E402.EDF	E40	2
113	3965261	3965262	6597	6598	1	RIGHT	E402.EDF	E40	2
113	3965296	3965303	6632	6639	7	RIGHT	E402.EDF	E40	2
114	3968465	3968608	519	662	143	RIGHT	E402.EDF	E40	2
114	3969198	3969298	1252	1352	100	RIGHT	E402.EDF	E40	2
114	3969322	3969328	1376	1382	6	RIGHT	E402.EDF	E40	2
115	3975799	3975860	57	118	61	RIGHT	E402.EDF	E40	2
115	3976476	3976571	734	829	95	RIGHT	E402.EDF	E40	2
115	3977541	3977685	1799	1943	144	RIGHT	E402.EDF	E40	2
115	3980014	3980047	4272	4305	33	RIGHT	E402.EDF	E40	2
115	3980078	3980088	4336	4346	10	RIGHT	E402.EDF	E40	2
116	3984362	3984557	804	999	195	RIGHT	E402.EDF	E40	2
116	3986194	3986341	2636	2783	147	RIGHT	E402.EDF	E40	2
116	3988908	3988986	5350	5428	78	RIGHT	E402.EDF	E40	2
117	3991795	3992083	471	759	288	RIGHT	E402.EDF	E40	2
118	3999863	3999985	486	608	122	RIGHT	E402.EDF	E40	2
118	4000781	4000908	1404	1531	127	RIGHT	E402.EDF	E40	2
118	4002147	4002318	2770	2941	171	RIGHT	E402.EDF	E40	2
118	4002784	4002938	3407	3561	154	RIGHT	E402.EDF	E40	2
118	4004108	4004167	4731	4790	59	RIGHT	E402.EDF	E40	2
118	4004737	4004825	5360	5448	88	RIGHT	E402.EDF	E40	2
119	4009122	4009198	2029	2105	76	RIGHT	E402.EDF	E40	2
119	4009227	4009240	2134	2147	13	RIGHT	E402.EDF	E40	2
120	4015266	4015372	679	785	106	RIGHT	E402.EDF	E40	2
120	4016489	4017303	1902	2716	814	RIGHT	E402.EDF	E40	2
120	4019352	4019392	4765	4805	40	RIGHT	E402.EDF	E40	2
120	4019413	4019423	4826	4836	10	RIGHT	E402.EDF	E40	2
120	4020991	4021055	6404	6468	64	RIGHT	E402.EDF	E40	2
1	4515065	4515080	347	362	15	RIGHT	E403.EDF	E40	3
1	4515752	4515836	1034	1118	84	RIGHT	E403.EDF	E40	3
1	4516310	4516379	1592	1661	69	RIGHT	E403.EDF	E40	3
1	4521085	4521139	6367	6421	54	RIGHT	E403.EDF	E40	3
1	4521160	4521163	6442	6445	3	RIGHT	E403.EDF	E40	3
2	4524244	4524295	560	611	51	RIGHT	E403.EDF	E40	3
2	4525499	4525597	1815	1913	98	RIGHT	E403.EDF	E40	3
3	4535472	4535563	2931	3022	91	RIGHT	E403.EDF	E40	3
3	4536156	4536238	3615	3697	82	RIGHT	E403.EDF	E40	3
4	4540159	4540268	464	573	109	RIGHT	E403.EDF	E40	3
5	4549964	4550091	515	642	127	RIGHT	E403.EDF	E40	3
5	4551496	4551581	2047	2132	85	RIGHT	E403.EDF	E40	3
5	4552518	4552585	3069	3136	67	RIGHT	E403.EDF	E40	3
6	4557910	4557946	284	320	36	RIGHT	E403.EDF	E40	3
6	4557967	4557968	341	342	1	RIGHT	E403.EDF	E40	3
6	4558197	4558272	571	646	75	RIGHT	E403.EDF	E40	3
6	4561740	4561836	4114	4210	96	RIGHT	E403.EDF	E40	3
7	4565000	4565130	737	867	130	RIGHT	E403.EDF	E40	3
7	4566625	4566729	2362	2466	104	RIGHT	E403.EDF	E40	3
7	4566760	4566774	2497	2511	14	RIGHT	E403.EDF	E40	3
7	4567536	4567634	3273	3371	98	RIGHT	E403.EDF	E40	3
7	4568710	4568790	4447	4527	80	RIGHT	E403.EDF	E40	3
8	4572654	4572881	754	981	227	RIGHT	E403.EDF	E40	3
9	4578713	4578783	57	127	70	RIGHT	E403.EDF	E40	3
9	4580729	4580793	2073	2137	64	RIGHT	E403.EDF	E40	3
9	4580819	4580823	2163	2167	4	RIGHT	E403.EDF	E40	3
10	4589621	4589776	638	793	155	RIGHT	E403.EDF	E40	3
10	4589930	4590051	947	1068	121	RIGHT	E403.EDF	E40	3
10	4590513	4590617	1530	1634	104	RIGHT	E403.EDF	E40	3
10	4590875	4591013	1892	2030	138	RIGHT	E403.EDF	E40	3
10	4591757	4591828	2774	2845	71	RIGHT	E403.EDF	E40	3
10	4592356	4592436	3373	3453	80	RIGHT	E403.EDF	E40	3
10	4593380	4593454	4397	4471	74	RIGHT	E403.EDF	E40	3
11	4596929	4597058	545	674	129	RIGHT	E403.EDF	E40	3
12	4604228	4604334	872	978	106	RIGHT	E403.EDF	E40	3
12	4605086	4605212	1730	1856	126	RIGHT	E403.EDF	E40	3
13	4612262	4612730	57	525	468	RIGHT	E403.EDF	E40	3
13	4614458	4614460	2253	2255	2	RIGHT	E403.EDF	E40	3
13	4614513	4614528	2308	2323	15	RIGHT	E403.EDF	E40	3
14	4620906	4621170	427	691	264	RIGHT	E403.EDF	E40	3
15	4631463	4631468	2069	2074	5	RIGHT	E403.EDF	E40	3
15	4631497	4631516	2103	2122	19	RIGHT	E403.EDF	E40	3
15	4631578	4631605	2184	2211	27	RIGHT	E403.EDF	E40	3
15	4634513	4634525	5119	5131	12	RIGHT	E403.EDF	E40	3
15	4634553	4634585	5159	5191	32	RIGHT	E403.EDF	E40	3
15	4635053	4635121	5659	5727	68	RIGHT	E403.EDF	E40	3
15	4635154	4635155	5760	5761	1	RIGHT	E403.EDF	E40	3
16	4638347	4638455	1005	1113	108	RIGHT	E403.EDF	E40	3
16	4641515	4641554	4173	4212	39	RIGHT	E403.EDF	E40	3
16	4642351	4642437	5009	5095	86	RIGHT	E403.EDF	E40	3
17	4646032	4646139	58	165	107	RIGHT	E403.EDF	E40	3
17	4652359	4652419	6385	6445	60	RIGHT	E403.EDF	E40	3
18	4655775	4655898	686	809	123	RIGHT	E403.EDF	E40	3
18	4655922	4655926	833	837	4	RIGHT	E403.EDF	E40	3
18	4656337	4656521	1248	1432	184	RIGHT	E403.EDF	E40	3
18	4658250	4658382	3161	3293	132	RIGHT	E403.EDF	E40	3
18	4658407	4658412	3318	3323	5	RIGHT	E403.EDF	E40	3
19	4663315	4663389	480	554	74	RIGHT	E403.EDF	E40	3
19	4664594	4664681	1759	1846	87	RIGHT	E403.EDF	E40	3
20	4670358	4670761	583	986	403	RIGHT	E403.EDF	E40	3
20	4671862	4671944	2087	2169	82	RIGHT	E403.EDF	E40	3
20	4671971	4671982	2196	2207	11	RIGHT	E403.EDF	E40	3
21	4681314	4681396	1803	1885	82	RIGHT	E403.EDF	E40	3
21	4681418	4681425	1907	1914	7	RIGHT	E403.EDF	E40	3
22	4686558	4686624	57	123	66	RIGHT	E403.EDF	E40	3
22	4688649	4688873	2148	2372	224	RIGHT	E403.EDF	E40	3
22	4689611	4689810	3110	3309	199	RIGHT	E403.EDF	E40	3
22	4689831	4689846	3330	3345	15	RIGHT	E403.EDF	E40	3
22	4690415	4690565	3914	4064	150	RIGHT	E403.EDF	E40	3
22	4692139	4692205	5638	5704	66	RIGHT	E403.EDF	E40	3
23	4694452	4694548	57	153	96	RIGHT	E403.EDF	E40	3
23	4695183	4695343	788	948	160	RIGHT	E403.EDF	E40	3
23	4696081	4696192	1686	1797	111	RIGHT	E403.EDF	E40	3
24	4702927	4703060	736	869	133	RIGHT	E403.EDF	E40	3
24	4703307	4703433	1116	1242	126	RIGHT	E403.EDF	E40	3
24	4703454	4703460	1263	1269	6	RIGHT	E403.EDF	E40	3
24	4703848	4703985	1657	1794	137	RIGHT	E403.EDF	E40	3
24	4704800	4704908	2609	2717	108	RIGHT	E403.EDF	E40	3
24	4704933	4704951	2742	2760	18	RIGHT	E403.EDF	E40	3
25	4709199	4709376	377	554	177	RIGHT	E403.EDF	E40	3
25	4710305	4710448	1483	1626	143	RIGHT	E403.EDF	E40	3
25	4710866	4710959	2044	2137	93	RIGHT	E403.EDF	E40	3
25	4711295	4711409	2473	2587	114	RIGHT	E403.EDF	E40	3
25	4711880	4711987	3058	3165	107	RIGHT	E403.EDF	E40	3
25	4712218	4712351	3396	3529	133	RIGHT	E403.EDF	E40	3
25	4713147	4713226	4325	4404	79	RIGHT	E403.EDF	E40	3
26	4716848	4716932	1397	1481	84	RIGHT	E403.EDF	E40	3
26	4717382	4717499	1931	2048	117	RIGHT	E403.EDF	E40	3
26	4718694	4718785	3243	3334	91	RIGHT	E403.EDF	E40	3
26	4718812	4718818	3361	3367	6	RIGHT	E403.EDF	E40	3
26	4719622	4719743	4171	4292	121	RIGHT	E403.EDF	E40	3
26	4719766	4719773	4315	4322	7	RIGHT	E403.EDF	E40	3
27	4722034	4722068	58	92	34	RIGHT	E403.EDF	E40	3
27	4722818	4722916	842	940	98	RIGHT	E403.EDF	E40	3
27	4723317	4723411	1341	1435	94	RIGHT	E403.EDF	E40	3
28	4729897	4730013	681	797	116	RIGHT	E403.EDF	E40	3
28	4730657	4730720	1441	1504	63	RIGHT	E403.EDF	E40	3
29	4737562	4738091	373	902	529	RIGHT	E403.EDF	E40	3
29	4738941	4739023	1752	1834	82	RIGHT	E403.EDF	E40	3
29	4742493	4742537	5304	5348	44	RIGHT	E403.EDF	E40	3
29	4742565	4742567	5376	5378	2	RIGHT	E403.EDF	E40	3
30	4745111	4745225	507	621	114	RIGHT	E403.EDF	E40	3
30	4745250	4745251	646	647	1	RIGHT	E403.EDF	E40	3
30	4746719	4746899	2115	2295	180	RIGHT	E403.EDF	E40	3
30	4747743	4747866	3139	3262	123	RIGHT	E403.EDF	E40	3
30	4748119	4748330	3515	3726	211	RIGHT	E403.EDF	E40	3
30	4748932	4749046	4328	4442	114	RIGHT	E403.EDF	E40	3
30	4750031	4750110	5427	5506	79	RIGHT	E403.EDF	E40	3
30	4750658	4750747	6054	6143	89	RIGHT	E403.EDF	E40	3
31	4753528	4753631	109	212	103	RIGHT	E403.EDF	E40	3
31	4753656	4753665	237	246	9	RIGHT	E403.EDF	E40	3
31	4754756	4754901	1337	1482	145	RIGHT	E403.EDF	E40	3
31	4754931	4754937	1512	1518	6	RIGHT	E403.EDF	E40	3
31	4755531	4755625	2112	2206	94	RIGHT	E403.EDF	E40	3
31	4756529	4756628	3110	3209	99	RIGHT	E403.EDF	E40	3
32	4767761	4767823	5757	5819	62	RIGHT	E403.EDF	E40	3
32	4767847	4767861	5843	5857	14	RIGHT	E403.EDF	E40	3
33	4771369	4771529	525	685	160	RIGHT	E403.EDF	E40	3
33	4771553	4771556	709	712	3	RIGHT	E403.EDF	E40	3
33	4772539	4772688	1695	1844	149	RIGHT	E403.EDF	E40	3
33	4774761	4774800	3917	3956	39	RIGHT	E403.EDF	E40	3
33	4774836	4774844	3992	4000	8	RIGHT	E403.EDF	E40	3
34	4778413	4778525	669	781	112	RIGHT	E403.EDF	E40	3
34	4778568	4778573	824	829	5	RIGHT	E403.EDF	E40	3
34	4778807	4778939	1063	1195	132	RIGHT	E403.EDF	E40	3
34	4778962	4778966	1218	1222	4	RIGHT	E403.EDF	E40	3
34	4780112	4780160	2368	2416	48	RIGHT	E403.EDF	E40	3
34	4784016	4784123	6272	6379	107	RIGHT	E403.EDF	E40	3
34	4784186	4784196	6442	6452	10	RIGHT	E403.EDF	E40	3
35	4786022	4786145	57	180	123	RIGHT	E403.EDF	E40	3
36	4794694	4794796	285	387	102	RIGHT	E403.EDF	E40	3
36	4795221	4795324	812	915	103	RIGHT	E403.EDF	E40	3
36	4796293	4796377	1884	1968	84	RIGHT	E403.EDF	E40	3
36	4796399	4796409	1990	2000	10	RIGHT	E403.EDF	E40	3
36	4796796	4796941	2387	2532	145	RIGHT	E403.EDF	E40	3
36	4797353	4797521	2944	3112	168	RIGHT	E403.EDF	E40	3
36	4797550	4797565	3141	3156	15	RIGHT	E403.EDF	E40	3
36	4798330	4798476	3921	4067	146	RIGHT	E403.EDF	E40	3
36	4798501	4798515	4092	4106	14	RIGHT	E403.EDF	E40	3
36	4800858	4800965	6449	6556	107	RIGHT	E403.EDF	E40	3
36	4800993	4801008	6584	6599	15	RIGHT	E403.EDF	E40	3
37	4804286	4804628	497	839	342	RIGHT	E403.EDF	E40	3
37	4806094	4806186	2305	2397	92	RIGHT	E403.EDF	E40	3
38	4811607	4811703	236	332	96	RIGHT	E403.EDF	E40	3
38	4813084	4813231	1713	1860	147	RIGHT	E403.EDF	E40	3
38	4814276	4814333	2905	2962	57	RIGHT	E403.EDF	E40	3
38	4814948	4815040	3577	3669	92	RIGHT	E403.EDF	E40	3
38	4815628	4815690	4257	4319	62	RIGHT	E403.EDF	E40	3
39	4818490	4818561	58	129	71	RIGHT	E403.EDF	E40	3
39	4818896	4819169	464	737	273	RIGHT	E403.EDF	E40	3
39	4819192	4819195	760	763	3	RIGHT	E403.EDF	E40	3
39	4820040	4820072	1608	1640	32	RIGHT	E403.EDF	E40	3
39	4820493	4820598	2061	2166	105	RIGHT	E403.EDF	E40	3
40	4827790	4828190	461	861	400	RIGHT	E403.EDF	E40	3
40	4828615	4828726	1286	1397	111	RIGHT	E403.EDF	E40	3
40	4828748	4828750	1419	1421	2	RIGHT	E403.EDF	E40	3
41	4835590	4835786	480	676	196	RIGHT	E403.EDF	E40	3
41	4836247	4836349	1137	1239	102	RIGHT	E403.EDF	E40	3
41	4836750	4836782	1640	1672	32	RIGHT	E403.EDF	E40	3
41	4836804	4836811	1694	1701	7	RIGHT	E403.EDF	E40	3
41	4836946	4837091	1836	1981	145	RIGHT	E403.EDF	E40	3
41	4837528	4837615	2418	2505	87	RIGHT	E403.EDF	E40	3
41	4838080	4838177	2970	3067	97	RIGHT	E403.EDF	E40	3
42	4842733	4842850	456	573	117	RIGHT	E403.EDF	E40	3
42	4843159	4843566	882	1289	407	RIGHT	E403.EDF	E40	3
43	4852201	4852295	1891	1985	94	RIGHT	E403.EDF	E40	3
43	4852831	4852924	2521	2614	93	RIGHT	E403.EDF	E40	3
44	4857513	4857636	96	219	123	RIGHT	E403.EDF	E40	3
44	4859306	4859469	1889	2052	163	RIGHT	E403.EDF	E40	3
45	4871799	4871807	6337	6345	8	RIGHT	E403.EDF	E40	3
45	4871832	4871867	6370	6405	35	RIGHT	E403.EDF	E40	3
45	4871952	4871997	6490	6535	45	RIGHT	E403.EDF	E40	3
46	4875746	4875783	57	94	37	RIGHT	E403.EDF	E40	3
46	4877295	4877372	1606	1683	77	RIGHT	E403.EDF	E40	3
46	4877394	4877408	1705	1719	14	RIGHT	E403.EDF	E40	3
47	4885277	4885427	644	794	150	RIGHT	E403.EDF	E40	3
47	4885449	4885466	816	833	17	RIGHT	E403.EDF	E40	3
48	4893094	4893216	454	576	122	RIGHT	E403.EDF	E40	3
48	4893240	4893250	600	610	10	RIGHT	E403.EDF	E40	3
48	4894619	4894777	1979	2137	158	RIGHT	E403.EDF	E40	3
49	4901399	4901858	506	965	459	RIGHT	E403.EDF	E40	3
49	4902552	4902687	1659	1794	135	RIGHT	E403.EDF	E40	3
49	4902712	4902717	1819	1824	5	RIGHT	E403.EDF	E40	3
49	4902988	4903111	2095	2218	123	RIGHT	E403.EDF	E40	3
49	4903578	4903756	2685	2863	178	RIGHT	E403.EDF	E40	3
49	4904273	4904440	3380	3547	167	RIGHT	E403.EDF	E40	3
49	4905966	4906064	5073	5171	98	RIGHT	E403.EDF	E40	3
49	4906102	4906123	5209	5230	21	RIGHT	E403.EDF	E40	3
50	4910637	4911113	460	936	476	RIGHT	E403.EDF	E40	3
50	4912276	4912415	2099	2238	139	RIGHT	E403.EDF	E40	3
50	4913541	4913703	3364	3526	162	RIGHT	E403.EDF	E40	3
50	4916701	4916781	6524	6604	80	RIGHT	E403.EDF	E40	3
51	4919685	4919771	462	548	86	RIGHT	E403.EDF	E40	3
51	4920530	4920650	1307	1427	120	RIGHT	E403.EDF	E40	3
51	4920909	4921016	1686	1793	107	RIGHT	E403.EDF	E40	3
51	4921299	4921429	2076	2206	130	RIGHT	E403.EDF	E40	3
51	4924001	4924055	4778	4832	54	RIGHT	E403.EDF	E40	3
51	4924091	4924101	4868	4878	10	RIGHT	E403.EDF	E40	3
52	4929821	4930203	2119	2501	382	RIGHT	E403.EDF	E40	3
52	4933399	4933587	5697	5885	188	RIGHT	E403.EDF	E40	3
53	4936844	4936962	457	575	118	RIGHT	E403.EDF	E40	3
53	4940881	4941014	4494	4627	133	RIGHT	E403.EDF	E40	3
54	4946064	4946122	1605	1663	58	RIGHT	E403.EDF	E40	3
54	4946539	4946617	2080	2158	78	RIGHT	E403.EDF	E40	3
55	4953173	4953287	1772	1886	114	RIGHT	E403.EDF	E40	3
56	4960135	4960208	859	932	73	RIGHT	E403.EDF	E40	3
56	4961383	4961477	2107	2201	94	RIGHT	E403.EDF	E40	3
57	4972931	4972954	5448	5471	23	RIGHT	E403.EDF	E40	3
57	4972975	4972983	5492	5500	8	RIGHT	E403.EDF	E40	3
58	4978650	4978695	1834	1879	45	RIGHT	E403.EDF	E40	3
58	4978716	4978720	1900	1904	4	RIGHT	E403.EDF	E40	3
58	4979025	4979188	2209	2372	163	RIGHT	E403.EDF	E40	3
58	4980529	4980578	3713	3762	49	RIGHT	E403.EDF	E40	3
58	4980936	4981113	4120	4297	177	RIGHT	E403.EDF	E40	3
58	4981659	4981809	4843	4993	150	RIGHT	E403.EDF	E40	3
59	4986773	4986984	2025	2236	211	RIGHT	E403.EDF	E40	3
60	4993679	4993839	165	325	160	RIGHT	E403.EDF	E40	3
60	4994330	4994451	816	937	121	RIGHT	E403.EDF	E40	3
60	4995742	4995867	2228	2353	125	RIGHT	E403.EDF	E40	3
60	4996188	4996351	2674	2837	163	RIGHT	E403.EDF	E40	3
60	4996686	4996817	3172	3303	131	RIGHT	E403.EDF	E40	3
60	4997339	4997488	3825	3974	149	RIGHT	E403.EDF	E40	3
61	5002211	5002264	58	111	53	RIGHT	E403.EDF	E40	3
61	5002622	5002808	469	655	186	RIGHT	E403.EDF	E40	3
61	5003778	5003936	1625	1783	158	RIGHT	E403.EDF	E40	3
61	5005198	5005442	3045	3289	244	RIGHT	E403.EDF	E40	3
61	5005985	5006171	3832	4018	186	RIGHT	E403.EDF	E40	3
62	5011149	5011156	71	78	7	RIGHT	E403.EDF	E40	3
62	5011554	5011660	476	582	106	RIGHT	E403.EDF	E40	3
62	5012154	5012289	1076	1211	135	RIGHT	E403.EDF	E40	3
63	5019892	5020346	504	958	454	RIGHT	E403.EDF	E40	3
63	5024343	5024510	4955	5122	167	RIGHT	E403.EDF	E40	3
63	5024908	5025021	5520	5633	113	RIGHT	E403.EDF	E40	3
64	5028166	5028300	1006	1140	134	RIGHT	E403.EDF	E40	3
65	5035694	5035843	505	654	149	RIGHT	E403.EDF	E40	3
65	5035867	5035874	678	685	7	RIGHT	E403.EDF	E40	3
65	5036771	5036824	1582	1635	53	RIGHT	E403.EDF	E40	3
65	5036855	5036859	1666	1670	4	RIGHT	E403.EDF	E40	3
65	5037195	5037294	2006	2105	99	RIGHT	E403.EDF	E40	3
65	5038210	5038305	3021	3116	95	RIGHT	E403.EDF	E40	3
65	5038574	5038600	3385	3411	26	RIGHT	E403.EDF	E40	3
65	5038627	5038628	3438	3439	1	RIGHT	E403.EDF	E40	3
65	5038875	5038957	3686	3768	82	RIGHT	E403.EDF	E40	3
65	5039490	5039512	4301	4323	22	RIGHT	E403.EDF	E40	3
65	5039538	5039541	4349	4352	3	RIGHT	E403.EDF	E40	3
66	5044531	5044600	115	184	69	RIGHT	E403.EDF	E40	3
66	5044621	5044625	205	209	4	RIGHT	E403.EDF	E40	3
66	5045094	5045233	678	817	139	RIGHT	E403.EDF	E40	3
66	5049350	5049355	4934	4939	5	RIGHT	E403.EDF	E40	3
66	5049391	5049402	4975	4986	11	RIGHT	E403.EDF	E40	3
67	5053832	5053837	1914	1919	5	RIGHT	E403.EDF	E40	3
67	5053875	5053886	1957	1968	11	RIGHT	E403.EDF	E40	3
67	5054340	5054470	2422	2552	130	RIGHT	E403.EDF	E40	3
68	5061301	5061455	466	620	154	RIGHT	E403.EDF	E40	3
68	5061681	5061874	846	1039	193	RIGHT	E403.EDF	E40	3
68	5064017	5064115	3182	3280	98	RIGHT	E403.EDF	E40	3
68	5064464	5064601	3629	3766	137	RIGHT	E403.EDF	E40	3
69	5067443	5067546	57	160	103	RIGHT	E403.EDF	E40	3
69	5068070	5068325	684	939	255	RIGHT	E403.EDF	E40	3
69	5069259	5069639	1873	2253	380	RIGHT	E403.EDF	E40	3
70	5075494	5075822	532	860	328	RIGHT	E403.EDF	E40	3
70	5076968	5077068	2006	2106	100	RIGHT	E403.EDF	E40	3
70	5078230	5078348	3268	3386	118	RIGHT	E403.EDF	E40	3
70	5079200	5079344	4238	4382	144	RIGHT	E403.EDF	E40	3
71	5082140	5082239	508	607	99	RIGHT	E403.EDF	E40	3
71	5083566	5083691	1934	2059	125	RIGHT	E403.EDF	E40	3
72	5090879	5090906	57	84	27	RIGHT	E403.EDF	E40	3
72	5091379	5091527	557	705	148	RIGHT	E403.EDF	E40	3
73	5099757	5099937	510	690	180	RIGHT	E403.EDF	E40	3
73	5101300	5101445	2053	2198	145	RIGHT	E403.EDF	E40	3
74	5107718	5107919	481	682	201	RIGHT	E403.EDF	E40	3
74	5108203	5108265	966	1028	62	RIGHT	E403.EDF	E40	3
74	5108428	5108554	1191	1317	126	RIGHT	E403.EDF	E40	3
74	5109007	5109188	1770	1951	181	RIGHT	E403.EDF	E40	3
74	5110981	5111091	3744	3854	110	RIGHT	E403.EDF	E40	3
74	5112048	5112166	4811	4929	118	RIGHT	E403.EDF	E40	3
74	5113026	5113133	5789	5896	107	RIGHT	E403.EDF	E40	3
74	5113158	5113158	5921	5921	0	RIGHT	E403.EDF	E40	3
74	5113394	5113464	6157	6227	70	RIGHT	E403.EDF	E40	3
75	5116380	5116466	467	553	86	RIGHT	E403.EDF	E40	3
75	5118600	5118765	2687	2852	165	RIGHT	E403.EDF	E40	3
75	5119775	5120050	3862	4137	275	RIGHT	E403.EDF	E40	3
75	5120347	5120551	4434	4638	204	RIGHT	E403.EDF	E40	3
76	5125164	5125297	474	607	133	RIGHT	E403.EDF	E40	3
76	5126803	5126891	2113	2201	88	RIGHT	E403.EDF	E40	3
76	5128026	5128128	3336	3438	102	RIGHT	E403.EDF	E40	3
76	5129076	5129175	4386	4485	99	RIGHT	E403.EDF	E40	3
77	5132098	5132283	485	670	185	RIGHT	E403.EDF	E40	3
77	5133566	5133759	1953	2146	193	RIGHT	E403.EDF	E40	3
78	5140546	5140628	358	440	82	RIGHT	E403.EDF	E40	3
78	5142202	5142294	2014	2106	92	RIGHT	E403.EDF	E40	3
78	5144869	5144939	4681	4751	70	RIGHT	E403.EDF	E40	3
78	5146526	5146532	6338	6344	6	RIGHT	E403.EDF	E40	3
78	5146567	5146578	6379	6390	11	RIGHT	E403.EDF	E40	3
79	5149514	5149574	57	117	60	RIGHT	E403.EDF	E40	3
79	5150103	5150259	646	802	156	RIGHT	E403.EDF	E40	3
79	5151455	5151611	1998	2154	156	RIGHT	E403.EDF	E40	3
79	5153140	5153223	3683	3766	83	RIGHT	E403.EDF	E40	3
79	5153244	5153250	3787	3793	6	RIGHT	E403.EDF	E40	3
80	5158597	5158812	58	273	215	RIGHT	E403.EDF	E40	3
80	5158836	5158847	297	308	11	RIGHT	E403.EDF	E40	3
80	5158938	5158939	399	400	1	RIGHT	E403.EDF	E40	3
80	5159047	5159299	508	760	252	RIGHT	E403.EDF	E40	3
80	5160628	5160716	2089	2177	88	RIGHT	E403.EDF	E40	3
80	5164047	5164148	5508	5609	101	RIGHT	E403.EDF	E40	3
82	5173236	5173273	57	94	37	RIGHT	E403.EDF	E40	3
82	5173692	5173875	513	696	183	RIGHT	E403.EDF	E40	3
82	5174336	5174480	1157	1301	144	RIGHT	E403.EDF	E40	3
82	5175179	5175260	2000	2081	81	RIGHT	E403.EDF	E40	3
83	5181259	5181348	541	630	89	RIGHT	E403.EDF	E40	3
83	5182324	5182415	1606	1697	91	RIGHT	E403.EDF	E40	3
83	5185977	5185982	5259	5264	5	RIGHT	E403.EDF	E40	3
83	5186051	5186092	5333	5374	41	RIGHT	E403.EDF	E40	3
84	5190769	5190878	1961	2070	109	RIGHT	E403.EDF	E40	3
84	5193856	5193986	5048	5178	130	RIGHT	E403.EDF	E40	3
85	5197222	5197402	515	695	180	RIGHT	E403.EDF	E40	3
85	5197657	5197893	950	1186	236	RIGHT	E403.EDF	E40	3
85	5198854	5199066	2147	2359	212	RIGHT	E403.EDF	E40	3
86	5204682	5204802	466	586	120	RIGHT	E403.EDF	E40	3
86	5205482	5205623	1266	1407	141	RIGHT	E403.EDF	E40	3
86	5205644	5205657	1428	1441	13	RIGHT	E403.EDF	E40	3
86	5207548	5207707	3332	3491	159	RIGHT	E403.EDF	E40	3
87	5211858	5211861	496	499	3	RIGHT	E403.EDF	E40	3
87	5211896	5211908	534	546	12	RIGHT	E403.EDF	E40	3
87	5212312	5212422	950	1060	110	RIGHT	E403.EDF	E40	3
88	5219349	5219645	463	759	296	RIGHT	E403.EDF	E40	3
88	5221176	5221314	2290	2428	138	RIGHT	E403.EDF	E40	3
89	5228597	5228688	485	576	91	RIGHT	E403.EDF	E40	3
89	5228710	5228725	598	613	15	RIGHT	E403.EDF	E40	3
89	5229915	5230035	1803	1923	120	RIGHT	E403.EDF	E40	3
89	5233478	5233561	5366	5449	83	RIGHT	E403.EDF	E40	3
90	5236421	5236541	458	578	120	RIGHT	E403.EDF	E40	3
90	5237699	5237731	1736	1768	32	RIGHT	E403.EDF	E40	3
90	5237758	5237766	1795	1803	8	RIGHT	E403.EDF	E40	3
90	5238412	5238523	2449	2560	111	RIGHT	E403.EDF	E40	3
90	5239770	5239914	3807	3951	144	RIGHT	E403.EDF	E40	3
90	5240853	5240939	4890	4976	86	RIGHT	E403.EDF	E40	3
90	5241594	5241677	5631	5714	83	RIGHT	E403.EDF	E40	3
91	5245380	5245454	488	562	74	RIGHT	E403.EDF	E40	3
91	5246796	5246888	1904	1996	92	RIGHT	E403.EDF	E40	3
91	5249224	5249268	4332	4376	44	RIGHT	E403.EDF	E40	3
91	5249290	5249296	4398	4404	6	RIGHT	E403.EDF	E40	3
92	5253531	5253710	462	641	179	RIGHT	E403.EDF	E40	3
92	5255149	5255305	2080	2236	156	RIGHT	E403.EDF	E40	3
92	5255537	5255713	2468	2644	176	RIGHT	E403.EDF	E40	3
92	5255986	5256169	2917	3100	183	RIGHT	E403.EDF	E40	3
92	5257043	5257107	3974	4038	64	RIGHT	E403.EDF	E40	3
92	5257499	5257580	4430	4511	81	RIGHT	E403.EDF	E40	3
93	5262111	5262225	454	568	114	RIGHT	E403.EDF	E40	3
93	5262248	5262248	591	591	0	RIGHT	E403.EDF	E40	3
94	5269211	5269419	469	677	208	RIGHT	E403.EDF	E40	3
94	5269440	5269450	698	708	10	RIGHT	E403.EDF	E40	3
94	5270627	5270728	1885	1986	101	RIGHT	E403.EDF	E40	3
95	5278429	5278475	1881	1927	46	RIGHT	E403.EDF	E40	3
95	5278502	5278516	1954	1968	14	RIGHT	E403.EDF	E40	3
95	5282696	5282807	6148	6259	111	RIGHT	E403.EDF	E40	3
96	5285563	5285639	300	376	76	RIGHT	E403.EDF	E40	3
96	5286694	5286735	1431	1472	41	RIGHT	E403.EDF	E40	3
96	5286765	5286765	1502	1502	0	RIGHT	E403.EDF	E40	3
96	5287170	5287320	1907	2057	150	RIGHT	E403.EDF	E40	3
96	5287341	5287353	2078	2090	12	RIGHT	E403.EDF	E40	3
96	5291470	5291474	6207	6211	4	RIGHT	E403.EDF	E40	3
96	5291512	5291519	6249	6256	7	RIGHT	E403.EDF	E40	3
97	5294605	5294734	163	292	129	RIGHT	E403.EDF	E40	3
97	5296354	5296437	1912	1995	83	RIGHT	E403.EDF	E40	3
97	5297630	5297748	3188	3306	118	RIGHT	E403.EDF	E40	3
98	5302938	5303063	290	415	125	RIGHT	E403.EDF	E40	3
98	5303531	5303891	883	1243	360	RIGHT	E403.EDF	E40	3
98	5304835	5304944	2187	2296	109	RIGHT	E403.EDF	E40	3
99	5312563	5312793	486	716	230	RIGHT	E403.EDF	E40	3
99	5312817	5312826	740	749	9	RIGHT	E403.EDF	E40	3
99	5313291	5314159	1214	2082	868	RIGHT	E403.EDF	E40	3
99	5315235	5315259	3158	3182	24	RIGHT	E403.EDF	E40	3
100	5321146	5321521	651	1026	375	RIGHT	E403.EDF	E40	3
101	5328960	5329053	240	333	93	RIGHT	E403.EDF	E40	3
101	5330154	5330259	1434	1539	105	RIGHT	E403.EDF	E40	3
102	5335540	5335590	129	179	50	RIGHT	E403.EDF	E40	3
102	5335730	5335828	319	417	98	RIGHT	E403.EDF	E40	3
102	5336160	5336254	749	843	94	RIGHT	E403.EDF	E40	3
102	5336855	5336933	1444	1522	78	RIGHT	E403.EDF	E40	3
102	5338661	5338743	3250	3332	82	RIGHT	E403.EDF	E40	3
103	5343800	5343897	469	566	97	RIGHT	E403.EDF	E40	3
103	5344501	5344592	1170	1261	91	RIGHT	E403.EDF	E40	3
103	5344613	5344616	1282	1285	3	RIGHT	E403.EDF	E40	3
103	5345544	5345658	2213	2327	114	RIGHT	E403.EDF	E40	3
104	5351307	5351443	456	592	136	RIGHT	E403.EDF	E40	3
105	5357958	5358287	480	809	329	RIGHT	E403.EDF	E40	3
106	5364920	5365092	57	229	172	RIGHT	E403.EDF	E40	3
106	5365743	5365882	880	1019	139	RIGHT	E403.EDF	E40	3
106	5367151	5367242	2288	2379	91	RIGHT	E403.EDF	E40	3
107	5372593	5372661	312	380	68	RIGHT	E403.EDF	E40	3
107	5372687	5372688	406	407	1	RIGHT	E403.EDF	E40	3
107	5373985	5374088	1704	1807	103	RIGHT	E403.EDF	E40	3
107	5374110	5374122	1829	1841	12	RIGHT	E403.EDF	E40	3
108	5380578	5380684	229	335	106	RIGHT	E403.EDF	E40	3
108	5381496	5381605	1147	1256	109	RIGHT	E403.EDF	E40	3
108	5382204	5382328	1855	1979	124	RIGHT	E403.EDF	E40	3
108	5384882	5384970	4533	4621	88	RIGHT	E403.EDF	E40	3
109	5391164	5391252	2722	2810	88	RIGHT	E403.EDF	E40	3
109	5392880	5392948	4438	4506	68	RIGHT	E403.EDF	E40	3
110	5398780	5398842	1391	1453	62	RIGHT	E403.EDF	E40	3
110	5401985	5402114	4596	4725	129	RIGHT	E403.EDF	E40	3
110	5403313	5403403	5924	6014	90	RIGHT	E403.EDF	E40	3
111	5405313	5405417	78	182	104	RIGHT	E403.EDF	E40	3
111	5405727	5405835	492	600	108	RIGHT	E403.EDF	E40	3
111	5407004	5407068	1769	1833	64	RIGHT	E403.EDF	E40	3
112	5413414	5413453	2120	2159	39	RIGHT	E403.EDF	E40	3
112	5413497	5413507	2203	2213	10	RIGHT	E403.EDF	E40	3
113	5421726	5421789	1743	1806	63	RIGHT	E403.EDF	E40	3
113	5425159	5425163	5176	5180	4	RIGHT	E403.EDF	E40	3
113	5425259	5425267	5276	5284	8	RIGHT	E403.EDF	E40	3
114	5427826	5427955	224	353	129	RIGHT	E403.EDF	E40	3
114	5428491	5428592	889	990	101	RIGHT	E403.EDF	E40	3
114	5428615	5428618	1013	1016	3	RIGHT	E403.EDF	E40	3
114	5429428	5429534	1826	1932	106	RIGHT	E403.EDF	E40	3
115	5435914	5436034	890	1010	120	RIGHT	E403.EDF	E40	3
115	5436844	5436933	1820	1909	89	RIGHT	E403.EDF	E40	3
115	5437428	5437520	2404	2496	92	RIGHT	E403.EDF	E40	3
115	5438041	5438144	3017	3120	103	RIGHT	E403.EDF	E40	3
115	5438739	5438821	3715	3797	82	RIGHT	E403.EDF	E40	3
115	5438845	5438851	3821	3827	6	RIGHT	E403.EDF	E40	3
116	5443277	5443391	360	474	114	RIGHT	E403.EDF	E40	3
116	5443421	5443423	504	506	2	RIGHT	E403.EDF	E40	3
116	5443617	5443972	700	1055	355	RIGHT	E403.EDF	E40	3
116	5444291	5444435	1374	1518	144	RIGHT	E403.EDF	E40	3
116	5445008	5445132	2091	2215	124	RIGHT	E403.EDF	E40	3
116	5446781	5446854	3864	3937	73	RIGHT	E403.EDF	E40	3
117	5450669	5450792	437	560	123	RIGHT	E403.EDF	E40	3
117	5451835	5451894	1603	1662	59	RIGHT	E403.EDF	E40	3
117	5451915	5451918	1683	1686	3	RIGHT	E403.EDF	E40	3
117	5452329	5452544	2097	2312	215	RIGHT	E403.EDF	E40	3
118	5458327	5458454	714	841	127	RIGHT	E403.EDF	E40	3
118	5458483	5458497	870	884	14	RIGHT	E403.EDF	E40	3
118	5459594	5459788	1981	2175	194	RIGHT	E403.EDF	E40	3
119	5466940	5467121	521	702	181	RIGHT	E403.EDF	E40	3
120	5473730	5473788	492	550	58	RIGHT	E403.EDF	E40	3
120	5474056	5474218	818	980	162	RIGHT	E403.EDF	E40	3
120	5474239	5474244	1001	1006	5	RIGHT	E403.EDF	E40	3
120	5475124	5475220	1886	1982	96	RIGHT	E403.EDF	E40	3
120	5475743	5475868	2505	2630	125	RIGHT	E403.EDF	E40	3
120	5476657	5476781	3419	3543	124	RIGHT	E403.EDF	E40	3
120	5476802	5476808	3564	3570	6	RIGHT	E403.EDF	E40	3
1	12316758	12316836	1563	1641	78	RIGHT	E461.EDF	E46	1
2	12324169	12324224	57	112	55	RIGHT	E461.EDF	E46	1
2	12325459	12325545	1347	1433	86	RIGHT	E461.EDF	E46	1
2	12329583	12329652	5471	5540	69	RIGHT	E461.EDF	E46	1
2	12329855	12329951	5743	5839	96	RIGHT	E461.EDF	E46	1
2	12330128	12330214	6016	6102	86	RIGHT	E461.EDF	E46	1
2	12330366	12330465	6254	6353	99	RIGHT	E461.EDF	E46	1
2	12330579	12330685	6467	6573	106	RIGHT	E461.EDF	E46	1
3	12332892	12333007	297	412	115	RIGHT	E461.EDF	E46	1
3	12333264	12333413	669	818	149	RIGHT	E461.EDF	E46	1
3	12338920	12339027	6325	6432	107	RIGHT	E461.EDF	E46	1
3	12339209	12339305	6614	6710	96	RIGHT	E461.EDF	E46	1
3	12339442	12339464	6847	6869	22	RIGHT	E461.EDF	E46	1
4	12342295	12342481	442	628	186	RIGHT	E461.EDF	E46	1
4	12347299	12347398	5446	5545	99	RIGHT	E461.EDF	E46	1
5	12352901	12353033	1521	1653	132	RIGHT	E461.EDF	E46	1
5	12353132	12353265	1752	1885	133	RIGHT	E461.EDF	E46	1
5	12353372	12353474	1992	2094	102	RIGHT	E461.EDF	E46	1
5	12353584	12353704	2204	2324	120	RIGHT	E461.EDF	E46	1
5	12353768	12353870	2388	2490	102	RIGHT	E461.EDF	E46	1
5	12353946	12354033	2566	2653	87	RIGHT	E461.EDF	E46	1
5	12354130	12354203	2750	2823	73	RIGHT	E461.EDF	E46	1
5	12354322	12354422	2942	3042	100	RIGHT	E461.EDF	E46	1
5	12354459	12354595	3079	3215	136	RIGHT	E461.EDF	E46	1
5	12354657	12354820	3277	3440	163	RIGHT	E461.EDF	E46	1
5	12354960	12355091	3580	3711	131	RIGHT	E461.EDF	E46	1
6	12359498	12359617	811	930	119	RIGHT	E461.EDF	E46	1
6	12363846	12363923	5159	5236	77	RIGHT	E461.EDF	E46	1
6	12364056	12364168	5369	5481	112	RIGHT	E461.EDF	E46	1
6	12364318	12364437	5631	5750	119	RIGHT	E461.EDF	E46	1
7	12372852	12372916	5457	5521	64	RIGHT	E461.EDF	E46	1
8	12380887	12380967	4439	4519	80	RIGHT	E461.EDF	E46	1
9	12384881	12384952	308	379	71	RIGHT	E461.EDF	E46	1
10	12392826	12392928	168	270	102	RIGHT	E461.EDF	E46	1
10	12393031	12393144	373	486	113	RIGHT	E461.EDF	E46	1
10	12393234	12393337	576	679	103	RIGHT	E461.EDF	E46	1
10	12397864	12397893	5206	5235	29	RIGHT	E461.EDF	E46	1
11	12402072	12402195	172	295	123	RIGHT	E461.EDF	E46	1
11	12406922	12406977	5022	5077	55	RIGHT	E461.EDF	E46	1
12	12409650	12409750	102	202	100	RIGHT	E461.EDF	E46	1
13	12420344	12420441	1333	1430	97	RIGHT	E461.EDF	E46	1
14	12428426	12428544	461	579	118	RIGHT	E461.EDF	E46	1
14	12429062	12429172	1097	1207	110	RIGHT	E461.EDF	E46	1
15	12436239	12436346	314	421	107	RIGHT	E461.EDF	E46	1
15	12436469	12436577	544	652	108	RIGHT	E461.EDF	E46	1
15	12437497	12437615	1572	1690	118	RIGHT	E461.EDF	E46	1
16	12443552	12443655	67	170	103	RIGHT	E461.EDF	E46	1
16	12443973	12444098	488	613	125	RIGHT	E461.EDF	E46	1
17	12452253	12452485	57	289	232	RIGHT	E461.EDF	E46	1
17	12452665	12452785	469	589	120	RIGHT	E461.EDF	E46	1
17	12453242	12453322	1046	1126	80	RIGHT	E461.EDF	E46	1
17	12456309	12456362	4113	4166	53	RIGHT	E461.EDF	E46	1
17	12456481	12456584	4285	4388	103	RIGHT	E461.EDF	E46	1
17	12456679	12456778	4483	4582	99	RIGHT	E461.EDF	E46	1
17	12458636	12458645	6440	6449	9	RIGHT	E461.EDF	E46	1
18	12461467	12461604	508	645	137	RIGHT	E461.EDF	E46	1
18	12465200	12465278	4241	4319	78	RIGHT	E461.EDF	E46	1
19	12470081	12470166	326	411	85	RIGHT	E461.EDF	E46	1
19	12470565	12470696	810	941	131	RIGHT	E461.EDF	E46	1
20	12478994	12479225	453	684	231	RIGHT	E461.EDF	E46	1
20	12479484	12479606	943	1065	122	RIGHT	E461.EDF	E46	1
20	12483373	12483454	4832	4913	81	RIGHT	E461.EDF	E46	1
20	12483615	12483705	5074	5164	90	RIGHT	E461.EDF	E46	1
20	12483898	12483974	5357	5433	76	RIGHT	E461.EDF	E46	1
20	12484092	12484192	5551	5651	100	RIGHT	E461.EDF	E46	1
20	12484295	12484392	5754	5851	97	RIGHT	E461.EDF	E46	1
22	12494966	12495073	475	582	107	RIGHT	E461.EDF	E46	1
22	12495302	12495455	811	964	153	RIGHT	E461.EDF	E46	1
23	12505271	12505301	1709	1739	30	RIGHT	E461.EDF	E46	1
25	12521832	12521958	3079	3205	126	RIGHT	E461.EDF	E46	1
25	12522107	12522226	3354	3473	119	RIGHT	E461.EDF	E46	1
25	12522324	12522449	3571	3696	125	RIGHT	E461.EDF	E46	1
25	12525303	12525351	6550	6598	48	RIGHT	E461.EDF	E46	1
26	12528295	12528317	345	367	22	RIGHT	E461.EDF	E46	1
26	12529649	12529650	1699	1700	1	RIGHT	E461.EDF	E46	1
29	12551257	12551390	184	317	133	RIGHT	E461.EDF	E46	1
30	12558700	12558838	481	619	138	RIGHT	E461.EDF	E46	1
32	12575426	12575478	498	550	52	RIGHT	E461.EDF	E46	1
33	12585689	12585719	2559	2589	30	RIGHT	E461.EDF	E46	1
33	12586407	12586547	3277	3417	140	RIGHT	E461.EDF	E46	1
33	12588043	12588177	4913	5047	134	RIGHT	E461.EDF	E46	1
33	12588350	12588535	5220	5405	185	RIGHT	E461.EDF	E46	1
33	12589329	12589463	6199	6333	134	RIGHT	E461.EDF	E46	1
35	12601004	12601056	208	260	52	RIGHT	E461.EDF	E46	1
35	12601081	12601084	285	288	3	RIGHT	E461.EDF	E46	1
35	12601235	12601361	439	565	126	RIGHT	E461.EDF	E46	1
36	12609128	12609148	57	77	20	RIGHT	E461.EDF	E46	1
36	12609530	12609738	459	667	208	RIGHT	E461.EDF	E46	1
36	12609888	12609995	817	924	107	RIGHT	E461.EDF	E46	1
36	12610359	12610359	1288	1288	0	RIGHT	E461.EDF	E46	1
36	12613304	12613479	4233	4408	175	RIGHT	E461.EDF	E46	1
36	12613614	12613741	4543	4670	127	RIGHT	E461.EDF	E46	1
36	12614291	12614416	5220	5345	125	RIGHT	E461.EDF	E46	1
37	12617431	12617533	231	333	102	RIGHT	E461.EDF	E46	1
38	12626139	12626165	1779	1805	26	RIGHT	E461.EDF	E46	1
40	12643008	12643154	58	204	146	RIGHT	E461.EDF	E46	1
40	12643452	12643524	502	574	72	RIGHT	E461.EDF	E46	1
40	12645661	12645758	2711	2808	97	RIGHT	E461.EDF	E46	1
41	12652302	12652317	460	475	15	RIGHT	E461.EDF	E46	1
41	12653173	12653261	1331	1419	88	RIGHT	E461.EDF	E46	1
42	12661771	12661893	2480	2602	122	RIGHT	E461.EDF	E46	1
42	12662021	12662156	2730	2865	135	RIGHT	E461.EDF	E46	1
43	12667805	12667964	479	638	159	RIGHT	E461.EDF	E46	1
44	12675230	12675343	140	253	113	RIGHT	E461.EDF	E46	1
44	12678574	12678607	3484	3517	33	RIGHT	E461.EDF	E46	1
44	12680272	12680306	5182	5216	34	RIGHT	E461.EDF	E46	1
44	12681035	12681152	5945	6062	117	RIGHT	E461.EDF	E46	1
45	12685092	12685169	473	550	77	RIGHT	E461.EDF	E46	1
46	12693102	12693174	329	401	72	RIGHT	E461.EDF	E46	1
48	12709606	12709676	313	383	70	RIGHT	E461.EDF	E46	1
51	12736185	12736224	467	506	39	RIGHT	E461.EDF	E46	1
52	12743233	12743296	343	406	63	RIGHT	E461.EDF	E46	1
55	12767968	12768021	100	153	53	RIGHT	E461.EDF	E46	1
55	12768402	12768438	534	570	36	RIGHT	E461.EDF	E46	1
56	12776912	12777109	307	504	197	RIGHT	E461.EDF	E46	1
57	12785094	12785222	306	434	128	RIGHT	E461.EDF	E46	1
58	12792544	12792654	181	291	110	RIGHT	E461.EDF	E46	1
58	12792903	12792982	540	619	79	RIGHT	E461.EDF	E46	1
58	12794625	12794733	2262	2370	108	RIGHT	E461.EDF	E46	1
58	12794898	12795040	2535	2677	142	RIGHT	E461.EDF	E46	1
58	12796346	12796484	3983	4121	138	RIGHT	E461.EDF	E46	1
59	12801052	12801153	1013	1114	101	RIGHT	E461.EDF	E46	1
59	12803238	12803312	3199	3273	74	RIGHT	E461.EDF	E46	1
60	12807625	12807702	586	663	77	RIGHT	E461.EDF	E46	1
60	12809737	12809842	2698	2803	105	RIGHT	E461.EDF	E46	1
61	12814463	12814526	434	497	63	RIGHT	E461.EDF	E46	1
63	12830054	12832107	508	2561	2053	RIGHT	E461.EDF	E46	1
63	12832600	12832683	3054	3137	83	RIGHT	E461.EDF	E46	1
63	12834665	12834686	5119	5140	21	RIGHT	E461.EDF	E46	1
64	12840348	12840420	1419	1491	72	RIGHT	E461.EDF	E46	1
64	12841960	12842034	3031	3105	74	RIGHT	E461.EDF	E46	1
65	12847242	12847317	177	252	75	RIGHT	E461.EDF	E46	1
65	12847543	12847652	478	587	109	RIGHT	E461.EDF	E46	1
69	12876763	12876913	58	208	150	RIGHT	E461.EDF	E46	1
69	12877068	12877274	363	569	206	RIGHT	E461.EDF	E46	1
70	12884971	12885097	89	215	126	RIGHT	E461.EDF	E46	1
70	12885122	12885134	240	252	12	RIGHT	E461.EDF	E46	1
70	12887755	12887840	2873	2958	85	RIGHT	E461.EDF	E46	1
73	12911371	12911457	2389	2475	86	RIGHT	E461.EDF	E46	1
73	12911480	12911486	2498	2504	6	RIGHT	E461.EDF	E46	1
75	12925611	12925694	760	843	83	RIGHT	E461.EDF	E46	1
78	12947668	12947802	143	277	134	RIGHT	E461.EDF	E46	1
79	12957894	12958011	1094	1211	117	RIGHT	E461.EDF	E46	1
84	12998287	12998319	1032	1064	32	RIGHT	E461.EDF	E46	1
87	13023350	13023454	158	262	104	RIGHT	E461.EDF	E46	1
87	13023711	13023809	519	617	98	RIGHT	E461.EDF	E46	1
87	13024147	13026515	955	3323	2368	RIGHT	E461.EDF	E46	1
87	13028022	13028097	4830	4905	75	RIGHT	E461.EDF	E46	1
87	13028514	13028641	5322	5449	127	RIGHT	E461.EDF	E46	1
88	13038490	13038568	5859	5937	78	RIGHT	E461.EDF	E46	1
92	13066636	13068466	477	2307	1830	RIGHT	E461.EDF	E46	1
92	13068510	13068541	2351	2382	31	RIGHT	E461.EDF	E46	1
92	13069287	13069374	3128	3215	87	RIGHT	E461.EDF	E46	1
92	13069620	13069727	3461	3568	107	RIGHT	E461.EDF	E46	1
92	13069800	13069986	3641	3827	186	RIGHT	E461.EDF	E46	1
92	13070089	13070268	3930	4109	179	RIGHT	E461.EDF	E46	1
92	13070415	13070563	4256	4404	148	RIGHT	E461.EDF	E46	1
92	13070697	13070884	4538	4725	187	RIGHT	E461.EDF	E46	1
92	13071053	13071245	4894	5086	192	RIGHT	E461.EDF	E46	1
93	13073111	13073319	104	312	208	RIGHT	E461.EDF	E46	1
93	13073904	13074023	897	1016	119	RIGHT	E461.EDF	E46	1
93	13075965	13076087	2958	3080	122	RIGHT	E461.EDF	E46	1
93	13076162	13076342	3155	3335	180	RIGHT	E461.EDF	E46	1
93	13076454	13076594	3447	3587	140	RIGHT	E461.EDF	E46	1
93	13076786	13076894	3779	3887	108	RIGHT	E461.EDF	E46	1
93	13077622	13077730	4615	4723	108	RIGHT	E461.EDF	E46	1
93	13078489	13078679	5482	5672	190	RIGHT	E461.EDF	E46	1
94	13081515	13081903	404	792	388	RIGHT	E461.EDF	E46	1
94	13083951	13084172	2840	3061	221	RIGHT	E461.EDF	E46	1
94	13084201	13084201	3090	3090	0	RIGHT	E461.EDF	E46	1
95	13092031	13092385	3849	4203	354	RIGHT	E461.EDF	E46	1
95	13092465	13092500	4283	4318	35	RIGHT	E461.EDF	E46	1
95	13093667	13093676	5485	5494	9	RIGHT	E461.EDF	E46	1
95	13093697	13094010	5515	5828	313	RIGHT	E461.EDF	E46	1
95	13094047	13094063	5865	5881	16	RIGHT	E461.EDF	E46	1
96	13098336	13098425	1232	1321	89	RIGHT	E461.EDF	E46	1
96	13100567	13100701	3463	3597	134	RIGHT	E461.EDF	E46	1
96	13100756	13100764	3652	3660	8	RIGHT	E461.EDF	E46	1
96	13101488	13101651	4384	4547	163	RIGHT	E461.EDF	E46	1
96	13101688	13101706	4584	4602	18	RIGHT	E461.EDF	E46	1
97	13108534	13108664	2146	2276	130	RIGHT	E461.EDF	E46	1
97	13111641	13111799	5253	5411	158	RIGHT	E461.EDF	E46	1
98	13115888	13116055	298	465	167	RIGHT	E461.EDF	E46	1
98	13118590	13118704	3000	3114	114	RIGHT	E461.EDF	E46	1
98	13119211	13119331	3621	3741	120	RIGHT	E461.EDF	E46	1
98	13120578	13120679	4988	5089	101	RIGHT	E461.EDF	E46	1
100	13133641	13134003	1502	1864	362	RIGHT	E461.EDF	E46	1
100	13134050	13134084	1911	1945	34	RIGHT	E461.EDF	E46	1
100	13137439	13137546	5300	5407	107	RIGHT	E461.EDF	E46	1
101	13140921	13141343	728	1150	422	RIGHT	E461.EDF	E46	1
101	13143750	13143895	3557	3702	145	RIGHT	E461.EDF	E46	1
101	13144662	13144905	4469	4712	243	RIGHT	E461.EDF	E46	1
101	13145916	13146098	5723	5905	182	RIGHT	E461.EDF	E46	1
102	13150617	13150825	744	952	208	RIGHT	E461.EDF	E46	1
102	13151078	13151590	1205	1717	512	RIGHT	E461.EDF	E46	1
102	13151612	13151676	1739	1803	64	RIGHT	E461.EDF	E46	1
102	13154308	13154314	4435	4441	6	RIGHT	E461.EDF	E46	1
102	13154343	13154410	4470	4537	67	RIGHT	E461.EDF	E46	1
102	13154447	13154454	4574	4581	7	RIGHT	E461.EDF	E46	1
102	13154992	13155112	5119	5239	120	RIGHT	E461.EDF	E46	1
102	13155143	13155155	5270	5282	12	RIGHT	E461.EDF	E46	1
103	13159733	13159926	809	1002	193	RIGHT	E461.EDF	E46	1
103	13160232	13160602	1308	1678	370	RIGHT	E461.EDF	E46	1
103	13164013	13164086	5089	5162	73	RIGHT	E461.EDF	E46	1
104	13167351	13167483	488	620	132	RIGHT	E461.EDF	E46	1
104	13168018	13170675	1155	3812	2657	RIGHT	E461.EDF	E46	1
105	13176941	13176990	1574	1623	49	RIGHT	E461.EDF	E46	1
105	13182183	13182202	6816	6835	19	RIGHT	E461.EDF	E46	1
106	13184861	13189374	672	5185	4513	RIGHT	E461.EDF	E46	1
106	13191319	13191401	7130	7212	82	RIGHT	E461.EDF	E46	1
107	13193282	13193425	84	227	143	RIGHT	E461.EDF	E46	1
113	13244495	13244515	1204	1224	20	RIGHT	E461.EDF	E46	1
118	13282878	13282964	497	583	86	RIGHT	E461.EDF	E46	1
118	13287438	13287452	5057	5071	14	RIGHT	E461.EDF	E46	1
119	13290137	13290377	940	1180	240	RIGHT	E461.EDF	E46	1
119	13292274	13292517	3077	3320	243	RIGHT	E461.EDF	E46	1
119	13294840	13294923	5643	5726	83	RIGHT	E461.EDF	E46	1
119	13294989	13295000	5792	5803	11	RIGHT	E461.EDF	E46	1
120	13298545	13298571	112	138	26	RIGHT	E461.EDF	E46	1
120	13301877	13302063	3444	3630	186	RIGHT	E461.EDF	E46	1
120	13303431	13303508	4998	5075	77	RIGHT	E461.EDF	E46	1
1	14011501	14011622	746	867	121	RIGHT	E462.EDF	E46	2
1	14015170	14015233	4415	4478	63	RIGHT	E462.EDF	E46	2
1	14015356	14015439	4601	4684	83	RIGHT	E462.EDF	E46	2
1	14015564	14015627	4809	4872	63	RIGHT	E462.EDF	E46	2
2	14021026	14021162	460	596	136	RIGHT	E462.EDF	E46	2
2	14025093	14025163	4527	4597	70	RIGHT	E462.EDF	E46	2
2	14025357	14025429	4791	4863	72	RIGHT	E462.EDF	E46	2
2	14025674	14025747	5108	5181	73	RIGHT	E462.EDF	E46	2
2	14025945	14026022	5379	5456	77	RIGHT	E462.EDF	E46	2
3	14030807	14030887	1462	1542	80	RIGHT	E462.EDF	E46	2
3	14034643	14034697	5298	5352	54	RIGHT	E462.EDF	E46	2
4	14037593	14037732	145	284	139	RIGHT	E462.EDF	E46	2
4	14041803	14041827	4355	4379	24	RIGHT	E462.EDF	E46	2
4	14042036	14042106	4588	4658	70	RIGHT	E462.EDF	E46	2
4	14042253	14042350	4805	4902	97	RIGHT	E462.EDF	E46	2
4	14042521	14042611	5073	5163	90	RIGHT	E462.EDF	E46	2
4	14042812	14042893	5364	5445	81	RIGHT	E462.EDF	E46	2
5	14046143	14046215	448	520	72	RIGHT	E462.EDF	E46	2
5	14047138	14047257	1443	1562	119	RIGHT	E462.EDF	E46	2
5	14049009	14049109	3314	3414	100	RIGHT	E462.EDF	E46	2
5	14052364	14052445	6669	6750	81	RIGHT	E462.EDF	E46	2
6	14057451	14057584	529	662	133	RIGHT	E462.EDF	E46	2
6	14058629	14058749	1707	1827	120	RIGHT	E462.EDF	E46	2
6	14060656	14060810	3734	3888	154	RIGHT	E462.EDF	E46	2
7	14063834	14063896	58	120	62	RIGHT	E462.EDF	E46	2
7	14067214	14067344	3438	3568	130	RIGHT	E462.EDF	E46	2
7	14069551	14069645	5775	5869	94	RIGHT	E462.EDF	E46	2
8	14072086	14072228	295	437	142	RIGHT	E462.EDF	E46	2
8	14074284	14074396	2493	2605	112	RIGHT	E462.EDF	E46	2
8	14076168	14076290	4377	4499	122	RIGHT	E462.EDF	E46	2
8	14077303	14077429	5512	5638	126	RIGHT	E462.EDF	E46	2
9	14080416	14080548	499	631	132	RIGHT	E462.EDF	E46	2
9	14082196	14082289	2279	2372	93	RIGHT	E462.EDF	E46	2
9	14082672	14082791	2755	2874	119	RIGHT	E462.EDF	E46	2
10	14089430	14089524	1279	1373	94	RIGHT	E462.EDF	E46	2
10	14091585	14091685	3434	3534	100	RIGHT	E462.EDF	E46	2
11	14097586	14097670	1469	1553	84	RIGHT	E462.EDF	E46	2
11	14099301	14099396	3184	3279	95	RIGHT	E462.EDF	E46	2
11	14100155	14100265	4038	4148	110	RIGHT	E462.EDF	E46	2
12	14107405	14107510	2534	2639	105	RIGHT	E462.EDF	E46	2
12	14109860	14109921	4989	5050	61	RIGHT	E462.EDF	E46	2
13	14114718	14114864	486	632	146	RIGHT	E462.EDF	E46	2
14	14127126	14127159	4353	4386	33	RIGHT	E462.EDF	E46	2
15	14132601	14132648	2875	2922	47	RIGHT	E462.EDF	E46	2
15	14134226	14134321	4500	4595	95	RIGHT	E462.EDF	E46	2
16	14143593	14143615	6326	6348	22	RIGHT	E462.EDF	E46	2
16	14143827	14143886	6560	6619	59	RIGHT	E462.EDF	E46	2
17	14147145	14147316	519	690	171	RIGHT	E462.EDF	E46	2
18	14154830	14154954	1150	1274	124	RIGHT	E462.EDF	E46	2
20	14170732	14170768	4043	4079	36	RIGHT	E462.EDF	E46	2
20	14171250	14171370	4561	4681	120	RIGHT	E462.EDF	E46	2
21	14174845	14175111	469	735	266	RIGHT	E462.EDF	E46	2
21	14180818	14180852	6442	6476	34	RIGHT	E462.EDF	E46	2
22	14183526	14183675	464	613	149	RIGHT	E462.EDF	E46	2
23	14190906	14191128	515	737	222	RIGHT	E462.EDF	E46	2
24	14199295	14199413	1316	1434	118	RIGHT	E462.EDF	E46	2
25	14205971	14206344	540	913	373	RIGHT	E462.EDF	E46	2
25	14206454	14206579	1023	1148	125	RIGHT	E462.EDF	E46	2
25	14207219	14207332	1788	1901	113	RIGHT	E462.EDF	E46	2
25	14207560	14207808	2129	2377	248	RIGHT	E462.EDF	E46	2
25	14208264	14208470	2833	3039	206	RIGHT	E462.EDF	E46	2
25	14209328	14209476	3897	4045	148	RIGHT	E462.EDF	E46	2
26	14216515	14216545	4421	4451	30	RIGHT	E462.EDF	E46	2
27	14219595	14219743	236	384	148	RIGHT	E462.EDF	E46	2
27	14221970	14222071	2611	2712	101	RIGHT	E462.EDF	E46	2
27	14224954	14224991	5595	5632	37	RIGHT	E462.EDF	E46	2
27	14226479	14226525	7120	7166	46	RIGHT	E462.EDF	E46	2
28	14228844	14229066	510	732	222	RIGHT	E462.EDF	E46	2
29	14241848	14241920	6227	6299	72	RIGHT	E462.EDF	E46	2
30	14244967	14245068	512	613	101	RIGHT	E462.EDF	E46	2
30	14249847	14249879	5392	5424	32	RIGHT	E462.EDF	E46	2
31	14252337	14252574	57	294	237	RIGHT	E462.EDF	E46	2
32	14259137	14259361	64	288	224	RIGHT	E462.EDF	E46	2
32	14262399	14262490	3326	3417	91	RIGHT	E462.EDF	E46	2
37	14299874	14300066	2726	2918	192	RIGHT	E462.EDF	E46	2
37	14301268	14301385	4120	4237	117	RIGHT	E462.EDF	E46	2
38	14308021	14308067	2956	3002	46	RIGHT	E462.EDF	E46	2
38	14309045	14309159	3980	4094	114	RIGHT	E462.EDF	E46	2
38	14310891	14310990	5826	5925	99	RIGHT	E462.EDF	E46	2
40	14323721	14323810	1739	1828	89	RIGHT	E462.EDF	E46	2
40	14324062	14324241	2080	2259	179	RIGHT	E462.EDF	E46	2
40	14325081	14325238	3099	3256	157	RIGHT	E462.EDF	E46	2
40	14326140	14326276	4158	4294	136	RIGHT	E462.EDF	E46	2
40	14326991	14327134	5009	5152	143	RIGHT	E462.EDF	E46	2
40	14327298	14327396	5316	5414	98	RIGHT	E462.EDF	E46	2
41	14329650	14329792	252	394	142	RIGHT	E462.EDF	E46	2
41	14331117	14331202	1719	1804	85	RIGHT	E462.EDF	E46	2
41	14332070	14332190	2672	2792	120	RIGHT	E462.EDF	E46	2
41	14332669	14332810	3271	3412	141	RIGHT	E462.EDF	E46	2
41	14335444	14335590	6046	6192	146	RIGHT	E462.EDF	E46	2
42	14338137	14338275	61	199	138	RIGHT	E462.EDF	E46	2
42	14338542	14338639	466	563	97	RIGHT	E462.EDF	E46	2
42	14341193	14341327	3117	3251	134	RIGHT	E462.EDF	E46	2
42	14341845	14341951	3769	3875	106	RIGHT	E462.EDF	E46	2
43	14344901	14344999	233	331	98	RIGHT	E462.EDF	E46	2
43	14345940	14346028	1272	1360	88	RIGHT	E462.EDF	E46	2
43	14346903	14347016	2235	2348	113	RIGHT	E462.EDF	E46	2
43	14347749	14347861	3081	3193	112	RIGHT	E462.EDF	E46	2
43	14348463	14348567	3795	3899	104	RIGHT	E462.EDF	E46	2
43	14348715	14348843	4047	4175	128	RIGHT	E462.EDF	E46	2
43	14349460	14349553	4792	4885	93	RIGHT	E462.EDF	E46	2
43	14350015	14350124	5347	5456	109	RIGHT	E462.EDF	E46	2
44	14353203	14353311	481	589	108	RIGHT	E462.EDF	E46	2
44	14354456	14354565	1734	1843	109	RIGHT	E462.EDF	E46	2
44	14355633	14355732	2911	3010	99	RIGHT	E462.EDF	E46	2
44	14355903	14356005	3181	3283	102	RIGHT	E462.EDF	E46	2
44	14356132	14356231	3410	3509	99	RIGHT	E462.EDF	E46	2
44	14356658	14356756	3936	4034	98	RIGHT	E462.EDF	E46	2
44	14356914	14357022	4192	4300	108	RIGHT	E462.EDF	E46	2
44	14357919	14358001	5197	5279	82	RIGHT	E462.EDF	E46	2
45	14362182	14362268	2546	2632	86	RIGHT	E462.EDF	E46	2
45	14363181	14363286	3545	3650	105	RIGHT	E462.EDF	E46	2
45	14363459	14363566	3823	3930	107	RIGHT	E462.EDF	E46	2
45	14364121	14364228	4485	4592	107	RIGHT	E462.EDF	E46	2
46	14367888	14367985	1368	1465	97	RIGHT	E462.EDF	E46	2
46	14370425	14370521	3905	4001	96	RIGHT	E462.EDF	E46	2
48	14380891	14381001	501	611	110	RIGHT	E462.EDF	E46	2
48	14382897	14382997	2507	2607	100	RIGHT	E462.EDF	E46	2
48	14383424	14383551	3034	3161	127	RIGHT	E462.EDF	E46	2
48	14383714	14383824	3324	3434	110	RIGHT	E462.EDF	E46	2
48	14384354	14384465	3964	4075	111	RIGHT	E462.EDF	E46	2
48	14384668	14384801	4278	4411	133	RIGHT	E462.EDF	E46	2
48	14385843	14385946	5453	5556	103	RIGHT	E462.EDF	E46	2
49	14388955	14389046	990	1081	91	RIGHT	E462.EDF	E46	2
49	14391718	14391806	3753	3841	88	RIGHT	E462.EDF	E46	2
50	14395823	14395910	848	935	87	RIGHT	E462.EDF	E46	2
50	14398071	14398176	3096	3201	105	RIGHT	E462.EDF	E46	2
51	14404339	14404471	452	584	132	RIGHT	E462.EDF	E46	2
51	14404647	14405778	760	1891	1131	RIGHT	E462.EDF	E46	2
51	14406716	14406811	2829	2924	95	RIGHT	E462.EDF	E46	2
51	14408054	14408142	4167	4255	88	RIGHT	E462.EDF	E46	2
52	14411298	14411419	668	789	121	RIGHT	E462.EDF	E46	2
52	14413810	14413902	3180	3272	92	RIGHT	E462.EDF	E46	2
52	14415384	14415489	4754	4859	105	RIGHT	E462.EDF	E46	2
53	14421955	14422048	2539	2632	93	RIGHT	E462.EDF	E46	2
53	14422853	14422954	3437	3538	101	RIGHT	E462.EDF	E46	2
53	14425015	14425098	5599	5682	83	RIGHT	E462.EDF	E46	2
54	14431246	14431335	3046	3135	89	RIGHT	E462.EDF	E46	2
54	14432010	14432144	3810	3944	134	RIGHT	E462.EDF	E46	2
54	14433868	14433960	5668	5760	92	RIGHT	E462.EDF	E46	2
55	14438660	14438757	2479	2576	97	RIGHT	E462.EDF	E46	2
56	14446279	14446375	3380	3476	96	RIGHT	E462.EDF	E46	2
57	14455557	14455626	4204	4273	69	RIGHT	E462.EDF	E46	2
58	14460274	14460500	720	946	226	RIGHT	E462.EDF	E46	2
59	14471327	14471375	4775	4823	48	RIGHT	E462.EDF	E46	2
61	14484929	14484985	2823	2879	56	RIGHT	E462.EDF	E46	2
62	14491804	14491902	1036	1134	98	RIGHT	E462.EDF	E46	2
63	14498175	14498271	62	158	96	RIGHT	E462.EDF	E46	2
64	14512279	14512326	5424	5471	47	RIGHT	E462.EDF	E46	2
64	14512444	14512513	5589	5658	69	RIGHT	E462.EDF	E46	2
64	14512670	14512745	5815	5890	75	RIGHT	E462.EDF	E46	2
64	14512901	14512912	6046	6057	11	RIGHT	E462.EDF	E46	2
65	14514572	14514709	69	206	137	RIGHT	E462.EDF	E46	2
65	14514853	14514986	350	483	133	RIGHT	E462.EDF	E46	2
67	14532595	14532643	2633	2681	48	RIGHT	E462.EDF	E46	2
69	14545448	14545577	456	585	129	RIGHT	E462.EDF	E46	2
71	14562720	14562788	3081	3149	68	RIGHT	E462.EDF	E46	2
73	14581206	14581242	6246	6282	36	RIGHT	E462.EDF	E46	2
77	14606758	14606866	57	165	108	RIGHT	E462.EDF	E46	2
77	14607213	14607571	512	870	358	RIGHT	E462.EDF	E46	2
77	14609675	14609782	2974	3081	107	RIGHT	E462.EDF	E46	2
78	14615899	14615917	1673	1691	18	RIGHT	E462.EDF	E46	2
78	14619040	14619072	4814	4846	32	RIGHT	E462.EDF	E46	2
79	14622481	14622607	772	898	126	RIGHT	E462.EDF	E46	2
79	14624257	14624326	2548	2617	69	RIGHT	E462.EDF	E46	2
79	14625688	14625722	3979	4013	34	RIGHT	E462.EDF	E46	2
80	14629618	14629687	1201	1270	69	RIGHT	E462.EDF	E46	2
80	14630620	14630739	2203	2322	119	RIGHT	E462.EDF	E46	2
80	14631783	14631920	3366	3503	137	RIGHT	E462.EDF	E46	2
80	14632438	14632608	4021	4191	170	RIGHT	E462.EDF	E46	2
81	14636397	14636482	1111	1196	85	RIGHT	E462.EDF	E46	2
81	14637760	14637880	2474	2594	120	RIGHT	E462.EDF	E46	2
81	14642018	14642155	6732	6869	137	RIGHT	E462.EDF	E46	2
82	14644536	14649905	465	5834	5369	RIGHT	E462.EDF	E46	2
83	14651602	14651974	58	430	372	RIGHT	E462.EDF	E46	2
83	14652114	14652234	570	690	120	RIGHT	E462.EDF	E46	2
83	14652713	14652865	1169	1321	152	RIGHT	E462.EDF	E46	2
84	14659813	14659995	572	754	182	RIGHT	E462.EDF	E46	2
84	14661239	14661388	1998	2147	149	RIGHT	E462.EDF	E46	2
84	14662336	14662497	3095	3256	161	RIGHT	E462.EDF	E46	2
85	14666970	14667087	262	379	117	RIGHT	E462.EDF	E46	2
85	14668844	14668943	2136	2235	99	RIGHT	E462.EDF	E46	2
85	14669521	14669638	2813	2930	117	RIGHT	E462.EDF	E46	2
85	14671046	14671160	4338	4452	114	RIGHT	E462.EDF	E46	2
85	14672350	14672443	5642	5735	93	RIGHT	E462.EDF	E46	2
86	14675509	14675660	478	629	151	RIGHT	E462.EDF	E46	2
86	14678970	14679015	3939	3984	45	RIGHT	E462.EDF	E46	2
87	14684068	14684180	502	614	112	RIGHT	E462.EDF	E46	2
87	14685510	14685594	1944	2028	84	RIGHT	E462.EDF	E46	2
88	14696646	14696690	4218	4262	44	RIGHT	E462.EDF	E46	2
89	14700748	14700894	881	1027	146	RIGHT	E462.EDF	E46	2
89	14701931	14702050	2064	2183	119	RIGHT	E462.EDF	E46	2
90	14708058	14708194	519	655	136	RIGHT	E462.EDF	E46	2
90	14710520	14710603	2981	3064	83	RIGHT	E462.EDF	E46	2
90	14711471	14711568	3932	4029	97	RIGHT	E462.EDF	E46	2
92	14725341	14725545	57	261	204	RIGHT	E462.EDF	E46	2
92	14725821	14726149	537	865	328	RIGHT	E462.EDF	E46	2
92	14726220	14726349	936	1065	129	RIGHT	E462.EDF	E46	2
92	14727010	14727171	1726	1887	161	RIGHT	E462.EDF	E46	2
92	14731833	14731838	6549	6554	5	RIGHT	E462.EDF	E46	2
93	14734369	14734459	883	973	90	RIGHT	E462.EDF	E46	2
93	14736614	14736713	3128	3227	99	RIGHT	E462.EDF	E46	2
93	14738144	14738247	4658	4761	103	RIGHT	E462.EDF	E46	2
94	14741490	14741670	57	237	180	RIGHT	E462.EDF	E46	2
94	14744927	14745050	3494	3617	123	RIGHT	E462.EDF	E46	2
94	14745823	14745974	4390	4541	151	RIGHT	E462.EDF	E46	2
95	14750585	14756197	58	5670	5612	RIGHT	E462.EDF	E46	2
96	14760534	14760640	2043	2149	106	RIGHT	E462.EDF	E46	2
96	14761404	14761547	2913	3056	143	RIGHT	E462.EDF	E46	2
96	14765205	14765327	6714	6836	122	RIGHT	E462.EDF	E46	2
97	14768065	14768065	781	781	0	RIGHT	E462.EDF	E46	2
97	14768102	14768987	818	1703	885	RIGHT	E462.EDF	E46	2
97	14769116	14769116	1832	1832	0	RIGHT	E462.EDF	E46	2
97	14769152	14769172	1868	1888	20	RIGHT	E462.EDF	E46	2
97	14769262	14769262	1978	1978	0	RIGHT	E462.EDF	E46	2
97	14769320	14769321	2036	2037	1	RIGHT	E462.EDF	E46	2
97	14769408	14770849	2124	3565	1441	RIGHT	E462.EDF	E46	2
97	14770932	14774512	3648	7228	3580	RIGHT	E462.EDF	E46	2
98	14776515	14782057	57	5599	5542	RIGHT	E462.EDF	E46	2
99	14783719	14788357	58	4696	4638	RIGHT	E462.EDF	E46	2
99	14789026	14789140	5365	5479	114	RIGHT	E462.EDF	E46	2
100	14791197	14791417	58	278	220	RIGHT	E462.EDF	E46	2
100	14792348	14792841	1209	1702	493	RIGHT	E462.EDF	E46	2
100	14793786	14793917	2647	2778	131	RIGHT	E462.EDF	E46	2
100	14796464	14796467	5325	5328	3	RIGHT	E462.EDF	E46	2
101	14798188	14798384	57	253	196	RIGHT	E462.EDF	E46	2
101	14799165	14799283	1034	1152	118	RIGHT	E462.EDF	E46	2
101	14800593	14801161	2462	3030	568	RIGHT	E462.EDF	E46	2
101	14802251	14802352	4120	4221	101	RIGHT	E462.EDF	E46	2
101	14803180	14803284	5049	5153	104	RIGHT	E462.EDF	E46	2
101	14803802	14803958	5671	5827	156	RIGHT	E462.EDF	E46	2
102	14807535	14807654	1764	1883	119	RIGHT	E462.EDF	E46	2
102	14809276	14809406	3505	3635	130	RIGHT	E462.EDF	E46	2
102	14812231	14812377	6460	6606	146	RIGHT	E462.EDF	E46	2
103	14814990	14815181	432	623	191	RIGHT	E462.EDF	E46	2
103	14817119	14817214	2561	2656	95	RIGHT	E462.EDF	E46	2
103	14818460	14818580	3902	4022	120	RIGHT	E462.EDF	E46	2
103	14819756	14819840	5198	5282	84	RIGHT	E462.EDF	E46	2
104	14828768	14828816	5596	5644	48	RIGHT	E462.EDF	E46	2
105	14833900	14834003	2383	2486	103	RIGHT	E462.EDF	E46	2
105	14834587	14834811	3070	3294	224	RIGHT	E462.EDF	E46	2
105	14835692	14835805	4175	4288	113	RIGHT	E462.EDF	E46	2
109	14861695	14861898	469	672	203	RIGHT	E462.EDF	E46	2
109	14861997	14862141	771	915	144	RIGHT	E462.EDF	E46	2
110	14870399	14870539	434	574	140	RIGHT	E462.EDF	E46	2
110	14871013	14871116	1048	1151	103	RIGHT	E462.EDF	E46	2
111	14877408	14877508	131	231	100	RIGHT	E462.EDF	E46	2
115	14908376	14908498	321	443	122	RIGHT	E462.EDF	E46	2
1	4331513	4331638	871	996	125	RIGHT	G58a.EDF	G58	1
2	4340861	4340974	929	1042	113	RIGHT	G58a.EDF	G58	1
2	4341055	4341164	1123	1232	109	RIGHT	G58a.EDF	G58	1
2	4344405	4344490	4473	4558	85	RIGHT	G58a.EDF	G58	1
3	4348999	4349077	509	587	78	RIGHT	G58a.EDF	G58	1
3	4349110	4349264	620	774	154	RIGHT	G58a.EDF	G58	1
3	4353024	4353111	4534	4621	87	RIGHT	G58a.EDF	G58	1
4	4357117	4357234	287	404	117	RIGHT	G58a.EDF	G58	1
4	4358071	4358391	1241	1561	320	RIGHT	G58a.EDF	G58	1
4	4362007	4362080	5177	5250	73	RIGHT	G58a.EDF	G58	1
5	4367579	4367698	480	599	119	RIGHT	G58a.EDF	G58	1
5	4368153	4368419	1054	1320	266	RIGHT	G58a.EDF	G58	1
6	4374966	4375085	61	180	119	RIGHT	G58a.EDF	G58	1
6	4375711	4375989	806	1084	278	RIGHT	G58a.EDF	G58	1
7	4384741	4384787	57	103	46	RIGHT	G58a.EDF	G58	1
7	4385325	4385633	641	949	308	RIGHT	G58a.EDF	G58	1
7	4385705	4385806	1021	1122	101	RIGHT	G58a.EDF	G58	1
7	4385962	4386104	1278	1420	142	RIGHT	G58a.EDF	G58	1
7	4389764	4389867	5080	5183	103	RIGHT	G58a.EDF	G58	1
7	4390641	4390788	5957	6104	147	RIGHT	G58a.EDF	G58	1
8	4394838	4395012	489	663	174	RIGHT	G58a.EDF	G58	1
8	4395757	4395867	1408	1518	110	RIGHT	G58a.EDF	G58	1
8	4398920	4399027	4571	4678	107	RIGHT	G58a.EDF	G58	1
9	4401191	4401277	58	144	86	RIGHT	G58a.EDF	G58	1
9	4401416	4401534	283	401	118	RIGHT	G58a.EDF	G58	1
9	4402998	4403097	1865	1964	99	RIGHT	G58a.EDF	G58	1
9	4406162	4406195	5029	5062	33	RIGHT	G58a.EDF	G58	1
10	4409585	4409720	589	724	135	RIGHT	G58a.EDF	G58	1
10	4409790	4409925	794	929	135	RIGHT	G58a.EDF	G58	1
11	4417977	4418087	247	357	110	RIGHT	G58a.EDF	G58	1
11	4418321	4418467	591	737	146	RIGHT	G58a.EDF	G58	1
11	4418521	4418664	791	934	143	RIGHT	G58a.EDF	G58	1
11	4419276	4419400	1546	1670	124	RIGHT	G58a.EDF	G58	1
11	4422049	4422152	4319	4422	103	RIGHT	G58a.EDF	G58	1
11	4423936	4424084	6206	6354	148	RIGHT	G58a.EDF	G58	1
11	4424174	4424307	6444	6577	133	RIGHT	G58a.EDF	G58	1
12	4427722	4427867	385	530	145	RIGHT	G58a.EDF	G58	1
12	4427929	4428049	592	712	120	RIGHT	G58a.EDF	G58	1
12	4433670	4433796	6333	6459	126	RIGHT	G58a.EDF	G58	1
13	4437950	4438093	58	201	143	RIGHT	G58a.EDF	G58	1
13	4438340	4438467	448	575	127	RIGHT	G58a.EDF	G58	1
13	4439534	4439656	1642	1764	122	RIGHT	G58a.EDF	G58	1
14	4445843	4445865	58	80	22	RIGHT	G58a.EDF	G58	1
14	4445937	4446071	152	286	134	RIGHT	G58a.EDF	G58	1
14	4446726	4447013	941	1228	287	RIGHT	G58a.EDF	G58	1
14	4447035	4447192	1250	1407	157	RIGHT	G58a.EDF	G58	1
14	4450777	4450881	4992	5096	104	RIGHT	G58a.EDF	G58	1
14	4452490	4452594	6705	6809	104	RIGHT	G58a.EDF	G58	1
15	4455592	4455839	58	305	247	RIGHT	G58a.EDF	G58	1
15	4455971	4456058	437	524	87	RIGHT	G58a.EDF	G58	1
15	4456135	4456274	601	740	139	RIGHT	G58a.EDF	G58	1
15	4461257	4461346	5723	5812	89	RIGHT	G58a.EDF	G58	1
16	4466626	4466760	83	217	134	RIGHT	G58a.EDF	G58	1
16	4466844	4466964	301	421	120	RIGHT	G58a.EDF	G58	1
16	4467179	4467305	636	762	126	RIGHT	G58a.EDF	G58	1
17	4475223	4475306	58	141	83	RIGHT	G58a.EDF	G58	1
17	4475427	4475545	262	380	118	RIGHT	G58a.EDF	G58	1
18	4485998	4486157	113	272	159	RIGHT	G58a.EDF	G58	1
18	4486244	4486375	359	490	131	RIGHT	G58a.EDF	G58	1
18	4486488	4486644	603	759	156	RIGHT	G58a.EDF	G58	1
18	4491693	4491810	5808	5925	117	RIGHT	G58a.EDF	G58	1
18	4492608	4492719	6723	6834	111	RIGHT	G58a.EDF	G58	1
18	4492956	4493008	7071	7123	52	RIGHT	G58a.EDF	G58	1
19	4495494	4495583	58	147	89	RIGHT	G58a.EDF	G58	1
19	4495651	4495762	215	326	111	RIGHT	G58a.EDF	G58	1
19	4496127	4496264	691	828	137	RIGHT	G58a.EDF	G58	1
19	4496340	4496485	904	1049	145	RIGHT	G58a.EDF	G58	1
19	4501786	4501938	6350	6502	152	RIGHT	G58a.EDF	G58	1
19	4502069	4502214	6633	6778	145	RIGHT	G58a.EDF	G58	1
20	4506126	4506314	58	246	188	RIGHT	G58a.EDF	G58	1
20	4506649	4506745	581	677	96	RIGHT	G58a.EDF	G58	1
20	4506863	4506995	795	927	132	RIGHT	G58a.EDF	G58	1
20	4507876	4508007	1808	1939	131	RIGHT	G58a.EDF	G58	1
21	4514870	4514939	57	126	69	RIGHT	G58a.EDF	G58	1
21	4515260	4515377	447	564	117	RIGHT	G58a.EDF	G58	1
21	4515454	4515604	641	791	150	RIGHT	G58a.EDF	G58	1
22	4523280	4523384	182	286	104	RIGHT	G58a.EDF	G58	1
22	4523769	4523897	671	799	128	RIGHT	G58a.EDF	G58	1
22	4523965	4524117	867	1019	152	RIGHT	G58a.EDF	G58	1
22	4524291	4524407	1193	1309	116	RIGHT	G58a.EDF	G58	1
22	4524772	4524904	1674	1806	132	RIGHT	G58a.EDF	G58	1
23	4532822	4532853	57	88	31	RIGHT	G58a.EDF	G58	1
23	4533351	4533656	586	891	305	RIGHT	G58a.EDF	G58	1
24	4543042	4543164	131	253	122	RIGHT	G58a.EDF	G58	1
24	4543379	4543496	468	585	117	RIGHT	G58a.EDF	G58	1
24	4543608	4543742	697	831	134	RIGHT	G58a.EDF	G58	1
24	4543854	4543950	943	1039	96	RIGHT	G58a.EDF	G58	1
24	4544126	4544246	1215	1335	120	RIGHT	G58a.EDF	G58	1
24	4544384	4544507	1473	1596	123	RIGHT	G58a.EDF	G58	1
25	4550904	4551142	58	296	238	RIGHT	G58a.EDF	G58	1
25	4552279	4552389	1433	1543	110	RIGHT	G58a.EDF	G58	1
25	4552518	4552650	1672	1804	132	RIGHT	G58a.EDF	G58	1
25	4555671	4555808	4825	4962	137	RIGHT	G58a.EDF	G58	1
26	4560038	4560084	57	103	46	RIGHT	G58a.EDF	G58	1
26	4560174	4560284	193	303	110	RIGHT	G58a.EDF	G58	1
26	4560642	4560775	661	794	133	RIGHT	G58a.EDF	G58	1
26	4560873	4561001	892	1020	128	RIGHT	G58a.EDF	G58	1
26	4565770	4565900	5789	5919	130	RIGHT	G58a.EDF	G58	1
27	4569886	4569932	57	103	46	RIGHT	G58a.EDF	G58	1
27	4569997	4570159	168	330	162	RIGHT	G58a.EDF	G58	1
27	4571120	4571263	1291	1434	143	RIGHT	G58a.EDF	G58	1
27	4571290	4571432	1461	1603	142	RIGHT	G58a.EDF	G58	1
27	4575225	4575373	5396	5544	148	RIGHT	G58a.EDF	G58	1
28	4579730	4579853	130	253	123	RIGHT	G58a.EDF	G58	1
28	4579896	4580012	296	412	116	RIGHT	G58a.EDF	G58	1
28	4580663	4580787	1063	1187	124	RIGHT	G58a.EDF	G58	1
28	4580866	4581011	1266	1411	145	RIGHT	G58a.EDF	G58	1
29	4589800	4589916	410	526	116	RIGHT	G58a.EDF	G58	1
29	4594370	4594482	4980	5092	112	RIGHT	G58a.EDF	G58	1
30	4599173	4599377	58	262	204	RIGHT	G58a.EDF	G58	1
30	4599485	4599569	370	454	84	RIGHT	G58a.EDF	G58	1
30	4599839	4599991	724	876	152	RIGHT	G58a.EDF	G58	1
30	4600125	4600265	1010	1150	140	RIGHT	G58a.EDF	G58	1
30	4603574	4603647	4459	4532	73	RIGHT	G58a.EDF	G58	1
30	4605431	4605544	6316	6429	113	RIGHT	G58a.EDF	G58	1
30	4605616	4605719	6501	6604	103	RIGHT	G58a.EDF	G58	1
31	4608855	4608937	58	140	82	RIGHT	G58a.EDF	G58	1
31	4609378	4609494	581	697	116	RIGHT	G58a.EDF	G58	1
31	4615737	4615858	6940	7061	121	RIGHT	G58a.EDF	G58	1
32	4619831	4620066	58	293	235	RIGHT	G58a.EDF	G58	1
32	4620564	4620873	791	1100	309	RIGHT	G58a.EDF	G58	1
32	4621005	4621139	1232	1366	134	RIGHT	G58a.EDF	G58	1
32	4621234	4621376	1461	1603	142	RIGHT	G58a.EDF	G58	1
32	4624271	4624346	4498	4573	75	RIGHT	G58a.EDF	G58	1
32	4625543	4625636	5770	5863	93	RIGHT	G58a.EDF	G58	1
32	4625700	4625828	5927	6055	128	RIGHT	G58a.EDF	G58	1
33	4629378	4629494	70	186	116	RIGHT	G58a.EDF	G58	1
33	4629550	4629713	242	405	163	RIGHT	G58a.EDF	G58	1
34	4637581	4637623	72	114	42	RIGHT	G58a.EDF	G58	1
34	4638418	4638525	909	1016	107	RIGHT	G58a.EDF	G58	1
34	4642036	4642139	4527	4630	103	RIGHT	G58a.EDF	G58	1
35	4645398	4645444	58	104	46	RIGHT	G58a.EDF	G58	1
35	4645506	4645647	166	307	141	RIGHT	G58a.EDF	G58	1
35	4645704	4645826	364	486	122	RIGHT	G58a.EDF	G58	1
35	4650042	4650162	4702	4822	120	RIGHT	G58a.EDF	G58	1
35	4650287	4650417	4947	5077	130	RIGHT	G58a.EDF	G58	1
35	4651908	4652029	6568	6689	121	RIGHT	G58a.EDF	G58	1
36	4655465	4655610	97	242	145	RIGHT	G58a.EDF	G58	1
36	4656329	4656451	961	1083	122	RIGHT	G58a.EDF	G58	1
36	4656498	4656647	1130	1279	149	RIGHT	G58a.EDF	G58	1
36	4656670	4656672	1302	1304	2	RIGHT	G58a.EDF	G58	1
36	4656816	4656905	1448	1537	89	RIGHT	G58a.EDF	G58	1
37	4664215	4664450	57	292	235	RIGHT	G58a.EDF	G58	1
37	4664537	4664644	379	486	107	RIGHT	G58a.EDF	G58	1
37	4665444	4665571	1286	1413	127	RIGHT	G58a.EDF	G58	1
37	4665599	4665726	1441	1568	127	RIGHT	G58a.EDF	G58	1
38	4673207	4673291	58	142	84	RIGHT	G58a.EDF	G58	1
38	4673748	4673894	599	745	146	RIGHT	G58a.EDF	G58	1
38	4673980	4674133	831	984	153	RIGHT	G58a.EDF	G58	1
39	4682102	4682339	57	294	237	RIGHT	G58a.EDF	G58	1
39	4682414	4682530	369	485	116	RIGHT	G58a.EDF	G58	1
39	4683476	4683568	1431	1523	92	RIGHT	G58a.EDF	G58	1
39	4683657	4683793	1612	1748	136	RIGHT	G58a.EDF	G58	1
39	4687226	4687335	5181	5290	109	RIGHT	G58a.EDF	G58	1
40	4691456	4691493	57	94	37	RIGHT	G58a.EDF	G58	1
40	4692627	4692778	1228	1379	151	RIGHT	G58a.EDF	G58	1
41	4699859	4699889	58	88	30	RIGHT	G58a.EDF	G58	1
41	4699997	4700112	196	311	115	RIGHT	G58a.EDF	G58	1
41	4700271	4700388	470	587	117	RIGHT	G58a.EDF	G58	1
41	4703448	4703542	3647	3741	94	RIGHT	G58a.EDF	G58	1
41	4703762	4703863	3961	4062	101	RIGHT	G58a.EDF	G58	1
41	4705633	4705766	5832	5965	133	RIGHT	G58a.EDF	G58	1
41	4705895	4706026	6094	6225	131	RIGHT	G58a.EDF	G58	1
41	4706720	4707040	6919	7239	320	RIGHT	G58a.EDF	G58	1
42	4710281	4710379	58	156	98	RIGHT	G58a.EDF	G58	1
42	4710471	4710612	248	389	141	RIGHT	G58a.EDF	G58	1
42	4711813	4711926	1590	1703	113	RIGHT	G58a.EDF	G58	1
43	4718432	4718488	69	125	56	RIGHT	G58a.EDF	G58	1
43	4718605	4718726	242	363	121	RIGHT	G58a.EDF	G58	1
44	4726721	4726993	58	330	272	RIGHT	G58a.EDF	G58	1
44	4727125	4727248	462	585	123	RIGHT	G58a.EDF	G58	1
44	4731531	4731633	4868	4970	102	RIGHT	G58a.EDF	G58	1
45	4735757	4736044	1539	1826	287	RIGHT	G58a.EDF	G58	1
45	4740402	4740523	6184	6305	121	RIGHT	G58a.EDF	G58	1
46	4742990	4743048	57	115	58	RIGHT	G58a.EDF	G58	1
46	4743177	4743294	244	361	117	RIGHT	G58a.EDF	G58	1
46	4744230	4744356	1297	1423	126	RIGHT	G58a.EDF	G58	1
46	4744450	4744590	1517	1657	140	RIGHT	G58a.EDF	G58	1
47	4753149	4753190	58	99	41	RIGHT	G58a.EDF	G58	1
47	4753260	4753426	169	335	166	RIGHT	G58a.EDF	G58	1
47	4754409	4754547	1318	1456	138	RIGHT	G58a.EDF	G58	1
47	4758842	4758918	5751	5827	76	RIGHT	G58a.EDF	G58	1
48	4761903	4762147	576	820	244	RIGHT	G58a.EDF	G58	1
48	4762168	4762172	841	845	4	RIGHT	G58a.EDF	G58	1
48	4765210	4765301	3883	3974	91	RIGHT	G58a.EDF	G58	1
49	4769456	4769491	58	93	35	RIGHT	G58a.EDF	G58	1
49	4769632	4769728	234	330	96	RIGHT	G58a.EDF	G58	1
49	4770600	4770706	1202	1308	106	RIGHT	G58a.EDF	G58	1
49	4770797	4770942	1399	1544	145	RIGHT	G58a.EDF	G58	1
50	4777200	4777240	57	97	40	RIGHT	G58a.EDF	G58	1
50	4777352	4777474	209	331	122	RIGHT	G58a.EDF	G58	1
50	4780142	4780263	2999	3120	121	RIGHT	G58a.EDF	G58	1
50	4781701	4781823	4558	4680	122	RIGHT	G58a.EDF	G58	1
50	4781914	4782061	4771	4918	147	RIGHT	G58a.EDF	G58	1
50	4782848	4782989	5705	5846	141	RIGHT	G58a.EDF	G58	1
50	4783895	4783977	6752	6834	82	RIGHT	G58a.EDF	G58	1
51	4785973	4786126	58	211	153	RIGHT	G58a.EDF	G58	1
51	4786258	4786358	343	443	100	RIGHT	G58a.EDF	G58	1
51	4786917	4787233	1002	1318	316	RIGHT	G58a.EDF	G58	1
51	4791255	4791386	5340	5471	131	RIGHT	G58a.EDF	G58	1
52	4794173	4794263	57	147	90	RIGHT	G58a.EDF	G58	1
52	4794375	4794533	259	417	158	RIGHT	G58a.EDF	G58	1
52	4794841	4794979	725	863	138	RIGHT	G58a.EDF	G58	1
52	4795199	4795328	1083	1212	129	RIGHT	G58a.EDF	G58	1
52	4795697	4795785	1581	1669	88	RIGHT	G58a.EDF	G58	1
52	4799713	4799863	5597	5747	150	RIGHT	G58a.EDF	G58	1
53	4803968	4804051	57	140	83	RIGHT	G58a.EDF	G58	1
53	4804172	4804318	261	407	146	RIGHT	G58a.EDF	G58	1
53	4804516	4804647	605	736	131	RIGHT	G58a.EDF	G58	1
53	4808270	4808396	4359	4485	126	RIGHT	G58a.EDF	G58	1
53	4808446	4808580	4535	4669	134	RIGHT	G58a.EDF	G58	1
53	4809702	4809773	5791	5862	71	RIGHT	G58a.EDF	G58	1
54	4812471	4812559	58	146	88	RIGHT	G58a.EDF	G58	1
54	4815507	4815637	3094	3224	130	RIGHT	G58a.EDF	G58	1
55	4821666	4821997	57	388	331	RIGHT	G58a.EDF	G58	1
55	4822075	4822201	466	592	126	RIGHT	G58a.EDF	G58	1
56	4831185	4831426	58	299	241	RIGHT	G58a.EDF	G58	1
56	4831594	4831701	467	574	107	RIGHT	G58a.EDF	G58	1
56	4831939	4832071	812	944	132	RIGHT	G58a.EDF	G58	1
56	4832151	4832291	1024	1164	140	RIGHT	G58a.EDF	G58	1
57	4840728	4840841	57	170	113	RIGHT	G58a.EDF	G58	1
57	4840873	4841011	202	340	138	RIGHT	G58a.EDF	G58	1
57	4841570	4841704	899	1033	134	RIGHT	G58a.EDF	G58	1
57	4841797	4841911	1126	1240	114	RIGHT	G58a.EDF	G58	1
58	4850035	4850147	794	906	112	RIGHT	G58a.EDF	G58	1
58	4853983	4854104	4742	4863	121	RIGHT	G58a.EDF	G58	1
59	4858013	4858069	57	113	56	RIGHT	G58a.EDF	G58	1
59	4858167	4858293	211	337	126	RIGHT	G58a.EDF	G58	1
59	4861649	4861767	3693	3811	118	RIGHT	G58a.EDF	G58	1
60	4866132	4866163	57	88	31	RIGHT	G58a.EDF	G58	1
60	4866397	4866489	322	414	92	RIGHT	G58a.EDF	G58	1
61	4873941	4873996	58	113	55	RIGHT	G58a.EDF	G58	1
61	4874147	4874250	264	367	103	RIGHT	G58a.EDF	G58	1
61	4875247	4875392	1364	1509	145	RIGHT	G58a.EDF	G58	1
61	4879132	4879257	5249	5374	125	RIGHT	G58a.EDF	G58	1
62	4882884	4883062	58	236	178	RIGHT	G58a.EDF	G58	1
62	4883426	4883540	600	714	114	RIGHT	G58a.EDF	G58	1
62	4887927	4888065	5101	5239	138	RIGHT	G58a.EDF	G58	1
63	4890480	4890511	58	89	31	RIGHT	G58a.EDF	G58	1
63	4890580	4890732	158	310	152	RIGHT	G58a.EDF	G58	1
63	4894821	4894885	4399	4463	64	RIGHT	G58a.EDF	G58	1
63	4896596	4896716	6174	6294	120	RIGHT	G58a.EDF	G58	1
64	4899616	4899667	58	109	51	RIGHT	G58a.EDF	G58	1
64	4900336	4900451	778	893	115	RIGHT	G58a.EDF	G58	1
64	4900472	4900479	914	921	7	RIGHT	G58a.EDF	G58	1
64	4900574	4900675	1016	1117	101	RIGHT	G58a.EDF	G58	1
64	4905071	4905192	5513	5634	121	RIGHT	G58a.EDF	G58	1
65	4908422	4908565	91	234	143	RIGHT	G58a.EDF	G58	1
65	4908671	4908777	340	446	106	RIGHT	G58a.EDF	G58	1
65	4912243	4912356	3912	4025	113	RIGHT	G58a.EDF	G58	1
65	4912665	4912805	4334	4474	140	RIGHT	G58a.EDF	G58	1
65	4912914	4913048	4583	4717	134	RIGHT	G58a.EDF	G58	1
66	4916004	4916166	74	236	162	RIGHT	G58a.EDF	G58	1
66	4920583	4920714	4653	4784	131	RIGHT	G58a.EDF	G58	1
66	4921677	4921795	5747	5865	118	RIGHT	G58a.EDF	G58	1
66	4921885	4921979	5955	6049	94	RIGHT	G58a.EDF	G58	1
66	4922808	4922953	6878	7023	145	RIGHT	G58a.EDF	G58	1
67	4927484	4927641	80	237	157	RIGHT	G58a.EDF	G58	1
67	4929065	4929190	1661	1786	125	RIGHT	G58a.EDF	G58	1
67	4931121	4931250	3717	3846	129	RIGHT	G58a.EDF	G58	1
67	4931328	4931463	3924	4059	135	RIGHT	G58a.EDF	G58	1
67	4932636	4932740	5232	5336	104	RIGHT	G58a.EDF	G58	1
67	4932852	4932982	5448	5578	130	RIGHT	G58a.EDF	G58	1
68	4937190	4937328	1824	1962	138	RIGHT	G58a.EDF	G58	1
68	4939225	4939321	3859	3955	96	RIGHT	G58a.EDF	G58	1
68	4939756	4939903	4390	4537	147	RIGHT	G58a.EDF	G58	1
69	4944058	4944148	57	147	90	RIGHT	G58a.EDF	G58	1
69	4944227	4944384	226	383	157	RIGHT	G58a.EDF	G58	1
69	4944582	4944730	581	729	148	RIGHT	G58a.EDF	G58	1
69	4945519	4945871	1518	1870	352	RIGHT	G58a.EDF	G58	1
69	4947026	4947143	3025	3142	117	RIGHT	G58a.EDF	G58	1
69	4948430	4948763	4429	4762	333	RIGHT	G58a.EDF	G58	1
69	4950035	4950331	6034	6330	296	RIGHT	G58a.EDF	G58	1
70	4953047	4953165	66	184	118	RIGHT	G58a.EDF	G58	1
71	4960285	4960326	58	99	41	RIGHT	G58a.EDF	G58	1
71	4960605	4960949	378	722	344	RIGHT	G58a.EDF	G58	1
71	4966732	4966795	6505	6568	63	RIGHT	G58a.EDF	G58	1
71	4966927	4967056	6700	6829	129	RIGHT	G58a.EDF	G58	1
72	4969399	4969465	69	135	66	RIGHT	G58a.EDF	G58	1
72	4973206	4973333	3876	4003	127	RIGHT	G58a.EDF	G58	1
73	4976151	4976177	57	83	26	RIGHT	G58a.EDF	G58	1
73	4976299	4976423	205	329	124	RIGHT	G58a.EDF	G58	1
73	4981825	4981953	5731	5859	128	RIGHT	G58a.EDF	G58	1
73	4982083	4982209	5989	6115	126	RIGHT	G58a.EDF	G58	1
74	4984686	4984776	58	148	90	RIGHT	G58a.EDF	G58	1
74	4985101	4985222	473	594	121	RIGHT	G58a.EDF	G58	1
74	4985344	4985463	716	835	119	RIGHT	G58a.EDF	G58	1
74	4990956	4991057	6328	6429	101	RIGHT	G58a.EDF	G58	1
75	4993955	4994122	58	225	167	RIGHT	G58a.EDF	G58	1
75	4995015	4995160	1118	1263	145	RIGHT	G58a.EDF	G58	1
75	4995245	4995375	1348	1478	130	RIGHT	G58a.EDF	G58	1
76	5001637	5001656	57	76	19	RIGHT	G58a.EDF	G58	1
76	5001799	5001914	219	334	115	RIGHT	G58a.EDF	G58	1
76	5005311	5005429	3731	3849	118	RIGHT	G58a.EDF	G58	1
76	5006826	5006966	5246	5386	140	RIGHT	G58a.EDF	G58	1
77	5010546	5010623	57	134	77	RIGHT	G58a.EDF	G58	1
77	5010705	5010822	216	333	117	RIGHT	G58a.EDF	G58	1
77	5011010	5011134	521	645	124	RIGHT	G58a.EDF	G58	1
77	5014481	5014543	3992	4054	62	RIGHT	G58a.EDF	G58	1
77	5015642	5015704	5153	5215	62	RIGHT	G58a.EDF	G58	1
77	5015885	5015974	5396	5485	89	RIGHT	G58a.EDF	G58	1
78	5019148	5019291	81	224	143	RIGHT	G58a.EDF	G58	1
78	5022737	5022851	3670	3784	114	RIGHT	G58a.EDF	G58	1
78	5023605	5023706	4538	4639	101	RIGHT	G58a.EDF	G58	1
78	5023835	5023974	4768	4907	139	RIGHT	G58a.EDF	G58	1
78	5024648	5024774	5581	5707	126	RIGHT	G58a.EDF	G58	1
79	5029340	5029608	94	362	268	RIGHT	G58a.EDF	G58	1
79	5035122	5035221	5876	5975	99	RIGHT	G58a.EDF	G58	1
79	5035536	5035699	6290	6453	163	RIGHT	G58a.EDF	G58	1
79	5035837	5035926	6591	6680	89	RIGHT	G58a.EDF	G58	1
79	5036417	5036555	7171	7309	138	RIGHT	G58a.EDF	G58	1
79	5036646	5036673	7400	7427	27	RIGHT	G58a.EDF	G58	1
80	5038953	5038996	58	101	43	RIGHT	G58a.EDF	G58	1
80	5040191	5040341	1296	1446	150	RIGHT	G58a.EDF	G58	1
80	5042939	5043048	4044	4153	109	RIGHT	G58a.EDF	G58	1
80	5045849	5045969	6954	7074	120	RIGHT	G58a.EDF	G58	1
81	5048740	5048857	282	399	117	RIGHT	G58a.EDF	G58	1
81	5052358	5052454	3900	3996	96	RIGHT	G58a.EDF	G58	1
82	5056385	5056477	57	149	92	RIGHT	G58a.EDF	G58	1
82	5056956	5057084	628	756	128	RIGHT	G58a.EDF	G58	1
82	5057289	5057427	961	1099	138	RIGHT	G58a.EDF	G58	1
83	5064070	5064256	60	246	186	RIGHT	G58a.EDF	G58	1
83	5069483	5069594	5473	5584	111	RIGHT	G58a.EDF	G58	1
83	5069835	5069992	5825	5982	157	RIGHT	G58a.EDF	G58	1
84	5073345	5073457	58	170	112	RIGHT	G58a.EDF	G58	1
84	5076573	5076691	3286	3404	118	RIGHT	G58a.EDF	G58	1
84	5076952	5077112	3665	3825	160	RIGHT	G58a.EDF	G58	1
84	5077640	5077802	4353	4515	162	RIGHT	G58a.EDF	G58	1
84	5077953	5078107	4666	4820	154	RIGHT	G58a.EDF	G58	1
85	5081270	5081377	58	165	107	RIGHT	G58a.EDF	G58	1
85	5081531	5081652	319	440	121	RIGHT	G58a.EDF	G58	1
85	5084494	5084618	3282	3406	124	RIGHT	G58a.EDF	G58	1
85	5085640	5085760	4428	4548	120	RIGHT	G58a.EDF	G58	1
86	5089033	5089080	72	119	47	RIGHT	G58a.EDF	G58	1
86	5089642	5089823	681	862	181	RIGHT	G58a.EDF	G58	1
86	5093360	5093468	4399	4507	108	RIGHT	G58a.EDF	G58	1
86	5093550	5093676	4589	4715	126	RIGHT	G58a.EDF	G58	1
86	5095228	5095353	6267	6392	125	RIGHT	G58a.EDF	G58	1
86	5095603	5095775	6642	6814	172	RIGHT	G58a.EDF	G58	1
86	5095992	5096121	7031	7160	129	RIGHT	G58a.EDF	G58	1
87	5100121	5100229	1329	1437	108	RIGHT	G58a.EDF	G58	1
87	5100268	5100277	1476	1485	9	RIGHT	G58a.EDF	G58	1
87	5100311	5100468	1519	1676	157	RIGHT	G58a.EDF	G58	1
87	5104294	5104408	5502	5616	114	RIGHT	G58a.EDF	G58	1
87	5104561	5104699	5769	5907	138	RIGHT	G58a.EDF	G58	1
88	5108174	5108280	1126	1232	106	RIGHT	G58a.EDF	G58	1
88	5108445	5108561	1397	1513	116	RIGHT	G58a.EDF	G58	1
88	5108768	5108892	1720	1844	124	RIGHT	G58a.EDF	G58	1
88	5112767	5112892	5719	5844	125	RIGHT	G58a.EDF	G58	1
89	5115925	5116034	426	535	109	RIGHT	G58a.EDF	G58	1
89	5116174	5116310	675	811	136	RIGHT	G58a.EDF	G58	1
89	5120390	5120473	4891	4974	83	RIGHT	G58a.EDF	G58	1
89	5121187	5121355	5688	5856	168	RIGHT	G58a.EDF	G58	1
89	5121731	5121899	6232	6400	168	RIGHT	G58a.EDF	G58	1
90	5125052	5125195	57	200	143	RIGHT	G58a.EDF	G58	1
90	5125927	5126070	932	1075	143	RIGHT	G58a.EDF	G58	1
90	5126561	5126737	1566	1742	176	RIGHT	G58a.EDF	G58	1
91	5133685	5133755	58	128	70	RIGHT	G58a.EDF	G58	1
91	5136516	5136579	2889	2952	63	RIGHT	G58a.EDF	G58	1
92	5142587	5142728	733	874	141	RIGHT	G58a.EDF	G58	1
92	5144787	5144865	2933	3011	78	RIGHT	G58a.EDF	G58	1
92	5144905	5145027	3051	3173	122	RIGHT	G58a.EDF	G58	1
92	5146757	5146875	4903	5021	118	RIGHT	G58a.EDF	G58	1
93	5149508	5149634	108	234	126	RIGHT	G58a.EDF	G58	1
93	5153329	5153435	3929	4035	106	RIGHT	G58a.EDF	G58	1
94	5156922	5156973	58	109	51	RIGHT	G58a.EDF	G58	1
94	5157433	5157541	569	677	108	RIGHT	G58a.EDF	G58	1
94	5159648	5159797	2784	2933	149	RIGHT	G58a.EDF	G58	1
95	5164832	5164917	58	143	85	RIGHT	G58a.EDF	G58	1
95	5165431	5165561	657	787	130	RIGHT	G58a.EDF	G58	1
95	5168099	5168197	3325	3423	98	RIGHT	G58a.EDF	G58	1
96	5172302	5172374	57	129	72	RIGHT	G58a.EDF	G58	1
96	5173310	5173439	1065	1194	129	RIGHT	G58a.EDF	G58	1
96	5173577	5173725	1332	1480	148	RIGHT	G58a.EDF	G58	1
96	5177626	5177680	5381	5435	54	RIGHT	G58a.EDF	G58	1
96	5177832	5177963	5587	5718	131	RIGHT	G58a.EDF	G58	1
97	5180501	5180585	58	142	84	RIGHT	G58a.EDF	G58	1
97	5181692	5181846	1249	1403	154	RIGHT	G58a.EDF	G58	1
97	5182172	5182459	1729	2016	287	RIGHT	G58a.EDF	G58	1
98	5188970	5189124	1022	1176	154	RIGHT	G58a.EDF	G58	1
98	5193472	5193520	5524	5572	48	RIGHT	G58a.EDF	G58	1
99	5197577	5197705	354	482	128	RIGHT	G58a.EDF	G58	1
99	5198570	5198699	1347	1476	129	RIGHT	G58a.EDF	G58	1
99	5202641	5202646	5418	5423	5	RIGHT	G58a.EDF	G58	1
100	5205738	5205892	233	387	154	RIGHT	G58a.EDF	G58	1
100	5206658	5206769	1153	1264	111	RIGHT	G58a.EDF	G58	1
100	5210785	5210885	5280	5380	100	RIGHT	G58a.EDF	G58	1
101	5213517	5213657	58	198	140	RIGHT	G58a.EDF	G58	1
101	5214110	5214288	651	829	178	RIGHT	G58a.EDF	G58	1
101	5214404	5214570	945	1111	166	RIGHT	G58a.EDF	G58	1
101	5217941	5218038	4482	4579	97	RIGHT	G58a.EDF	G58	1
101	5219421	5219518	5962	6059	97	RIGHT	G58a.EDF	G58	1
102	5222644	5222769	606	731	125	RIGHT	G58a.EDF	G58	1
102	5222857	5223013	819	975	156	RIGHT	G58a.EDF	G58	1
102	5225628	5225762	3590	3724	134	RIGHT	G58a.EDF	G58	1
103	5230976	5231104	57	185	128	RIGHT	G58a.EDF	G58	1
103	5231422	5231541	503	622	119	RIGHT	G58a.EDF	G58	1
103	5231711	5231853	792	934	142	RIGHT	G58a.EDF	G58	1
103	5236680	5236787	5761	5868	107	RIGHT	G58a.EDF	G58	1
103	5237108	5237242	6189	6323	134	RIGHT	G58a.EDF	G58	1
104	5239984	5240097	124	237	113	RIGHT	G58a.EDF	G58	1
104	5240579	5240758	719	898	179	RIGHT	G58a.EDF	G58	1
104	5244589	5244673	4729	4813	84	RIGHT	G58a.EDF	G58	1
105	5248846	5248968	75	197	122	RIGHT	G58a.EDF	G58	1
105	5249930	5250093	1159	1322	163	RIGHT	G58a.EDF	G58	1
105	5250497	5250631	1726	1860	134	RIGHT	G58a.EDF	G58	1
105	5253459	5253561	4688	4790	102	RIGHT	G58a.EDF	G58	1
106	5257907	5257950	70	113	43	RIGHT	G58a.EDF	G58	1
106	5258275	5258400	438	563	125	RIGHT	G58a.EDF	G58	1
106	5262118	5262119	4281	4282	1	RIGHT	G58a.EDF	G58	1
107	5266595	5266691	58	154	96	RIGHT	G58a.EDF	G58	1
107	5267168	5267320	631	783	152	RIGHT	G58a.EDF	G58	1
107	5270428	5270544	3891	4007	116	RIGHT	G58a.EDF	G58	1
107	5271014	5271166	4477	4629	152	RIGHT	G58a.EDF	G58	1
108	5274728	5274899	632	803	171	RIGHT	G58a.EDF	G58	1
108	5280718	5281086	6622	6990	368	RIGHT	G58a.EDF	G58	1
109	5283649	5283776	58	185	127	RIGHT	G58a.EDF	G58	1
109	5284405	5284797	814	1206	392	RIGHT	G58a.EDF	G58	1
109	5287333	5287471	3742	3880	138	RIGHT	G58a.EDF	G58	1
109	5288277	5288412	4686	4821	135	RIGHT	G58a.EDF	G58	1
110	5293246	5293554	1547	1855	308	RIGHT	G58a.EDF	G58	1
111	5300322	5300474	1531	1683	152	RIGHT	G58a.EDF	G58	1
111	5301703	5301851	2912	3060	148	RIGHT	G58a.EDF	G58	1
111	5304048	5304191	5257	5400	143	RIGHT	G58a.EDF	G58	1
111	5304954	5305120	6163	6329	166	RIGHT	G58a.EDF	G58	1
112	5309492	5309624	1533	1665	132	RIGHT	G58a.EDF	G58	1
112	5313592	5313735	5633	5776	143	RIGHT	G58a.EDF	G58	1
113	5317796	5317978	79	261	182	RIGHT	G58a.EDF	G58	1
113	5318024	5318176	307	459	152	RIGHT	G58a.EDF	G58	1
113	5319266	5319390	1549	1673	124	RIGHT	G58a.EDF	G58	1
113	5322200	5322321	4483	4604	121	RIGHT	G58a.EDF	G58	1
113	5323139	5323269	5422	5552	130	RIGHT	G58a.EDF	G58	1
114	5326716	5326855	137	276	139	RIGHT	G58a.EDF	G58	1
114	5331048	5331072	4469	4493	24	RIGHT	G58a.EDF	G58	1
114	5331284	5331343	4705	4764	59	RIGHT	G58a.EDF	G58	1
115	5335295	5335423	141	269	128	RIGHT	G58a.EDF	G58	1
115	5339068	5339198	3914	4044	130	RIGHT	G58a.EDF	G58	1
115	5340495	5340561	5341	5407	66	RIGHT	G58a.EDF	G58	1
116	5346206	5346339	3258	3391	133	RIGHT	G58a.EDF	G58	1
116	5348466	5348581	5518	5633	115	RIGHT	G58a.EDF	G58	1
116	5349116	5349278	6168	6330	162	RIGHT	G58a.EDF	G58	1
117	5354489	5354588	2769	2868	99	RIGHT	G58a.EDF	G58	1
117	5356704	5356827	4984	5107	123	RIGHT	G58a.EDF	G58	1
118	5360126	5360303	59	236	177	RIGHT	G58a.EDF	G58	1
118	5361153	5361252	1086	1185	99	RIGHT	G58a.EDF	G58	1
118	5364648	5364709	4581	4642	61	RIGHT	G58a.EDF	G58	1
118	5365815	5366219	5748	6152	404	RIGHT	G58a.EDF	G58	1
119	5370607	5370759	375	527	152	RIGHT	G58a.EDF	G58	1
119	5371057	5371189	825	957	132	RIGHT	G58a.EDF	G58	1
120	5377396	5377566	58	228	170	RIGHT	G58a.EDF	G58	1
120	5380835	5380958	3497	3620	123	RIGHT	G58a.EDF	G58	1
1	6408325	6408457	1387	1519	132	RIGHT	G58b.EDF	G58	2
2	6417243	6417314	58	129	71	RIGHT	G58b.EDF	G58	2
2	6417398	6417529	213	344	131	RIGHT	G58b.EDF	G58	2
2	6417700	6417815	515	630	115	RIGHT	G58b.EDF	G58	2
2	6417885	6418040	700	855	155	RIGHT	G58b.EDF	G58	2
2	6418911	6419025	1726	1840	114	RIGHT	G58b.EDF	G58	2
3	6426033	6426113	58	138	80	RIGHT	G58b.EDF	G58	2
3	6426205	6426334	230	359	129	RIGHT	G58b.EDF	G58	2
3	6431805	6431921	5830	5946	116	RIGHT	G58b.EDF	G58	2
3	6432110	6432222	6135	6247	112	RIGHT	G58b.EDF	G58	2
4	6435186	6435457	57	328	271	RIGHT	G58b.EDF	G58	2
4	6435514	6435637	385	508	123	RIGHT	G58b.EDF	G58	2
4	6436620	6436689	1491	1560	69	RIGHT	G58b.EDF	G58	2
4	6436786	6436926	1657	1797	140	RIGHT	G58b.EDF	G58	2
4	6437017	6437117	1888	1988	100	RIGHT	G58b.EDF	G58	2
5	6443808	6444011	58	261	203	RIGHT	G58b.EDF	G58	2
5	6445397	6445708	1647	1958	311	RIGHT	G58b.EDF	G58	2
5	6449462	6449582	5712	5832	120	RIGHT	G58b.EDF	G58	2
6	6452215	6452277	58	120	62	RIGHT	G58b.EDF	G58	2
6	6452489	6452727	332	570	238	RIGHT	G58b.EDF	G58	2
6	6452808	6452918	651	761	110	RIGHT	G58b.EDF	G58	2
7	6459961	6460112	71	222	151	RIGHT	G58b.EDF	G58	2
7	6462385	6462516	2495	2626	131	RIGHT	G58b.EDF	G58	2
7	6462589	6462731	2699	2841	142	RIGHT	G58b.EDF	G58	2
7	6463358	6463690	3468	3800	332	RIGHT	G58b.EDF	G58	2
7	6463762	6463919	3872	4029	157	RIGHT	G58b.EDF	G58	2
7	6464048	6464198	4158	4308	150	RIGHT	G58b.EDF	G58	2
7	6465154	6465446	5264	5556	292	RIGHT	G58b.EDF	G58	2
8	6470224	6470270	57	103	46	RIGHT	G58b.EDF	G58	2
8	6470349	6470498	182	331	149	RIGHT	G58b.EDF	G58	2
8	6470521	6470526	354	359	5	RIGHT	G58b.EDF	G58	2
8	6470580	6470706	413	539	126	RIGHT	G58b.EDF	G58	2
8	6475081	6475155	4914	4988	74	RIGHT	G58b.EDF	G58	2
9	6481343	6481472	92	221	129	RIGHT	G58b.EDF	G58	2
9	6481586	6481692	335	441	106	RIGHT	G58b.EDF	G58	2
9	6481805	6481961	554	710	156	RIGHT	G58b.EDF	G58	2
9	6482392	6482676	1141	1425	284	RIGHT	G58b.EDF	G58	2
10	6488934	6488998	58	122	64	RIGHT	G58b.EDF	G58	2
10	6489075	6489222	199	346	147	RIGHT	G58b.EDF	G58	2
10	6489374	6489496	498	620	122	RIGHT	G58b.EDF	G58	2
10	6489593	6489724	717	848	131	RIGHT	G58b.EDF	G58	2
11	6497662	6497862	58	258	200	RIGHT	G58b.EDF	G58	2
11	6498215	6498535	611	931	320	RIGHT	G58b.EDF	G58	2
11	6498660	6498807	1056	1203	147	RIGHT	G58b.EDF	G58	2
11	6499245	6499390	1641	1786	145	RIGHT	G58b.EDF	G58	2
11	6502843	6503236	5239	5632	393	RIGHT	G58b.EDF	G58	2
12	6506658	6506770	163	275	112	RIGHT	G58b.EDF	G58	2
12	6511972	6512109	5477	5614	137	RIGHT	G58b.EDF	G58	2
12	6512170	6512250	5675	5755	80	RIGHT	G58b.EDF	G58	2
13	6515342	6515460	121	239	118	RIGHT	G58b.EDF	G58	2
13	6515589	6515693	368	472	104	RIGHT	G58b.EDF	G58	2
13	6516699	6516992	1478	1771	293	RIGHT	G58b.EDF	G58	2
14	6522465	6522511	58	104	46	RIGHT	G58b.EDF	G58	2
14	6522569	6522718	162	311	149	RIGHT	G58b.EDF	G58	2
14	6523916	6524189	1509	1782	273	RIGHT	G58b.EDF	G58	2
14	6524258	6524405	1851	1998	147	RIGHT	G58b.EDF	G58	2
14	6528223	6528332	5816	5925	109	RIGHT	G58b.EDF	G58	2
14	6528463	6528574	6056	6167	111	RIGHT	G58b.EDF	G58	2
15	6531435	6531582	135	282	147	RIGHT	G58b.EDF	G58	2
15	6531672	6531799	372	499	127	RIGHT	G58b.EDF	G58	2
15	6531963	6532111	663	811	148	RIGHT	G58b.EDF	G58	2
15	6532133	6532379	833	1079	246	RIGHT	G58b.EDF	G58	2
16	6538805	6538882	58	135	77	RIGHT	G58b.EDF	G58	2
16	6538911	6539076	164	329	165	RIGHT	G58b.EDF	G58	2
16	6539287	6539409	540	662	122	RIGHT	G58b.EDF	G58	2
16	6539522	6539626	775	879	104	RIGHT	G58b.EDF	G58	2
17	6547077	6547213	106	242	136	RIGHT	G58b.EDF	G58	2
17	6547710	6547994	739	1023	284	RIGHT	G58b.EDF	G58	2
18	6554065	6554252	58	245	187	RIGHT	G58b.EDF	G58	2
18	6554727	6554853	720	846	126	RIGHT	G58b.EDF	G58	2
18	6554879	6555070	872	1063	191	RIGHT	G58b.EDF	G58	2
18	6555138	6555265	1131	1258	127	RIGHT	G58b.EDF	G58	2
18	6555422	6555550	1415	1543	128	RIGHT	G58b.EDF	G58	2
19	6562581	6562708	61	188	127	RIGHT	G58b.EDF	G58	2
19	6562942	6563082	422	562	140	RIGHT	G58b.EDF	G58	2
19	6563205	6563342	685	822	137	RIGHT	G58b.EDF	G58	2
19	6563476	6563594	956	1074	118	RIGHT	G58b.EDF	G58	2
19	6563811	6563930	1291	1410	119	RIGHT	G58b.EDF	G58	2
20	6571216	6571285	58	127	69	RIGHT	G58b.EDF	G58	2
20	6571358	6571497	200	339	139	RIGHT	G58b.EDF	G58	2
20	6572193	6572509	1035	1351	316	RIGHT	G58b.EDF	G58	2
20	6572601	6572749	1443	1591	148	RIGHT	G58b.EDF	G58	2
21	6580153	6580241	57	145	88	RIGHT	G58b.EDF	G58	2
21	6580304	6580451	208	355	147	RIGHT	G58b.EDF	G58	2
21	6580564	6580665	468	569	101	RIGHT	G58b.EDF	G58	2
21	6580821	6580945	725	849	124	RIGHT	G58b.EDF	G58	2
21	6580979	6581152	883	1056	173	RIGHT	G58b.EDF	G58	2
21	6581246	6581395	1150	1299	149	RIGHT	G58b.EDF	G58	2
21	6581503	6581624	1407	1528	121	RIGHT	G58b.EDF	G58	2
21	6585581	6585617	5485	5521	36	RIGHT	G58b.EDF	G58	2
22	6588442	6588814	593	965	372	RIGHT	G58b.EDF	G58	2
22	6588838	6589019	989	1170	181	RIGHT	G58b.EDF	G58	2
22	6592870	6593021	5021	5172	151	RIGHT	G58b.EDF	G58	2
23	6595789	6596229	57	497	440	RIGHT	G58b.EDF	G58	2
23	6596307	6596460	575	728	153	RIGHT	G58b.EDF	G58	2
23	6599406	6599496	3674	3764	90	RIGHT	G58b.EDF	G58	2
24	6605133	6605266	133	266	133	RIGHT	G58b.EDF	G58	2
24	6605655	6605793	655	793	138	RIGHT	G58b.EDF	G58	2
24	6605912	6606064	912	1064	152	RIGHT	G58b.EDF	G58	2
24	6610489	6610592	5489	5592	103	RIGHT	G58b.EDF	G58	2
25	6614464	6614494	58	88	30	RIGHT	G58b.EDF	G58	2
25	6614547	6614724	141	318	177	RIGHT	G58b.EDF	G58	2
25	6614794	6614948	388	542	154	RIGHT	G58b.EDF	G58	2
25	6615113	6615274	707	868	161	RIGHT	G58b.EDF	G58	2
26	6622737	6622892	57	212	155	RIGHT	G58b.EDF	G58	2
26	6623000	6623145	320	465	145	RIGHT	G58b.EDF	G58	2
26	6626979	6627079	4299	4399	100	RIGHT	G58b.EDF	G58	2
26	6627148	6627298	4468	4618	150	RIGHT	G58b.EDF	G58	2
27	6629869	6629923	57	111	54	RIGHT	G58b.EDF	G58	2
27	6630042	6630212	230	400	170	RIGHT	G58b.EDF	G58	2
27	6630265	6630426	453	614	161	RIGHT	G58b.EDF	G58	2
27	6630562	6630720	750	908	158	RIGHT	G58b.EDF	G58	2
28	6639330	6639479	98	247	149	RIGHT	G58b.EDF	G58	2
28	6639640	6639781	408	549	141	RIGHT	G58b.EDF	G58	2
28	6639875	6640032	643	800	157	RIGHT	G58b.EDF	G58	2
28	6640155	6640290	923	1058	135	RIGHT	G58b.EDF	G58	2
28	6640462	6640641	1230	1409	179	RIGHT	G58b.EDF	G58	2
29	6648491	6648642	133	284	151	RIGHT	G58b.EDF	G58	2
29	6648996	6649158	638	800	162	RIGHT	G58b.EDF	G58	2
29	6649211	6649353	853	995	142	RIGHT	G58b.EDF	G58	2
29	6649490	6649633	1132	1275	143	RIGHT	G58b.EDF	G58	2
29	6652734	6652875	4376	4517	141	RIGHT	G58b.EDF	G58	2
29	6653036	6653177	4678	4819	141	RIGHT	G58b.EDF	G58	2
29	6653384	6653569	5026	5211	185	RIGHT	G58b.EDF	G58	2
29	6654027	6654421	5669	6063	394	RIGHT	G58b.EDF	G58	2
30	6656983	6657311	57	385	328	RIGHT	G58b.EDF	G58	2
30	6657778	6658173	852	1247	395	RIGHT	G58b.EDF	G58	2
30	6658224	6658549	1298	1623	325	RIGHT	G58b.EDF	G58	2
31	6663939	6663980	58	99	41	RIGHT	G58b.EDF	G58	2
31	6664043	6664433	162	552	390	RIGHT	G58b.EDF	G58	2
31	6664555	6664689	674	808	134	RIGHT	G58b.EDF	G58	2
31	6664884	6665012	1003	1131	128	RIGHT	G58b.EDF	G58	2
31	6665046	6665055	1165	1174	9	RIGHT	G58b.EDF	G58	2
31	6669671	6669806	5790	5925	135	RIGHT	G58b.EDF	G58	2
31	6671045	6671159	7164	7278	114	RIGHT	G58b.EDF	G58	2
32	6674263	6674271	82	90	8	RIGHT	G58b.EDF	G58	2
32	6674330	6674481	149	300	151	RIGHT	G58b.EDF	G58	2
32	6674507	6674513	326	332	6	RIGHT	G58b.EDF	G58	2
32	6674813	6675153	632	972	340	RIGHT	G58b.EDF	G58	2
32	6675185	6675194	1004	1013	9	RIGHT	G58b.EDF	G58	2
33	6682534	6682539	90	95	5	RIGHT	G58b.EDF	G58	2
33	6682637	6682755	193	311	118	RIGHT	G58b.EDF	G58	2
33	6682779	6682782	335	338	3	RIGHT	G58b.EDF	G58	2
34	6691037	6691123	58	144	86	RIGHT	G58b.EDF	G58	2
34	6691721	6692085	742	1106	364	RIGHT	G58b.EDF	G58	2
35	6699186	6699407	57	278	221	RIGHT	G58b.EDF	G58	2
35	6699452	6699582	323	453	130	RIGHT	G58b.EDF	G58	2
35	6699611	6699620	482	491	9	RIGHT	G58b.EDF	G58	2
35	6699664	6699975	535	846	311	RIGHT	G58b.EDF	G58	2
35	6701557	6701678	2428	2549	121	RIGHT	G58b.EDF	G58	2
35	6704469	6704470	5340	5341	1	RIGHT	G58b.EDF	G58	2
36	6706646	6706685	58	97	39	RIGHT	G58b.EDF	G58	2
36	6706790	6707227	202	639	437	RIGHT	G58b.EDF	G58	2
36	6708350	6708460	1762	1872	110	RIGHT	G58b.EDF	G58	2
36	6711706	6711848	5118	5260	142	RIGHT	G58b.EDF	G58	2
37	6716067	6716450	692	1075	383	RIGHT	G58b.EDF	G58	2
37	6720943	6721055	5568	5680	112	RIGHT	G58b.EDF	G58	2
37	6721141	6721286	5766	5911	145	RIGHT	G58b.EDF	G58	2
37	6721966	6722103	6591	6728	137	RIGHT	G58b.EDF	G58	2
38	6724958	6725046	58	146	88	RIGHT	G58b.EDF	G58	2
38	6725114	6725290	214	390	176	RIGHT	G58b.EDF	G58	2
38	6725413	6725557	513	657	144	RIGHT	G58b.EDF	G58	2
38	6725599	6725788	699	888	189	RIGHT	G58b.EDF	G58	2
38	6725851	6726026	951	1126	175	RIGHT	G58b.EDF	G58	2
38	6726145	6726283	1245	1383	138	RIGHT	G58b.EDF	G58	2
39	6734339	6734731	63	455	392	RIGHT	G58b.EDF	G58	2
40	6743633	6744015	58	440	382	RIGHT	G58b.EDF	G58	2
40	6744226	6744392	651	817	166	RIGHT	G58b.EDF	G58	2
40	6744465	6744611	890	1036	146	RIGHT	G58b.EDF	G58	2
41	6752526	6752982	539	995	456	RIGHT	G58b.EDF	G58	2
41	6753741	6753895	1754	1908	154	RIGHT	G58b.EDF	G58	2
41	6757196	6757293	5209	5306	97	RIGHT	G58b.EDF	G58	2
41	6757351	6757443	5364	5456	92	RIGHT	G58b.EDF	G58	2
42	6760363	6760501	58	196	138	RIGHT	G58b.EDF	G58	2
42	6760552	6760709	247	404	157	RIGHT	G58b.EDF	G58	2
42	6760960	6761074	655	769	114	RIGHT	G58b.EDF	G58	2
43	6768184	6768347	58	221	163	RIGHT	G58b.EDF	G58	2
43	6769652	6769807	1526	1681	155	RIGHT	G58b.EDF	G58	2
43	6771865	6771965	3739	3839	100	RIGHT	G58b.EDF	G58	2
43	6772059	6772195	3933	4069	136	RIGHT	G58b.EDF	G58	2
44	6775278	6775392	64	178	114	RIGHT	G58b.EDF	G58	2
44	6776332	6776646	1118	1432	314	RIGHT	G58b.EDF	G58	2
44	6776934	6777021	1720	1807	87	RIGHT	G58b.EDF	G58	2
45	6785247	6785573	650	976	326	RIGHT	G58b.EDF	G58	2
45	6789113	6789262	4516	4665	149	RIGHT	G58b.EDF	G58	2
45	6790573	6790683	5976	6086	110	RIGHT	G58b.EDF	G58	2
46	6792911	6793071	210	370	160	RIGHT	G58b.EDF	G58	2
46	6797078	6797214	4377	4513	136	RIGHT	G58b.EDF	G58	2
47	6801290	6801534	58	302	244	RIGHT	G58b.EDF	G58	2
47	6805760	6805868	4528	4636	108	RIGHT	G58b.EDF	G58	2
47	6805890	6805910	4658	4678	20	RIGHT	G58b.EDF	G58	2
47	6806754	6806906	5522	5674	152	RIGHT	G58b.EDF	G58	2
47	6806983	6807053	5751	5821	70	RIGHT	G58b.EDF	G58	2
48	6814295	6814446	4931	5082	151	RIGHT	G58b.EDF	G58	2
49	6817678	6817778	57	157	100	RIGHT	G58b.EDF	G58	2
49	6817915	6818010	294	389	95	RIGHT	G58b.EDF	G58	2
49	6818032	6818032	411	411	0	RIGHT	G58b.EDF	G58	2
49	6818164	6818472	543	851	308	RIGHT	G58b.EDF	G58	2
49	6822010	6822097	4389	4476	87	RIGHT	G58b.EDF	G58	2
49	6822121	6822151	4500	4530	30	RIGHT	G58b.EDF	G58	2
49	6824009	6824152	6388	6531	143	RIGHT	G58b.EDF	G58	2
50	6827026	6827065	57	96	39	RIGHT	G58b.EDF	G58	2
50	6827573	6827698	604	729	125	RIGHT	G58b.EDF	G58	2
50	6827719	6827722	750	753	3	RIGHT	G58b.EDF	G58	2
50	6828524	6828532	1555	1563	8	RIGHT	G58b.EDF	G58	2
50	6828591	6828783	1622	1814	192	RIGHT	G58b.EDF	G58	2
50	6831923	6832069	4954	5100	146	RIGHT	G58b.EDF	G58	2
50	6832183	6832308	5214	5339	125	RIGHT	G58b.EDF	G58	2
51	6835881	6835881	108	108	0	RIGHT	G58b.EDF	G58	2
51	6836347	6836750	574	977	403	RIGHT	G58b.EDF	G58	2
51	6836923	6836972	1150	1199	49	RIGHT	G58b.EDF	G58	2
51	6836993	6837027	1220	1254	34	RIGHT	G58b.EDF	G58	2
51	6837055	6837058	1282	1285	3	RIGHT	G58b.EDF	G58	2
51	6837247	6837352	1474	1579	105	RIGHT	G58b.EDF	G58	2
52	6844232	6844313	58	139	81	RIGHT	G58b.EDF	G58	2
52	6844810	6844937	636	763	127	RIGHT	G58b.EDF	G58	2
52	6844965	6844966	791	792	1	RIGHT	G58b.EDF	G58	2
52	6845088	6845225	914	1051	137	RIGHT	G58b.EDF	G58	2
52	6845249	6845255	1075	1081	6	RIGHT	G58b.EDF	G58	2
53	6853688	6853835	112	259	147	RIGHT	G58b.EDF	G58	2
53	6854109	6854230	533	654	121	RIGHT	G58b.EDF	G58	2
53	6854276	6854279	700	703	3	RIGHT	G58b.EDF	G58	2
53	6854395	6854525	819	949	130	RIGHT	G58b.EDF	G58	2
53	6854579	6854582	1003	1006	3	RIGHT	G58b.EDF	G58	2
53	6857725	6857863	4149	4287	138	RIGHT	G58b.EDF	G58	2
54	6861200	6861299	57	156	99	RIGHT	G58b.EDF	G58	2
54	6861335	6861342	192	199	7	RIGHT	G58b.EDF	G58	2
55	6870092	6870122	75	105	30	RIGHT	G58b.EDF	G58	2
55	6871392	6871442	1375	1425	50	RIGHT	G58b.EDF	G58	2
55	6874548	6874709	4531	4692	161	RIGHT	G58b.EDF	G58	2
56	6878166	6878304	162	300	138	RIGHT	G58b.EDF	G58	2
56	6879652	6879796	1648	1792	144	RIGHT	G58b.EDF	G58	2
57	6886020	6886157	80	217	137	RIGHT	G58b.EDF	G58	2
57	6891322	6891442	5382	5502	120	RIGHT	G58b.EDF	G58	2
58	6894312	6894377	57	122	65	RIGHT	G58b.EDF	G58	2
58	6894568	6894720	313	465	152	RIGHT	G58b.EDF	G58	2
58	6895881	6895967	1626	1712	86	RIGHT	G58b.EDF	G58	2
59	6901917	6901975	57	115	58	RIGHT	G58b.EDF	G58	2
59	6902107	6902225	247	365	118	RIGHT	G58b.EDF	G58	2
60	6909428	6909569	123	264	141	RIGHT	G58b.EDF	G58	2
60	6909597	6909602	292	297	5	RIGHT	G58b.EDF	G58	2
60	6910236	6910343	931	1038	107	RIGHT	G58b.EDF	G58	2
60	6910475	6910616	1170	1311	141	RIGHT	G58b.EDF	G58	2
60	6914322	6914429	5017	5124	107	RIGHT	G58b.EDF	G58	2
61	6916899	6917001	57	159	102	RIGHT	G58b.EDF	G58	2
61	6917426	6917549	584	707	123	RIGHT	G58b.EDF	G58	2
61	6917663	6917800	821	958	137	RIGHT	G58b.EDF	G58	2
62	6924006	6924139	109	242	133	RIGHT	G58b.EDF	G58	2
62	6924569	6924711	672	814	142	RIGHT	G58b.EDF	G58	2
63	6931960	6931990	58	88	30	RIGHT	G58b.EDF	G58	2
63	6932075	6932231	173	329	156	RIGHT	G58b.EDF	G58	2
63	6932266	6932288	364	386	22	RIGHT	G58b.EDF	G58	2
63	6932590	6932743	688	841	153	RIGHT	G58b.EDF	G58	2
63	6932777	6932785	875	883	8	RIGHT	G58b.EDF	G58	2
63	6932809	6932988	907	1086	179	RIGHT	G58b.EDF	G58	2
63	6933017	6933025	1115	1123	8	RIGHT	G58b.EDF	G58	2
63	6936201	6936319	4299	4417	118	RIGHT	G58b.EDF	G58	2
63	6936479	6936636	4577	4734	157	RIGHT	G58b.EDF	G58	2
64	6939565	6939699	199	333	134	RIGHT	G58b.EDF	G58	2
65	6947353	6947382	66	95	29	RIGHT	G58b.EDF	G58	2
65	6947538	6947669	251	382	131	RIGHT	G58b.EDF	G58	2
65	6948724	6948853	1437	1566	129	RIGHT	G58b.EDF	G58	2
66	6956059	6956262	58	261	203	RIGHT	G58b.EDF	G58	2
66	6956728	6957084	727	1083	356	RIGHT	G58b.EDF	G58	2
66	6962835	6962899	6834	6898	64	RIGHT	G58b.EDF	G58	2
67	6965683	6965828	664	809	145	RIGHT	G58b.EDF	G58	2
67	6965872	6966027	853	1008	155	RIGHT	G58b.EDF	G58	2
67	6966549	6966728	1530	1709	179	RIGHT	G58b.EDF	G58	2
68	6972955	6973038	58	141	83	RIGHT	G58b.EDF	G58	2
68	6973436	6973578	539	681	142	RIGHT	G58b.EDF	G58	2
68	6973619	6973927	722	1030	308	RIGHT	G58b.EDF	G58	2
69	6980739	6980898	435	594	159	RIGHT	G58b.EDF	G58	2
69	6980934	6981086	630	782	152	RIGHT	G58b.EDF	G58	2
70	6989799	6989923	141	265	124	RIGHT	G58b.EDF	G58	2
70	6990177	6990557	519	899	380	RIGHT	G58b.EDF	G58	2
71	6998249	6998388	1114	1253	139	RIGHT	G58b.EDF	G58	2
71	6998480	6998788	1345	1653	308	RIGHT	G58b.EDF	G58	2
72	7005612	7005770	219	377	158	RIGHT	G58b.EDF	G58	2
72	7005792	7005797	399	404	5	RIGHT	G58b.EDF	G58	2
72	7005901	7006022	508	629	121	RIGHT	G58b.EDF	G58	2
72	7006190	7006319	797	926	129	RIGHT	G58b.EDF	G58	2
72	7006341	7006342	948	949	1	RIGHT	G58b.EDF	G58	2
72	7006458	7006598	1065	1205	140	RIGHT	G58b.EDF	G58	2
72	7006620	7006624	1227	1231	4	RIGHT	G58b.EDF	G58	2
72	7009972	7010122	4579	4729	150	RIGHT	G58b.EDF	G58	2
73	7013744	7013941	572	769	197	RIGHT	G58b.EDF	G58	2
73	7014062	7014232	890	1060	170	RIGHT	G58b.EDF	G58	2
73	7018690	7018852	5518	5680	162	RIGHT	G58b.EDF	G58	2
74	7022064	7022181	140	257	117	RIGHT	G58b.EDF	G58	2
74	7022289	7022418	365	494	129	RIGHT	G58b.EDF	G58	2
74	7022444	7022447	520	523	3	RIGHT	G58b.EDF	G58	2
74	7022729	7022876	805	952	147	RIGHT	G58b.EDF	G58	2
75	7030254	7030302	76	124	48	RIGHT	G58b.EDF	G58	2
75	7030363	7030482	185	304	119	RIGHT	G58b.EDF	G58	2
75	7030778	7030923	600	745	145	RIGHT	G58b.EDF	G58	2
75	7030956	7030958	778	780	2	RIGHT	G58b.EDF	G58	2
75	7031098	7031250	920	1072	152	RIGHT	G58b.EDF	G58	2
75	7031282	7031288	1104	1110	6	RIGHT	G58b.EDF	G58	2
76	7037173	7037294	239	360	121	RIGHT	G58b.EDF	G58	2
76	7039319	7039385	2385	2451	66	RIGHT	G58b.EDF	G58	2
77	7044611	7044723	61	173	112	RIGHT	G58b.EDF	G58	2
77	7044969	7045108	419	558	139	RIGHT	G58b.EDF	G58	2
77	7048379	7048502	3829	3952	123	RIGHT	G58b.EDF	G58	2
78	7054259	7054409	1046	1196	150	RIGHT	G58b.EDF	G58	2
78	7054514	7054642	1301	1429	128	RIGHT	G58b.EDF	G58	2
79	7061419	7061568	112	261	149	RIGHT	G58b.EDF	G58	2
79	7061988	7062342	681	1035	354	RIGHT	G58b.EDF	G58	2
79	7064907	7065054	3600	3747	147	RIGHT	G58b.EDF	G58	2
79	7066601	7066761	5294	5454	160	RIGHT	G58b.EDF	G58	2
80	7069660	7069744	58	142	84	RIGHT	G58b.EDF	G58	2
80	7073866	7073981	4264	4379	115	RIGHT	G58b.EDF	G58	2
80	7074924	7075047	5322	5445	123	RIGHT	G58b.EDF	G58	2
81	7079279	7079647	1547	1915	368	RIGHT	G58b.EDF	G58	2
82	7085014	7085059	58	103	45	RIGHT	G58b.EDF	G58	2
82	7085305	7085466	349	510	161	RIGHT	G58b.EDF	G58	2
82	7088193	7088327	3237	3371	134	RIGHT	G58b.EDF	G58	2
82	7089901	7090040	4945	5084	139	RIGHT	G58b.EDF	G58	2
82	7090892	7091221	5936	6265	329	RIGHT	G58b.EDF	G58	2
82	7091348	7091389	6392	6433	41	RIGHT	G58b.EDF	G58	2
83	7093546	7093599	58	111	53	RIGHT	G58b.EDF	G58	2
83	7093964	7094090	476	602	126	RIGHT	G58b.EDF	G58	2
83	7094155	7094313	667	825	158	RIGHT	G58b.EDF	G58	2
83	7094983	7095410	1495	1922	427	RIGHT	G58b.EDF	G58	2
84	7102705	7102830	58	183	125	RIGHT	G58b.EDF	G58	2
84	7102924	7102978	277	331	54	RIGHT	G58b.EDF	G58	2
84	7103255	7103423	608	776	168	RIGHT	G58b.EDF	G58	2
84	7107546	7107682	4899	5035	136	RIGHT	G58b.EDF	G58	2
84	7108173	7108335	5526	5688	162	RIGHT	G58b.EDF	G58	2
85	7110895	7110972	57	134	77	RIGHT	G58b.EDF	G58	2
85	7114946	7115061	4108	4223	115	RIGHT	G58b.EDF	G58	2
86	7117523	7117542	58	77	19	RIGHT	G58b.EDF	G58	2
86	7117660	7117807	195	342	147	RIGHT	G58b.EDF	G58	2
86	7122222	7122326	4757	4861	104	RIGHT	G58b.EDF	G58	2
86	7122709	7122868	5244	5403	159	RIGHT	G58b.EDF	G58	2
87	7125464	7125571	57	164	107	RIGHT	G58b.EDF	G58	2
87	7125675	7125826	268	419	151	RIGHT	G58b.EDF	G58	2
87	7126267	7126450	860	1043	183	RIGHT	G58b.EDF	G58	2
87	7126569	7126750	1162	1343	181	RIGHT	G58b.EDF	G58	2
87	7130324	7130392	4917	4985	68	RIGHT	G58b.EDF	G58	2
88	7132679	7132858	102	281	179	RIGHT	G58b.EDF	G58	2
88	7134142	7134270	1565	1693	128	RIGHT	G58b.EDF	G58	2
88	7137351	7137496	4774	4919	145	RIGHT	G58b.EDF	G58	2
88	7137712	7137890	5135	5313	178	RIGHT	G58b.EDF	G58	2
89	7140688	7140740	76	128	52	RIGHT	G58b.EDF	G58	2
89	7141966	7142160	1354	1548	194	RIGHT	G58b.EDF	G58	2
90	7150678	7150860	554	736	182	RIGHT	G58b.EDF	G58	2
90	7150953	7151129	829	1005	176	RIGHT	G58b.EDF	G58	2
91	7159251	7159384	114	247	133	RIGHT	G58b.EDF	G58	2
91	7159597	7159742	460	605	145	RIGHT	G58b.EDF	G58	2
91	7160388	7160577	1251	1440	189	RIGHT	G58b.EDF	G58	2
91	7162234	7162410	3097	3273	176	RIGHT	G58b.EDF	G58	2
91	7163675	7163854	4538	4717	179	RIGHT	G58b.EDF	G58	2
91	7164071	7164245	4934	5108	174	RIGHT	G58b.EDF	G58	2
92	7166998	7167153	63	218	155	RIGHT	G58b.EDF	G58	2
92	7167178	7167486	243	551	308	RIGHT	G58b.EDF	G58	2
92	7167729	7167968	794	1033	239	RIGHT	G58b.EDF	G58	2
92	7168156	7168377	1221	1442	221	RIGHT	G58b.EDF	G58	2
92	7168399	7168403	1464	1468	4	RIGHT	G58b.EDF	G58	2
92	7168696	7168879	1761	1944	183	RIGHT	G58b.EDF	G58	2
93	7175169	7175205	57	93	36	RIGHT	G58b.EDF	G58	2
93	7176075	7176494	963	1382	419	RIGHT	G58b.EDF	G58	2
93	7178896	7179232	3784	4120	336	RIGHT	G58b.EDF	G58	2
93	7179257	7179338	4145	4226	81	RIGHT	G58b.EDF	G58	2
94	7184964	7185342	722	1100	378	RIGHT	G58b.EDF	G58	2
94	7185363	7185364	1121	1122	1	RIGHT	G58b.EDF	G58	2
94	7188101	7188252	3859	4010	151	RIGHT	G58b.EDF	G58	2
94	7188421	7188528	4179	4286	107	RIGHT	G58b.EDF	G58	2
94	7188553	7188562	4311	4320	9	RIGHT	G58b.EDF	G58	2
94	7189953	7190101	5711	5859	148	RIGHT	G58b.EDF	G58	2
95	7194082	7194258	58	234	176	RIGHT	G58b.EDF	G58	2
95	7198415	7198581	4391	4557	166	RIGHT	G58b.EDF	G58	2
96	7203166	7203271	58	163	105	RIGHT	G58b.EDF	G58	2
96	7206339	7206494	3231	3386	155	RIGHT	G58b.EDF	G58	2
96	7207788	7207935	4680	4827	147	RIGHT	G58b.EDF	G58	2
97	7210920	7210927	70	77	7	RIGHT	G58b.EDF	G58	2
97	7211673	7211871	823	1021	198	RIGHT	G58b.EDF	G58	2
97	7214734	7214828	3884	3978	94	RIGHT	G58b.EDF	G58	2
97	7216850	7216972	6000	6122	122	RIGHT	G58b.EDF	G58	2
98	7219726	7219954	218	446	228	RIGHT	G58b.EDF	G58	2
98	7220067	7220250	559	742	183	RIGHT	G58b.EDF	G58	2
98	7223584	7223772	4076	4264	188	RIGHT	G58b.EDF	G58	2
98	7225505	7225875	5997	6367	370	RIGHT	G58b.EDF	G58	2
99	7234328	7234492	4977	5141	164	RIGHT	G58b.EDF	G58	2
99	7235171	7235309	5820	5958	138	RIGHT	G58b.EDF	G58	2
99	7235861	7235992	6510	6641	131	RIGHT	G58b.EDF	G58	2
99	7236031	7236032	6680	6681	1	RIGHT	G58b.EDF	G58	2
100	7239390	7239577	407	594	187	RIGHT	G58b.EDF	G58	2
100	7240352	7240572	1369	1589	220	RIGHT	G58b.EDF	G58	2
101	7246750	7247079	674	1003	329	RIGHT	G58b.EDF	G58	2
101	7250041	7250110	3965	4034	69	RIGHT	G58b.EDF	G58	2
101	7251808	7251972	5732	5896	164	RIGHT	G58b.EDF	G58	2
102	7255648	7255680	70	102	32	RIGHT	G58b.EDF	G58	2
102	7256397	7256931	819	1353	534	RIGHT	G58b.EDF	G58	2
102	7261417	7261494	5839	5916	77	RIGHT	G58b.EDF	G58	2
102	7261521	7261773	5943	6195	252	RIGHT	G58b.EDF	G58	2
103	7264530	7264549	58	77	19	RIGHT	G58b.EDF	G58	2
103	7265531	7265917	1059	1445	386	RIGHT	G58b.EDF	G58	2
103	7269264	7269536	4792	5064	272	RIGHT	G58b.EDF	G58	2
103	7269609	7269816	5137	5344	207	RIGHT	G58b.EDF	G58	2
103	7269839	7269932	5367	5460	93	RIGHT	G58b.EDF	G58	2
104	7280493	7280807	58	372	314	RIGHT	G58b.EDF	G58	2
104	7283155	7283232	2720	2797	77	RIGHT	G58b.EDF	G58	2
104	7283260	7283260	2825	2825	0	RIGHT	G58b.EDF	G58	2
104	7285307	7285451	4872	5016	144	RIGHT	G58b.EDF	G58	2
105	7289995	7290021	57	83	26	RIGHT	G58b.EDF	G58	2
105	7290962	7291144	1024	1206	182	RIGHT	G58b.EDF	G58	2
106	7297151	7297270	57	176	119	RIGHT	G58b.EDF	G58	2
106	7300811	7300969	3717	3875	158	RIGHT	G58b.EDF	G58	2
106	7301165	7301316	4071	4222	151	RIGHT	G58b.EDF	G58	2
106	7301859	7302014	4765	4920	155	RIGHT	G58b.EDF	G58	2
106	7302149	7302285	5055	5191	136	RIGHT	G58b.EDF	G58	2
107	7305190	7305546	848	1204	356	RIGHT	G58b.EDF	G58	2
107	7308245	7308589	3903	4247	344	RIGHT	G58b.EDF	G58	2
107	7309425	7309623	5083	5281	198	RIGHT	G58b.EDF	G58	2
107	7311702	7311834	7360	7492	132	RIGHT	G58b.EDF	G58	2
108	7314148	7314330	405	587	182	RIGHT	G58b.EDF	G58	2
108	7314997	7315329	1254	1586	332	RIGHT	G58b.EDF	G58	2
108	7318538	7318669	4795	4926	131	RIGHT	G58b.EDF	G58	2
109	7321007	7321099	58	150	92	RIGHT	G58b.EDF	G58	2
109	7321506	7321718	557	769	212	RIGHT	G58b.EDF	G58	2
109	7322050	7322526	1101	1577	476	RIGHT	G58b.EDF	G58	2
109	7325483	7325678	4534	4729	195	RIGHT	G58b.EDF	G58	2
110	7329246	7329659	640	1053	413	RIGHT	G58b.EDF	G58	2
110	7333726	7333928	5120	5322	202	RIGHT	G58b.EDF	G58	2
110	7334019	7334273	5413	5667	254	RIGHT	G58b.EDF	G58	2
111	7337066	7337085	58	77	19	RIGHT	G58b.EDF	G58	2
111	7338313	7338854	1305	1846	541	RIGHT	G58b.EDF	G58	2
111	7341827	7342469	4819	5461	642	RIGHT	G58b.EDF	G58	2
112	7346281	7346301	75	95	20	RIGHT	G58b.EDF	G58	2
112	7346951	7347197	745	991	246	RIGHT	G58b.EDF	G58	2
112	7350247	7350429	4041	4223	182	RIGHT	G58b.EDF	G58	2
113	7354475	7355164	847	1536	689	RIGHT	G58b.EDF	G58	2
113	7356601	7357076	2973	3448	475	RIGHT	G58b.EDF	G58	2
113	7358347	7359450	4719	5822	1103	RIGHT	G58b.EDF	G58	2
114	7364181	7364746	837	1402	565	RIGHT	G58b.EDF	G58	2
114	7367904	7368629	4560	5285	725	RIGHT	G58b.EDF	G58	2
115	7372165	7372488	596	919	323	RIGHT	G58b.EDF	G58	2
115	7375813	7376187	4244	4618	374	RIGHT	G58b.EDF	G58	2
116	7379892	7380019	57	184	127	RIGHT	G58b.EDF	G58	2
116	7380041	7380053	206	218	12	RIGHT	G58b.EDF	G58	2
116	7380699	7381092	864	1257	393	RIGHT	G58b.EDF	G58	2
116	7386043	7386150	6208	6315	107	RIGHT	G58b.EDF	G58	2
117	7389868	7390280	1149	1561	412	RIGHT	G58b.EDF	G58	2
117	7392917	7393493	4198	4774	576	RIGHT	G58b.EDF	G58	2
117	7393592	7393592	4873	4873	0	RIGHT	G58b.EDF	G58	2
118	7398893	7398928	58	93	35	RIGHT	G58b.EDF	G58	2
118	7398952	7398955	117	120	3	RIGHT	G58b.EDF	G58	2
118	7399525	7399608	690	773	83	RIGHT	G58b.EDF	G58	2
118	7399632	7400069	797	1234	437	RIGHT	G58b.EDF	G58	2
118	7400397	7400842	1562	2007	445	RIGHT	G58b.EDF	G58	2
118	7402846	7403404	4011	4569	558	RIGHT	G58b.EDF	G58	2
118	7403994	7405242	5159	6407	1248	RIGHT	G58b.EDF	G58	2
119	7409168	7409668	1323	1823	500	RIGHT	G58b.EDF	G58	2
119	7411619	7411830	3774	3985	211	RIGHT	G58b.EDF	G58	2
120	7417036	7417201	57	222	165	RIGHT	G58b.EDF	G58	2
120	7417349	7417580	370	601	231	RIGHT	G58b.EDF	G58	2
120	7418206	7418538	1227	1559	332	RIGHT	G58b.EDF	G58	2
120	7421677	7421812	4698	4833	135	RIGHT	G58b.EDF	G58	2
1	5279986	5280213	231	458	227	RIGHT	H28.EDF	H28	.
2	5289250	5289471	444	665	221	RIGHT	H28.EDF	H28	.
3	5299148	5299314	1966	2132	166	RIGHT	H28.EDF	H28	.
4	5305632	5305938	57	363	306	RIGHT	H28.EDF	H28	.
4	5306703	5306846	1128	1271	143	RIGHT	H28.EDF	H28	.
4	5307137	5307257	1562	1682	120	RIGHT	H28.EDF	H28	.
5	5313539	5313780	57	298	241	RIGHT	H28.EDF	H28	.
5	5314472	5314646	990	1164	174	RIGHT	H28.EDF	H28	.
6	5320765	5320940	57	232	175	RIGHT	H28.EDF	H28	.
6	5323614	5323809	2906	3101	195	RIGHT	H28.EDF	H28	.
7	5329482	5329776	124	418	294	RIGHT	H28.EDF	H28	.
9	5343442	5343730	57	345	288	RIGHT	H28.EDF	H28	.
11	5360424	5360759	57	392	335	RIGHT	H28.EDF	H28	.
12	5368361	5368395	58	92	34	RIGHT	H28.EDF	H28	.
12	5369606	5369772	1303	1469	166	RIGHT	H28.EDF	H28	.
12	5373801	5373801	5498	5498	0	RIGHT	H28.EDF	H28	.
12	5373822	5373822	5519	5519	0	RIGHT	H28.EDF	H28	.
12	5374079	5374263	5776	5960	184	RIGHT	H28.EDF	H28	.
13	5376588	5376804	419	635	216	RIGHT	H28.EDF	H28	.
14	5384665	5384960	58	353	295	RIGHT	H28.EDF	H28	.
16	5399763	5399930	58	225	167	RIGHT	H28.EDF	H28	.
17	5407805	5408291	57	543	486	RIGHT	H28.EDF	H28	.
18	5414911	5415248	58	395	337	RIGHT	H28.EDF	H28	.
19	5422074	5422146	57	129	72	RIGHT	H28.EDF	H28	.
20	5430535	5430625	58	148	90	RIGHT	H28.EDF	H28	.
21	5437395	5437792	57	454	397	RIGHT	H28.EDF	H28	.
22	5444193	5444460	57	324	267	RIGHT	H28.EDF	H28	.
22	5444525	5444554	389	418	29	RIGHT	H28.EDF	H28	.
22	5445455	5445673	1319	1537	218	RIGHT	H28.EDF	H28	.
23	5451444	5451561	57	174	117	RIGHT	H28.EDF	H28	.
23	5452674	5452917	1287	1530	243	RIGHT	H28.EDF	H28	.
24	5460244	5460449	58	263	205	RIGHT	H28.EDF	H28	.
24	5460930	5461122	744	936	192	RIGHT	H28.EDF	H28	.
24	5463625	5463842	3439	3656	217	RIGHT	H28.EDF	H28	.
25	5468246	5468574	86	414	328	RIGHT	H28.EDF	H28	.
26	5479180	5479393	2266	2479	213	RIGHT	H28.EDF	H28	.
26	5483859	5484042	6945	7128	183	RIGHT	H28.EDF	H28	.
27	5485766	5485894	57	185	128	RIGHT	H28.EDF	H28	.
28	5492579	5492648	57	126	69	RIGHT	H28.EDF	H28	.
28	5492958	5493177	436	655	219	RIGHT	H28.EDF	H28	.
29	5499980	5500695	58	773	715	RIGHT	H28.EDF	H28	.
29	5502622	5502793	2700	2871	171	RIGHT	H28.EDF	H28	.
29	5503825	5504010	3903	4088	185	RIGHT	H28.EDF	H28	.
33	5533126	5533363	2040	2277	237	RIGHT	H28.EDF	H28	.
33	5534368	5534618	3282	3532	250	RIGHT	H28.EDF	H28	.
34	5538927	5539342	58	473	415	RIGHT	H28.EDF	H28	.
34	5540165	5540344	1296	1475	179	RIGHT	H28.EDF	H28	.
34	5542171	5542443	3302	3574	272	RIGHT	H28.EDF	H28	.
34	5543808	5544059	4939	5190	251	RIGHT	H28.EDF	H28	.
35	5547556	5548009	58	511	453	RIGHT	H28.EDF	H28	.
35	5548030	5548032	532	534	2	RIGHT	H28.EDF	H28	.
36	5555155	5555370	57	272	215	RIGHT	H28.EDF	H28	.
37	5562313	5562404	57	148	91	RIGHT	H28.EDF	H28	.
37	5564635	5564915	2379	2659	280	RIGHT	H28.EDF	H28	.
37	5565902	5566276	3646	4020	374	RIGHT	H28.EDF	H28	.
38	5574961	5575103	3140	3282	142	RIGHT	H28.EDF	H28	.
39	5580769	5580898	739	868	129	RIGHT	H28.EDF	H28	.
39	5582614	5582748	2584	2718	134	RIGHT	H28.EDF	H28	.
41	5596983	5597068	57	142	85	RIGHT	H28.EDF	H28	.
41	5597487	5597670	561	744	183	RIGHT	H28.EDF	H28	.
41	5604225	5604274	7299	7348	49	RIGHT	H28.EDF	H28	.
42	5605913	5605938	58	83	25	RIGHT	H28.EDF	H28	.
42	5606703	5606849	848	994	146	RIGHT	H28.EDF	H28	.
42	5608684	5608837	2829	2982	153	RIGHT	H28.EDF	H28	.
42	5610120	5610213	4265	4358	93	RIGHT	H28.EDF	H28	.
43	5615187	5615280	58	151	93	RIGHT	H28.EDF	H28	.
44	5624988	5625163	1975	2150	175	RIGHT	H28.EDF	H28	.
44	5626624	5626811	3611	3798	187	RIGHT	H28.EDF	H28	.
44	5627221	5627412	4208	4399	191	RIGHT	H28.EDF	H28	.
45	5631197	5631473	57	333	276	RIGHT	H28.EDF	H28	.
45	5631809	5631972	669	832	163	RIGHT	H28.EDF	H28	.
46	5639294	5639475	323	504	181	RIGHT	H28.EDF	H28	.
46	5641338	5641513	2367	2542	175	RIGHT	H28.EDF	H28	.
46	5642653	5642835	3682	3864	182	RIGHT	H28.EDF	H28	.
47	5648595	5648783	433	621	188	RIGHT	H28.EDF	H28	.
48	5655777	5655930	922	1075	153	RIGHT	H28.EDF	H28	.
49	5663647	5664018	57	428	371	RIGHT	H28.EDF	H28	.
49	5664263	5664415	673	825	152	RIGHT	H28.EDF	H28	.
50	5671274	5671436	700	862	162	RIGHT	H28.EDF	H28	.
50	5673672	5673886	3098	3312	214	RIGHT	H28.EDF	H28	.
51	5680193	5680420	732	959	227	RIGHT	H28.EDF	H28	.
51	5682498	5682730	3037	3269	232	RIGHT	H28.EDF	H28	.
52	5687677	5687931	58	312	254	RIGHT	H28.EDF	H28	.
52	5688387	5688899	768	1280	512	RIGHT	H28.EDF	H28	.
53	5696548	5696632	57	141	84	RIGHT	H28.EDF	H28	.
53	5696712	5697021	221	530	309	RIGHT	H28.EDF	H28	.
54	5703435	5703561	57	183	126	RIGHT	H28.EDF	H28	.
55	5712345	5712427	57	139	82	RIGHT	H28.EDF	H28	.
56	5721382	5721619	957	1194	237	RIGHT	H28.EDF	H28	.
56	5723739	5723910	3314	3485	171	RIGHT	H28.EDF	H28	.
57	5728867	5728931	57	121	64	RIGHT	H28.EDF	H28	.
58	5736864	5737043	890	1069	179	RIGHT	H28.EDF	H28	.
59	5743953	5744385	57	489	432	RIGHT	H28.EDF	H28	.
59	5746434	5746685	2538	2789	251	RIGHT	H28.EDF	H28	.
61	5758840	5759042	691	893	202	RIGHT	H28.EDF	H28	.
61	5760930	5761151	2781	3002	221	RIGHT	H28.EDF	H28	.
62	5768330	5768547	2197	2414	217	RIGHT	H28.EDF	H28	.
63	5774715	5774924	500	709	209	RIGHT	H28.EDF	H28	.
63	5777037	5777225	2822	3010	188	RIGHT	H28.EDF	H28	.
63	5777680	5777925	3465	3710	245	RIGHT	H28.EDF	H28	.
64	5783995	5784051	57	113	56	RIGHT	H28.EDF	H28	.
64	5786136	5786266	2198	2328	130	RIGHT	H28.EDF	H28	.
65	5792023	5792107	57	141	84	RIGHT	H28.EDF	H28	.
65	5794372	5794620	2406	2654	248	RIGHT	H28.EDF	H28	.
65	5796357	5796525	4391	4559	168	RIGHT	H28.EDF	H28	.
66	5800620	5800860	1940	2180	240	RIGHT	H28.EDF	H28	.
66	5800889	5800889	2209	2209	0	RIGHT	H28.EDF	H28	.
66	5801939	5802330	3259	3650	391	RIGHT	H28.EDF	H28	.
68	5815188	5815621	235	668	433	RIGHT	H28.EDF	H28	.
68	5815790	5816148	837	1195	358	RIGHT	H28.EDF	H28	.
68	5816170	5816366	1217	1413	196	RIGHT	H28.EDF	H28	.
69	5825184	5825314	1185	1315	130	RIGHT	H28.EDF	H28	.
70	5830287	5830457	57	227	170	RIGHT	H28.EDF	H28	.
70	5832132	5832313	1902	2083	181	RIGHT	H28.EDF	H28	.
71	5838059	5838251	284	476	192	RIGHT	H28.EDF	H28	.
71	5840172	5840313	2397	2538	141	RIGHT	H28.EDF	H28	.
71	5840580	5840788	2805	3013	208	RIGHT	H28.EDF	H28	.
71	5841527	5841730	3752	3955	203	RIGHT	H28.EDF	H28	.
72	5846483	5846649	954	1120	166	RIGHT	H28.EDF	H28	.
72	5848655	5848798	3126	3269	143	RIGHT	H28.EDF	H28	.
73	5853645	5853780	992	1127	135	RIGHT	H28.EDF	H28	.
73	5855668	5855857	3015	3204	189	RIGHT	H28.EDF	H28	.
75	5868698	5868866	202	370	168	RIGHT	H28.EDF	H28	.
75	5869891	5870041	1395	1545	150	RIGHT	H28.EDF	H28	.
75	5872393	5872542	3897	4046	149	RIGHT	H28.EDF	H28	.
76	5876770	5876947	477	654	177	RIGHT	H28.EDF	H28	.
77	5884696	5884877	104	285	181	RIGHT	H28.EDF	H28	.
77	5886620	5886745	2028	2153	125	RIGHT	H28.EDF	H28	.
77	5887122	5887309	2530	2717	187	RIGHT	H28.EDF	H28	.
78	5893565	5893792	72	299	227	RIGHT	H28.EDF	H28	.
78	5894599	5894761	1106	1268	162	RIGHT	H28.EDF	H28	.
79	5901404	5901552	481	629	148	RIGHT	H28.EDF	H28	.
80	5909905	5910079	463	637	174	RIGHT	H28.EDF	H28	.
80	5912049	5912217	2607	2775	168	RIGHT	H28.EDF	H28	.
80	5912324	5912472	2882	3030	148	RIGHT	H28.EDF	H28	.
80	5913397	5913533	3955	4091	136	RIGHT	H28.EDF	H28	.
81	5917572	5917710	319	457	138	RIGHT	H28.EDF	H28	.
81	5919081	5919266	1828	2013	185	RIGHT	H28.EDF	H28	.
81	5919743	5919950	2490	2697	207	RIGHT	H28.EDF	H28	.
81	5920826	5921007	3573	3754	181	RIGHT	H28.EDF	H28	.
81	5921970	5922200	4717	4947	230	RIGHT	H28.EDF	H28	.
81	5922449	5922651	5196	5398	202	RIGHT	H28.EDF	H28	.
82	5925813	5925988	616	791	175	RIGHT	H28.EDF	H28	.
82	5926675	5926884	1478	1687	209	RIGHT	H28.EDF	H28	.
83	5935307	5935510	2068	2271	203	RIGHT	H28.EDF	H28	.
83	5936187	5936373	2948	3134	186	RIGHT	H28.EDF	H28	.
84	5941639	5941836	787	984	197	RIGHT	H28.EDF	H28	.
85	5950010	5950044	57	91	34	RIGHT	H28.EDF	H28	.
85	5950485	5950642	532	689	157	RIGHT	H28.EDF	H28	.
86	5957020	5957234	58	272	214	RIGHT	H28.EDF	H28	.
86	5958269	5958412	1307	1450	143	RIGHT	H28.EDF	H28	.
86	5958535	5958696	1573	1734	161	RIGHT	H28.EDF	H28	.
87	5965280	5965482	834	1036	202	RIGHT	H28.EDF	H28	.
88	5971517	5971678	57	218	161	RIGHT	H28.EDF	H28	.
88	5973488	5973674	2028	2214	186	RIGHT	H28.EDF	H28	.
89	5980885	5981003	903	1021	118	RIGHT	H28.EDF	H28	.
90	5989025	5989251	296	522	226	RIGHT	H28.EDF	H28	.
90	5991260	5991421	2531	2692	161	RIGHT	H28.EDF	H28	.
90	5991705	5991893	2976	3164	188	RIGHT	H28.EDF	H28	.
91	5996962	5997172	209	419	210	RIGHT	H28.EDF	H28	.
91	5999468	5999648	2715	2895	180	RIGHT	H28.EDF	H28	.
91	6002281	6002433	5528	5680	152	RIGHT	H28.EDF	H28	.
92	6006516	6006671	205	360	155	RIGHT	H28.EDF	H28	.
92	6008391	6008563	2080	2252	172	RIGHT	H28.EDF	H28	.
92	6009499	6009683	3188	3372	184	RIGHT	H28.EDF	H28	.
93	6014529	6014754	116	341	225	RIGHT	H28.EDF	H28	.
94	6023121	6023377	174	430	256	RIGHT	H28.EDF	H28	.
94	6025792	6025949	2845	3002	157	RIGHT	H28.EDF	H28	.
95	6033561	6033756	1942	2137	195	RIGHT	H28.EDF	H28	.
96	6041770	6041921	2300	2451	151	RIGHT	H28.EDF	H28	.
97	6048182	6048389	57	264	207	RIGHT	H28.EDF	H28	.
97	6048821	6049033	696	908	212	RIGHT	H28.EDF	H28	.
98	6055945	6056184	167	406	239	RIGHT	H28.EDF	H28	.
99	6065962	6066142	138	318	180	RIGHT	H28.EDF	H28	.
99	6066378	6066567	554	743	189	RIGHT	H28.EDF	H28	.
100	6074080	6074281	67	268	201	RIGHT	H28.EDF	H28	.
100	6075298	6075461	1285	1448	163	RIGHT	H28.EDF	H28	.
100	6076549	6076731	2536	2718	182	RIGHT	H28.EDF	H28	.
101	6082308	6082527	71	290	219	RIGHT	H28.EDF	H28	.
101	6083674	6083839	1437	1602	165	RIGHT	H28.EDF	H28	.
101	6084656	6084827	2419	2590	171	RIGHT	H28.EDF	H28	.
101	6087364	6087520	5127	5283	156	RIGHT	H28.EDF	H28	.
102	6089986	6090240	58	312	254	RIGHT	H28.EDF	H28	.
103	6098621	6098648	58	85	27	RIGHT	H28.EDF	H28	.
103	6099113	6099307	550	744	194	RIGHT	H28.EDF	H28	.
103	6101030	6101199	2467	2636	169	RIGHT	H28.EDF	H28	.
105	6115009	6115221	233	445	212	RIGHT	H28.EDF	H28	.
105	6116829	6117035	2053	2259	206	RIGHT	H28.EDF	H28	.
105	6117745	6118078	2969	3302	333	RIGHT	H28.EDF	H28	.
106	6123379	6123429	58	108	50	RIGHT	H28.EDF	H28	.
106	6129232	6129424	5911	6103	192	RIGHT	H28.EDF	H28	.
107	6132298	6132662	762	1126	364	RIGHT	H28.EDF	H28	.
107	6133565	6133742	2029	2206	177	RIGHT	H28.EDF	H28	.
107	6135416	6135581	3880	4045	165	RIGHT	H28.EDF	H28	.
108	6140874	6141048	2103	2277	174	RIGHT	H28.EDF	H28	.
108	6141743	6141975	2972	3204	232	RIGHT	H28.EDF	H28	.
109	6147085	6147227	832	974	142	RIGHT	H28.EDF	H28	.
110	6154346	6154492	116	262	146	RIGHT	H28.EDF	H28	.
110	6156545	6156683	2315	2453	138	RIGHT	H28.EDF	H28	.
111	6165258	6165429	2223	2394	171	RIGHT	H28.EDF	H28	.
112	6171974	6172178	2435	2639	204	RIGHT	H28.EDF	H28	.
113	6177330	6177705	57	432	375	RIGHT	H28.EDF	H28	.
114	6186733	6186931	504	702	198	RIGHT	H28.EDF	H28	.
114	6188610	6188832	2381	2603	222	RIGHT	H28.EDF	H28	.
115	6195324	6195413	57	146	89	RIGHT	H28.EDF	H28	.
115	6197247	6197432	1980	2165	185	RIGHT	H28.EDF	H28	.
115	6198214	6198451	2947	3184	237	RIGHT	H28.EDF	H28	.
117	6209504	6209602	58	156	98	RIGHT	H28.EDF	H28	.
117	6211305	6211466	1859	2020	161	RIGHT	H28.EDF	H28	.
118	6216398	6216647	358	607	249	RIGHT	H28.EDF	H28	.
119	6224803	6224972	479	648	169	RIGHT	H28.EDF	H28	.
119	6225540	6225674	1216	1350	134	RIGHT	H28.EDF	H28	.
119	6226981	6227152	2657	2828	171	RIGHT	H28.EDF	H28	.
119	6227777	6227969	3453	3645	192	RIGHT	H28.EDF	H28	.
119	6229041	6229196	4717	4872	155	RIGHT	H28.EDF	H28	.
120	6233765	6233927	277	439	162	RIGHT	H28.EDF	H28	.
1	5274801	5274820	59	78	19	RIGHT	J16a.EDF	J16	1
1	5275806	5275888	1064	1146	82	RIGHT	J16a.EDF	J16	1
1	5276195	5276293	1453	1551	98	RIGHT	J16a.EDF	J16	1
1	5277103	5277201	2361	2459	98	RIGHT	J16a.EDF	J16	1
1	5278120	5278210	3378	3468	90	RIGHT	J16a.EDF	J16	1
2	5292836	5292923	601	688	87	RIGHT	J16a.EDF	J16	1
2	5293518	5293605	1283	1370	87	RIGHT	J16a.EDF	J16	1
3	5302385	5302415	58	88	30	RIGHT	J16a.EDF	J16	1
3	5303644	5303745	1317	1418	101	RIGHT	J16a.EDF	J16	1
4	5311043	5311159	715	831	116	RIGHT	J16a.EDF	J16	1
5	5317687	5317772	178	263	85	RIGHT	J16a.EDF	J16	1
5	5319681	5319774	2172	2265	93	RIGHT	J16a.EDF	J16	1
6	5324364	5324455	456	547	91	RIGHT	J16a.EDF	J16	1
6	5325133	5325228	1225	1320	95	RIGHT	J16a.EDF	J16	1
6	5326348	5326419	2440	2511	71	RIGHT	J16a.EDF	J16	1
7	5332452	5332547	656	751	95	RIGHT	J16a.EDF	J16	1
7	5333366	5333460	1570	1664	94	RIGHT	J16a.EDF	J16	1
7	5334387	5334465	2591	2669	78	RIGHT	J16a.EDF	J16	1
8	5339336	5339392	1014	1070	56	RIGHT	J16a.EDF	J16	1
8	5340582	5340687	2260	2365	105	RIGHT	J16a.EDF	J16	1
9	5346528	5346641	1169	1282	113	RIGHT	J16a.EDF	J16	1
10	5352240	5352269	58	87	29	RIGHT	J16a.EDF	J16	1
10	5352873	5352988	691	806	115	RIGHT	J16a.EDF	J16	1
10	5353689	5353763	1507	1581	74	RIGHT	J16a.EDF	J16	1
11	5358981	5359058	63	140	77	RIGHT	J16a.EDF	J16	1
11	5359253	5359356	335	438	103	RIGHT	J16a.EDF	J16	1
11	5360121	5360223	1203	1305	102	RIGHT	J16a.EDF	J16	1
11	5361920	5361978	3002	3060	58	RIGHT	J16a.EDF	J16	1
12	5367074	5367188	924	1038	114	RIGHT	J16a.EDF	J16	1
12	5367457	5367548	1307	1398	91	RIGHT	J16a.EDF	J16	1
13	5373484	5373549	1072	1137	65	RIGHT	J16a.EDF	J16	1
14	5380013	5380127	372	486	114	RIGHT	J16a.EDF	J16	1
14	5380813	5380897	1172	1256	84	RIGHT	J16a.EDF	J16	1
15	5387068	5387160	559	651	92	RIGHT	J16a.EDF	J16	1
15	5387950	5388034	1441	1525	84	RIGHT	J16a.EDF	J16	1
15	5390825	5390849	4316	4340	24	RIGHT	J16a.EDF	J16	1
16	5394136	5394247	688	799	111	RIGHT	J16a.EDF	J16	1
16	5395934	5395978	2486	2530	44	RIGHT	J16a.EDF	J16	1
17	5400096	5400196	507	607	100	RIGHT	J16a.EDF	J16	1
18	5405819	5405901	77	159	82	RIGHT	J16a.EDF	J16	1
18	5407434	5407518	1692	1776	84	RIGHT	J16a.EDF	J16	1
19	5413357	5413442	724	809	85	RIGHT	J16a.EDF	J16	1
20	5419602	5419681	1119	1198	79	RIGHT	J16a.EDF	J16	1
20	5419981	5420079	1498	1596	98	RIGHT	J16a.EDF	J16	1
21	5425389	5425470	1045	1126	81	RIGHT	J16a.EDF	J16	1
22	5431329	5431436	610	717	107	RIGHT	J16a.EDF	J16	1
23	5437747	5437794	874	921	47	RIGHT	J16a.EDF	J16	1
25	5449481	5449567	176	262	86	RIGHT	J16a.EDF	J16	1
25	5449890	5449979	585	674	89	RIGHT	J16a.EDF	J16	1
25	5450301	5450390	996	1085	89	RIGHT	J16a.EDF	J16	1
25	5450754	5450850	1449	1545	96	RIGHT	J16a.EDF	J16	1
26	5456821	5456933	94	206	112	RIGHT	J16a.EDF	J16	1
27	5463756	5463829	1771	1844	73	RIGHT	J16a.EDF	J16	1
28	5467836	5467909	137	210	73	RIGHT	J16a.EDF	J16	1
28	5468679	5468757	980	1058	78	RIGHT	J16a.EDF	J16	1
29	5474487	5474578	1086	1177	91	RIGHT	J16a.EDF	J16	1
30	5480338	5480447	955	1064	109	RIGHT	J16a.EDF	J16	1
31	5485574	5485659	417	502	85	RIGHT	J16a.EDF	J16	1
31	5485819	5485920	662	763	101	RIGHT	J16a.EDF	J16	1
31	5486127	5486218	970	1061	91	RIGHT	J16a.EDF	J16	1
31	5486520	5486601	1363	1444	81	RIGHT	J16a.EDF	J16	1
32	5491363	5491478	501	616	115	RIGHT	J16a.EDF	J16	1
32	5492383	5492447	1521	1585	64	RIGHT	J16a.EDF	J16	1
32	5494302	5494375	3440	3513	73	RIGHT	J16a.EDF	J16	1
33	5497779	5497885	1378	1484	106	RIGHT	J16a.EDF	J16	1
35	5510757	5510855	464	562	98	RIGHT	J16a.EDF	J16	1
37	5522567	5522648	76	157	81	RIGHT	J16a.EDF	J16	1
37	5523141	5523225	650	734	84	RIGHT	J16a.EDF	J16	1
37	5523933	5524015	1442	1524	82	RIGHT	J16a.EDF	J16	1
38	5529424	5529515	59	150	91	RIGHT	J16a.EDF	J16	1
38	5530708	5530776	1343	1411	68	RIGHT	J16a.EDF	J16	1
39	5535978	5536035	58	115	57	RIGHT	J16a.EDF	J16	1
39	5537088	5537173	1168	1253	85	RIGHT	J16a.EDF	J16	1
40	5542599	5542713	448	562	114	RIGHT	J16a.EDF	J16	1
40	5542932	5543030	781	879	98	RIGHT	J16a.EDF	J16	1
41	5548733	5548850	419	536	117	RIGHT	J16a.EDF	J16	1
41	5549827	5549920	1513	1606	93	RIGHT	J16a.EDF	J16	1
41	5551888	5551923	3574	3609	35	RIGHT	J16a.EDF	J16	1
41	5552370	5552424	4056	4110	54	RIGHT	J16a.EDF	J16	1
41	5552465	5552817	4151	4503	352	RIGHT	J16a.EDF	J16	1
42	5555307	5558734	58	3485	3427	RIGHT	J16a.EDF	J16	1
43	5561210	5564747	58	3595	3537	RIGHT	J16a.EDF	J16	1
44	5567474	5571801	58	4385	4327	RIGHT	J16a.EDF	J16	1
45	5573622	5577665	58	4101	4043	RIGHT	J16a.EDF	J16	1
46	5580035	5584501	58	4524	4466	RIGHT	J16a.EDF	J16	1
47	5586620	5590748	59	4187	4128	RIGHT	J16a.EDF	J16	1
48	5595322	5599079	90	3847	3757	RIGHT	J16a.EDF	J16	1
49	5602098	5603006	229	1137	908	RIGHT	J16a.EDF	J16	1
49	5603314	5603443	1445	1574	129	RIGHT	J16a.EDF	J16	1
49	5603691	5605861	1822	3992	2170	RIGHT	J16a.EDF	J16	1
50	5607736	5608374	165	803	638	RIGHT	J16a.EDF	J16	1
50	5608601	5611685	1030	4114	3084	RIGHT	J16a.EDF	J16	1
51	5614916	5614988	58	130	72	RIGHT	J16a.EDF	J16	1
51	5615034	5615068	176	210	34	RIGHT	J16a.EDF	J16	1
51	5615173	5615663	315	805	490	RIGHT	J16a.EDF	J16	1
51	5615793	5618722	935	3864	2929	RIGHT	J16a.EDF	J16	1
52	5621082	5621580	59	557	498	RIGHT	J16a.EDF	J16	1
52	5621835	5621958	812	935	123	RIGHT	J16a.EDF	J16	1
52	5622196	5624402	1173	3379	2206	RIGHT	J16a.EDF	J16	1
53	5626704	5627628	199	1123	924	RIGHT	J16a.EDF	J16	1
53	5627662	5627680	1157	1175	18	RIGHT	J16a.EDF	J16	1
53	5627942	5630772	1437	4267	2830	RIGHT	J16a.EDF	J16	1
54	5632948	5637188	58	4298	4240	RIGHT	J16a.EDF	J16	1
55	5639611	5639674	86	149	63	RIGHT	J16a.EDF	J16	1
55	5640260	5643464	735	3939	3204	RIGHT	J16a.EDF	J16	1
56	5645590	5645632	233	275	42	RIGHT	J16a.EDF	J16	1
56	5645966	5649297	609	3940	3331	RIGHT	J16a.EDF	J16	1
57	5651818	5651935	62	179	117	RIGHT	J16a.EDF	J16	1
57	5652323	5652389	567	633	66	RIGHT	J16a.EDF	J16	1
58	5658279	5658362	706	789	83	RIGHT	J16a.EDF	J16	1
59	5663748	5663855	485	592	107	RIGHT	J16a.EDF	J16	1
59	5664143	5664234	880	971	91	RIGHT	J16a.EDF	J16	1
59	5664977	5665090	1714	1827	113	RIGHT	J16a.EDF	J16	1
60	5670852	5670922	490	560	70	RIGHT	J16a.EDF	J16	1
60	5671291	5671383	929	1021	92	RIGHT	J16a.EDF	J16	1
61	5676843	5676930	371	458	87	RIGHT	J16a.EDF	J16	1
61	5677315	5677403	843	931	88	RIGHT	J16a.EDF	J16	1
61	5677701	5677799	1229	1327	98	RIGHT	J16a.EDF	J16	1
63	5688745	5688823	125	203	78	RIGHT	J16a.EDF	J16	1
64	5695176	5695281	724	829	105	RIGHT	J16a.EDF	J16	1
65	5700752	5700789	58	95	37	RIGHT	J16a.EDF	J16	1
65	5701380	5701477	686	783	97	RIGHT	J16a.EDF	J16	1
66	5706326	5706401	89	164	75	RIGHT	J16a.EDF	J16	1
66	5707257	5707355	1020	1118	98	RIGHT	J16a.EDF	J16	1
67	5713049	5713110	1006	1067	61	RIGHT	J16a.EDF	J16	1
67	5713309	5713409	1266	1366	100	RIGHT	J16a.EDF	J16	1
68	5719251	5719334	453	536	83	RIGHT	J16a.EDF	J16	1
68	5719781	5719864	983	1066	83	RIGHT	J16a.EDF	J16	1
68	5720198	5720513	1400	1715	315	RIGHT	J16a.EDF	J16	1
69	5725112	5725207	161	256	95	RIGHT	J16a.EDF	J16	1
69	5725851	5725977	900	1026	126	RIGHT	J16a.EDF	J16	1
70	5731847	5731952	497	602	105	RIGHT	J16a.EDF	J16	1
70	5732098	5732217	748	867	119	RIGHT	J16a.EDF	J16	1
71	5737384	5737510	884	1010	126	RIGHT	J16a.EDF	J16	1
72	5743989	5744071	104	186	82	RIGHT	J16a.EDF	J16	1
72	5744541	5744645	656	760	104	RIGHT	J16a.EDF	J16	1
72	5744942	5745057	1057	1172	115	RIGHT	J16a.EDF	J16	1
72	5745555	5745658	1670	1773	103	RIGHT	J16a.EDF	J16	1
73	5750060	5750154	148	242	94	RIGHT	J16a.EDF	J16	1
73	5751331	5751437	1419	1525	106	RIGHT	J16a.EDF	J16	1
74	5756288	5756391	94	197	103	RIGHT	J16a.EDF	J16	1
74	5756652	5756776	458	582	124	RIGHT	J16a.EDF	J16	1
74	5757024	5757137	830	943	113	RIGHT	J16a.EDF	J16	1
75	5762420	5762525	86	191	105	RIGHT	J16a.EDF	J16	1
75	5762794	5762905	460	571	111	RIGHT	J16a.EDF	J16	1
75	5763266	5763373	932	1039	107	RIGHT	J16a.EDF	J16	1
76	5770028	5770140	1052	1164	112	RIGHT	J16a.EDF	J16	1
77	5775410	5775465	57	112	55	RIGHT	J16a.EDF	J16	1
77	5775682	5775784	329	431	102	RIGHT	J16a.EDF	J16	1
77	5776576	5776651	1223	1298	75	RIGHT	J16a.EDF	J16	1
78	5782923	5783020	782	879	97	RIGHT	J16a.EDF	J16	1
79	5788494	5788586	69	161	92	RIGHT	J16a.EDF	J16	1
79	5789211	5789304	786	879	93	RIGHT	J16a.EDF	J16	1
80	5794996	5795097	514	615	101	RIGHT	J16a.EDF	J16	1
80	5795459	5795555	977	1073	96	RIGHT	J16a.EDF	J16	1
81	5800070	5800161	115	206	91	RIGHT	J16a.EDF	J16	1
81	5800732	5800823	777	868	91	RIGHT	J16a.EDF	J16	1
81	5801575	5801681	1620	1726	106	RIGHT	J16a.EDF	J16	1
82	5806838	5806901	139	202	63	RIGHT	J16a.EDF	J16	1
83	5812626	5812723	58	155	97	RIGHT	J16a.EDF	J16	1
83	5813186	5813283	618	715	97	RIGHT	J16a.EDF	J16	1
83	5813783	5813895	1215	1327	112	RIGHT	J16a.EDF	J16	1
84	5818464	5818567	565	668	103	RIGHT	J16a.EDF	J16	1
85	5824743	5824844	639	740	101	RIGHT	J16a.EDF	J16	1
85	5825464	5825531	1360	1427	67	RIGHT	J16a.EDF	J16	1
85	5827968	5828142	3864	4038	174	RIGHT	J16a.EDF	J16	1
86	5830775	5830869	633	727	94	RIGHT	J16a.EDF	J16	1
87	5836411	5836528	402	519	117	RIGHT	J16a.EDF	J16	1
87	5836983	5837083	974	1074	100	RIGHT	J16a.EDF	J16	1
87	5837441	5837539	1432	1530	98	RIGHT	J16a.EDF	J16	1
88	5842648	5842735	676	763	87	RIGHT	J16a.EDF	J16	1
88	5843817	5843938	1845	1966	121	RIGHT	J16a.EDF	J16	1
89	5848594	5848681	1020	1107	87	RIGHT	J16a.EDF	J16	1
90	5854878	5854953	726	801	75	RIGHT	J16a.EDF	J16	1
91	5860692	5860763	555	626	71	RIGHT	J16a.EDF	J16	1
93	5872826	5872943	406	523	117	RIGHT	J16a.EDF	J16	1
94	5879876	5879986	447	557	110	RIGHT	J16a.EDF	J16	1
94	5880384	5880487	955	1058	103	RIGHT	J16a.EDF	J16	1
94	5880834	5880914	1405	1485	80	RIGHT	J16a.EDF	J16	1
95	5886705	5886819	512	626	114	RIGHT	J16a.EDF	J16	1
96	5893683	5893744	192	253	61	RIGHT	J16a.EDF	J16	1
96	5894474	5894539	983	1048	65	RIGHT	J16a.EDF	J16	1
96	5895077	5895180	1586	1689	103	RIGHT	J16a.EDF	J16	1
97	5901620	5901691	1437	1508	71	RIGHT	J16a.EDF	J16	1
98	5906686	5906763	132	209	77	RIGHT	J16a.EDF	J16	1
98	5907386	5907480	832	926	94	RIGHT	J16a.EDF	J16	1
98	5907986	5908086	1432	1532	100	RIGHT	J16a.EDF	J16	1
99	5914532	5914635	400	503	103	RIGHT	J16a.EDF	J16	1
99	5915570	5915645	1438	1513	75	RIGHT	J16a.EDF	J16	1
100	5921790	5921871	759	840	81	RIGHT	J16a.EDF	J16	1
101	5927804	5927920	829	945	116	RIGHT	J16a.EDF	J16	1
101	5928220	5928301	1245	1326	81	RIGHT	J16a.EDF	J16	1
102	5936575	5936670	431	526	95	RIGHT	J16a.EDF	J16	1
102	5937474	5937558	1330	1414	84	RIGHT	J16a.EDF	J16	1
103	5942557	5942656	63	162	99	RIGHT	J16a.EDF	J16	1
104	5948566	5948639	58	131	73	RIGHT	J16a.EDF	J16	1
104	5949438	5949521	930	1013	83	RIGHT	J16a.EDF	J16	1
105	5955193	5955270	59	136	77	RIGHT	J16a.EDF	J16	1
105	5955867	5955973	733	839	106	RIGHT	J16a.EDF	J16	1
106	5962454	5962544	754	844	90	RIGHT	J16a.EDF	J16	1
106	5963505	5963602	1805	1902	97	RIGHT	J16a.EDF	J16	1
107	5969979	5970024	1277	1322	45	RIGHT	J16a.EDF	J16	1
108	5974924	5975014	105	195	90	RIGHT	J16a.EDF	J16	1
109	5981126	5981228	101	203	102	RIGHT	J16a.EDF	J16	1
110	5986903	5986978	91	166	75	RIGHT	J16a.EDF	J16	1
110	5987802	5987871	990	1059	69	RIGHT	J16a.EDF	J16	1
110	5990762	5990770	3950	3958	8	RIGHT	J16a.EDF	J16	1
112	5999617	5999690	715	788	73	RIGHT	J16a.EDF	J16	1
113	6008152	6008425	3447	3720	273	RIGHT	J16a.EDF	J16	1
114	6011235	6011291	246	302	56	RIGHT	J16a.EDF	J16	1
114	6011646	6011749	657	760	103	RIGHT	J16a.EDF	J16	1
114	6012287	6012370	1298	1381	83	RIGHT	J16a.EDF	J16	1
115	6017532	6017595	58	121	63	RIGHT	J16a.EDF	J16	1
115	6018055	6018168	581	694	113	RIGHT	J16a.EDF	J16	1
115	6018480	6018585	1006	1111	105	RIGHT	J16a.EDF	J16	1
115	6018951	6019047	1477	1573	96	RIGHT	J16a.EDF	J16	1
116	6024243	6024325	160	242	82	RIGHT	J16a.EDF	J16	1
117	6029946	6030033	59	146	87	RIGHT	J16a.EDF	J16	1
117	6031143	6031221	1256	1334	78	RIGHT	J16a.EDF	J16	1
118	6035757	6035843	164	250	86	RIGHT	J16a.EDF	J16	1
118	6037086	6037150	1493	1557	64	RIGHT	J16a.EDF	J16	1
119	6043506	6043568	1306	1368	62	RIGHT	J16a.EDF	J16	1
120	6048322	6048406	65	149	84	RIGHT	J16a.EDF	J16	1
120	6048635	6048754	378	497	119	RIGHT	J16a.EDF	J16	1
120	6049541	6049624	1284	1367	83	RIGHT	J16a.EDF	J16	1
1	6522524	6522609	110	195	85	RIGHT	J16b.EDF	J16	2
1	6523451	6523526	1037	1112	75	RIGHT	J16b.EDF	J16	2
1	6524161	6524250	1747	1836	89	RIGHT	J16b.EDF	J16	2
1	6524734	6524819	2320	2405	85	RIGHT	J16b.EDF	J16	2
3	6536347	6536443	491	587	96	RIGHT	J16b.EDF	J16	2
5	6548782	6548877	577	672	95	RIGHT	J16b.EDF	J16	2
6	6555092	6555178	461	547	86	RIGHT	J16b.EDF	J16	2
6	6556062	6556155	1431	1524	93	RIGHT	J16b.EDF	J16	2
7	6561849	6561943	652	746	94	RIGHT	J16b.EDF	J16	2
8	6567311	6567407	166	262	96	RIGHT	J16b.EDF	J16	2
9	6573061	6573151	57	147	90	RIGHT	J16b.EDF	J16	2
9	6573657	6573766	653	762	109	RIGHT	J16b.EDF	J16	2
10	6579021	6579130	114	223	109	RIGHT	J16b.EDF	J16	2
11	6584631	6584722	150	241	91	RIGHT	J16b.EDF	J16	2
11	6584936	6585030	455	549	94	RIGHT	J16b.EDF	J16	2
12	6590970	6591083	69	182	113	RIGHT	J16b.EDF	J16	2
12	6591193	6591311	292	410	118	RIGHT	J16b.EDF	J16	2
12	6591502	6591613	601	712	111	RIGHT	J16b.EDF	J16	2
13	6596789	6596910	57	178	121	RIGHT	J16b.EDF	J16	2
13	6597912	6597979	1180	1247	67	RIGHT	J16b.EDF	J16	2
14	6602788	6602829	58	99	41	RIGHT	J16b.EDF	J16	2
14	6603054	6603153	324	423	99	RIGHT	J16b.EDF	J16	2
15	6608638	6608701	58	121	63	RIGHT	J16b.EDF	J16	2
15	6609841	6609939	1261	1359	98	RIGHT	J16b.EDF	J16	2
15	6610121	6610218	1541	1638	97	RIGHT	J16b.EDF	J16	2
16	6615411	6615501	589	679	90	RIGHT	J16b.EDF	J16	2
16	6615828	6615937	1006	1115	109	RIGHT	J16b.EDF	J16	2
17	6621205	6621240	58	93	35	RIGHT	J16b.EDF	J16	2
18	6627823	6627937	513	627	114	RIGHT	J16b.EDF	J16	2
18	6628259	6628377	949	1067	118	RIGHT	J16b.EDF	J16	2
19	6633006	6633073	58	125	67	RIGHT	J16b.EDF	J16	2
20	6639131	6639192	57	118	61	RIGHT	J16b.EDF	J16	2
21	6645140	6645252	408	520	112	RIGHT	J16b.EDF	J16	2
23	6656199	6656320	298	419	121	RIGHT	J16b.EDF	J16	2
24	6662006	6662091	204	289	85	RIGHT	J16b.EDF	J16	2
25	6667475	6667584	157	266	109	RIGHT	J16b.EDF	J16	2
26	6673542	6673570	57	85	28	RIGHT	J16b.EDF	J16	2
26	6673731	6673834	246	349	103	RIGHT	J16b.EDF	J16	2
26	6674099	6674210	614	725	111	RIGHT	J16b.EDF	J16	2
27	6679363	6679469	109	215	106	RIGHT	J16b.EDF	J16	2
28	6684547	6684660	68	181	113	RIGHT	J16b.EDF	J16	2
29	6690731	6690779	57	105	48	RIGHT	J16b.EDF	J16	2
30	6697424	6697470	59	105	46	RIGHT	J16b.EDF	J16	2
30	6697648	6697724	283	359	76	RIGHT	J16b.EDF	J16	2
31	6703575	6703702	311	438	127	RIGHT	J16b.EDF	J16	2
31	6703801	6703889	537	625	88	RIGHT	J16b.EDF	J16	2
31	6704061	6704154	797	890	93	RIGHT	J16b.EDF	J16	2
31	6704475	6704576	1211	1312	101	RIGHT	J16b.EDF	J16	2
31	6704795	6704903	1531	1639	108	RIGHT	J16b.EDF	J16	2
32	6709367	6709427	58	118	60	RIGHT	J16b.EDF	J16	2
33	6715515	6715549	57	91	34	RIGHT	J16b.EDF	J16	2
33	6715871	6715982	413	524	111	RIGHT	J16b.EDF	J16	2
33	6716279	6716395	821	937	116	RIGHT	J16b.EDF	J16	2
34	6721402	6721509	58	165	107	RIGHT	J16b.EDF	J16	2
35	6727544	6727653	86	195	109	RIGHT	J16b.EDF	J16	2
36	6733845	6733946	738	839	101	RIGHT	J16b.EDF	J16	2
38	6744915	6745004	58	147	89	RIGHT	J16b.EDF	J16	2
38	6745453	6745574	596	717	121	RIGHT	J16b.EDF	J16	2
39	6750501	6750604	175	278	103	RIGHT	J16b.EDF	J16	2
39	6750913	6751028	587	702	115	RIGHT	J16b.EDF	J16	2
40	6756577	6756673	443	539	96	RIGHT	J16b.EDF	J16	2
41	6762622	6762679	57	114	57	RIGHT	J16b.EDF	J16	2
41	6764047	6764109	1482	1544	62	RIGHT	J16b.EDF	J16	2
42	6768545	6768646	90	191	101	RIGHT	J16b.EDF	J16	2
42	6769024	6769145	569	690	121	RIGHT	J16b.EDF	J16	2
42	6769497	6769613	1042	1158	116	RIGHT	J16b.EDF	J16	2
43	6774768	6774882	462	576	114	RIGHT	J16b.EDF	J16	2
44	6780547	6780646	92	191	99	RIGHT	J16b.EDF	J16	2
45	6786989	6787021	57	89	32	RIGHT	J16b.EDF	J16	2
45	6788510	6788564	1578	1632	54	RIGHT	J16b.EDF	J16	2
46	6794112	6794213	897	998	101	RIGHT	J16b.EDF	J16	2
47	6798694	6798802	61	169	108	RIGHT	J16b.EDF	J16	2
47	6798971	6799090	338	457	119	RIGHT	J16b.EDF	J16	2
49	6810064	6810123	58	117	59	RIGHT	J16b.EDF	J16	2
49	6810636	6810717	630	711	81	RIGHT	J16b.EDF	J16	2
50	6815748	6816036	58	346	288	RIGHT	J16b.EDF	J16	2
50	6816256	6816365	566	675	109	RIGHT	J16b.EDF	J16	2
50	6816543	6816627	853	937	84	RIGHT	J16b.EDF	J16	2
51	6822252	6822344	687	779	92	RIGHT	J16b.EDF	J16	2
51	6822501	6822606	936	1041	105	RIGHT	J16b.EDF	J16	2
52	6826687	6826785	121	219	98	RIGHT	J16b.EDF	J16	2
54	6838570	6838681	479	590	111	RIGHT	J16b.EDF	J16	2
55	6844753	6844820	58	125	67	RIGHT	J16b.EDF	J16	2
55	6844936	6845026	241	331	90	RIGHT	J16b.EDF	J16	2
55	6845405	6845509	710	814	104	RIGHT	J16b.EDF	J16	2
55	6846165	6846265	1470	1570	100	RIGHT	J16b.EDF	J16	2
56	6850878	6850897	59	78	19	RIGHT	J16b.EDF	J16	2
57	6858808	6858837	58	87	29	RIGHT	J16b.EDF	J16	2
57	6859813	6859892	1063	1142	79	RIGHT	J16b.EDF	J16	2
58	6865152	6865257	146	251	105	RIGHT	J16b.EDF	J16	2
58	6865928	6865999	922	993	71	RIGHT	J16b.EDF	J16	2
59	6870862	6870902	57	97	40	RIGHT	J16b.EDF	J16	2
60	6876396	6876467	57	128	71	RIGHT	J16b.EDF	J16	2
60	6876869	6877003	530	664	134	RIGHT	J16b.EDF	J16	2
60	6877499	6877597	1160	1258	98	RIGHT	J16b.EDF	J16	2
61	6882540	6882621	319	400	81	RIGHT	J16b.EDF	J16	2
62	6888380	6888478	506	604	98	RIGHT	J16b.EDF	J16	2
63	6893740	6893793	58	111	53	RIGHT	J16b.EDF	J16	2
63	6894292	6894380	610	698	88	RIGHT	J16b.EDF	J16	2
64	6899713	6899799	58	144	86	RIGHT	J16b.EDF	J16	2
64	6900981	6901057	1326	1402	76	RIGHT	J16b.EDF	J16	2
65	6905242	6905282	57	97	40	RIGHT	J16b.EDF	J16	2
65	6906053	6906152	868	967	99	RIGHT	J16b.EDF	J16	2
66	6911205	6911300	74	169	95	RIGHT	J16b.EDF	J16	2
67	6917997	6918111	548	662	114	RIGHT	J16b.EDF	J16	2
68	6925218	6925324	570	676	106	RIGHT	J16b.EDF	J16	2
69	6931860	6931944	840	924	84	RIGHT	J16b.EDF	J16	2
70	6937377	6937471	610	704	94	RIGHT	J16b.EDF	J16	2
71	6942432	6942521	59	148	89	RIGHT	J16b.EDF	J16	2
72	6949257	6949390	435	568	133	RIGHT	J16b.EDF	J16	2
72	6949575	6949680	753	858	105	RIGHT	J16b.EDF	J16	2
73	6955951	6956059	71	179	108	RIGHT	J16b.EDF	J16	2
73	6956577	6956679	697	799	102	RIGHT	J16b.EDF	J16	2
74	6961916	6962001	57	142	85	RIGHT	J16b.EDF	J16	2
74	6962479	6962594	620	735	115	RIGHT	J16b.EDF	J16	2
74	6963120	6963230	1261	1371	110	RIGHT	J16b.EDF	J16	2
75	6967816	6967923	64	171	107	RIGHT	J16b.EDF	J16	2
75	6968329	6968424	577	672	95	RIGHT	J16b.EDF	J16	2
75	6968628	6968721	876	969	93	RIGHT	J16b.EDF	J16	2
76	6974072	6974170	438	536	98	RIGHT	J16b.EDF	J16	2
76	6974497	6974610	863	976	113	RIGHT	J16b.EDF	J16	2
77	6980097	6980116	57	76	19	RIGHT	J16b.EDF	J16	2
77	6980754	6980842	714	802	88	RIGHT	J16b.EDF	J16	2
78	6986546	6986640	114	208	94	RIGHT	J16b.EDF	J16	2
79	6992394	6992455	58	119	61	RIGHT	J16b.EDF	J16	2
79	6992900	6993007	564	671	107	RIGHT	J16b.EDF	J16	2
81	7005161	7005267	510	616	106	RIGHT	J16b.EDF	J16	2
82	7010975	7011018	59	102	43	RIGHT	J16b.EDF	J16	2
82	7011149	7011244	233	328	95	RIGHT	J16b.EDF	J16	2
82	7011717	7011825	801	909	108	RIGHT	J16b.EDF	J16	2
83	7017101	7017197	570	666	96	RIGHT	J16b.EDF	J16	2
84	7023286	7023394	113	221	108	RIGHT	J16b.EDF	J16	2
84	7023665	7023772	492	599	107	RIGHT	J16b.EDF	J16	2
85	7029541	7029630	593	682	89	RIGHT	J16b.EDF	J16	2
85	7030382	7030465	1434	1517	83	RIGHT	J16b.EDF	J16	2
86	7035553	7035582	58	87	29	RIGHT	J16b.EDF	J16	2
86	7035822	7035952	327	457	130	RIGHT	J16b.EDF	J16	2
86	7036503	7036584	1008	1089	81	RIGHT	J16b.EDF	J16	2
87	7040623	7040670	58	105	47	RIGHT	J16b.EDF	J16	2
87	7041123	7041237	558	672	114	RIGHT	J16b.EDF	J16	2
88	7046208	7046334	432	558	126	RIGHT	J16b.EDF	J16	2
88	7046496	7046613	720	837	117	RIGHT	J16b.EDF	J16	2
89	7051864	7051981	514	631	117	RIGHT	J16b.EDF	J16	2
90	7057812	7057891	550	629	79	RIGHT	J16b.EDF	J16	2
91	7064542	7064627	370	455	85	RIGHT	J16b.EDF	J16	2
91	7064848	7064942	676	770	94	RIGHT	J16b.EDF	J16	2
92	7070421	7070470	58	107	49	RIGHT	J16b.EDF	J16	2
92	7071019	7071091	656	728	72	RIGHT	J16b.EDF	J16	2
93	7076097	7076203	386	492	106	RIGHT	J16b.EDF	J16	2
93	7076681	7076795	970	1084	114	RIGHT	J16b.EDF	J16	2
94	7081314	7081383	59	128	69	RIGHT	J16b.EDF	J16	2
94	7082034	7082120	779	865	86	RIGHT	J16b.EDF	J16	2
95	7087199	7087250	57	108	51	RIGHT	J16b.EDF	J16	2
95	7087857	7087978	715	836	121	RIGHT	J16b.EDF	J16	2
95	7088751	7088853	1609	1711	102	RIGHT	J16b.EDF	J16	2
96	7095436	7095525	1503	1592	89	RIGHT	J16b.EDF	J16	2
97	7099651	7099737	59	145	86	RIGHT	J16b.EDF	J16	2
98	7105726	7105815	209	298	89	RIGHT	J16b.EDF	J16	2
98	7106298	7106428	781	911	130	RIGHT	J16b.EDF	J16	2
99	7111107	7111207	57	157	100	RIGHT	J16b.EDF	J16	2
100	7117596	7117724	443	571	128	RIGHT	J16b.EDF	J16	2
100	7118408	7118492	1255	1339	84	RIGHT	J16b.EDF	J16	2
101	7122359	7122459	94	194	100	RIGHT	J16b.EDF	J16	2
102	7128249	7128337	100	188	88	RIGHT	J16b.EDF	J16	2
103	7134425	7134531	536	642	106	RIGHT	J16b.EDF	J16	2
104	7140208	7140277	232	301	69	RIGHT	J16b.EDF	J16	2
104	7140784	7140897	808	921	113	RIGHT	J16b.EDF	J16	2
105	7146434	7146513	58	137	79	RIGHT	J16b.EDF	J16	2
105	7147744	7147837	1368	1461	93	RIGHT	J16b.EDF	J16	2
106	7153137	7153223	203	289	86	RIGHT	J16b.EDF	J16	2
108	7164569	7164624	58	113	55	RIGHT	J16b.EDF	J16	2
108	7166066	7166148	1555	1637	82	RIGHT	J16b.EDF	J16	2
109	7171041	7171165	435	559	124	RIGHT	J16b.EDF	J16	2
110	7178902	7178975	1296	1369	73	RIGHT	J16b.EDF	J16	2
111	7184437	7184545	418	526	108	RIGHT	J16b.EDF	J16	2
113	7197654	7197761	633	740	107	RIGHT	J16b.EDF	J16	2
113	7197970	7198080	949	1059	110	RIGHT	J16b.EDF	J16	2
114	7203578	7203676	57	155	98	RIGHT	J16b.EDF	J16	2
114	7203999	7204135	478	614	136	RIGHT	J16b.EDF	J16	2
114	7204423	7204555	902	1034	132	RIGHT	J16b.EDF	J16	2
115	7209598	7209697	58	157	99	RIGHT	J16b.EDF	J16	2
115	7210150	7210268	610	728	118	RIGHT	J16b.EDF	J16	2
116	7215878	7216013	383	518	135	RIGHT	J16b.EDF	J16	2
116	7216146	7216268	651	773	122	RIGHT	J16b.EDF	J16	2
116	7216767	7216892	1272	1397	125	RIGHT	J16b.EDF	J16	2
117	7222610	7222744	524	658	134	RIGHT	J16b.EDF	J16	2
118	7227722	7227761	58	97	39	RIGHT	J16b.EDF	J16	2
118	7228099	7228225	435	561	126	RIGHT	J16b.EDF	J16	2
118	7228793	7228910	1129	1246	117	RIGHT	J16b.EDF	J16	2
119	7233687	7233717	58	88	30	RIGHT	J16b.EDF	J16	2
119	7235263	7235336	1634	1707	73	RIGHT	J16b.EDF	J16	2
120	7240003	7240108	88	193	105	RIGHT	J16b.EDF	J16	2
5	2779543	2779597	794	848	54	RIGHT	J19a.EDF	J19	1
5	2779618	2779771	869	1022	153	RIGHT	J19a.EDF	J19	1
9	2815490	2815617	4977	5104	127	RIGHT	J19a.EDF	J19	1
9	2815665	2815670	5152	5157	5	RIGHT	J19a.EDF	J19	1
9	2815711	2815766	5198	5253	55	RIGHT	J19a.EDF	J19	1
9	2815794	2815812	5281	5299	18	RIGHT	J19a.EDF	J19	1
40	3067932	3067932	1524	1524	0	RIGHT	J19a.EDF	J19	1
40	3067957	3067995	1549	1587	38	RIGHT	J19a.EDF	J19	1
40	3068034	3068047	1626	1639	13	RIGHT	J19a.EDF	J19	1
40	3068082	3068082	1674	1674	0	RIGHT	J19a.EDF	J19	1
70	3303314	3303318	1452	1456	4	RIGHT	J19a.EDF	J19	1
70	3303574	3303628	1712	1766	54	RIGHT	J19a.EDF	J19	1
38	4069864	4069886	677	699	22	RIGHT	J19b.EDF	J19	2
38	4070137	4070140	950	953	3	RIGHT	J19b.EDF	J19	2
53	4190244	4190244	107	107	0	RIGHT	J19b.EDF	J19	2
55	4207901	4208152	747	998	251	RIGHT	J19b.EDF	J19	2
54	5325320	5325510	509	699	190	RIGHT	J19c.EDF	J19	3
2	4056009	4056009	213	213	0	RIGHT	J33.EDF	J33	.
2	4056039	4056039	243	243	0	RIGHT	J33.EDF	J33	.
7	4095122	4095230	57	165	108	RIGHT	J33.EDF	J33	.
9	4108576	4108775	115	314	199	RIGHT	J33.EDF	J33	.
10	4115736	4115862	58	184	126	RIGHT	J33.EDF	J33	.
11	4125331	4125445	468	582	114	RIGHT	J33.EDF	J33	.
13	4142333	4142555	422	644	222	RIGHT	J33.EDF	J33	.
14	4149103	4149211	462	570	108	RIGHT	J33.EDF	J33	.
16	4164687	4164725	57	95	38	RIGHT	J33.EDF	J33	.
17	4172949	4173138	537	726	189	RIGHT	J33.EDF	J33	.
18	4180422	4180692	85	355	270	RIGHT	J33.EDF	J33	.
19	4189338	4189600	211	473	262	RIGHT	J33.EDF	J33	.
20	4197276	4197619	583	926	343	RIGHT	J33.EDF	J33	.
22	4211235	4211407	111	283	172	RIGHT	J33.EDF	J33	.
22	4217586	4217659	6462	6535	73	RIGHT	J33.EDF	J33	.
23	4220146	4220227	57	138	81	RIGHT	J33.EDF	J33	.
23	4220666	4220703	577	614	37	RIGHT	J33.EDF	J33	.
23	4220787	4220787	698	698	0	RIGHT	J33.EDF	J33	.
23	4220865	4221108	776	1019	243	RIGHT	J33.EDF	J33	.
23	4223249	4223249	3160	3160	0	RIGHT	J33.EDF	J33	.
23	4223275	4223275	3186	3186	0	RIGHT	J33.EDF	J33	.
23	4223316	4223317	3227	3228	1	RIGHT	J33.EDF	J33	.
23	4223377	4223406	3288	3317	29	RIGHT	J33.EDF	J33	.
23	4223435	4223454	3346	3365	19	RIGHT	J33.EDF	J33	.
23	4223547	4223584	3458	3495	37	RIGHT	J33.EDF	J33	.
23	4223653	4223671	3564	3582	18	RIGHT	J33.EDF	J33	.
23	4223723	4223742	3634	3653	19	RIGHT	J33.EDF	J33	.
23	4223776	4224412	3687	4323	636	RIGHT	J33.EDF	J33	.
23	4224440	4224451	4351	4362	11	RIGHT	J33.EDF	J33	.
23	4224515	4224515	4426	4426	0	RIGHT	J33.EDF	J33	.
23	4224577	4224577	4488	4488	0	RIGHT	J33.EDF	J33	.
23	4224600	4224695	4511	4606	95	RIGHT	J33.EDF	J33	.
23	4224824	4224824	4735	4735	0	RIGHT	J33.EDF	J33	.
23	4225284	4225285	5195	5196	1	RIGHT	J33.EDF	J33	.
23	4225335	4225362	5246	5273	27	RIGHT	J33.EDF	J33	.
23	4225390	4225390	5301	5301	0	RIGHT	J33.EDF	J33	.
23	4225413	4225413	5324	5324	0	RIGHT	J33.EDF	J33	.
23	4225494	4225494	5405	5405	0	RIGHT	J33.EDF	J33	.
24	4231512	4231568	3837	3893	56	RIGHT	J33.EDF	J33	.
24	4231603	4231604	3928	3929	1	RIGHT	J33.EDF	J33	.
24	4231740	4231752	4065	4077	12	RIGHT	J33.EDF	J33	.
24	4231872	4231872	4197	4197	0	RIGHT	J33.EDF	J33	.
24	4232026	4232026	4351	4351	0	RIGHT	J33.EDF	J33	.
24	4232056	4232056	4381	4381	0	RIGHT	J33.EDF	J33	.
24	4232125	4232125	4450	4450	0	RIGHT	J33.EDF	J33	.
24	4232203	4232203	4528	4528	0	RIGHT	J33.EDF	J33	.
24	4232551	4232552	4876	4877	1	RIGHT	J33.EDF	J33	.
26	4243397	4243530	266	399	133	RIGHT	J33.EDF	J33	.
26	4243699	4243935	568	804	236	RIGHT	J33.EDF	J33	.
27	4251462	4251462	81	81	0	RIGHT	J33.EDF	J33	.
27	4251842	4252040	461	659	198	RIGHT	J33.EDF	J33	.
30	4275055	4275243	670	858	188	RIGHT	J33.EDF	J33	.
31	4282305	4282723	506	924	418	RIGHT	J33.EDF	J33	.
31	4285487	4285509	3688	3710	22	RIGHT	J33.EDF	J33	.
31	4285547	4285549	3748	3750	2	RIGHT	J33.EDF	J33	.
31	4285574	4285581	3775	3782	7	RIGHT	J33.EDF	J33	.
31	4285603	4285637	3804	3838	34	RIGHT	J33.EDF	J33	.
31	4286585	4286601	4786	4802	16	RIGHT	J33.EDF	J33	.
32	4288721	4288721	168	168	0	RIGHT	J33.EDF	J33	.
32	4288784	4288784	231	231	0	RIGHT	J33.EDF	J33	.
32	4288901	4288902	348	349	1	RIGHT	J33.EDF	J33	.
32	4288982	4289003	429	450	21	RIGHT	J33.EDF	J33	.
32	4289109	4289527	556	974	418	RIGHT	J33.EDF	J33	.
32	4290651	4290723	2098	2170	72	RIGHT	J33.EDF	J33	.
32	4291164	4291420	2611	2867	256	RIGHT	J33.EDF	J33	.
32	4291454	4291455	2901	2902	1	RIGHT	J33.EDF	J33	.
35	4309822	4310093	460	731	271	RIGHT	J33.EDF	J33	.
38	4333549	4333549	539	539	0	RIGHT	J33.EDF	J33	.
38	4333589	4333613	579	603	24	RIGHT	J33.EDF	J33	.
38	4333718	4333724	708	714	6	RIGHT	J33.EDF	J33	.
38	4333771	4333771	761	761	0	RIGHT	J33.EDF	J33	.
38	4333809	4333809	799	799	0	RIGHT	J33.EDF	J33	.
38	4333833	4333876	823	866	43	RIGHT	J33.EDF	J33	.
38	4335133	4335222	2123	2212	89	RIGHT	J33.EDF	J33	.
38	4335780	4335780	2770	2770	0	RIGHT	J33.EDF	J33	.
38	4335810	4335904	2800	2894	94	RIGHT	J33.EDF	J33	.
39	4341104	4341256	58	210	152	RIGHT	J33.EDF	J33	.
39	4341329	4341330	283	284	1	RIGHT	J33.EDF	J33	.
39	4343156	4343339	2110	2293	183	RIGHT	J33.EDF	J33	.
39	4343360	4343366	2314	2320	6	RIGHT	J33.EDF	J33	.
39	4343807	4344344	2761	3298	537	RIGHT	J33.EDF	J33	.
39	4344375	4344375	3329	3329	0	RIGHT	J33.EDF	J33	.
39	4344402	4344403	3356	3357	1	RIGHT	J33.EDF	J33	.
39	4344448	4344453	3402	3407	5	RIGHT	J33.EDF	J33	.
39	4344476	4344520	3430	3474	44	RIGHT	J33.EDF	J33	.
39	4344541	4344552	3495	3506	11	RIGHT	J33.EDF	J33	.
40	4350111	4350669	1873	2431	558	RIGHT	J33.EDF	J33	.
40	4350740	4350740	2502	2502	0	RIGHT	J33.EDF	J33	.
40	4353006	4353131	4768	4893	125	RIGHT	J33.EDF	J33	.
40	4353158	4353246	4920	5008	88	RIGHT	J33.EDF	J33	.
40	4353349	4353349	5111	5111	0	RIGHT	J33.EDF	J33	.
40	4353374	4353389	5136	5151	15	RIGHT	J33.EDF	J33	.
40	4353431	4353431	5193	5193	0	RIGHT	J33.EDF	J33	.
40	4353701	4353701	5463	5463	0	RIGHT	J33.EDF	J33	.
40	4353728	4353728	5490	5490	0	RIGHT	J33.EDF	J33	.
40	4353855	4353855	5617	5617	0	RIGHT	J33.EDF	J33	.
40	4353904	4353904	5666	5666	0	RIGHT	J33.EDF	J33	.
41	4356187	4356389	57	259	202	RIGHT	J33.EDF	J33	.
41	4356410	4356833	280	703	423	RIGHT	J33.EDF	J33	.
41	4356893	4356924	763	794	31	RIGHT	J33.EDF	J33	.
41	4357760	4357858	1630	1728	98	RIGHT	J33.EDF	J33	.
41	4357893	4358971	1763	2841	1078	RIGHT	J33.EDF	J33	.
41	4359019	4359020	2889	2890	1	RIGHT	J33.EDF	J33	.
41	4359047	4359072	2917	2942	25	RIGHT	J33.EDF	J33	.
41	4359100	4359100	2970	2970	0	RIGHT	J33.EDF	J33	.
41	4359127	4359128	2997	2998	1	RIGHT	J33.EDF	J33	.
41	4359170	4359193	3040	3063	23	RIGHT	J33.EDF	J33	.
41	4359237	4359237	3107	3107	0	RIGHT	J33.EDF	J33	.
41	4359267	4359286	3137	3156	19	RIGHT	J33.EDF	J33	.
41	4359308	4359313	3178	3183	5	RIGHT	J33.EDF	J33	.
41	4359336	4359371	3206	3241	35	RIGHT	J33.EDF	J33	.
41	4359424	4359452	3294	3322	28	RIGHT	J33.EDF	J33	.
41	4359483	4360496	3353	4366	1013	RIGHT	J33.EDF	J33	.
41	4360524	4360706	4394	4576	182	RIGHT	J33.EDF	J33	.
41	4360730	4362879	4600	6749	2149	RIGHT	J33.EDF	J33	.
42	4365228	4365328	57	157	100	RIGHT	J33.EDF	J33	.
42	4365473	4365866	302	695	393	RIGHT	J33.EDF	J33	.
42	4365948	4366011	777	840	63	RIGHT	J33.EDF	J33	.
42	4366969	4367283	1798	2112	314	RIGHT	J33.EDF	J33	.
42	4367324	4367324	2153	2153	0	RIGHT	J33.EDF	J33	.
42	4367607	4368963	2436	3792	1356	RIGHT	J33.EDF	J33	.
42	4368990	4368990	3819	3819	0	RIGHT	J33.EDF	J33	.
43	4373292	4373476	58	242	184	RIGHT	J33.EDF	J33	.
43	4373498	4373629	264	395	131	RIGHT	J33.EDF	J33	.
43	4373665	4373665	431	431	0	RIGHT	J33.EDF	J33	.
43	4373687	4373701	453	467	14	RIGHT	J33.EDF	J33	.
43	4373722	4373722	488	488	0	RIGHT	J33.EDF	J33	.
43	4373871	4374165	637	931	294	RIGHT	J33.EDF	J33	.
43	4374213	4374226	979	992	13	RIGHT	J33.EDF	J33	.
43	4375575	4375732	2341	2498	157	RIGHT	J33.EDF	J33	.
43	4375826	4375925	2592	2691	99	RIGHT	J33.EDF	J33	.
43	4376519	4376551	3285	3317	32	RIGHT	J33.EDF	J33	.
43	4378187	4378187	4953	4953	0	RIGHT	J33.EDF	J33	.
43	4378222	4378231	4988	4997	9	RIGHT	J33.EDF	J33	.
43	4378271	4378271	5037	5037	0	RIGHT	J33.EDF	J33	.
43	4378314	4378403	5080	5169	89	RIGHT	J33.EDF	J33	.
43	4378426	4378426	5192	5192	0	RIGHT	J33.EDF	J33	.
43	4378479	4378480	5245	5246	1	RIGHT	J33.EDF	J33	.
43	4378511	4378511	5277	5277	0	RIGHT	J33.EDF	J33	.
44	4381589	4381589	91	91	0	RIGHT	J33.EDF	J33	.
44	4381629	4381716	131	218	87	RIGHT	J33.EDF	J33	.
44	4381738	4381766	240	268	28	RIGHT	J33.EDF	J33	.
44	4381922	4381922	424	424	0	RIGHT	J33.EDF	J33	.
44	4382834	4383119	1336	1621	285	RIGHT	J33.EDF	J33	.
44	4383169	4383169	1671	1671	0	RIGHT	J33.EDF	J33	.
44	4383190	4383261	1692	1763	71	RIGHT	J33.EDF	J33	.
44	4383619	4383819	2121	2321	200	RIGHT	J33.EDF	J33	.
44	4384270	4384273	2772	2775	3	RIGHT	J33.EDF	J33	.
44	4384295	4384317	2797	2819	22	RIGHT	J33.EDF	J33	.
44	4384340	4384356	2842	2858	16	RIGHT	J33.EDF	J33	.
45	4389495	4389683	93	281	188	RIGHT	J33.EDF	J33	.
45	4391583	4391775	2181	2373	192	RIGHT	J33.EDF	J33	.
45	4392380	4392634	2978	3232	254	RIGHT	J33.EDF	J33	.
45	4392669	4392684	3267	3282	15	RIGHT	J33.EDF	J33	.
45	4392745	4392745	3343	3343	0	RIGHT	J33.EDF	J33	.
45	4392807	4392855	3405	3453	48	RIGHT	J33.EDF	J33	.
45	4392884	4392981	3482	3579	97	RIGHT	J33.EDF	J33	.
45	4393016	4393017	3614	3615	1	RIGHT	J33.EDF	J33	.
45	4393051	4393051	3649	3649	0	RIGHT	J33.EDF	J33	.
45	4393089	4393102	3687	3700	13	RIGHT	J33.EDF	J33	.
45	4393167	4393171	3765	3769	4	RIGHT	J33.EDF	J33	.
45	4393231	4393239	3829	3837	8	RIGHT	J33.EDF	J33	.
45	4393288	4393289	3886	3887	1	RIGHT	J33.EDF	J33	.
45	4393412	4393412	4010	4010	0	RIGHT	J33.EDF	J33	.
45	4393459	4393479	4057	4077	20	RIGHT	J33.EDF	J33	.
45	4394466	4394466	5064	5064	0	RIGHT	J33.EDF	J33	.
46	4397033	4397108	58	133	75	RIGHT	J33.EDF	J33	.
46	4400215	4400225	3240	3250	10	RIGHT	J33.EDF	J33	.
46	4400247	4400247	3272	3272	0	RIGHT	J33.EDF	J33	.
46	4400992	4400992	4017	4017	0	RIGHT	J33.EDF	J33	.
47	4404788	4405037	58	307	249	RIGHT	J33.EDF	J33	.
47	4405161	4405161	431	431	0	RIGHT	J33.EDF	J33	.
47	4405204	4405215	474	485	11	RIGHT	J33.EDF	J33	.
47	4406608	4406682	1878	1952	74	RIGHT	J33.EDF	J33	.
47	4407201	4407201	2471	2471	0	RIGHT	J33.EDF	J33	.
47	4407228	4407391	2498	2661	163	RIGHT	J33.EDF	J33	.
48	4415115	4415230	2055	2170	115	RIGHT	J33.EDF	J33	.
48	4415885	4416228	2825	3168	343	RIGHT	J33.EDF	J33	.
48	4416255	4416266	3195	3206	11	RIGHT	J33.EDF	J33	.
48	4416325	4416327	3265	3267	2	RIGHT	J33.EDF	J33	.
49	4421080	4421222	57	199	142	RIGHT	J33.EDF	J33	.
49	4421284	4421294	261	271	10	RIGHT	J33.EDF	J33	.
49	4423034	4423790	2011	2767	756	RIGHT	J33.EDF	J33	.
49	4426603	4426621	5580	5598	18	RIGHT	J33.EDF	J33	.
49	4426642	4426642	5619	5619	0	RIGHT	J33.EDF	J33	.
49	4426675	4426678	5652	5655	3	RIGHT	J33.EDF	J33	.
49	4426718	4426936	5695	5913	218	RIGHT	J33.EDF	J33	.
49	4427082	4427103	6059	6080	21	RIGHT	J33.EDF	J33	.
49	4427133	4427133	6110	6110	0	RIGHT	J33.EDF	J33	.
50	4429447	4429588	58	199	141	RIGHT	J33.EDF	J33	.
50	4429876	4430279	487	890	403	RIGHT	J33.EDF	J33	.
50	4430385	4430402	996	1013	17	RIGHT	J33.EDF	J33	.
50	4431299	4431344	1910	1955	45	RIGHT	J33.EDF	J33	.
50	4431384	4431862	1995	2473	478	RIGHT	J33.EDF	J33	.
50	4431896	4431915	2507	2526	19	RIGHT	J33.EDF	J33	.
50	4434015	4434048	4626	4659	33	RIGHT	J33.EDF	J33	.
50	4434069	4434160	4680	4771	91	RIGHT	J33.EDF	J33	.
50	4434209	4434218	4820	4829	9	RIGHT	J33.EDF	J33	.
50	4434252	4434252	4863	4863	0	RIGHT	J33.EDF	J33	.
50	4434283	4434294	4894	4905	11	RIGHT	J33.EDF	J33	.
50	4434315	4434352	4926	4963	37	RIGHT	J33.EDF	J33	.
50	4434443	4434443	5054	5054	0	RIGHT	J33.EDF	J33	.
51	4436338	4436342	175	179	4	RIGHT	J33.EDF	J33	.
51	4436635	4436816	472	653	181	RIGHT	J33.EDF	J33	.
51	4438088	4438088	1925	1925	0	RIGHT	J33.EDF	J33	.
51	4438123	4438123	1960	1960	0	RIGHT	J33.EDF	J33	.
51	4438283	4438290	2120	2127	7	RIGHT	J33.EDF	J33	.
51	4438372	4438616	2209	2453	244	RIGHT	J33.EDF	J33	.
51	4438760	4438767	2597	2604	7	RIGHT	J33.EDF	J33	.
51	4438845	4438909	2682	2746	64	RIGHT	J33.EDF	J33	.
51	4438931	4439445	2768	3282	514	RIGHT	J33.EDF	J33	.
51	4439467	4439557	3304	3394	90	RIGHT	J33.EDF	J33	.
51	4439589	4441235	3426	5072	1646	RIGHT	J33.EDF	J33	.
51	4441257	4441335	5094	5172	78	RIGHT	J33.EDF	J33	.
51	4441381	4441426	5218	5263	45	RIGHT	J33.EDF	J33	.
51	4441448	4441535	5285	5372	87	RIGHT	J33.EDF	J33	.
51	4441564	4441687	5401	5524	123	RIGHT	J33.EDF	J33	.
52	4444768	4444807	119	158	39	RIGHT	J33.EDF	J33	.
52	4445274	4445647	625	998	373	RIGHT	J33.EDF	J33	.
52	4446538	4446577	1889	1928	39	RIGHT	J33.EDF	J33	.
52	4446943	4447063	2294	2414	120	RIGHT	J33.EDF	J33	.
52	4449953	4449954	5304	5305	1	RIGHT	J33.EDF	J33	.
52	4449997	4450001	5348	5352	4	RIGHT	J33.EDF	J33	.
52	4450158	4450225	5509	5576	67	RIGHT	J33.EDF	J33	.
52	4450272	4450272	5623	5623	0	RIGHT	J33.EDF	J33	.
52	4450404	4450404	5755	5755	0	RIGHT	J33.EDF	J33	.
52	4450447	4450474	5798	5825	27	RIGHT	J33.EDF	J33	.
52	4450499	4450540	5850	5891	41	RIGHT	J33.EDF	J33	.
52	4450567	4450592	5918	5943	25	RIGHT	J33.EDF	J33	.
53	4452491	4452566	57	132	75	RIGHT	J33.EDF	J33	.
53	4454290	4454325	1856	1891	35	RIGHT	J33.EDF	J33	.
53	4454347	4454437	1913	2003	90	RIGHT	J33.EDF	J33	.
53	4454487	4455871	2053	3437	1384	RIGHT	J33.EDF	J33	.
53	4455892	4455929	3458	3495	37	RIGHT	J33.EDF	J33	.
53	4455956	4456000	3522	3566	44	RIGHT	J33.EDF	J33	.
53	4456030	4456059	3596	3625	29	RIGHT	J33.EDF	J33	.
53	4456087	4456097	3653	3663	10	RIGHT	J33.EDF	J33	.
53	4456130	4456130	3696	3696	0	RIGHT	J33.EDF	J33	.
53	4456166	4456694	3732	4260	528	RIGHT	J33.EDF	J33	.
53	4456719	4456913	4285	4479	194	RIGHT	J33.EDF	J33	.
53	4456963	4457004	4529	4570	41	RIGHT	J33.EDF	J33	.
53	4457030	4457030	4596	4596	0	RIGHT	J33.EDF	J33	.
53	4457054	4457130	4620	4696	76	RIGHT	J33.EDF	J33	.
53	4457161	4457226	4727	4792	65	RIGHT	J33.EDF	J33	.
53	4457248	4457959	4814	5525	711	RIGHT	J33.EDF	J33	.
53	4457985	4457985	5551	5551	0	RIGHT	J33.EDF	J33	.
53	4458567	4458567	6133	6133	0	RIGHT	J33.EDF	J33	.
53	4458694	4458694	6260	6260	0	RIGHT	J33.EDF	J33	.
53	4459212	4459212	6778	6778	0	RIGHT	J33.EDF	J33	.
54	4461393	4461412	58	77	19	RIGHT	J33.EDF	J33	.
54	4461922	4461922	587	587	0	RIGHT	J33.EDF	J33	.
54	4461967	4462020	632	685	53	RIGHT	J33.EDF	J33	.
54	4462076	4462355	741	1020	279	RIGHT	J33.EDF	J33	.
54	4462545	4462545	1210	1210	0	RIGHT	J33.EDF	J33	.
54	4462603	4463174	1268	1839	571	RIGHT	J33.EDF	J33	.
54	4463201	4463217	1866	1882	16	RIGHT	J33.EDF	J33	.
54	4463246	4463280	1911	1945	34	RIGHT	J33.EDF	J33	.
54	4463320	4463328	1985	1993	8	RIGHT	J33.EDF	J33	.
54	4463354	4463355	2019	2020	1	RIGHT	J33.EDF	J33	.
54	4463379	4463400	2044	2065	21	RIGHT	J33.EDF	J33	.
54	4463433	4463434	2098	2099	1	RIGHT	J33.EDF	J33	.
54	4463461	4464414	2126	3079	953	RIGHT	J33.EDF	J33	.
54	4464435	4464435	3100	3100	0	RIGHT	J33.EDF	J33	.
54	4464463	4464529	3128	3194	66	RIGHT	J33.EDF	J33	.
54	4464557	4464622	3222	3287	65	RIGHT	J33.EDF	J33	.
54	4464656	4464671	3321	3336	15	RIGHT	J33.EDF	J33	.
54	4464715	4464737	3380	3402	22	RIGHT	J33.EDF	J33	.
54	4464965	4464965	3630	3630	0	RIGHT	J33.EDF	J33	.
54	4465683	4465683	4348	4348	0	RIGHT	J33.EDF	J33	.
54	4467435	4467436	6100	6101	1	RIGHT	J33.EDF	J33	.
54	4467579	4467613	6244	6278	34	RIGHT	J33.EDF	J33	.
54	4467640	4467640	6305	6305	0	RIGHT	J33.EDF	J33	.
54	4467738	4467742	6403	6407	4	RIGHT	J33.EDF	J33	.
54	4467768	4467768	6433	6433	0	RIGHT	J33.EDF	J33	.
54	4467804	4467833	6469	6498	29	RIGHT	J33.EDF	J33	.
54	4467885	4468034	6550	6699	149	RIGHT	J33.EDF	J33	.
54	4468067	4468136	6732	6801	69	RIGHT	J33.EDF	J33	.
54	4468158	4468344	6823	7009	186	RIGHT	J33.EDF	J33	.
54	4468371	4468371	7036	7036	0	RIGHT	J33.EDF	J33	.
54	4468438	4468473	7103	7138	35	RIGHT	J33.EDF	J33	.
55	4471293	4471302	135	144	9	RIGHT	J33.EDF	J33	.
55	4471627	4471790	469	632	163	RIGHT	J33.EDF	J33	.
55	4471857	4471880	699	722	23	RIGHT	J33.EDF	J33	.
55	4473140	4473148	1982	1990	8	RIGHT	J33.EDF	J33	.
55	4473181	4473694	2023	2536	513	RIGHT	J33.EDF	J33	.
55	4473720	4473942	2562	2784	222	RIGHT	J33.EDF	J33	.
55	4474007	4474007	2849	2849	0	RIGHT	J33.EDF	J33	.
55	4474417	4474432	3259	3274	15	RIGHT	J33.EDF	J33	.
55	4474495	4474522	3337	3364	27	RIGHT	J33.EDF	J33	.
55	4474578	4474601	3420	3443	23	RIGHT	J33.EDF	J33	.
55	4474623	4474623	3465	3465	0	RIGHT	J33.EDF	J33	.
55	4474648	4474648	3490	3490	0	RIGHT	J33.EDF	J33	.
55	4474674	4475331	3516	4173	657	RIGHT	J33.EDF	J33	.
55	4475352	4475361	4194	4203	9	RIGHT	J33.EDF	J33	.
55	4475426	4475426	4268	4268	0	RIGHT	J33.EDF	J33	.
55	4475497	4475637	4339	4479	140	RIGHT	J33.EDF	J33	.
55	4475664	4475697	4506	4539	33	RIGHT	J33.EDF	J33	.
55	4476372	4476372	5214	5214	0	RIGHT	J33.EDF	J33	.
55	4476877	4476880	5719	5722	3	RIGHT	J33.EDF	J33	.
55	4476955	4476962	5797	5804	7	RIGHT	J33.EDF	J33	.
55	4477076	4477076	5918	5918	0	RIGHT	J33.EDF	J33	.
55	4477103	4477108	5945	5950	5	RIGHT	J33.EDF	J33	.
55	4477225	4477234	6067	6076	9	RIGHT	J33.EDF	J33	.
55	4477311	4477312	6153	6154	1	RIGHT	J33.EDF	J33	.
55	4477349	4477350	6191	6192	1	RIGHT	J33.EDF	J33	.
55	4477392	4477392	6234	6234	0	RIGHT	J33.EDF	J33	.
55	4477438	4477450	6280	6292	12	RIGHT	J33.EDF	J33	.
55	4477495	4477506	6337	6348	11	RIGHT	J33.EDF	J33	.
55	4477535	4477550	6377	6392	15	RIGHT	J33.EDF	J33	.
56	4479551	4479954	521	924	403	RIGHT	J33.EDF	J33	.
57	4488402	4488440	2218	2256	38	RIGHT	J33.EDF	J33	.
57	4488465	4488475	2281	2291	10	RIGHT	J33.EDF	J33	.
57	4488508	4488508	2324	2324	0	RIGHT	J33.EDF	J33	.
57	4488575	4488582	2391	2398	7	RIGHT	J33.EDF	J33	.
57	4488652	4488653	2468	2469	1	RIGHT	J33.EDF	J33	.
57	4488748	4488760	2564	2576	12	RIGHT	J33.EDF	J33	.
57	4488818	4488820	2634	2636	2	RIGHT	J33.EDF	J33	.
57	4492786	4493249	6602	7065	463	RIGHT	J33.EDF	J33	.
58	4494916	4494979	57	120	63	RIGHT	J33.EDF	J33	.
58	4495008	4495016	149	157	8	RIGHT	J33.EDF	J33	.
58	4497065	4497085	2206	2226	20	RIGHT	J33.EDF	J33	.
58	4497116	4497117	2257	2258	1	RIGHT	J33.EDF	J33	.
58	4497159	4497192	2300	2333	33	RIGHT	J33.EDF	J33	.
58	4497250	4497251	2391	2392	1	RIGHT	J33.EDF	J33	.
59	4504862	4504906	2251	2295	44	RIGHT	J33.EDF	J33	.
59	4505905	4506160	3294	3549	255	RIGHT	J33.EDF	J33	.
59	4506182	4506451	3571	3840	269	RIGHT	J33.EDF	J33	.
59	4507029	4507029	4418	4418	0	RIGHT	J33.EDF	J33	.
59	4507073	4507085	4462	4474	12	RIGHT	J33.EDF	J33	.
59	4507109	4507210	4498	4599	101	RIGHT	J33.EDF	J33	.
59	4507244	4507342	4633	4731	98	RIGHT	J33.EDF	J33	.
59	4507372	4507482	4761	4871	110	RIGHT	J33.EDF	J33	.
59	4507531	4507693	4920	5082	162	RIGHT	J33.EDF	J33	.
59	4508093	4508103	5482	5492	10	RIGHT	J33.EDF	J33	.
59	4508124	4508125	5513	5514	1	RIGHT	J33.EDF	J33	.
59	4508160	4508160	5549	5549	0	RIGHT	J33.EDF	J33	.
59	4508325	4508325	5714	5714	0	RIGHT	J33.EDF	J33	.
60	4510846	4510959	58	171	113	RIGHT	J33.EDF	J33	.
61	4519643	4519653	299	309	10	RIGHT	J33.EDF	J33	.
61	4519676	4519676	332	332	0	RIGHT	J33.EDF	J33	.
62	4531392	4531860	4012	4480	468	RIGHT	J33.EDF	J33	.
62	4531882	4531889	4502	4509	7	RIGHT	J33.EDF	J33	.
62	4532324	4532813	4944	5433	489	RIGHT	J33.EDF	J33	.
63	4534650	4534826	169	345	176	RIGHT	J33.EDF	J33	.
63	4534856	4534879	375	398	23	RIGHT	J33.EDF	J33	.
63	4534904	4534953	423	472	49	RIGHT	J33.EDF	J33	.
63	4534984	4534984	503	503	0	RIGHT	J33.EDF	J33	.
63	4535061	4535092	580	611	31	RIGHT	J33.EDF	J33	.
63	4536347	4536372	1866	1891	25	RIGHT	J33.EDF	J33	.
63	4537474	4537905	2993	3424	431	RIGHT	J33.EDF	J33	.
64	4541235	4541399	57	221	164	RIGHT	J33.EDF	J33	.
65	4548039	4548249	157	367	210	RIGHT	J33.EDF	J33	.
67	4565155	4565155	484	484	0	RIGHT	J33.EDF	J33	.
67	4565196	4565217	525	546	21	RIGHT	J33.EDF	J33	.
67	4565305	4565306	634	635	1	RIGHT	J33.EDF	J33	.
67	4566692	4566692	2021	2021	0	RIGHT	J33.EDF	J33	.
67	4566717	4566761	2046	2090	44	RIGHT	J33.EDF	J33	.
67	4567450	4567535	2779	2864	85	RIGHT	J33.EDF	J33	.
68	4573666	4573747	77	158	81	RIGHT	J33.EDF	J33	.
68	4574060	4574268	471	679	208	RIGHT	J33.EDF	J33	.
68	4574322	4574326	733	737	4	RIGHT	J33.EDF	J33	.
68	4575879	4576566	2290	2977	687	RIGHT	J33.EDF	J33	.
68	4579936	4579936	6347	6347	0	RIGHT	J33.EDF	J33	.
69	4582034	4582034	99	99	0	RIGHT	J33.EDF	J33	.
69	4582194	4582194	259	259	0	RIGHT	J33.EDF	J33	.
69	4582222	4582225	287	290	3	RIGHT	J33.EDF	J33	.
69	4582246	4582264	311	329	18	RIGHT	J33.EDF	J33	.
69	4582292	4582320	357	385	28	RIGHT	J33.EDF	J33	.
69	4582363	4582364	428	429	1	RIGHT	J33.EDF	J33	.
69	4583940	4583983	2005	2048	43	RIGHT	J33.EDF	J33	.
69	4584776	4584776	2841	2841	0	RIGHT	J33.EDF	J33	.
69	4584797	4585111	2862	3176	314	RIGHT	J33.EDF	J33	.
69	4585140	4585140	3205	3205	0	RIGHT	J33.EDF	J33	.
69	4586767	4586767	4832	4832	0	RIGHT	J33.EDF	J33	.
69	4586848	4586856	4913	4921	8	RIGHT	J33.EDF	J33	.
69	4586887	4586952	4952	5017	65	RIGHT	J33.EDF	J33	.
70	4589248	4589556	468	776	308	RIGHT	J33.EDF	J33	.
70	4590637	4590779	1857	1999	142	RIGHT	J33.EDF	J33	.
70	4591455	4591456	2675	2676	1	RIGHT	J33.EDF	J33	.
70	4591483	4591484	2703	2704	1	RIGHT	J33.EDF	J33	.
70	4591507	4592427	2727	3647	920	RIGHT	J33.EDF	J33	.
70	4592451	4592475	3671	3695	24	RIGHT	J33.EDF	J33	.
70	4592499	4592521	3719	3741	22	RIGHT	J33.EDF	J33	.
70	4592553	4592579	3773	3799	26	RIGHT	J33.EDF	J33	.
70	4592616	4592669	3836	3889	53	RIGHT	J33.EDF	J33	.
70	4592751	4592775	3971	3995	24	RIGHT	J33.EDF	J33	.
71	4596586	4596803	464	681	217	RIGHT	J33.EDF	J33	.
71	4597984	4598052	1862	1930	68	RIGHT	J33.EDF	J33	.
71	4598876	4598877	2754	2755	1	RIGHT	J33.EDF	J33	.
71	4598907	4600280	2785	4158	1373	RIGHT	J33.EDF	J33	.
71	4600312	4600360	4190	4238	48	RIGHT	J33.EDF	J33	.
71	4600406	4600406	4284	4284	0	RIGHT	J33.EDF	J33	.
71	4600436	4600436	4314	4314	0	RIGHT	J33.EDF	J33	.
71	4600509	4601055	4387	4933	546	RIGHT	J33.EDF	J33	.
72	4603007	4603334	74	401	327	RIGHT	J33.EDF	J33	.
72	4603388	4603675	455	742	287	RIGHT	J33.EDF	J33	.
72	4603701	4603750	768	817	49	RIGHT	J33.EDF	J33	.
72	4603773	4603820	840	887	47	RIGHT	J33.EDF	J33	.
72	4603871	4603871	938	938	0	RIGHT	J33.EDF	J33	.
72	4603917	4603985	984	1052	68	RIGHT	J33.EDF	J33	.
72	4604057	4604057	1124	1124	0	RIGHT	J33.EDF	J33	.
72	4604096	4604127	1163	1194	31	RIGHT	J33.EDF	J33	.
72	4604708	4604853	1775	1920	145	RIGHT	J33.EDF	J33	.
72	4604889	4604890	1956	1957	1	RIGHT	J33.EDF	J33	.
72	4605402	4606846	2469	3913	1444	RIGHT	J33.EDF	J33	.
72	4606873	4606982	3940	4049	109	RIGHT	J33.EDF	J33	.
72	4607004	4607004	4071	4071	0	RIGHT	J33.EDF	J33	.
72	4607031	4607409	4098	4476	378	RIGHT	J33.EDF	J33	.
72	4607438	4607496	4505	4563	58	RIGHT	J33.EDF	J33	.
72	4607532	4607532	4599	4599	0	RIGHT	J33.EDF	J33	.
72	4607554	4607594	4621	4661	40	RIGHT	J33.EDF	J33	.
72	4607619	4607628	4686	4695	9	RIGHT	J33.EDF	J33	.
72	4607687	4607687	4754	4754	0	RIGHT	J33.EDF	J33	.
72	4607762	4607973	4829	5040	211	RIGHT	J33.EDF	J33	.
72	4608036	4608036	5103	5103	0	RIGHT	J33.EDF	J33	.
72	4608091	4608091	5158	5158	0	RIGHT	J33.EDF	J33	.
72	4608227	4608237	5294	5304	10	RIGHT	J33.EDF	J33	.
73	4615195	4615224	3568	3597	29	RIGHT	J33.EDF	J33	.
73	4615256	4615257	3629	3630	1	RIGHT	J33.EDF	J33	.
73	4616091	4616091	4464	4464	0	RIGHT	J33.EDF	J33	.
73	4616434	4616444	4807	4817	10	RIGHT	J33.EDF	J33	.
73	4616498	4616852	4871	5225	354	RIGHT	J33.EDF	J33	.
73	4616884	4616884	5257	5257	0	RIGHT	J33.EDF	J33	.
73	4616954	4616954	5327	5327	0	RIGHT	J33.EDF	J33	.
73	4617115	4617115	5488	5488	0	RIGHT	J33.EDF	J33	.
73	4617220	4617234	5593	5607	14	RIGHT	J33.EDF	J33	.
73	4617268	4617284	5641	5657	16	RIGHT	J33.EDF	J33	.
74	4624988	4625005	4301	4318	17	RIGHT	J33.EDF	J33	.
74	4625055	4625141	4368	4454	86	RIGHT	J33.EDF	J33	.
74	4625176	4625180	4489	4493	4	RIGHT	J33.EDF	J33	.
74	4625203	4625253	4516	4566	50	RIGHT	J33.EDF	J33	.
74	4625701	4626902	5014	6215	1201	RIGHT	J33.EDF	J33	.
75	4628849	4629637	57	845	788	RIGHT	J33.EDF	J33	.
75	4630674	4631345	1882	2553	671	RIGHT	J33.EDF	J33	.
76	4635521	4635542	58	79	21	RIGHT	J33.EDF	J33	.
76	4637678	4637878	2215	2415	200	RIGHT	J33.EDF	J33	.
76	4637901	4637903	2438	2440	2	RIGHT	J33.EDF	J33	.
76	4637929	4638166	2466	2703	237	RIGHT	J33.EDF	J33	.
76	4642299	4642299	6836	6836	0	RIGHT	J33.EDF	J33	.
77	4645000	4645247	589	836	247	RIGHT	J33.EDF	J33	.
77	4646284	4646285	1873	1874	1	RIGHT	J33.EDF	J33	.
77	4646858	4646877	2447	2466	19	RIGHT	J33.EDF	J33	.
77	4646941	4646941	2530	2530	0	RIGHT	J33.EDF	J33	.
78	4652728	4653024	690	986	296	RIGHT	J33.EDF	J33	.
78	4654019	4654197	1981	2159	178	RIGHT	J33.EDF	J33	.
78	4654493	4654836	2455	2798	343	RIGHT	J33.EDF	J33	.
78	4654883	4654883	2845	2845	0	RIGHT	J33.EDF	J33	.
79	4659518	4659556	58	96	38	RIGHT	J33.EDF	J33	.
79	4660033	4660515	573	1055	482	RIGHT	J33.EDF	J33	.
79	4661418	4662234	1958	2774	816	RIGHT	J33.EDF	J33	.
80	4666042	4666224	118	300	182	RIGHT	J33.EDF	J33	.
80	4666566	4666802	642	878	236	RIGHT	J33.EDF	J33	.
80	4668225	4668362	2301	2438	137	RIGHT	J33.EDF	J33	.
80	4668649	4668936	2725	3012	287	RIGHT	J33.EDF	J33	.
81	4672678	4672719	70	111	41	RIGHT	J33.EDF	J33	.
81	4672743	4672832	135	224	89	RIGHT	J33.EDF	J33	.
81	4672854	4672858	246	250	4	RIGHT	J33.EDF	J33	.
81	4674494	4674630	1886	2022	136	RIGHT	J33.EDF	J33	.
81	4675035	4675036	2427	2428	1	RIGHT	J33.EDF	J33	.
81	4675057	4675293	2449	2685	236	RIGHT	J33.EDF	J33	.
82	4680630	4680788	58	216	158	RIGHT	J33.EDF	J33	.
82	4682522	4682522	1950	1950	0	RIGHT	J33.EDF	J33	.
82	4682703	4683881	2131	3309	1178	RIGHT	J33.EDF	J33	.
82	4683904	4683939	3332	3367	35	RIGHT	J33.EDF	J33	.
82	4683979	4683984	3407	3412	5	RIGHT	J33.EDF	J33	.
83	4688807	4689128	58	379	321	RIGHT	J33.EDF	J33	.
83	4690652	4690652	1903	1903	0	RIGHT	J33.EDF	J33	.
83	4690705	4690705	1956	1956	0	RIGHT	J33.EDF	J33	.
83	4690737	4690741	1988	1992	4	RIGHT	J33.EDF	J33	.
83	4690767	4690767	2018	2018	0	RIGHT	J33.EDF	J33	.
83	4690874	4690874	2125	2125	0	RIGHT	J33.EDF	J33	.
83	4693282	4693394	4533	4645	112	RIGHT	J33.EDF	J33	.
83	4693466	4693468	4717	4719	2	RIGHT	J33.EDF	J33	.
83	4693494	4693566	4745	4817	72	RIGHT	J33.EDF	J33	.
83	4693590	4695373	4841	6624	1783	RIGHT	J33.EDF	J33	.
84	4697729	4698072	573	916	343	RIGHT	J33.EDF	J33	.
84	4699414	4699606	2258	2450	192	RIGHT	J33.EDF	J33	.
84	4700184	4700185	3028	3029	1	RIGHT	J33.EDF	J33	.
84	4700237	4702417	3081	5261	2180	RIGHT	J33.EDF	J33	.
85	4705054	4705767	606	1319	713	RIGHT	J33.EDF	J33	.
85	4705797	4705803	1349	1355	6	RIGHT	J33.EDF	J33	.
85	4705831	4705842	1383	1394	11	RIGHT	J33.EDF	J33	.
85	4705949	4705952	1501	1504	3	RIGHT	J33.EDF	J33	.
85	4706176	4706276	1728	1828	100	RIGHT	J33.EDF	J33	.
85	4706838	4708614	2390	4166	1776	RIGHT	J33.EDF	J33	.
85	4708704	4708705	4256	4257	1	RIGHT	J33.EDF	J33	.
85	4708766	4708768	4318	4320	2	RIGHT	J33.EDF	J33	.
86	4713038	4713301	58	321	263	RIGHT	J33.EDF	J33	.
86	4713520	4713522	540	542	2	RIGHT	J33.EDF	J33	.
86	4713551	4713551	571	571	0	RIGHT	J33.EDF	J33	.
86	4713612	4713870	632	890	258	RIGHT	J33.EDF	J33	.
86	4713913	4713913	933	933	0	RIGHT	J33.EDF	J33	.
86	4715120	4715604	2140	2624	484	RIGHT	J33.EDF	J33	.
86	4715684	4715686	2704	2706	2	RIGHT	J33.EDF	J33	.
87	4721853	4721938	58	143	85	RIGHT	J33.EDF	J33	.
87	4722009	4722009	214	214	0	RIGHT	J33.EDF	J33	.
87	4722171	4722183	376	388	12	RIGHT	J33.EDF	J33	.
87	4725090	4725121	3295	3326	31	RIGHT	J33.EDF	J33	.
87	4725144	4725445	3349	3650	301	RIGHT	J33.EDF	J33	.
87	4725467	4725511	3672	3716	44	RIGHT	J33.EDF	J33	.
87	4725657	4725660	3862	3865	3	RIGHT	J33.EDF	J33	.
87	4725765	4725765	3970	3970	0	RIGHT	J33.EDF	J33	.
87	4725796	4726698	4001	4903	902	RIGHT	J33.EDF	J33	.
87	4726747	4726773	4952	4978	26	RIGHT	J33.EDF	J33	.
87	4726853	4726853	5058	5058	0	RIGHT	J33.EDF	J33	.
87	4727148	4727162	5353	5367	14	RIGHT	J33.EDF	J33	.
87	4727184	4727199	5389	5404	15	RIGHT	J33.EDF	J33	.
87	4727224	4727224	5429	5429	0	RIGHT	J33.EDF	J33	.
87	4727256	4727426	5461	5631	170	RIGHT	J33.EDF	J33	.
87	4727477	4727543	5682	5748	66	RIGHT	J33.EDF	J33	.
87	4727597	4727678	5802	5883	81	RIGHT	J33.EDF	J33	.
87	4727706	4727723	5911	5928	17	RIGHT	J33.EDF	J33	.
87	4727858	4727860	6063	6065	2	RIGHT	J33.EDF	J33	.
87	4728266	4728654	6471	6859	388	RIGHT	J33.EDF	J33	.
88	4731053	4731308	550	805	255	RIGHT	J33.EDF	J33	.
88	4732372	4732396	1869	1893	24	RIGHT	J33.EDF	J33	.
88	4732496	4732497	1993	1994	1	RIGHT	J33.EDF	J33	.
88	4732536	4732601	2033	2098	65	RIGHT	J33.EDF	J33	.
88	4733507	4733688	3004	3185	181	RIGHT	J33.EDF	J33	.
88	4733762	4733762	3259	3259	0	RIGHT	J33.EDF	J33	.
89	4737954	4737982	124	152	28	RIGHT	J33.EDF	J33	.
89	4738068	4738068	238	238	0	RIGHT	J33.EDF	J33	.
89	4738138	4738151	308	321	13	RIGHT	J33.EDF	J33	.
89	4738258	4738601	428	771	343	RIGHT	J33.EDF	J33	.
89	4740176	4740310	2346	2480	134	RIGHT	J33.EDF	J33	.
89	4740362	4740362	2532	2532	0	RIGHT	J33.EDF	J33	.
89	4740416	4740419	2586	2589	3	RIGHT	J33.EDF	J33	.
89	4740440	4740636	2610	2806	196	RIGHT	J33.EDF	J33	.
90	4746730	4746993	476	739	263	RIGHT	J33.EDF	J33	.
90	4748291	4748579	2037	2325	288	RIGHT	J33.EDF	J33	.
90	4748600	4748680	2346	2426	80	RIGHT	J33.EDF	J33	.
90	4748711	4748711	2457	2457	0	RIGHT	J33.EDF	J33	.
90	4748736	4748738	2482	2484	2	RIGHT	J33.EDF	J33	.
90	4749909	4749909	3655	3655	0	RIGHT	J33.EDF	J33	.
91	4753826	4753950	58	182	124	RIGHT	J33.EDF	J33	.
91	4756100	4756118	2332	2350	18	RIGHT	J33.EDF	J33	.
91	4756158	4756394	2390	2626	236	RIGHT	J33.EDF	J33	.
91	4759117	4759117	5349	5349	0	RIGHT	J33.EDF	J33	.
92	4763455	4763888	449	882	433	RIGHT	J33.EDF	J33	.
92	4765238	4767418	2232	4412	2180	RIGHT	J33.EDF	J33	.
93	4770226	4771134	57	965	908	RIGHT	J33.EDF	J33	.
93	4772415	4773384	2246	3215	969	RIGHT	J33.EDF	J33	.
93	4773430	4773432	3261	3263	2	RIGHT	J33.EDF	J33	.
93	4773474	4773516	3305	3347	42	RIGHT	J33.EDF	J33	.
93	4773639	4773656	3470	3487	17	RIGHT	J33.EDF	J33	.
93	4773745	4773746	3576	3577	1	RIGHT	J33.EDF	J33	.
93	4773797	4773797	3628	3628	0	RIGHT	J33.EDF	J33	.
93	4773833	4773835	3664	3666	2	RIGHT	J33.EDF	J33	.
93	4774027	4774027	3858	3858	0	RIGHT	J33.EDF	J33	.
93	4774048	4774048	3879	3879	0	RIGHT	J33.EDF	J33	.
93	4774069	4774664	3900	4495	595	RIGHT	J33.EDF	J33	.
93	4774765	4774776	4596	4607	11	RIGHT	J33.EDF	J33	.
93	4774810	4774810	4641	4641	0	RIGHT	J33.EDF	J33	.
93	4774833	4774833	4664	4664	0	RIGHT	J33.EDF	J33	.
93	4776257	4776264	6088	6095	7	RIGHT	J33.EDF	J33	.
93	4776295	4776300	6126	6131	5	RIGHT	J33.EDF	J33	.
94	4779652	4780072	57	477	420	RIGHT	J33.EDF	J33	.
94	4780118	4780611	523	1016	493	RIGHT	J33.EDF	J33	.
94	4781368	4782091	1773	2496	723	RIGHT	J33.EDF	J33	.
94	4782116	4782137	2521	2542	21	RIGHT	J33.EDF	J33	.
94	4783983	4783983	4388	4388	0	RIGHT	J33.EDF	J33	.
94	4784041	4784061	4446	4466	20	RIGHT	J33.EDF	J33	.
94	4784582	4784582	4987	4987	0	RIGHT	J33.EDF	J33	.
94	4784700	4784701	5105	5106	1	RIGHT	J33.EDF	J33	.
94	4784753	4784753	5158	5158	0	RIGHT	J33.EDF	J33	.
94	4784813	4784813	5218	5218	0	RIGHT	J33.EDF	J33	.
94	4784835	4784835	5240	5240	0	RIGHT	J33.EDF	J33	.
94	4784975	4784975	5380	5380	0	RIGHT	J33.EDF	J33	.
94	4785387	4785387	5792	5792	0	RIGHT	J33.EDF	J33	.
95	4787735	4788348	467	1080	613	RIGHT	J33.EDF	J33	.
95	4789430	4790383	2162	3115	953	RIGHT	J33.EDF	J33	.
96	4794151	4794446	58	353	295	RIGHT	J33.EDF	J33	.
96	4796174	4797113	2081	3020	939	RIGHT	J33.EDF	J33	.
96	4797156	4797158	3063	3065	2	RIGHT	J33.EDF	J33	.
96	4797188	4797191	3095	3098	3	RIGHT	J33.EDF	J33	.
96	4797239	4797240	3146	3147	1	RIGHT	J33.EDF	J33	.
96	4798622	4798622	4529	4529	0	RIGHT	J33.EDF	J33	.
96	4798645	4798645	4552	4552	0	RIGHT	J33.EDF	J33	.
96	4798765	4798793	4672	4700	28	RIGHT	J33.EDF	J33	.
96	4798959	4798960	4866	4867	1	RIGHT	J33.EDF	J33	.
96	4799045	4799045	4952	4952	0	RIGHT	J33.EDF	J33	.
96	4799088	4799088	4995	4995	0	RIGHT	J33.EDF	J33	.
96	4799155	4799155	5062	5062	0	RIGHT	J33.EDF	J33	.
97	4801651	4801706	73	128	55	RIGHT	J33.EDF	J33	.
97	4802052	4802352	474	774	300	RIGHT	J33.EDF	J33	.
97	4803563	4803624	1985	2046	61	RIGHT	J33.EDF	J33	.
97	4804607	4807812	3029	6234	3205	RIGHT	J33.EDF	J33	.
98	4809861	4810158	57	354	297	RIGHT	J33.EDF	J33	.
98	4810200	4810200	396	396	0	RIGHT	J33.EDF	J33	.
98	4810232	4811257	428	1453	1025	RIGHT	J33.EDF	J33	.
98	4811285	4811321	1481	1517	36	RIGHT	J33.EDF	J33	.
98	4811345	4811345	1541	1541	0	RIGHT	J33.EDF	J33	.
98	4811370	4811370	1566	1566	0	RIGHT	J33.EDF	J33	.
98	4811787	4815017	1983	5213	3230	RIGHT	J33.EDF	J33	.
99	4816912	4817447	98	633	535	RIGHT	J33.EDF	J33	.
99	4817496	4817503	682	689	7	RIGHT	J33.EDF	J33	.
99	4818724	4818901	1910	2087	177	RIGHT	J33.EDF	J33	.
99	4819406	4823863	2592	7049	4457	RIGHT	J33.EDF	J33	.
100	4826161	4826307	57	203	146	RIGHT	J33.EDF	J33	.
100	4826347	4826473	243	369	126	RIGHT	J33.EDF	J33	.
100	4826494	4826582	390	478	88	RIGHT	J33.EDF	J33	.
100	4826610	4827448	506	1344	838	RIGHT	J33.EDF	J33	.
100	4827471	4827478	1367	1374	7	RIGHT	J33.EDF	J33	.
100	4827508	4827508	1404	1404	0	RIGHT	J33.EDF	J33	.
100	4828349	4828435	2245	2331	86	RIGHT	J33.EDF	J33	.
100	4828914	4829266	2810	3162	352	RIGHT	J33.EDF	J33	.
100	4829295	4829295	3191	3191	0	RIGHT	J33.EDF	J33	.
100	4829321	4829333	3217	3229	12	RIGHT	J33.EDF	J33	.
101	4834443	4834901	58	516	458	RIGHT	J33.EDF	J33	.
101	4836215	4837034	1830	2649	819	RIGHT	J33.EDF	J33	.
101	4837065	4837066	2680	2681	1	RIGHT	J33.EDF	J33	.
102	4841344	4841344	290	290	0	RIGHT	J33.EDF	J33	.
102	4841614	4841987	560	933	373	RIGHT	J33.EDF	J33	.
102	4842174	4842174	1120	1120	0	RIGHT	J33.EDF	J33	.
102	4842836	4842836	1782	1782	0	RIGHT	J33.EDF	J33	.
102	4842857	4842857	1803	1803	0	RIGHT	J33.EDF	J33	.
102	4843260	4843425	2206	2371	165	RIGHT	J33.EDF	J33	.
102	4843463	4843468	2409	2414	5	RIGHT	J33.EDF	J33	.
102	4844328	4844924	3274	3870	596	RIGHT	J33.EDF	J33	.
102	4844964	4845094	3910	4040	130	RIGHT	J33.EDF	J33	.
102	4845847	4845852	4793	4798	5	RIGHT	J33.EDF	J33	.
102	4845886	4846402	4832	5348	516	RIGHT	J33.EDF	J33	.
102	4846493	4846493	5439	5439	0	RIGHT	J33.EDF	J33	.
102	4846517	4846538	5463	5484	21	RIGHT	J33.EDF	J33	.
102	4847247	4848068	6193	7014	821	RIGHT	J33.EDF	J33	.
103	4850564	4850695	58	189	131	RIGHT	J33.EDF	J33	.
103	4850977	4851500	471	994	523	RIGHT	J33.EDF	J33	.
103	4853123	4853170	2617	2664	47	RIGHT	J33.EDF	J33	.
103	4853196	4853391	2690	2885	195	RIGHT	J33.EDF	J33	.
103	4853418	4853467	2912	2961	49	RIGHT	J33.EDF	J33	.
104	4858840	4858922	57	139	82	RIGHT	J33.EDF	J33	.
104	4859427	4859427	644	644	0	RIGHT	J33.EDF	J33	.
104	4859576	4859606	793	823	30	RIGHT	J33.EDF	J33	.
104	4859627	4859681	844	898	54	RIGHT	J33.EDF	J33	.
104	4859736	4859737	953	954	1	RIGHT	J33.EDF	J33	.
104	4860943	4861785	2160	3002	842	RIGHT	J33.EDF	J33	.
104	4861814	4861814	3031	3031	0	RIGHT	J33.EDF	J33	.
104	4863586	4863586	4803	4803	0	RIGHT	J33.EDF	J33	.
104	4863843	4863843	5060	5060	0	RIGHT	J33.EDF	J33	.
105	4866674	4866834	57	217	160	RIGHT	J33.EDF	J33	.
105	4868610	4868803	1993	2186	193	RIGHT	J33.EDF	J33	.
105	4869299	4871593	2682	4976	2294	RIGHT	J33.EDF	J33	.
106	4874117	4874475	433	791	358	RIGHT	J33.EDF	J33	.
106	4875834	4875868	2150	2184	34	RIGHT	J33.EDF	J33	.
106	4875900	4875904	2216	2220	4	RIGHT	J33.EDF	J33	.
106	4875994	4875995	2310	2311	1	RIGHT	J33.EDF	J33	.
106	4876019	4876021	2335	2337	2	RIGHT	J33.EDF	J33	.
106	4876081	4876115	2397	2431	34	RIGHT	J33.EDF	J33	.
106	4876169	4876176	2485	2492	7	RIGHT	J33.EDF	J33	.
106	4876211	4876216	2527	2532	5	RIGHT	J33.EDF	J33	.
106	4876277	4876429	2593	2745	152	RIGHT	J33.EDF	J33	.
107	4881097	4881110	233	246	13	RIGHT	J33.EDF	J33	.
107	4881136	4881286	272	422	150	RIGHT	J33.EDF	J33	.
107	4886920	4886920	6056	6056	0	RIGHT	J33.EDF	J33	.
108	4889783	4889802	165	184	19	RIGHT	J33.EDF	J33	.
108	4890176	4890176	558	558	0	RIGHT	J33.EDF	J33	.
109	4896255	4896523	97	365	268	RIGHT	J33.EDF	J33	.
109	4898472	4898473	2314	2315	1	RIGHT	J33.EDF	J33	.
109	4898496	4898575	2338	2417	79	RIGHT	J33.EDF	J33	.
109	4899172	4899345	3014	3187	173	RIGHT	J33.EDF	J33	.
109	4899370	4899414	3212	3256	44	RIGHT	J33.EDF	J33	.
109	4899754	4899772	3596	3614	18	RIGHT	J33.EDF	J33	.
110	4903096	4903435	57	396	339	RIGHT	J33.EDF	J33	.
110	4905049	4906742	2010	3703	1693	RIGHT	J33.EDF	J33	.
110	4906763	4906763	3724	3724	0	RIGHT	J33.EDF	J33	.
110	4906793	4906853	3754	3814	60	RIGHT	J33.EDF	J33	.
111	4910141	4910141	336	336	0	RIGHT	J33.EDF	J33	.
111	4910318	4910922	513	1117	604	RIGHT	J33.EDF	J33	.
111	4911867	4916460	2062	6655	4593	RIGHT	J33.EDF	J33	.
112	4918336	4918336	162	162	0	RIGHT	J33.EDF	J33	.
112	4918372	4918386	198	212	14	RIGHT	J33.EDF	J33	.
112	4918436	4918444	262	270	8	RIGHT	J33.EDF	J33	.
112	4918535	4918536	361	362	1	RIGHT	J33.EDF	J33	.
112	4918571	4918571	397	397	0	RIGHT	J33.EDF	J33	.
112	4918742	4918743	568	569	1	RIGHT	J33.EDF	J33	.
112	4918893	4918898	719	724	5	RIGHT	J33.EDF	J33	.
112	4918996	4919003	822	829	7	RIGHT	J33.EDF	J33	.
112	4919187	4919187	1013	1013	0	RIGHT	J33.EDF	J33	.
112	4919227	4919227	1053	1053	0	RIGHT	J33.EDF	J33	.
112	4919254	4919274	1080	1100	20	RIGHT	J33.EDF	J33	.
112	4919400	4919400	1226	1226	0	RIGHT	J33.EDF	J33	.
112	4920190	4920204	2016	2030	14	RIGHT	J33.EDF	J33	.
112	4920260	4920403	2086	2229	143	RIGHT	J33.EDF	J33	.
112	4920728	4920729	2554	2555	1	RIGHT	J33.EDF	J33	.
112	4920750	4920865	2576	2691	115	RIGHT	J33.EDF	J33	.
112	4920968	4920986	2794	2812	18	RIGHT	J33.EDF	J33	.
112	4921010	4921014	2836	2840	4	RIGHT	J33.EDF	J33	.
112	4921038	4921040	2864	2866	2	RIGHT	J33.EDF	J33	.
112	4921068	4921068	2894	2894	0	RIGHT	J33.EDF	J33	.
113	4927418	4928230	461	1273	812	RIGHT	J33.EDF	J33	.
113	4928878	4931980	1921	5023	3102	RIGHT	J33.EDF	J33	.
114	4933814	4934489	58	733	675	RIGHT	J33.EDF	J33	.
114	4936642	4936975	2886	3219	333	RIGHT	J33.EDF	J33	.
114	4936996	4937034	3240	3278	38	RIGHT	J33.EDF	J33	.
114	4937059	4937062	3303	3306	3	RIGHT	J33.EDF	J33	.
114	4937205	4937205	3449	3449	0	RIGHT	J33.EDF	J33	.
114	4937262	4937281	3506	3525	19	RIGHT	J33.EDF	J33	.
114	4937310	4937310	3554	3554	0	RIGHT	J33.EDF	J33	.
115	4944043	4944181	1207	1345	138	RIGHT	J33.EDF	J33	.
115	4945770	4945770	2934	2934	0	RIGHT	J33.EDF	J33	.
116	4951069	4951294	58	283	225	RIGHT	J33.EDF	J33	.
116	4952982	4953012	1971	2001	30	RIGHT	J33.EDF	J33	.
116	4953750	4953753	2739	2742	3	RIGHT	J33.EDF	J33	.
116	4953775	4953874	2764	2863	99	RIGHT	J33.EDF	J33	.
116	4953898	4953934	2887	2923	36	RIGHT	J33.EDF	J33	.
116	4956499	4956500	5488	5489	1	RIGHT	J33.EDF	J33	.
117	4959029	4959045	154	170	16	RIGHT	J33.EDF	J33	.
117	4959092	4959245	217	370	153	RIGHT	J33.EDF	J33	.
117	4959308	4959651	433	776	343	RIGHT	J33.EDF	J33	.
117	4960947	4961217	2072	2342	270	RIGHT	J33.EDF	J33	.
117	4961691	4963894	2816	5019	2203	RIGHT	J33.EDF	J33	.
117	4963934	4963934	5059	5059	0	RIGHT	J33.EDF	J33	.
117	4963960	4963986	5085	5111	26	RIGHT	J33.EDF	J33	.
117	4964027	4964170	5152	5295	143	RIGHT	J33.EDF	J33	.
117	4964192	4964519	5317	5644	327	RIGHT	J33.EDF	J33	.
117	4964561	4964622	5686	5747	61	RIGHT	J33.EDF	J33	.
118	4966647	4966674	164	191	27	RIGHT	J33.EDF	J33	.
118	4966696	4966757	213	274	61	RIGHT	J33.EDF	J33	.
118	4966811	4966870	328	387	59	RIGHT	J33.EDF	J33	.
118	4966896	4967077	413	594	181	RIGHT	J33.EDF	J33	.
118	4967360	4967360	877	877	0	RIGHT	J33.EDF	J33	.
118	4967411	4967880	928	1397	469	RIGHT	J33.EDF	J33	.
118	4967965	4967966	1482	1483	1	RIGHT	J33.EDF	J33	.
118	4967994	4967994	1511	1511	0	RIGHT	J33.EDF	J33	.
118	4968616	4969488	2133	3005	872	RIGHT	J33.EDF	J33	.
118	4969517	4969576	3034	3093	59	RIGHT	J33.EDF	J33	.
118	4969606	4969658	3123	3175	52	RIGHT	J33.EDF	J33	.
118	4969697	4969724	3214	3241	27	RIGHT	J33.EDF	J33	.
118	4969836	4969836	3353	3353	0	RIGHT	J33.EDF	J33	.
119	4975237	4975674	64	501	437	RIGHT	J33.EDF	J33	.
119	4975700	4975707	527	534	7	RIGHT	J33.EDF	J33	.
119	4975729	4975798	556	625	69	RIGHT	J33.EDF	J33	.
119	4976099	4976337	926	1164	238	RIGHT	J33.EDF	J33	.
119	4977353	4978202	2180	3029	849	RIGHT	J33.EDF	J33	.
119	4978231	4978241	3058	3068	10	RIGHT	J33.EDF	J33	.
120	4983547	4983547	147	147	0	RIGHT	J33.EDF	J33	.
120	4983577	4983577	177	177	0	RIGHT	J33.EDF	J33	.
120	4983626	4983646	226	246	20	RIGHT	J33.EDF	J33	.
120	4983680	4983689	280	289	9	RIGHT	J33.EDF	J33	.
120	4983713	4983714	313	314	1	RIGHT	J33.EDF	J33	.
120	4983802	4983830	402	430	28	RIGHT	J33.EDF	J33	.
120	4983893	4984075	493	675	182	RIGHT	J33.EDF	J33	.
120	4984100	4984208	700	808	108	RIGHT	J33.EDF	J33	.
120	4985252	4985464	1852	2064	212	RIGHT	J33.EDF	J33	.
120	4985815	4985815	2415	2415	0	RIGHT	J33.EDF	J33	.
120	4985839	4987271	2439	3871	1432	RIGHT	J33.EDF	J33	.
120	4987300	4987300	3900	3900	0	RIGHT	J33.EDF	J33	.
120	4987325	4987351	3925	3951	26	RIGHT	J33.EDF	J33	.
120	4987386	4987386	3986	3986	0	RIGHT	J33.EDF	J33	.
1	22317294	22317443	837	986	149	RIGHT	J371.EDF	J37	1
2	22325325	22325460	668	803	135	RIGHT	J371.EDF	J37	1
2	22325506	22325525	849	868	19	RIGHT	J371.EDF	J37	1
3	22335491	22335574	1476	1559	83	RIGHT	J371.EDF	J37	1
4	22348198	22348275	6449	6526	77	RIGHT	J371.EDF	J37	1
4	22348333	22348337	6584	6588	4	RIGHT	J371.EDF	J37	1
5	22351479	22351611	561	693	132	RIGHT	J371.EDF	J37	1
5	22351679	22351686	761	768	7	RIGHT	J371.EDF	J37	1
6	22358686	22358781	944	1039	95	RIGHT	J371.EDF	J37	1
6	22358856	22358862	1114	1120	6	RIGHT	J371.EDF	J37	1
7	22368277	22368369	1519	1611	92	RIGHT	J371.EDF	J37	1
7	22368494	22368509	1736	1751	15	RIGHT	J371.EDF	J37	1
8	22377036	22377183	824	971	147	RIGHT	J371.EDF	J37	1
9	22384581	22384712	364	495	131	RIGHT	J371.EDF	J37	1
10	22392929	22393063	196	330	134	RIGHT	J371.EDF	J37	1
10	22393655	22393817	922	1084	162	RIGHT	J371.EDF	J37	1
10	22393937	22393939	1204	1206	2	RIGHT	J371.EDF	J37	1
11	22402120	22402180	1463	1523	60	RIGHT	J371.EDF	J37	1
11	22402252	22402254	1595	1597	2	RIGHT	J371.EDF	J37	1
11	22405254	22405352	4597	4695	98	RIGHT	J371.EDF	J37	1
11	22405415	22405435	4758	4778	20	RIGHT	J371.EDF	J37	1
12	22408758	22408864	646	752	106	RIGHT	J371.EDF	J37	1
12	22408940	22408952	828	840	12	RIGHT	J371.EDF	J37	1
13	22416515	22416641	139	265	126	RIGHT	J371.EDF	J37	1
13	22417253	22418553	877	2177	1300	RIGHT	J371.EDF	J37	1
13	22418921	22418921	2545	2545	0	RIGHT	J371.EDF	J37	1
13	22421306	22421309	4930	4933	3	RIGHT	J371.EDF	J37	1
13	22421582	22421582	5206	5206	0	RIGHT	J371.EDF	J37	1
14	22424342	22424368	82	108	26	RIGHT	J371.EDF	J37	1
14	22424712	22424715	452	455	3	RIGHT	J371.EDF	J37	1
14	22424738	22424902	478	642	164	RIGHT	J371.EDF	J37	1
14	22425009	22425062	749	802	53	RIGHT	J371.EDF	J37	1
14	22427148	22427290	2888	3030	142	RIGHT	J371.EDF	J37	1
14	22427315	22427316	3055	3056	1	RIGHT	J371.EDF	J37	1
14	22427340	22427400	3080	3140	60	RIGHT	J371.EDF	J37	1
14	22431209	22431308	6949	7048	99	RIGHT	J371.EDF	J37	1
14	22431380	22431394	7120	7134	14	RIGHT	J371.EDF	J37	1
15	22434757	22434894	1091	1228	137	RIGHT	J371.EDF	J37	1
15	22434952	22434970	1286	1304	18	RIGHT	J371.EDF	J37	1
15	22435180	22435345	1514	1679	165	RIGHT	J371.EDF	J37	1
15	22435383	22435501	1717	1835	118	RIGHT	J371.EDF	J37	1
15	22436605	22436734	2939	3068	129	RIGHT	J371.EDF	J37	1
15	22436797	22436819	3131	3153	22	RIGHT	J371.EDF	J37	1
16	22442772	22442863	1554	1645	91	RIGHT	J371.EDF	J37	1
16	22442928	22442944	1710	1726	16	RIGHT	J371.EDF	J37	1
17	22449784	22449788	267	271	4	RIGHT	J371.EDF	J37	1
17	22449992	22450107	475	590	115	RIGHT	J371.EDF	J37	1
17	22450587	22450768	1070	1251	181	RIGHT	J371.EDF	J37	1
17	22451279	22451321	1762	1804	42	RIGHT	J371.EDF	J37	1
17	22451476	22451491	1959	1974	15	RIGHT	J371.EDF	J37	1
18	22458398	22458509	546	657	111	RIGHT	J371.EDF	J37	1
18	22458617	22458618	765	766	1	RIGHT	J371.EDF	J37	1
18	22461205	22461324	3353	3472	119	RIGHT	J371.EDF	J37	1
18	22461373	22461388	3521	3536	15	RIGHT	J371.EDF	J37	1
19	22467210	22467369	883	1042	159	RIGHT	J371.EDF	J37	1
19	22467448	22467507	1121	1180	59	RIGHT	J371.EDF	J37	1
20	22474933	22475041	1036	1144	108	RIGHT	J371.EDF	J37	1
20	22475130	22475147	1233	1250	17	RIGHT	J371.EDF	J37	1
21	22482851	22483049	633	831	198	RIGHT	J371.EDF	J37	1
21	22483093	22483137	875	919	44	RIGHT	J371.EDF	J37	1
21	22487012	22487136	4794	4918	124	RIGHT	J371.EDF	J37	1
21	22487163	22487188	4945	4970	25	RIGHT	J371.EDF	J37	1
21	22488432	22488612	6214	6394	180	RIGHT	J371.EDF	J37	1
23	22500440	22500588	684	832	148	RIGHT	J371.EDF	J37	1
23	22500637	22500672	881	916	35	RIGHT	J371.EDF	J37	1
23	22503300	22503434	3544	3678	134	RIGHT	J371.EDF	J37	1
23	22503496	22503536	3740	3780	40	RIGHT	J371.EDF	J37	1
24	22508364	22508519	1412	1567	155	RIGHT	J371.EDF	J37	1
24	22508573	22508621	1621	1669	48	RIGHT	J371.EDF	J37	1
24	22513782	22513906	6830	6954	124	RIGHT	J371.EDF	J37	1
25	22516838	22516950	582	694	112	RIGHT	J371.EDF	J37	1
25	22517036	22517063	780	807	27	RIGHT	J371.EDF	J37	1
25	22517785	22517787	1529	1531	2	RIGHT	J371.EDF	J37	1
25	22517809	22517954	1553	1698	145	RIGHT	J371.EDF	J37	1
25	22518021	22518049	1765	1793	28	RIGHT	J371.EDF	J37	1
26	22526633	22526751	1110	1228	118	RIGHT	J371.EDF	J37	1
26	22526786	22526811	1263	1288	25	RIGHT	J371.EDF	J37	1
27	22534548	22534551	473	476	3	RIGHT	J371.EDF	J37	1
27	22534573	22534698	498	623	125	RIGHT	J371.EDF	J37	1
27	22534777	22534800	702	725	23	RIGHT	J371.EDF	J37	1
28	22542552	22542553	1531	1532	1	RIGHT	J371.EDF	J37	1
28	22542576	22542695	1555	1674	119	RIGHT	J371.EDF	J37	1
28	22542803	22542849	1782	1828	46	RIGHT	J371.EDF	J37	1
29	22550195	22550209	79	93	14	RIGHT	J371.EDF	J37	1
29	22550567	22550567	451	451	0	RIGHT	J371.EDF	J37	1
29	22550591	22550801	475	685	210	RIGHT	J371.EDF	J37	1
29	22550872	22550909	756	793	37	RIGHT	J371.EDF	J37	1
30	22560750	22560957	2136	2343	207	RIGHT	J371.EDF	J37	1
30	22561929	22562070	3315	3456	141	RIGHT	J371.EDF	J37	1
30	22562148	22562185	3534	3571	37	RIGHT	J371.EDF	J37	1
31	22569330	22569428	3706	3804	98	RIGHT	J371.EDF	J37	1
31	22569462	22569472	3838	3848	10	RIGHT	J371.EDF	J37	1
32	22575053	22575159	582	688	106	RIGHT	J371.EDF	J37	1
32	22575207	22575233	736	762	26	RIGHT	J371.EDF	J37	1
32	22578381	22578521	3910	4050	140	RIGHT	J371.EDF	J37	1
32	22578556	22578573	4085	4102	17	RIGHT	J371.EDF	J37	1
33	22583798	22583932	802	936	134	RIGHT	J371.EDF	J37	1
33	22583968	22583993	972	997	25	RIGHT	J371.EDF	J37	1
34	22591971	22592100	987	1116	129	RIGHT	J371.EDF	J37	1
34	22592163	22592178	1179	1194	15	RIGHT	J371.EDF	J37	1
34	22595622	22595707	4638	4723	85	RIGHT	J371.EDF	J37	1
34	22595756	22595767	4772	4783	11	RIGHT	J371.EDF	J37	1
35	22600167	22600282	1098	1213	115	RIGHT	J371.EDF	J37	1
35	22600325	22600342	1256	1273	17	RIGHT	J371.EDF	J37	1
36	22607209	22607474	338	603	265	RIGHT	J371.EDF	J37	1
36	22607550	22607553	679	682	3	RIGHT	J371.EDF	J37	1
36	22608387	22608387	1516	1516	0	RIGHT	J371.EDF	J37	1
36	22608408	22608500	1537	1629	92	RIGHT	J371.EDF	J37	1
36	22608563	22608590	1692	1719	27	RIGHT	J371.EDF	J37	1
37	22615697	22615963	327	593	266	RIGHT	J371.EDF	J37	1
37	22616045	22616045	675	675	0	RIGHT	J371.EDF	J37	1
38	22626017	22626161	2874	3018	144	RIGHT	J371.EDF	J37	1
39	22630174	22630327	487	640	153	RIGHT	J371.EDF	J37	1
40	22638515	22638621	225	331	106	RIGHT	J371.EDF	J37	1
40	22640739	22640867	2449	2577	128	RIGHT	J371.EDF	J37	1
40	22640892	22640918	2602	2628	26	RIGHT	J371.EDF	J37	1
40	22644489	22644568	6199	6278	79	RIGHT	J371.EDF	J37	1
41	22647328	22647454	613	739	126	RIGHT	J371.EDF	J37	1
41	22648903	22649080	2188	2365	177	RIGHT	J371.EDF	J37	1
41	22650708	22650894	3993	4179	186	RIGHT	J371.EDF	J37	1
42	22654517	22654652	745	880	135	RIGHT	J371.EDF	J37	1
42	22654686	22654705	914	933	19	RIGHT	J371.EDF	J37	1
42	22654918	22655073	1146	1301	155	RIGHT	J371.EDF	J37	1
42	22657453	22657567	3681	3795	114	RIGHT	J371.EDF	J37	1
42	22657617	22657630	3845	3858	13	RIGHT	J371.EDF	J37	1
43	22663114	22663260	699	845	146	RIGHT	J371.EDF	J37	1
43	22663335	22663356	920	941	21	RIGHT	J371.EDF	J37	1
44	22669588	22669772	474	658	184	RIGHT	J371.EDF	J37	1
44	22673550	22673636	4436	4522	86	RIGHT	J371.EDF	J37	1
44	22673683	22673684	4569	4570	1	RIGHT	J371.EDF	J37	1
45	22676292	22676438	605	751	146	RIGHT	J371.EDF	J37	1
45	22676505	22676510	818	823	5	RIGHT	J371.EDF	J37	1
46	22682712	22682852	471	611	140	RIGHT	J371.EDF	J37	1
47	22690664	22690829	1108	1273	165	RIGHT	J371.EDF	J37	1
47	22690895	22690910	1339	1354	15	RIGHT	J371.EDF	J37	1
48	22697796	22697923	560	687	127	RIGHT	J371.EDF	J37	1
48	22697993	22698012	757	776	19	RIGHT	J371.EDF	J37	1
49	22705740	22705914	476	650	174	RIGHT	J371.EDF	J37	1
50	22712795	22712971	510	686	176	RIGHT	J371.EDF	J37	1
50	22716862	22716950	4577	4665	88	RIGHT	J371.EDF	J37	1
51	22722206	22722320	1320	1434	114	RIGHT	J371.EDF	J37	1
51	22722412	22722422	1526	1536	10	RIGHT	J371.EDF	J37	1
52	22730056	22730174	499	617	118	RIGHT	J371.EDF	J37	1
53	22737028	22737189	514	675	161	RIGHT	J371.EDF	J37	1
53	22738760	22738865	2246	2351	105	RIGHT	J371.EDF	J37	1
53	22738893	22738910	2379	2396	17	RIGHT	J371.EDF	J37	1
53	22740597	22740704	4083	4190	107	RIGHT	J371.EDF	J37	1
53	22740792	22740792	4278	4278	0	RIGHT	J371.EDF	J37	1
54	22745666	22745813	481	628	147	RIGHT	J371.EDF	J37	1
54	22745873	22745892	688	707	19	RIGHT	J371.EDF	J37	1
54	22746747	22746848	1562	1663	101	RIGHT	J371.EDF	J37	1
54	22746886	22746902	1701	1717	16	RIGHT	J371.EDF	J37	1
55	22753888	22754025	594	731	137	RIGHT	J371.EDF	J37	1
55	22754134	22754135	840	841	1	RIGHT	J371.EDF	J37	1
55	22755295	22755424	2001	2130	129	RIGHT	J371.EDF	J37	1
55	22755460	22755479	2166	2185	19	RIGHT	J371.EDF	J37	1
55	22756402	22756566	3108	3272	164	RIGHT	J371.EDF	J37	1
55	22756636	22756663	3342	3369	27	RIGHT	J371.EDF	J37	1
55	22758277	22758389	4983	5095	112	RIGHT	J371.EDF	J37	1
56	22762666	22762784	580	698	118	RIGHT	J371.EDF	J37	1
56	22767052	22767132	4966	5046	80	RIGHT	J371.EDF	J37	1
57	22769294	22769439	262	407	145	RIGHT	J371.EDF	J37	1
57	22770962	22771134	1930	2102	172	RIGHT	J371.EDF	J37	1
57	22773419	22773509	4387	4477	90	RIGHT	J371.EDF	J37	1
57	22773572	22773573	4540	4541	1	RIGHT	J371.EDF	J37	1
58	22777600	22777747	644	791	147	RIGHT	J371.EDF	J37	1
58	22777810	22777827	854	871	17	RIGHT	J371.EDF	J37	1
59	22784982	22785108	919	1045	126	RIGHT	J371.EDF	J37	1
60	22791954	22792097	558	701	143	RIGHT	J371.EDF	J37	1
61	22799435	22799575	964	1104	140	RIGHT	J371.EDF	J37	1
62	22807769	22807910	935	1076	141	RIGHT	J371.EDF	J37	1
63	22816745	22816837	1187	1279	92	RIGHT	J371.EDF	J37	1
63	22816983	22816983	1425	1425	0	RIGHT	J371.EDF	J37	1
63	22817004	22817006	1446	1448	2	RIGHT	J371.EDF	J37	1
64	22824553	22824672	596	715	119	RIGHT	J371.EDF	J37	1
65	22832221	22832311	1122	1212	90	RIGHT	J371.EDF	J37	1
65	22832379	22832384	1280	1285	5	RIGHT	J371.EDF	J37	1
66	22838761	22838902	264	405	141	RIGHT	J371.EDF	J37	1
66	22839777	22839889	1280	1392	112	RIGHT	J371.EDF	J37	1
68	22854643	22854778	587	722	135	RIGHT	J371.EDF	J37	1
68	22856070	22856244	2014	2188	174	RIGHT	J371.EDF	J37	1
68	22856277	22856319	2221	2263	42	RIGHT	J371.EDF	J37	1
68	22857514	22857620	3458	3564	106	RIGHT	J371.EDF	J37	1
68	22857672	22857688	3616	3632	16	RIGHT	J371.EDF	J37	1
68	22860617	22860694	6561	6638	77	RIGHT	J371.EDF	J37	1
68	22860762	22860778	6706	6722	16	RIGHT	J371.EDF	J37	1
69	22863888	22864027	961	1100	139	RIGHT	J371.EDF	J37	1
69	22864127	22864156	1200	1229	29	RIGHT	J371.EDF	J37	1
70	22870710	22870844	997	1131	134	RIGHT	J371.EDF	J37	1
70	22870918	22870948	1205	1235	30	RIGHT	J371.EDF	J37	1
70	22872149	22872298	2436	2585	149	RIGHT	J371.EDF	J37	1
70	22872320	22872345	2607	2632	25	RIGHT	J371.EDF	J37	1
70	22874591	22874709	4878	4996	118	RIGHT	J371.EDF	J37	1
70	22874754	22874769	5041	5056	15	RIGHT	J371.EDF	J37	1
72	22885703	22885848	272	417	145	RIGHT	J371.EDF	J37	1
72	22886589	22886720	1158	1289	131	RIGHT	J371.EDF	J37	1
72	22886821	22886837	1390	1406	16	RIGHT	J371.EDF	J37	1
72	22887798	22887997	2367	2566	199	RIGHT	J371.EDF	J37	1
72	22889569	22889720	4138	4289	151	RIGHT	J371.EDF	J37	1
72	22889751	22889775	4320	4344	24	RIGHT	J371.EDF	J37	1
73	22894071	22894205	743	877	134	RIGHT	J371.EDF	J37	1
73	22894245	22894266	917	938	21	RIGHT	J371.EDF	J37	1
74	22901449	22901617	915	1083	168	RIGHT	J371.EDF	J37	1
74	22901680	22901711	1146	1177	31	RIGHT	J371.EDF	J37	1
75	22908395	22908519	967	1091	124	RIGHT	J371.EDF	J37	1
75	22908596	22908614	1168	1186	18	RIGHT	J371.EDF	J37	1
75	22910705	22910806	3277	3378	101	RIGHT	J371.EDF	J37	1
75	22910869	22910915	3441	3487	46	RIGHT	J371.EDF	J37	1
77	22922810	22922967	636	793	157	RIGHT	J371.EDF	J37	1
77	22923006	22923035	832	861	29	RIGHT	J371.EDF	J37	1
78	22931211	22931357	648	794	146	RIGHT	J371.EDF	J37	1
78	22931512	22931526	949	963	14	RIGHT	J371.EDF	J37	1
79	22938653	22938807	477	631	154	RIGHT	J371.EDF	J37	1
79	22938931	22938932	755	756	1	RIGHT	J371.EDF	J37	1
79	22941412	22941561	3236	3385	149	RIGHT	J371.EDF	J37	1
79	22941616	22941656	3440	3480	40	RIGHT	J371.EDF	J37	1
80	22946984	22947112	531	659	128	RIGHT	J371.EDF	J37	1
80	22949651	22949755	3198	3302	104	RIGHT	J371.EDF	J37	1
80	22949808	22949810	3355	3357	2	RIGHT	J371.EDF	J37	1
81	22959894	22959966	5326	5398	72	RIGHT	J371.EDF	J37	1
82	22962829	22962957	957	1085	128	RIGHT	J371.EDF	J37	1
82	22963062	22963076	1190	1204	14	RIGHT	J371.EDF	J37	1
82	22966516	22966616	4644	4744	100	RIGHT	J371.EDF	J37	1
82	22966689	22966690	4817	4818	1	RIGHT	J371.EDF	J37	1
83	22970178	22970340	922	1084	162	RIGHT	J371.EDF	J37	1
83	22970366	22970413	1110	1157	47	RIGHT	J371.EDF	J37	1
83	22971836	22972019	2580	2763	183	RIGHT	J371.EDF	J37	1
83	22973000	22973151	3744	3895	151	RIGHT	J371.EDF	J37	1
83	22973181	22973207	3925	3951	26	RIGHT	J371.EDF	J37	1
83	22974029	22974099	4773	4843	70	RIGHT	J371.EDF	J37	1
84	22977969	22978155	2401	2587	186	RIGHT	J371.EDF	J37	1
85	22983187	22983346	535	694	159	RIGHT	J371.EDF	J37	1
85	22983380	22983414	728	762	34	RIGHT	J371.EDF	J37	1
86	22991293	22991307	334	348	14	RIGHT	J371.EDF	J37	1
86	22991337	22991340	378	381	3	RIGHT	J371.EDF	J37	1
86	22991456	22991613	497	654	157	RIGHT	J371.EDF	J37	1
86	22991801	22993545	842	2586	1744	RIGHT	J371.EDF	J37	1
86	22998260	22998284	7301	7325	24	RIGHT	J371.EDF	J37	1
87	23000606	23000769	501	664	163	RIGHT	J371.EDF	J37	1
87	23002491	23002604	2386	2499	113	RIGHT	J371.EDF	J37	1
87	23002627	23002661	2522	2556	34	RIGHT	J371.EDF	J37	1
88	23009213	23009214	1053	1054	1	RIGHT	J371.EDF	J37	1
88	23009237	23009326	1077	1166	89	RIGHT	J371.EDF	J37	1
88	23009407	23009431	1247	1271	24	RIGHT	J371.EDF	J37	1
89	23017716	23017855	1104	1243	139	RIGHT	J371.EDF	J37	1
90	23025078	23025246	488	656	168	RIGHT	J371.EDF	J37	1
91	23033249	23033363	1057	1171	114	RIGHT	J371.EDF	J37	1
91	23033466	23033489	1274	1297	23	RIGHT	J371.EDF	J37	1
92	23039912	23040143	485	716	231	RIGHT	J371.EDF	J37	1
92	23040226	23040241	799	814	15	RIGHT	J371.EDF	J37	1
93	23048115	23048155	1650	1690	40	RIGHT	J371.EDF	J37	1
93	23048201	23048308	1736	1843	107	RIGHT	J371.EDF	J37	1
93	23048354	23048365	1889	1900	11	RIGHT	J371.EDF	J37	1
93	23052811	23052913	6346	6448	102	RIGHT	J371.EDF	J37	1
93	23052975	23052994	6510	6529	19	RIGHT	J371.EDF	J37	1
94	23056234	23056386	1056	1208	152	RIGHT	J371.EDF	J37	1
94	23056457	23056505	1279	1327	48	RIGHT	J371.EDF	J37	1
95	23065371	23065382	74	85	11	RIGHT	J371.EDF	J37	1
96	23073579	23073715	1018	1154	136	RIGHT	J371.EDF	J37	1
96	23073823	23073865	1262	1304	42	RIGHT	J371.EDF	J37	1
97	23081849	23081962	563	676	113	RIGHT	J371.EDF	J37	1
97	23083603	23083766	2317	2480	163	RIGHT	J371.EDF	J37	1
97	23083810	23083848	2524	2562	38	RIGHT	J371.EDF	J37	1
97	23085950	23086105	4664	4819	155	RIGHT	J371.EDF	J37	1
97	23086143	23086166	4857	4880	23	RIGHT	J371.EDF	J37	1
99	23098405	23098557	469	621	152	RIGHT	J371.EDF	J37	1
99	23098629	23098654	693	718	25	RIGHT	J371.EDF	J37	1
99	23100069	23100263	2133	2327	194	RIGHT	J371.EDF	J37	1
99	23102065	23102221	4129	4285	156	RIGHT	J371.EDF	J37	1
99	23102287	23102329	4351	4393	42	RIGHT	J371.EDF	J37	1
100	23107092	23107319	445	672	227	RIGHT	J371.EDF	J37	1
100	23107398	23107416	751	769	18	RIGHT	J371.EDF	J37	1
101	23114340	23114508	755	923	168	RIGHT	J371.EDF	J37	1
101	23114592	23114619	1007	1034	27	RIGHT	J371.EDF	J37	1
102	23120657	23120784	607	734	127	RIGHT	J371.EDF	J37	1
102	23124562	23124677	4512	4627	115	RIGHT	J371.EDF	J37	1
102	23124734	23124748	4684	4698	14	RIGHT	J371.EDF	J37	1
103	23127300	23127442	506	648	142	RIGHT	J371.EDF	J37	1
103	23127578	23127578	784	784	0	RIGHT	J371.EDF	J37	1
104	23134973	23135125	454	606	152	RIGHT	J371.EDF	J37	1
104	23135190	23135194	671	675	4	RIGHT	J371.EDF	J37	1
104	23135940	23136095	1421	1576	155	RIGHT	J371.EDF	J37	1
104	23136143	23136156	1624	1637	13	RIGHT	J371.EDF	J37	1
104	23137187	23137330	2668	2811	143	RIGHT	J371.EDF	J37	1
104	23137378	23137409	2859	2890	31	RIGHT	J371.EDF	J37	1
104	23138426	23138577	3907	4058	151	RIGHT	J371.EDF	J37	1
104	23138628	23138652	4109	4133	24	RIGHT	J371.EDF	J37	1
105	23142665	23142821	842	998	156	RIGHT	J371.EDF	J37	1
105	23142857	23142881	1034	1058	24	RIGHT	J371.EDF	J37	1
105	23143742	23143778	1919	1955	36	RIGHT	J371.EDF	J37	1
105	23143825	23143854	2002	2031	29	RIGHT	J371.EDF	J37	1
106	23151075	23151212	58	195	137	RIGHT	J371.EDF	J37	1
106	23151305	23151306	288	289	1	RIGHT	J371.EDF	J37	1
106	23151926	23152064	909	1047	138	RIGHT	J371.EDF	J37	1
106	23152139	23152149	1122	1132	10	RIGHT	J371.EDF	J37	1
107	23159540	23159697	535	692	157	RIGHT	J371.EDF	J37	1
107	23159790	23159797	785	792	7	RIGHT	J371.EDF	J37	1
108	23168627	23168743	829	945	116	RIGHT	J371.EDF	J37	1
108	23170247	23170436	2449	2638	189	RIGHT	J371.EDF	J37	1
108	23171738	23171933	3940	4135	195	RIGHT	J371.EDF	J37	1
109	23176792	23176959	597	764	167	RIGHT	J371.EDF	J37	1
109	23180380	23180495	4185	4300	115	RIGHT	J371.EDF	J37	1
109	23180527	23180560	4332	4365	33	RIGHT	J371.EDF	J37	1
110	23183637	23183838	623	824	201	RIGHT	J371.EDF	J37	1
110	23183859	23183884	845	870	25	RIGHT	J371.EDF	J37	1
112	23202120	23202228	4886	4994	108	RIGHT	J371.EDF	J37	1
113	23205612	23205612	1053	1053	0	RIGHT	J371.EDF	J37	1
113	23205635	23205796	1076	1237	161	RIGHT	J371.EDF	J37	1
113	23205897	23205907	1338	1348	10	RIGHT	J371.EDF	J37	1
114	23212058	23212208	616	766	150	RIGHT	J371.EDF	J37	1
114	23212266	23212294	824	852	28	RIGHT	J371.EDF	J37	1
114	23213814	23214013	2372	2571	199	RIGHT	J371.EDF	J37	1
114	23215280	23215520	3838	4078	240	RIGHT	J371.EDF	J37	1
114	23217070	23217225	5628	5783	155	RIGHT	J371.EDF	J37	1
114	23217260	23217303	5818	5861	43	RIGHT	J371.EDF	J37	1
115	23220147	23220352	536	741	205	RIGHT	J371.EDF	J37	1
115	23220381	23220403	770	792	22	RIGHT	J371.EDF	J37	1
115	23220886	23221078	1275	1467	192	RIGHT	J371.EDF	J37	1
115	23221154	23221154	1543	1543	0	RIGHT	J371.EDF	J37	1
116	23227136	23227324	544	732	188	RIGHT	J371.EDF	J37	1
116	23227376	23227397	784	805	21	RIGHT	J371.EDF	J37	1
117	23235150	23235300	260	410	150	RIGHT	J371.EDF	J37	1
117	23235386	23235404	496	514	18	RIGHT	J371.EDF	J37	1
117	23235974	23236098	1084	1208	124	RIGHT	J371.EDF	J37	1
117	23237273	23237529	2383	2639	256	RIGHT	J371.EDF	J37	1
117	23239374	23239495	4484	4605	121	RIGHT	J371.EDF	J37	1
117	23239601	23239643	4711	4753	42	RIGHT	J371.EDF	J37	1
118	23242771	23242806	58	93	35	RIGHT	J371.EDF	J37	1
118	23242844	23243005	131	292	161	RIGHT	J371.EDF	J37	1
118	23249323	23249412	6610	6699	89	RIGHT	J371.EDF	J37	1
119	23252028	23252156	180	308	128	RIGHT	J371.EDF	J37	1
119	23252973	23253100	1125	1252	127	RIGHT	J371.EDF	J37	1
119	23253165	23253171	1317	1323	6	RIGHT	J371.EDF	J37	1
120	23260669	23260844	314	489	175	RIGHT	J371.EDF	J37	1
120	23260935	23261087	580	732	152	RIGHT	J371.EDF	J37	1
1	23901166	23901317	1007	1158	151	RIGHT	J372.EDF	J37	2
2	23908442	23908442	242	242	0	RIGHT	J372.EDF	J37	2
2	23908467	23908601	267	401	134	RIGHT	J372.EDF	J37	2
2	23908648	23908662	448	462	14	RIGHT	J372.EDF	J37	2
2	23908694	23909465	494	1265	771	RIGHT	J372.EDF	J37	2
2	23909586	23909591	1386	1391	5	RIGHT	J372.EDF	J37	2
2	23910977	23911072	2777	2872	95	RIGHT	J372.EDF	J37	2
2	23911113	23911114	2913	2914	1	RIGHT	J372.EDF	J37	2
2	23912531	23912616	4331	4416	85	RIGHT	J372.EDF	J37	2
2	23912684	23912685	4484	4485	1	RIGHT	J372.EDF	J37	2
3	23917520	23917649	776	905	129	RIGHT	J372.EDF	J37	2
4	23925343	23925429	980	1066	86	RIGHT	J372.EDF	J37	2
5	23933818	23933819	2558	2559	1	RIGHT	J372.EDF	J37	2
5	23933845	23933898	2585	2638	53	RIGHT	J372.EDF	J37	2
5	23933956	23933968	2696	2708	12	RIGHT	J372.EDF	J37	2
5	23934014	23934132	2754	2872	118	RIGHT	J372.EDF	J37	2
5	23934183	23934188	2923	2928	5	RIGHT	J372.EDF	J37	2
6	23939106	23939291	502	687	185	RIGHT	J372.EDF	J37	2
6	23939358	23939368	754	764	10	RIGHT	J372.EDF	J37	2
7	23949279	23949371	1840	1932	92	RIGHT	J372.EDF	J37	2
8	23956249	23956365	584	700	116	RIGHT	J372.EDF	J37	2
8	23956569	23958476	904	2811	1907	RIGHT	J372.EDF	J37	2
9	23963442	23963627	453	638	185	RIGHT	J372.EDF	J37	2
10	23971691	23971851	497	657	160	RIGHT	J372.EDF	J37	2
10	23977118	23977212	5924	6018	94	RIGHT	J372.EDF	J37	2
11	23980394	23980546	513	665	152	RIGHT	J372.EDF	J37	2
11	23980654	23980659	773	778	5	RIGHT	J372.EDF	J37	2
11	23982008	23982211	2127	2330	203	RIGHT	J372.EDF	J37	2
11	23983392	23983518	3511	3637	126	RIGHT	J372.EDF	J37	2
11	23983586	23983600	3705	3719	14	RIGHT	J372.EDF	J37	2
11	23983785	23983794	3904	3913	9	RIGHT	J372.EDF	J37	2
11	23983895	23983963	4014	4082	68	RIGHT	J372.EDF	J37	2
11	23984486	23984616	4605	4735	130	RIGHT	J372.EDF	J37	2
11	23984694	23984694	4813	4813	0	RIGHT	J372.EDF	J37	2
13	23995848	23996049	511	712	201	RIGHT	J372.EDF	J37	2
14	24004148	24004287	554	693	139	RIGHT	J372.EDF	J37	2
14	24005612	24005778	2018	2184	166	RIGHT	J372.EDF	J37	2
14	24005835	24005857	2241	2263	22	RIGHT	J372.EDF	J37	2
14	24006993	24007141	3399	3547	148	RIGHT	J372.EDF	J37	2
14	24007214	24007227	3620	3633	13	RIGHT	J372.EDF	J37	2
14	24009134	24009245	5540	5651	111	RIGHT	J372.EDF	J37	2
14	24009296	24009307	5702	5713	11	RIGHT	J372.EDF	J37	2
16	24020844	24021040	584	780	196	RIGHT	J372.EDF	J37	2
16	24021100	24021130	840	870	30	RIGHT	J372.EDF	J37	2
17	24028706	24028876	449	619	170	RIGHT	J372.EDF	J37	2
17	24034656	24034745	6399	6488	89	RIGHT	J372.EDF	J37	2
18	24037749	24037930	846	1027	181	RIGHT	J372.EDF	J37	2
18	24037991	24038026	1088	1123	35	RIGHT	J372.EDF	J37	2
19	24044640	24044858	504	722	218	RIGHT	J372.EDF	J37	2
19	24045232	24046175	1096	2039	943	RIGHT	J372.EDF	J37	2
20	24054214	24054345	2055	2186	131	RIGHT	J372.EDF	J37	2
20	24054394	24054421	2235	2262	27	RIGHT	J372.EDF	J37	2
21	24060352	24060550	449	647	198	RIGHT	J372.EDF	J37	2
21	24060598	24060630	695	727	32	RIGHT	J372.EDF	J37	2
21	24064034	24064159	4131	4256	125	RIGHT	J372.EDF	J37	2
22	24069433	24069628	549	744	195	RIGHT	J372.EDF	J37	2
22	24069734	24069751	850	867	17	RIGHT	J372.EDF	J37	2
23	24076023	24076260	728	965	237	RIGHT	J372.EDF	J37	2
23	24078092	24078287	2797	2992	195	RIGHT	J372.EDF	J37	2
24	24084746	24084943	814	1011	197	RIGHT	J372.EDF	J37	2
24	24084976	24085002	1044	1070	26	RIGHT	J372.EDF	J37	2
24	24088707	24088870	4775	4938	163	RIGHT	J372.EDF	J37	2
25	24093548	24093730	738	920	182	RIGHT	J372.EDF	J37	2
25	24093756	24093778	946	968	22	RIGHT	J372.EDF	J37	2
26	24100446	24100603	505	662	157	RIGHT	J372.EDF	J37	2
26	24100668	24100680	727	739	12	RIGHT	J372.EDF	J37	2
26	24102172	24102331	2231	2390	159	RIGHT	J372.EDF	J37	2
26	24103675	24103797	3734	3856	122	RIGHT	J372.EDF	J37	2
26	24103827	24103845	3886	3904	18	RIGHT	J372.EDF	J37	2
26	24106204	24106216	6263	6275	12	RIGHT	J372.EDF	J37	2
27	24107978	24108157	501	680	179	RIGHT	J372.EDF	J37	2
27	24108184	24108188	707	711	4	RIGHT	J372.EDF	J37	2
27	24109075	24109211	1598	1734	136	RIGHT	J372.EDF	J37	2
27	24109287	24109289	1810	1812	2	RIGHT	J372.EDF	J37	2
28	24116889	24117034	136	281	145	RIGHT	J372.EDF	J37	2
28	24117325	24117540	572	787	215	RIGHT	J372.EDF	J37	2
28	24117614	24117615	861	862	1	RIGHT	J372.EDF	J37	2
28	24117879	24118150	1126	1397	271	RIGHT	J372.EDF	J37	2
28	24118330	24118330	1577	1577	0	RIGHT	J372.EDF	J37	2
28	24118429	24118476	1676	1723	47	RIGHT	J372.EDF	J37	2
29	24125228	24125388	1003	1163	160	RIGHT	J372.EDF	J37	2
29	24125428	24125449	1203	1224	21	RIGHT	J372.EDF	J37	2
30	24136439	24136561	5386	5508	122	RIGHT	J372.EDF	J37	2
30	24136615	24136623	5562	5570	8	RIGHT	J372.EDF	J37	2
31	24140008	24140163	502	657	155	RIGHT	J372.EDF	J37	2
31	24140227	24140254	721	748	27	RIGHT	J372.EDF	J37	2
32	24148422	24148425	344	347	3	RIGHT	J372.EDF	J37	2
32	24148454	24148601	376	523	147	RIGHT	J372.EDF	J37	2
32	24148646	24148660	568	582	14	RIGHT	J372.EDF	J37	2
32	24149079	24149277	1001	1199	198	RIGHT	J372.EDF	J37	2
32	24149338	24149364	1260	1286	26	RIGHT	J372.EDF	J37	2
32	24149459	24149532	1381	1454	73	RIGHT	J372.EDF	J37	2
32	24149679	24149696	1601	1618	17	RIGHT	J372.EDF	J37	2
32	24149821	24149845	1743	1767	24	RIGHT	J372.EDF	J37	2
32	24150730	24150893	2652	2815	163	RIGHT	J372.EDF	J37	2
33	24157760	24157872	442	554	112	RIGHT	J372.EDF	J37	2
33	24157900	24157914	582	596	14	RIGHT	J372.EDF	J37	2
33	24159551	24159709	2233	2391	158	RIGHT	J372.EDF	J37	2
33	24160526	24160664	3208	3346	138	RIGHT	J372.EDF	J37	2
33	24160693	24160718	3375	3400	25	RIGHT	J372.EDF	J37	2
33	24162156	24162360	4838	5042	204	RIGHT	J372.EDF	J37	2
34	24166391	24166950	57	616	559	RIGHT	J372.EDF	J37	2
35	24173952	24173975	58	81	23	RIGHT	J372.EDF	J37	2
35	24174077	24174089	183	195	12	RIGHT	J372.EDF	J37	2
35	24174148	24174153	254	259	5	RIGHT	J372.EDF	J37	2
35	24174519	24174580	625	686	61	RIGHT	J372.EDF	J37	2
35	24174606	24174648	712	754	42	RIGHT	J372.EDF	J37	2
35	24174674	24174748	780	854	74	RIGHT	J372.EDF	J37	2
35	24174773	24174819	879	925	46	RIGHT	J372.EDF	J37	2
35	24174875	24174882	981	988	7	RIGHT	J372.EDF	J37	2
35	24175136	24175290	1242	1396	154	RIGHT	J372.EDF	J37	2
36	24182793	24182908	1743	1858	115	RIGHT	J372.EDF	J37	2
36	24183705	24183859	2655	2809	154	RIGHT	J372.EDF	J37	2
36	24185528	24185621	4478	4571	93	RIGHT	J372.EDF	J37	2
36	24187768	24187865	6718	6815	97	RIGHT	J372.EDF	J37	2
37	24190232	24190354	555	677	122	RIGHT	J372.EDF	J37	2
37	24192005	24192181	2328	2504	176	RIGHT	J372.EDF	J37	2
37	24192665	24192832	2988	3155	167	RIGHT	J372.EDF	J37	2
37	24192870	24192870	3193	3193	0	RIGHT	J372.EDF	J37	2
37	24193554	24193701	3877	4024	147	RIGHT	J372.EDF	J37	2
37	24194270	24194423	4593	4746	153	RIGHT	J372.EDF	J37	2
37	24195139	24195274	5462	5597	135	RIGHT	J372.EDF	J37	2
38	24197951	24198171	348	568	220	RIGHT	J372.EDF	J37	2
39	24204790	24204791	123	124	1	RIGHT	J372.EDF	J37	2
39	24204928	24205225	261	558	297	RIGHT	J372.EDF	J37	2
39	24205664	24205778	997	1111	114	RIGHT	J372.EDF	J37	2
39	24205867	24205915	1200	1248	48	RIGHT	J372.EDF	J37	2
39	24206107	24206111	1440	1444	4	RIGHT	J372.EDF	J37	2
39	24206133	24206265	1466	1598	132	RIGHT	J372.EDF	J37	2
40	24212634	24212827	566	759	193	RIGHT	J372.EDF	J37	2
41	24220836	24221020	940	1124	184	RIGHT	J372.EDF	J37	2
42	24228830	24229043	900	1113	213	RIGHT	J372.EDF	J37	2
42	24229080	24229083	1150	1153	3	RIGHT	J372.EDF	J37	2
43	24236909	24236909	201	201	0	RIGHT	J372.EDF	J37	2
43	24236938	24237153	230	445	215	RIGHT	J372.EDF	J37	2
43	24237923	24240884	1215	4176	2961	RIGHT	J372.EDF	J37	2
43	24240925	24240964	4217	4256	39	RIGHT	J372.EDF	J37	2
44	24243554	24243621	57	124	67	RIGHT	J372.EDF	J37	2
44	24243656	24243656	159	159	0	RIGHT	J372.EDF	J37	2
44	24243682	24243682	185	185	0	RIGHT	J372.EDF	J37	2
44	24244287	24244291	790	794	4	RIGHT	J372.EDF	J37	2
44	24244322	24244470	825	973	148	RIGHT	J372.EDF	J37	2
44	24244568	24244635	1071	1138	67	RIGHT	J372.EDF	J37	2
44	24249703	24249794	6206	6297	91	RIGHT	J372.EDF	J37	2
45	24252369	24252533	643	807	164	RIGHT	J372.EDF	J37	2
45	24252595	24252608	869	882	13	RIGHT	J372.EDF	J37	2
45	24253042	24253042	1316	1316	0	RIGHT	J372.EDF	J37	2
45	24253069	24253159	1343	1433	90	RIGHT	J372.EDF	J37	2
45	24253231	24253250	1505	1524	19	RIGHT	J372.EDF	J37	2
46	24259811	24259952	661	802	141	RIGHT	J372.EDF	J37	2
47	24269587	24269819	168	400	232	RIGHT	J372.EDF	J37	2
47	24269848	24270000	429	581	152	RIGHT	J372.EDF	J37	2
47	24270536	24270646	1117	1227	110	RIGHT	J372.EDF	J37	2
47	24270681	24270863	1262	1444	182	RIGHT	J372.EDF	J37	2
48	24278894	24279013	542	661	119	RIGHT	J372.EDF	J37	2
48	24279955	24280079	1603	1727	124	RIGHT	J372.EDF	J37	2
49	24288005	24288083	57	135	78	RIGHT	J372.EDF	J37	2
49	24288408	24288598	460	650	190	RIGHT	J372.EDF	J37	2
49	24288848	24289089	900	1141	241	RIGHT	J372.EDF	J37	2
49	24289319	24289501	1371	1553	182	RIGHT	J372.EDF	J37	2
50	24297442	24297590	507	655	148	RIGHT	J372.EDF	J37	2
50	24297654	24297676	719	741	22	RIGHT	J372.EDF	J37	2
51	24305889	24306057	520	688	168	RIGHT	J372.EDF	J37	2
52	24312805	24312939	160	294	134	RIGHT	J372.EDF	J37	2
52	24313774	24313774	1129	1129	0	RIGHT	J372.EDF	J37	2
52	24313799	24313908	1154	1263	109	RIGHT	J372.EDF	J37	2
52	24315686	24315817	3041	3172	131	RIGHT	J372.EDF	J37	2
53	24320117	24320654	58	595	537	RIGHT	J372.EDF	J37	2
53	24320896	24320902	837	843	6	RIGHT	J372.EDF	J37	2
53	24321082	24321362	1023	1303	280	RIGHT	J372.EDF	J37	2
53	24321538	24321569	1479	1510	31	RIGHT	J372.EDF	J37	2
53	24322635	24322810	2576	2751	175	RIGHT	J372.EDF	J37	2
54	24327705	24327840	302	437	135	RIGHT	J372.EDF	J37	2
54	24327899	24327911	496	508	12	RIGHT	J372.EDF	J37	2
54	24328990	24329098	1587	1695	108	RIGHT	J372.EDF	J37	2
55	24335094	24335228	478	612	134	RIGHT	J372.EDF	J37	2
56	24343850	24343931	1058	1139	81	RIGHT	J372.EDF	J37	2
57	24352004	24352132	2211	2339	128	RIGHT	J372.EDF	J37	2
58	24364313	24364427	5111	5225	114	RIGHT	J372.EDF	J37	2
59	24366858	24367073	474	689	215	RIGHT	J372.EDF	J37	2
59	24371859	24371937	5475	5553	78	RIGHT	J372.EDF	J37	2
60	24375732	24375848	490	606	116	RIGHT	J372.EDF	J37	2
60	24376261	24376403	1019	1161	142	RIGHT	J372.EDF	J37	2
60	24377855	24378010	2613	2768	155	RIGHT	J372.EDF	J37	2
60	24379604	24379741	4362	4499	137	RIGHT	J372.EDF	J37	2
62	24389934	24390071	403	540	137	RIGHT	J372.EDF	J37	2
62	24391694	24391880	2163	2349	186	RIGHT	J372.EDF	J37	2
62	24393649	24393817	4118	4286	168	RIGHT	J372.EDF	J37	2
62	24396340	24396460	6809	6929	120	RIGHT	J372.EDF	J37	2
63	24400495	24400619	1075	1199	124	RIGHT	J372.EDF	J37	2
64	24407025	24407191	447	613	166	RIGHT	J372.EDF	J37	2
64	24408825	24409002	2247	2424	177	RIGHT	J372.EDF	J37	2
64	24409026	24409028	2448	2450	2	RIGHT	J372.EDF	J37	2
64	24410691	24410838	4113	4260	147	RIGHT	J372.EDF	J37	2
64	24410880	24410880	4302	4302	0	RIGHT	J372.EDF	J37	2
66	24423838	24423969	876	1007	131	RIGHT	J372.EDF	J37	2
66	24425146	24425301	2184	2339	155	RIGHT	J372.EDF	J37	2
67	24430706	24430919	450	663	213	RIGHT	J372.EDF	J37	2
67	24430941	24430942	685	686	1	RIGHT	J372.EDF	J37	2
68	24438082	24438217	592	727	135	RIGHT	J372.EDF	J37	2
68	24438238	24438239	748	749	1	RIGHT	J372.EDF	J37	2
69	24446522	24446715	487	680	193	RIGHT	J372.EDF	J37	2
69	24448129	24448311	2094	2276	182	RIGHT	J372.EDF	J37	2
70	24454334	24454526	727	919	192	RIGHT	J372.EDF	J37	2
70	24458025	24458217	4418	4610	192	RIGHT	J372.EDF	J37	2
70	24458667	24458842	5060	5235	175	RIGHT	J372.EDF	J37	2
70	24458865	24458871	5258	5264	6	RIGHT	J372.EDF	J37	2
71	24462342	24462556	796	1010	214	RIGHT	J372.EDF	J37	2
72	24468936	24469108	207	379	172	RIGHT	J372.EDF	J37	2
72	24469142	24469147	413	418	5	RIGHT	J372.EDF	J37	2
72	24470879	24471074	2150	2345	195	RIGHT	J372.EDF	J37	2
72	24472787	24472929	4058	4200	142	RIGHT	J372.EDF	J37	2
72	24472954	24472954	4225	4225	0	RIGHT	J372.EDF	J37	2
73	24477677	24477678	282	283	1	RIGHT	J372.EDF	J37	2
73	24477948	24478004	553	609	56	RIGHT	J372.EDF	J37	2
73	24478285	24478285	890	890	0	RIGHT	J372.EDF	J37	2
73	24478311	24478624	916	1229	313	RIGHT	J372.EDF	J37	2
74	24486839	24487011	439	611	172	RIGHT	J372.EDF	J37	2
74	24487613	24487755	1213	1355	142	RIGHT	J372.EDF	J37	2
75	24493934	24494112	323	501	178	RIGHT	J372.EDF	J37	2
75	24494137	24494137	526	526	0	RIGHT	J372.EDF	J37	2
76	24501259	24501438	568	747	179	RIGHT	J372.EDF	J37	2
76	24506324	24506390	5633	5699	66	RIGHT	J372.EDF	J37	2
77	24508483	24508623	539	679	140	RIGHT	J372.EDF	J37	2
77	24512127	24512247	4183	4303	120	RIGHT	J372.EDF	J37	2
78	24516466	24516594	721	849	128	RIGHT	J372.EDF	J37	2
78	24516642	24516658	897	913	16	RIGHT	J372.EDF	J37	2
78	24517851	24517977	2106	2232	126	RIGHT	J372.EDF	J37	2
78	24518590	24518721	2845	2976	131	RIGHT	J372.EDF	J37	2
79	24526264	24526392	2381	2509	128	RIGHT	J372.EDF	J37	2
80	24532358	24532495	947	1084	137	RIGHT	J372.EDF	J37	2
81	24539699	24540002	375	678	303	RIGHT	J372.EDF	J37	2
81	24540722	24540888	1398	1564	166	RIGHT	J372.EDF	J37	2
82	24547503	24547647	589	733	144	RIGHT	J372.EDF	J37	2
83	24555422	24555553	330	461	131	RIGHT	J372.EDF	J37	2
83	24557202	24557401	2110	2309	199	RIGHT	J372.EDF	J37	2
83	24557841	24558032	2749	2940	191	RIGHT	J372.EDF	J37	2
83	24558058	24558078	2966	2986	20	RIGHT	J372.EDF	J37	2
83	24558493	24558671	3401	3579	178	RIGHT	J372.EDF	J37	2
83	24558697	24558721	3605	3629	24	RIGHT	J372.EDF	J37	2
83	24560243	24560381	5151	5289	138	RIGHT	J372.EDF	J37	2
83	24560427	24560427	5335	5335	0	RIGHT	J372.EDF	J37	2
84	24563700	24563931	431	662	231	RIGHT	J372.EDF	J37	2
85	24571069	24571190	58	179	121	RIGHT	J372.EDF	J37	2
85	24573174	24573319	2163	2308	145	RIGHT	J372.EDF	J37	2
85	24576110	24576230	5099	5219	120	RIGHT	J372.EDF	J37	2
85	24577495	24577603	6484	6592	108	RIGHT	J372.EDF	J37	2
87	24589050	24589176	1346	1472	126	RIGHT	J372.EDF	J37	2
87	24594021	24594146	6317	6442	125	RIGHT	J372.EDF	J37	2
88	24599224	24599420	2098	2294	196	RIGHT	J372.EDF	J37	2
88	24601906	24602044	4780	4918	138	RIGHT	J372.EDF	J37	2
89	24606020	24606153	610	743	133	RIGHT	J372.EDF	J37	2
89	24606186	24606186	776	776	0	RIGHT	J372.EDF	J37	2
90	24615639	24615807	1102	1270	168	RIGHT	J372.EDF	J37	2
90	24615853	24615861	1316	1324	8	RIGHT	J372.EDF	J37	2
90	24618863	24618971	4326	4434	108	RIGHT	J372.EDF	J37	2
90	24619015	24619015	4478	4478	0	RIGHT	J372.EDF	J37	2
91	24623652	24623855	478	681	203	RIGHT	J372.EDF	J37	2
91	24627408	24627461	4234	4287	53	RIGHT	J372.EDF	J37	2
91	24627494	24627499	4320	4325	5	RIGHT	J372.EDF	J37	2
91	24627843	24627955	4669	4781	112	RIGHT	J372.EDF	J37	2
91	24627982	24627983	4808	4809	1	RIGHT	J372.EDF	J37	2
92	24630733	24630967	408	642	234	RIGHT	J372.EDF	J37	2
92	24631287	24631381	962	1056	94	RIGHT	J372.EDF	J37	2
92	24631823	24631995	1498	1670	172	RIGHT	J372.EDF	J37	2
92	24632049	24632242	1724	1917	193	RIGHT	J372.EDF	J37	2
92	24632875	24632986	2550	2661	111	RIGHT	J372.EDF	J37	2
92	24633367	24633697	3042	3372	330	RIGHT	J372.EDF	J37	2
92	24634720	24634846	4395	4521	126	RIGHT	J372.EDF	J37	2
92	24634881	24634886	4556	4561	5	RIGHT	J372.EDF	J37	2
94	24646705	24646857	547	699	152	RIGHT	J372.EDF	J37	2
94	24646903	24646904	745	746	1	RIGHT	J372.EDF	J37	2
95	24655321	24655499	557	735	178	RIGHT	J372.EDF	J37	2
95	24655562	24655577	798	813	15	RIGHT	J372.EDF	J37	2
95	24655848	24655851	1084	1087	3	RIGHT	J372.EDF	J37	2
95	24655895	24656137	1131	1373	242	RIGHT	J372.EDF	J37	2
95	24656291	24656291	1527	1527	0	RIGHT	J372.EDF	J37	2
95	24656320	24656379	1556	1615	59	RIGHT	J372.EDF	J37	2
96	24662398	24662570	680	852	172	RIGHT	J372.EDF	J37	2
96	24662621	24662641	903	923	20	RIGHT	J372.EDF	J37	2
97	24669314	24669334	58	78	20	RIGHT	J372.EDF	J37	2
97	24669368	24669388	112	132	20	RIGHT	J372.EDF	J37	2
98	24676375	24676428	57	110	53	RIGHT	J372.EDF	J37	2
98	24676458	24676491	140	173	33	RIGHT	J372.EDF	J37	2
98	24676901	24677036	583	718	135	RIGHT	J372.EDF	J37	2
98	24677082	24677085	764	767	3	RIGHT	J372.EDF	J37	2
99	24684949	24685149	519	719	200	RIGHT	J372.EDF	J37	2
99	24686772	24686884	2342	2454	112	RIGHT	J372.EDF	J37	2
99	24691039	24691178	6609	6748	139	RIGHT	J372.EDF	J37	2
100	24693431	24693891	605	1065	460	RIGHT	J372.EDF	J37	2
100	24693914	24693919	1088	1093	5	RIGHT	J372.EDF	J37	2
100	24693983	24694916	1157	2090	933	RIGHT	J372.EDF	J37	2
100	24695154	24695344	2328	2518	190	RIGHT	J372.EDF	J37	2
101	24700503	24700697	561	755	194	RIGHT	J372.EDF	J37	2
101	24702000	24702210	2058	2268	210	RIGHT	J372.EDF	J37	2
102	24708782	24709018	296	532	236	RIGHT	J372.EDF	J37	2
102	24710345	24710558	1859	2072	213	RIGHT	J372.EDF	J37	2
102	24711739	24711985	3253	3499	246	RIGHT	J372.EDF	J37	2
102	24712773	24713018	4287	4532	245	RIGHT	J372.EDF	J37	2
102	24714014	24714255	5528	5769	241	RIGHT	J372.EDF	J37	2
102	24714280	24714330	5794	5844	50	RIGHT	J372.EDF	J37	2
102	24714364	24714379	5878	5893	15	RIGHT	J372.EDF	J37	2
103	24717590	24717842	1197	1449	252	RIGHT	J372.EDF	J37	2
104	24725230	24725392	863	1025	162	RIGHT	J372.EDF	J37	2
104	24725416	24725418	1049	1051	2	RIGHT	J372.EDF	J37	2
105	24733661	24733859	673	871	198	RIGHT	J372.EDF	J37	2
105	24733892	24733893	904	905	1	RIGHT	J372.EDF	J37	2
105	24734903	24735115	1915	2127	212	RIGHT	J372.EDF	J37	2
105	24737029	24737229	4041	4241	200	RIGHT	J372.EDF	J37	2
105	24737954	24738108	4966	5120	154	RIGHT	J372.EDF	J37	2
105	24738130	24738134	5142	5146	4	RIGHT	J372.EDF	J37	2
106	24740853	24740887	57	91	34	RIGHT	J372.EDF	J37	2
106	24740927	24741002	131	206	75	RIGHT	J372.EDF	J37	2
106	24741070	24741084	274	288	14	RIGHT	J372.EDF	J37	2
106	24741492	24741638	696	842	146	RIGHT	J372.EDF	J37	2
106	24742873	24743084	2077	2288	211	RIGHT	J372.EDF	J37	2
106	24743799	24743972	3003	3176	173	RIGHT	J372.EDF	J37	2
106	24745891	24746038	5095	5242	147	RIGHT	J372.EDF	J37	2
106	24746091	24746115	5295	5319	24	RIGHT	J372.EDF	J37	2
107	24749321	24749513	592	784	192	RIGHT	J372.EDF	J37	2
108	24757765	24757943	829	1007	178	RIGHT	J372.EDF	J37	2
108	24757990	24757991	1054	1055	1	RIGHT	J372.EDF	J37	2
108	24761833	24761977	4897	5041	144	RIGHT	J372.EDF	J37	2
108	24762005	24762021	5069	5085	16	RIGHT	J372.EDF	J37	2
109	24765739	24765934	127	322	195	RIGHT	J372.EDF	J37	2
109	24771903	24772019	6291	6407	116	RIGHT	J372.EDF	J37	2
109	24772052	24772056	6440	6444	4	RIGHT	J372.EDF	J37	2
111	24781824	24781982	683	841	158	RIGHT	J372.EDF	J37	2
111	24782044	24782045	903	904	1	RIGHT	J372.EDF	J37	2
112	24790671	24790873	757	959	202	RIGHT	J372.EDF	J37	2
112	24790902	24790903	988	989	1	RIGHT	J372.EDF	J37	2
113	24798108	24798109	507	508	1	RIGHT	J372.EDF	J37	2
113	24798162	24798312	561	711	150	RIGHT	J372.EDF	J37	2
113	24798396	24798397	795	796	1	RIGHT	J372.EDF	J37	2
113	24799810	24800026	2209	2425	216	RIGHT	J372.EDF	J37	2
113	24801622	24801820	4021	4219	198	RIGHT	J372.EDF	J37	2
114	24804718	24804911	491	684	193	RIGHT	J372.EDF	J37	2
114	24806359	24806513	2132	2286	154	RIGHT	J372.EDF	J37	2
115	24814217	24814357	494	634	140	RIGHT	J372.EDF	J37	2
115	24814386	24814413	663	690	27	RIGHT	J372.EDF	J37	2
116	24821069	24821102	58	91	33	RIGHT	J372.EDF	J37	2
116	24821126	24821141	115	130	15	RIGHT	J372.EDF	J37	2
117	24830309	24830324	165	180	15	RIGHT	J372.EDF	J37	2
117	24830347	24831467	203	1323	1120	RIGHT	J372.EDF	J37	2
117	24832139	24832468	1995	2324	329	RIGHT	J372.EDF	J37	2
118	24837768	24837926	413	571	158	RIGHT	J372.EDF	J37	2
118	24837957	24837972	602	617	15	RIGHT	J372.EDF	J37	2
119	24846715	24846851	615	751	136	RIGHT	J372.EDF	J37	2
119	24846882	24846903	782	803	21	RIGHT	J372.EDF	J37	2
119	24852268	24852381	6168	6281	113	RIGHT	J372.EDF	J37	2
119	24852426	24852440	6326	6340	14	RIGHT	J372.EDF	J37	2
1	25506575	25506691	279	395	116	RIGHT	J373.EDF	J37	3
1	25507095	25507244	799	948	149	RIGHT	J373.EDF	J37	3
2	25514186	25514228	57	99	42	RIGHT	J373.EDF	J37	3
2	25514285	25514300	156	171	15	RIGHT	J373.EDF	J37	3
2	25514670	25514672	541	543	2	RIGHT	J373.EDF	J37	3
2	25514698	25514853	569	724	155	RIGHT	J373.EDF	J37	3
2	25514923	25514947	794	818	24	RIGHT	J373.EDF	J37	3
2	25516237	25516415	2108	2286	178	RIGHT	J373.EDF	J37	3
2	25517798	25517996	3669	3867	198	RIGHT	J373.EDF	J37	3
3	25523244	25523439	608	803	195	RIGHT	J373.EDF	J37	3
3	25523493	25523523	857	887	30	RIGHT	J373.EDF	J37	3
3	25525088	25525244	2452	2608	156	RIGHT	J373.EDF	J37	3
3	25525279	25525315	2643	2679	36	RIGHT	J373.EDF	J37	3
4	25530327	25530328	547	548	1	RIGHT	J373.EDF	J37	3
4	25530354	25530501	574	721	147	RIGHT	J373.EDF	J37	3
4	25530573	25530588	793	808	15	RIGHT	J373.EDF	J37	3
5	25537540	25537668	582	710	128	RIGHT	J373.EDF	J37	3
5	25537737	25537742	779	784	5	RIGHT	J373.EDF	J37	3
6	25545750	25545751	617	618	1	RIGHT	J373.EDF	J37	3
6	25545773	25545922	640	789	149	RIGHT	J373.EDF	J37	3
6	25545997	25546004	864	871	7	RIGHT	J373.EDF	J37	3
6	25549266	25549354	4133	4221	88	RIGHT	J373.EDF	J37	3
6	25551637	25551735	6504	6602	98	RIGHT	J373.EDF	J37	3
7	25555393	25555492	817	916	99	RIGHT	J373.EDF	J37	3
8	25562058	25562171	838	951	113	RIGHT	J373.EDF	J37	3
8	25562293	25562293	1073	1073	0	RIGHT	J373.EDF	J37	3
8	25563606	25563734	2386	2514	128	RIGHT	J373.EDF	J37	3
8	25563769	25563794	2549	2574	25	RIGHT	J373.EDF	J37	3
8	25564522	25564522	3302	3302	0	RIGHT	J373.EDF	J37	3
8	25564543	25564655	3323	3435	112	RIGHT	J373.EDF	J37	3
8	25564699	25564716	3479	3496	17	RIGHT	J373.EDF	J37	3
8	25565279	25565402	4059	4182	123	RIGHT	J373.EDF	J37	3
8	25565434	25565458	4214	4238	24	RIGHT	J373.EDF	J37	3
9	25572582	25572670	4576	4664	88	RIGHT	J373.EDF	J37	3
9	25572764	25572764	4758	4758	0	RIGHT	J373.EDF	J37	3
10	25577429	25577429	589	589	0	RIGHT	J373.EDF	J37	3
10	25577453	25577581	613	741	128	RIGHT	J373.EDF	J37	3
10	25577658	25577684	818	844	26	RIGHT	J373.EDF	J37	3
11	25583741	25584020	379	658	279	RIGHT	J373.EDF	J37	3
11	25585113	25585252	1751	1890	139	RIGHT	J373.EDF	J37	3
11	25585307	25585320	1945	1958	13	RIGHT	J373.EDF	J37	3
11	25585921	25585922	2559	2560	1	RIGHT	J373.EDF	J37	3
11	25585944	25586116	2582	2754	172	RIGHT	J373.EDF	J37	3
11	25586152	25586164	2790	2802	12	RIGHT	J373.EDF	J37	3
11	25587553	25587658	4191	4296	105	RIGHT	J373.EDF	J37	3
11	25587712	25587724	4350	4362	12	RIGHT	J373.EDF	J37	3
12	25591711	25591865	581	735	154	RIGHT	J373.EDF	J37	3
12	25592444	25593185	1314	2055	741	RIGHT	J373.EDF	J37	3
12	25593447	25593588	2317	2458	141	RIGHT	J373.EDF	J37	3
12	25593621	25593671	2491	2541	50	RIGHT	J373.EDF	J37	3
12	25593950	25593968	2820	2838	18	RIGHT	J373.EDF	J37	3
12	25595440	25595553	4310	4423	113	RIGHT	J373.EDF	J37	3
13	25598258	25598395	528	665	137	RIGHT	J373.EDF	J37	3
13	25598462	25598482	732	752	20	RIGHT	J373.EDF	J37	3
14	25604977	25605130	479	632	153	RIGHT	J373.EDF	J37	3
14	25605212	25605222	714	724	10	RIGHT	J373.EDF	J37	3
14	25606406	25606587	1908	2089	181	RIGHT	J373.EDF	J37	3
14	25607474	25607604	2976	3106	130	RIGHT	J373.EDF	J37	3
14	25607631	25607655	3133	3157	24	RIGHT	J373.EDF	J37	3
14	25608621	25608736	4123	4238	115	RIGHT	J373.EDF	J37	3
14	25608779	25608795	4281	4297	16	RIGHT	J373.EDF	J37	3
15	25613321	25613447	467	593	126	RIGHT	J373.EDF	J37	3
15	25613484	25613528	630	674	44	RIGHT	J373.EDF	J37	3
16	25622036	25622189	528	681	153	RIGHT	J373.EDF	J37	3
17	25630501	25630711	1801	2011	210	RIGHT	J373.EDF	J37	3
18	25635933	25636110	486	663	177	RIGHT	J373.EDF	J37	3
18	25636149	25636170	702	723	21	RIGHT	J373.EDF	J37	3
18	25640173	25640288	4726	4841	115	RIGHT	J373.EDF	J37	3
18	25640356	25640368	4909	4921	12	RIGHT	J373.EDF	J37	3
19	25645241	25645430	460	649	189	RIGHT	J373.EDF	J37	3
19	25645495	25645517	714	736	22	RIGHT	J373.EDF	J37	3
20	25652762	25652763	565	566	1	RIGHT	J373.EDF	J37	3
20	25652786	25652933	589	736	147	RIGHT	J373.EDF	J37	3
20	25652984	25653002	787	805	18	RIGHT	J373.EDF	J37	3
20	25653198	25653520	1001	1323	322	RIGHT	J373.EDF	J37	3
20	25653573	25653729	1376	1532	156	RIGHT	J373.EDF	J37	3
20	25658281	25658321	6084	6124	40	RIGHT	J373.EDF	J37	3
21	25660520	25660615	57	152	95	RIGHT	J373.EDF	J37	3
21	25660636	25660748	173	285	112	RIGHT	J373.EDF	J37	3
21	25661870	25661993	1407	1530	123	RIGHT	J373.EDF	J37	3
21	25662036	25662051	1573	1588	15	RIGHT	J373.EDF	J37	3
22	25667921	25668071	564	714	150	RIGHT	J373.EDF	J37	3
22	25668113	25668140	756	783	27	RIGHT	J373.EDF	J37	3
23	25676332	25676628	468	764	296	RIGHT	J373.EDF	J37	3
23	25676670	25676678	806	814	8	RIGHT	J373.EDF	J37	3
23	25676934	25677085	1070	1221	151	RIGHT	J373.EDF	J37	3
23	25677126	25677139	1262	1275	13	RIGHT	J373.EDF	J37	3
24	25683339	25683557	233	451	218	RIGHT	J373.EDF	J37	3
25	25692913	25693063	283	433	150	RIGHT	J373.EDF	J37	3
25	25694150	25694311	1520	1681	161	RIGHT	J373.EDF	J37	3
26	25700101	25700275	343	517	174	RIGHT	J373.EDF	J37	3
27	25707608	25707718	57	167	110	RIGHT	J373.EDF	J37	3
27	25707762	25707762	211	211	0	RIGHT	J373.EDF	J37	3
27	25708138	25708363	587	812	225	RIGHT	J373.EDF	J37	3
28	25714973	25715123	566	716	150	RIGHT	J373.EDF	J37	3
28	25715166	25715196	759	789	30	RIGHT	J373.EDF	J37	3
29	25722791	25722970	281	460	179	RIGHT	J373.EDF	J37	3
30	25729685	25729708	65	88	23	RIGHT	J373.EDF	J37	3
30	25729765	25729774	145	154	9	RIGHT	J373.EDF	J37	3
30	25730232	25730354	612	734	122	RIGHT	J373.EDF	J37	3
30	25730404	25730419	784	799	15	RIGHT	J373.EDF	J37	3
30	25731890	25732069	2270	2449	179	RIGHT	J373.EDF	J37	3
31	25738111	25738238	429	556	127	RIGHT	J373.EDF	J37	3
31	25738316	25738335	634	653	19	RIGHT	J373.EDF	J37	3
32	25746853	25746992	268	407	139	RIGHT	J373.EDF	J37	3
32	25747079	25747090	494	505	11	RIGHT	J373.EDF	J37	3
32	25747387	25747544	802	959	157	RIGHT	J373.EDF	J37	3
32	25747627	25747629	1042	1044	2	RIGHT	J373.EDF	J37	3
32	25748452	25748674	1867	2089	222	RIGHT	J373.EDF	J37	3
32	25750069	25750185	3484	3600	116	RIGHT	J373.EDF	J37	3
32	25750215	25750251	3630	3666	36	RIGHT	J373.EDF	J37	3
32	25750708	25750913	4123	4328	205	RIGHT	J373.EDF	J37	3
34	25763662	25763828	625	791	166	RIGHT	J373.EDF	J37	3
34	25763869	25763899	832	862	30	RIGHT	J373.EDF	J37	3
35	25770344	25770531	345	532	187	RIGHT	J373.EDF	J37	3
35	25770570	25770570	571	571	0	RIGHT	J373.EDF	J37	3
36	25779415	25779549	770	904	134	RIGHT	J373.EDF	J37	3
36	25780773	25781005	2128	2360	232	RIGHT	J373.EDF	J37	3
36	25782744	25782908	4099	4263	164	RIGHT	J373.EDF	J37	3
37	25787600	25787786	291	477	186	RIGHT	J373.EDF	J37	3
37	25787808	25787815	499	506	7	RIGHT	J373.EDF	J37	3
37	25789527	25789719	2218	2410	192	RIGHT	J373.EDF	J37	3
38	25794390	25794580	146	336	190	RIGHT	J373.EDF	J37	3
38	25795829	25795980	1585	1736	151	RIGHT	J373.EDF	J37	3
38	25799310	25799442	5066	5198	132	RIGHT	J373.EDF	J37	3
39	25801727	25801919	448	640	192	RIGHT	J373.EDF	J37	3
39	25803543	25803652	2264	2373	109	RIGHT	J373.EDF	J37	3
39	25804760	25804914	3481	3635	154	RIGHT	J373.EDF	J37	3
40	25809257	25809399	806	948	142	RIGHT	J373.EDF	J37	3
40	25809430	25809449	979	998	19	RIGHT	J373.EDF	J37	3
40	25810229	25810359	1778	1908	130	RIGHT	J373.EDF	J37	3
40	25810402	25810414	1951	1963	12	RIGHT	J373.EDF	J37	3
40	25811412	25811601	2961	3150	189	RIGHT	J373.EDF	J37	3
40	25814493	25814678	6042	6227	185	RIGHT	J373.EDF	J37	3
41	25817406	25817869	591	1054	463	RIGHT	J373.EDF	J37	3
42	25825154	25825335	141	322	181	RIGHT	J373.EDF	J37	3
42	25825380	25825393	367	380	13	RIGHT	J373.EDF	J37	3
42	25825634	25825820	621	807	186	RIGHT	J373.EDF	J37	3
42	25825862	25825883	849	870	21	RIGHT	J373.EDF	J37	3
42	25826520	25826653	1507	1640	133	RIGHT	J373.EDF	J37	3
43	25833098	25833232	720	854	134	RIGHT	J373.EDF	J37	3
43	25834533	25834674	2155	2296	141	RIGHT	J373.EDF	J37	3
43	25836965	25837101	4587	4723	136	RIGHT	J373.EDF	J37	3
44	25846604	25846715	5981	6092	111	RIGHT	J373.EDF	J37	3
45	25849694	25849859	155	320	165	RIGHT	J373.EDF	J37	3
45	25850184	25850431	645	892	247	RIGHT	J373.EDF	J37	3
45	25851381	25851506	1842	1967	125	RIGHT	J373.EDF	J37	3
45	25852892	25852996	3353	3457	104	RIGHT	J373.EDF	J37	3
46	25857071	25857218	608	755	147	RIGHT	J373.EDF	J37	3
46	25858194	25858360	1731	1897	166	RIGHT	J373.EDF	J37	3
46	25859789	25859895	3326	3432	106	RIGHT	J373.EDF	J37	3
47	25863862	25863862	306	306	0	RIGHT	J373.EDF	J37	3
47	25863884	25864029	328	473	145	RIGHT	J373.EDF	J37	3
47	25864069	25864080	513	524	11	RIGHT	J373.EDF	J37	3
47	25864368	25864556	812	1000	188	RIGHT	J373.EDF	J37	3
48	25870131	25870318	199	386	187	RIGHT	J373.EDF	J37	3
49	25877727	25877894	881	1048	167	RIGHT	J373.EDF	J37	3
50	25886207	25886345	460	598	138	RIGHT	J373.EDF	J37	3
50	25888056	25888188	2309	2441	132	RIGHT	J373.EDF	J37	3
50	25889000	25889146	3253	3399	146	RIGHT	J373.EDF	J37	3
50	25889663	25889783	3916	4036	120	RIGHT	J373.EDF	J37	3
50	25889832	25889839	4085	4092	7	RIGHT	J373.EDF	J37	3
50	25890693	25890819	4946	5072	126	RIGHT	J373.EDF	J37	3
50	25890868	25890873	5121	5126	5	RIGHT	J373.EDF	J37	3
51	25893980	25894103	469	592	123	RIGHT	J373.EDF	J37	3
51	25895343	25895656	1832	2145	313	RIGHT	J373.EDF	J37	3
52	25900445	25900586	58	199	141	RIGHT	J373.EDF	J37	3
52	25900610	25900635	223	248	25	RIGHT	J373.EDF	J37	3
52	25900683	25900717	296	330	34	RIGHT	J373.EDF	J37	3
52	25900977	25901310	590	923	333	RIGHT	J373.EDF	J37	3
54	25917239	25917414	469	644	175	RIGHT	J373.EDF	J37	3
54	25917467	25917478	697	708	11	RIGHT	J373.EDF	J37	3
54	25918886	25919064	2116	2294	178	RIGHT	J373.EDF	J37	3
55	25925759	25925922	2023	2186	163	RIGHT	J373.EDF	J37	3
55	25928336	25928489	4600	4753	153	RIGHT	J373.EDF	J37	3
56	25931987	25932103	461	577	116	RIGHT	J373.EDF	J37	3
56	25932135	25932147	609	621	12	RIGHT	J373.EDF	J37	3
57	25940847	25940966	873	992	119	RIGHT	J373.EDF	J37	3
58	25949255	25949486	596	827	231	RIGHT	J373.EDF	J37	3
59	25957478	25957650	955	1127	172	RIGHT	J373.EDF	J37	3
59	25957702	25957738	1179	1215	36	RIGHT	J373.EDF	J37	3
60	25964466	25964653	427	614	187	RIGHT	J373.EDF	J37	3
60	25964676	25964678	637	639	2	RIGHT	J373.EDF	J37	3
60	25964705	25964706	666	667	1	RIGHT	J373.EDF	J37	3
60	25965008	25965184	969	1145	176	RIGHT	J373.EDF	J37	3
60	25965236	25965247	1197	1208	11	RIGHT	J373.EDF	J37	3
60	25966504	25966657	2465	2618	153	RIGHT	J373.EDF	J37	3
60	25966679	25966682	2640	2643	3	RIGHT	J373.EDF	J37	3
61	25973472	25973615	579	722	143	RIGHT	J373.EDF	J37	3
61	25973638	25973642	745	749	4	RIGHT	J373.EDF	J37	3
62	25981271	25981396	523	648	125	RIGHT	J373.EDF	J37	3
63	25988149	25988289	313	453	140	RIGHT	J373.EDF	J37	3
64	25995893	25996046	578	731	153	RIGHT	J373.EDF	J37	3
64	25996091	25996109	776	794	18	RIGHT	J373.EDF	J37	3
65	26005712	26005903	896	1087	191	RIGHT	J373.EDF	J37	3
65	26005927	26005927	1111	1111	0	RIGHT	J373.EDF	J37	3
66	26014862	26015026	321	485	164	RIGHT	J373.EDF	J37	3
66	26015073	26015081	532	540	8	RIGHT	J373.EDF	J37	3
66	26015230	26015406	689	865	176	RIGHT	J373.EDF	J37	3
67	26024268	26024411	482	625	143	RIGHT	J373.EDF	J37	3
67	26025845	26026032	2059	2246	187	RIGHT	J373.EDF	J37	3
67	26027989	26028156	4203	4370	167	RIGHT	J373.EDF	J37	3
68	26033812	26033992	2030	2210	180	RIGHT	J373.EDF	J37	3
68	26036447	26036667	4665	4885	220	RIGHT	J373.EDF	J37	3
69	26041175	26041342	1918	2085	167	RIGHT	J373.EDF	J37	3
69	26044341	26044513	5084	5256	172	RIGHT	J373.EDF	J37	3
70	26047478	26047616	261	399	138	RIGHT	J373.EDF	J37	3
71	26056474	26056559	57	142	85	RIGHT	J373.EDF	J37	3
71	26056583	26056597	166	180	14	RIGHT	J373.EDF	J37	3
71	26057197	26057457	780	1040	260	RIGHT	J373.EDF	J37	3
72	26065049	26065226	651	828	177	RIGHT	J373.EDF	J37	3
73	26073673	26073812	580	719	139	RIGHT	J373.EDF	J37	3
73	26073853	26073857	760	764	4	RIGHT	J373.EDF	J37	3
73	26079449	26079544	6356	6451	95	RIGHT	J373.EDF	J37	3
74	26081924	26082081	213	370	157	RIGHT	J373.EDF	J37	3
74	26082135	26082140	424	429	5	RIGHT	J373.EDF	J37	3
75	26088208	26088376	322	490	168	RIGHT	J373.EDF	J37	3
75	26088854	26089227	968	1341	373	RIGHT	J373.EDF	J37	3
75	26089296	26090256	1410	2370	960	RIGHT	J373.EDF	J37	3
75	26091389	26095080	3503	7194	3691	RIGHT	J373.EDF	J37	3
76	26097209	26097365	491	647	156	RIGHT	J373.EDF	J37	3
76	26097422	26097425	704	707	3	RIGHT	J373.EDF	J37	3
77	26104292	26104402	57	167	110	RIGHT	J373.EDF	J37	3
77	26104427	26104442	192	207	15	RIGHT	J373.EDF	J37	3
78	26112721	26112884	611	774	163	RIGHT	J373.EDF	J37	3
78	26112927	26112938	817	828	11	RIGHT	J373.EDF	J37	3
79	26119763	26119772	288	297	9	RIGHT	J373.EDF	J37	3
79	26119799	26119951	324	476	152	RIGHT	J373.EDF	J37	3
79	26120064	26120120	589	645	56	RIGHT	J373.EDF	J37	3
79	26120465	26120555	990	1080	90	RIGHT	J373.EDF	J37	3
79	26120601	26122564	1126	3089	1963	RIGHT	J373.EDF	J37	3
80	26126704	26126892	254	442	188	RIGHT	J373.EDF	J37	3
80	26126942	26126971	492	521	29	RIGHT	J373.EDF	J37	3
81	26135668	26135842	294	468	174	RIGHT	J373.EDF	J37	3
81	26135907	26135937	533	563	30	RIGHT	J373.EDF	J37	3
81	26137663	26137883	2289	2509	220	RIGHT	J373.EDF	J37	3
81	26138674	26138865	3300	3491	191	RIGHT	J373.EDF	J37	3
81	26138902	26138929	3528	3555	27	RIGHT	J373.EDF	J37	3
82	26142770	26142912	680	822	142	RIGHT	J373.EDF	J37	3
82	26142968	26142990	878	900	22	RIGHT	J373.EDF	J37	3
82	26144733	26144966	2643	2876	233	RIGHT	J373.EDF	J37	3
85	26163744	26163902	452	610	158	RIGHT	J373.EDF	J37	3
85	26163928	26163943	636	651	15	RIGHT	J373.EDF	J37	3
86	26172070	26172239	354	523	169	RIGHT	J373.EDF	J37	3
86	26172312	26172313	596	597	1	RIGHT	J373.EDF	J37	3
87	26181286	26181463	303	480	177	RIGHT	J373.EDF	J37	3
87	26181516	26181527	533	544	11	RIGHT	J373.EDF	J37	3
87	26182067	26182207	1084	1224	140	RIGHT	J373.EDF	J37	3
87	26182258	26182270	1275	1287	12	RIGHT	J373.EDF	J37	3
88	26189917	26190071	525	679	154	RIGHT	J373.EDF	J37	3
88	26190138	26190146	746	754	8	RIGHT	J373.EDF	J37	3
89	26199202	26199373	497	668	171	RIGHT	J373.EDF	J37	3
89	26199408	26199427	703	722	19	RIGHT	J373.EDF	J37	3
90	26206107	26206115	259	267	8	RIGHT	J373.EDF	J37	3
90	26206139	26206298	291	450	159	RIGHT	J373.EDF	J37	3
90	26206328	26206368	480	520	40	RIGHT	J373.EDF	J37	3
91	26214308	26214461	849	1002	153	RIGHT	J373.EDF	J37	3
91	26214513	26214527	1054	1068	14	RIGHT	J373.EDF	J37	3
92	26222150	26222296	481	627	146	RIGHT	J373.EDF	J37	3
92	26222350	26222364	681	695	14	RIGHT	J373.EDF	J37	3
93	26228539	26228715	460	636	176	RIGHT	J373.EDF	J37	3
93	26228782	26228796	703	717	14	RIGHT	J373.EDF	J37	3
93	26230488	26230627	2409	2548	139	RIGHT	J373.EDF	J37	3
93	26231135	26231286	3056	3207	151	RIGHT	J373.EDF	J37	3
93	26231310	26231331	3231	3252	21	RIGHT	J373.EDF	J37	3
94	26235552	26235708	494	650	156	RIGHT	J373.EDF	J37	3
94	26235796	26235817	738	759	21	RIGHT	J373.EDF	J37	3
94	26236983	26237166	1925	2108	183	RIGHT	J373.EDF	J37	3
95	26242924	26243068	505	649	144	RIGHT	J373.EDF	J37	3
95	26243102	26243123	683	704	21	RIGHT	J373.EDF	J37	3
96	26250035	26250036	128	129	1	RIGHT	J373.EDF	J37	3
96	26250566	26250700	659	793	134	RIGHT	J373.EDF	J37	3
96	26250771	26250777	864	870	6	RIGHT	J373.EDF	J37	3
97	26257685	26257802	646	763	117	RIGHT	J373.EDF	J37	3
98	26265580	26265638	183	241	58	RIGHT	J373.EDF	J37	3
98	26265681	26265682	284	285	1	RIGHT	J373.EDF	J37	3
98	26265843	26265844	446	447	1	RIGHT	J373.EDF	J37	3
98	26265876	26266022	479	625	146	RIGHT	J373.EDF	J37	3
98	26266144	26266190	747	793	46	RIGHT	J373.EDF	J37	3
99	26275116	26275261	475	620	145	RIGHT	J373.EDF	J37	3
99	26275330	26275337	689	696	7	RIGHT	J373.EDF	J37	3
99	26276428	26276607	1787	1966	179	RIGHT	J373.EDF	J37	3
100	26283264	26283384	479	599	120	RIGHT	J373.EDF	J37	3
100	26283425	26283450	640	665	25	RIGHT	J373.EDF	J37	3
101	26291736	26291895	443	602	159	RIGHT	J373.EDF	J37	3
101	26291958	26291984	665	691	26	RIGHT	J373.EDF	J37	3
101	26295570	26295704	4277	4411	134	RIGHT	J373.EDF	J37	3
101	26295750	26295760	4457	4467	10	RIGHT	J373.EDF	J37	3
102	26299877	26300064	970	1157	187	RIGHT	J373.EDF	J37	3
103	26308282	26308426	630	774	144	RIGHT	J373.EDF	J37	3
103	26308464	26308492	812	840	28	RIGHT	J373.EDF	J37	3
104	26314328	26314337	86	95	9	RIGHT	J373.EDF	J37	3
104	26314830	26314976	588	734	146	RIGHT	J373.EDF	J37	3
104	26315015	26315024	773	782	9	RIGHT	J373.EDF	J37	3
104	26320961	26320961	6719	6719	0	RIGHT	J373.EDF	J37	3
104	26320987	26321095	6745	6853	108	RIGHT	J373.EDF	J37	3
104	26321146	26321158	6904	6916	12	RIGHT	J373.EDF	J37	3
105	26323569	26323765	280	476	196	RIGHT	J373.EDF	J37	3
105	26323818	26323835	529	546	17	RIGHT	J373.EDF	J37	3
105	26324221	26324436	932	1147	215	RIGHT	J373.EDF	J37	3
105	26324472	26324492	1183	1203	20	RIGHT	J373.EDF	J37	3
106	26332787	26332942	632	787	155	RIGHT	J373.EDF	J37	3
106	26332991	26333018	836	863	27	RIGHT	J373.EDF	J37	3
106	26334473	26334673	2318	2518	200	RIGHT	J373.EDF	J37	3
107	26340523	26340664	725	866	141	RIGHT	J373.EDF	J37	3
107	26340695	26340717	897	919	22	RIGHT	J373.EDF	J37	3
107	26341874	26342107	2076	2309	233	RIGHT	J373.EDF	J37	3
107	26343594	26343722	3796	3924	128	RIGHT	J373.EDF	J37	3
107	26343751	26343775	3953	3977	24	RIGHT	J373.EDF	J37	3
108	26348938	26349071	1673	1806	133	RIGHT	J373.EDF	J37	3
108	26349112	26349139	1847	1874	27	RIGHT	J373.EDF	J37	3
109	26356399	26356565	518	684	166	RIGHT	J373.EDF	J37	3
109	26356594	26356615	713	734	21	RIGHT	J373.EDF	J37	3
110	26365027	26365171	641	785	144	RIGHT	J373.EDF	J37	3
110	26365205	26365229	819	843	24	RIGHT	J373.EDF	J37	3
111	26372889	26373047	219	377	158	RIGHT	J373.EDF	J37	3
111	26373117	26373131	447	461	14	RIGHT	J373.EDF	J37	3
111	26376120	26376222	3450	3552	102	RIGHT	J373.EDF	J37	3
111	26376246	26376274	3576	3604	28	RIGHT	J373.EDF	J37	3
111	26378623	26378723	5953	6053	100	RIGHT	J373.EDF	J37	3
111	26378779	26378782	6109	6112	3	RIGHT	J373.EDF	J37	3
112	26382065	26382273	379	587	208	RIGHT	J373.EDF	J37	3
112	26382525	26382703	839	1017	178	RIGHT	J373.EDF	J37	3
112	26382728	26382746	1042	1060	18	RIGHT	J373.EDF	J37	3
112	26383843	26384044	2157	2358	201	RIGHT	J373.EDF	J37	3
112	26387433	26387574	5747	5888	141	RIGHT	J373.EDF	J37	3
112	26387616	26387642	5930	5956	26	RIGHT	J373.EDF	J37	3
113	26390588	26390771	550	733	183	RIGHT	J373.EDF	J37	3
113	26390795	26390835	757	797	40	RIGHT	J373.EDF	J37	3
113	26392876	26393013	2838	2975	137	RIGHT	J373.EDF	J37	3
114	26400000	26400211	1153	1364	211	RIGHT	J373.EDF	J37	3
114	26402565	26402679	3718	3832	114	RIGHT	J373.EDF	J37	3
114	26402713	26402732	3866	3885	19	RIGHT	J373.EDF	J37	3
114	26404173	26404305	5326	5458	132	RIGHT	J373.EDF	J37	3
114	26404344	26404366	5497	5519	22	RIGHT	J373.EDF	J37	3
114	26405320	26405464	6473	6617	144	RIGHT	J373.EDF	J37	3
114	26405499	26405518	6652	6671	19	RIGHT	J373.EDF	J37	3
115	26408400	26408445	57	102	45	RIGHT	J373.EDF	J37	3
115	26409712	26409832	1369	1489	120	RIGHT	J373.EDF	J37	3
115	26409877	26409894	1534	1551	17	RIGHT	J373.EDF	J37	3
116	26416421	26416741	331	651	320	RIGHT	J373.EDF	J37	3
116	26416796	26416801	706	711	5	RIGHT	J373.EDF	J37	3
116	26417465	26417628	1375	1538	163	RIGHT	J373.EDF	J37	3
116	26417674	26417682	1584	1592	8	RIGHT	J373.EDF	J37	3
116	26422431	26422513	6341	6423	82	RIGHT	J373.EDF	J37	3
117	26426156	26426264	322	430	108	RIGHT	J373.EDF	J37	3
117	26426325	26426336	491	502	11	RIGHT	J373.EDF	J37	3
117	26427024	26427143	1190	1309	119	RIGHT	J373.EDF	J37	3
117	26427192	26427207	1358	1373	15	RIGHT	J373.EDF	J37	3
118	26436905	26436987	4318	4400	82	RIGHT	J373.EDF	J37	3
118	26437028	26437049	4441	4462	21	RIGHT	J373.EDF	J37	3
119	26443085	26443250	1722	1887	165	RIGHT	J373.EDF	J37	3
120	26448807	26448968	572	733	161	RIGHT	J373.EDF	J37	3
120	26449001	26449032	766	797	31	RIGHT	J373.EDF	J37	3
1	4855596	4855677	1007	1088	81	RIGHT	J55a.EDF	J55	1
2	4864471	4864542	862	933	71	RIGHT	J55a.EDF	J55	1
3	4872256	4872333	657	734	77	RIGHT	J55a.EDF	J55	1
3	4873382	4873444	1783	1845	62	RIGHT	J55a.EDF	J55	1
4	4880122	4880192	314	384	70	RIGHT	J55a.EDF	J55	1
4	4880945	4881026	1137	1218	81	RIGHT	J55a.EDF	J55	1
4	4885881	4885935	6073	6127	54	RIGHT	J55a.EDF	J55	1
5	4889920	4889986	259	325	66	RIGHT	J55a.EDF	J55	1
5	4890569	4890649	908	988	80	RIGHT	J55a.EDF	J55	1
5	4891214	4891321	1553	1660	107	RIGHT	J55a.EDF	J55	1
6	4899061	4899150	568	657	89	RIGHT	J55a.EDF	J55	1
7	4909954	4910121	583	750	167	RIGHT	J55a.EDF	J55	1
8	4917955	4918041	209	295	86	RIGHT	J55a.EDF	J55	1
9	4928224	4928292	502	570	68	RIGHT	J55a.EDF	J55	1
9	4929428	4929495	1706	1773	67	RIGHT	J55a.EDF	J55	1
10	4937792	4937878	190	276	86	RIGHT	J55a.EDF	J55	1
10	4938595	4938683	993	1081	88	RIGHT	J55a.EDF	J55	1
11	4945782	4945816	326	360	34	RIGHT	J55a.EDF	J55	1
12	4955403	4955491	238	326	88	RIGHT	J55a.EDF	J55	1
12	4956370	4956424	1205	1259	54	RIGHT	J55a.EDF	J55	1
13	4964404	4964503	71	170	99	RIGHT	J55a.EDF	J55	1
13	4965287	4965357	954	1024	70	RIGHT	J55a.EDF	J55	1
14	4974087	4974153	1348	1414	66	RIGHT	J55a.EDF	J55	1
15	4981988	4982104	58	174	116	RIGHT	J55a.EDF	J55	1
15	4983528	4983600	1598	1670	72	RIGHT	J55a.EDF	J55	1
16	4990597	4990676	174	253	79	RIGHT	J55a.EDF	J55	1
16	4991507	4991636	1084	1213	129	RIGHT	J55a.EDF	J55	1
17	4999184	4999274	206	296	90	RIGHT	J55a.EDF	J55	1
17	4999751	4999856	773	878	105	RIGHT	J55a.EDF	J55	1
18	5009410	5009469	539	598	59	RIGHT	J55a.EDF	J55	1
18	5010209	5010293	1338	1422	84	RIGHT	J55a.EDF	J55	1
20	5028182	5028270	982	1070	88	RIGHT	J55a.EDF	J55	1
21	5036363	5036448	924	1009	85	RIGHT	J55a.EDF	J55	1
21	5037348	5037391	1909	1952	43	RIGHT	J55a.EDF	J55	1
22	5045421	5045525	58	162	104	RIGHT	J55a.EDF	J55	1
22	5045874	5045978	511	615	104	RIGHT	J55a.EDF	J55	1
22	5047208	5047289	1845	1926	81	RIGHT	J55a.EDF	J55	1
23	5055463	5055488	171	196	25	RIGHT	J55a.EDF	J55	1
23	5056087	5056210	795	918	123	RIGHT	J55a.EDF	J55	1
23	5059160	5059232	3868	3940	72	RIGHT	J55a.EDF	J55	1
24	5064940	5065034	822	916	94	RIGHT	J55a.EDF	J55	1
25	5072837	5072951	188	302	114	RIGHT	J55a.EDF	J55	1
26	5080772	5080912	58	198	140	RIGHT	J55a.EDF	J55	1
26	5081921	5082004	1207	1290	83	RIGHT	J55a.EDF	J55	1
27	5090477	5090580	58	161	103	RIGHT	J55a.EDF	J55	1
27	5094613	5094704	4194	4285	91	RIGHT	J55a.EDF	J55	1
28	5101482	5101608	782	908	126	RIGHT	J55a.EDF	J55	1
29	5110441	5110595	58	212	154	RIGHT	J55a.EDF	J55	1
29	5111403	5111497	1020	1114	94	RIGHT	J55a.EDF	J55	1
29	5114029	5114096	3646	3713	67	RIGHT	J55a.EDF	J55	1
30	5118926	5119015	305	394	89	RIGHT	J55a.EDF	J55	1
30	5120162	5120214	1541	1593	52	RIGHT	J55a.EDF	J55	1
31	5127283	5127371	540	628	88	RIGHT	J55a.EDF	J55	1
32	5136177	5136284	236	343	107	RIGHT	J55a.EDF	J55	1
33	5144804	5144852	498	546	48	RIGHT	J55a.EDF	J55	1
33	5144881	5145022	575	716	141	RIGHT	J55a.EDF	J55	1
33	5145775	5145850	1469	1544	75	RIGHT	J55a.EDF	J55	1
34	5154143	5154243	545	645	100	RIGHT	J55a.EDF	J55	1
34	5157442	5157502	3844	3904	60	RIGHT	J55a.EDF	J55	1
35	5164628	5164715	1462	1549	87	RIGHT	J55a.EDF	J55	1
35	5167625	5167693	4459	4527	68	RIGHT	J55a.EDF	J55	1
36	5171822	5171937	142	257	115	RIGHT	J55a.EDF	J55	1
37	5181293	5181392	560	659	99	RIGHT	J55a.EDF	J55	1
38	5189577	5189675	533	631	98	RIGHT	J55a.EDF	J55	1
39	5198968	5199065	1047	1144	97	RIGHT	J55a.EDF	J55	1
39	5203494	5203576	5573	5655	82	RIGHT	J55a.EDF	J55	1
40	5207555	5207633	533	611	78	RIGHT	J55a.EDF	J55	1
41	5214860	5214902	58	100	42	RIGHT	J55a.EDF	J55	1
41	5215695	5215793	893	991	98	RIGHT	J55a.EDF	J55	1
42	5222363	5222467	208	312	104	RIGHT	J55a.EDF	J55	1
42	5222986	5223117	831	962	131	RIGHT	J55a.EDF	J55	1
43	5232532	5232571	1641	1680	39	RIGHT	J55a.EDF	J55	1
44	5238279	5238337	58	116	58	RIGHT	J55a.EDF	J55	1
44	5239310	5239392	1089	1171	82	RIGHT	J55a.EDF	J55	1
45	5254402	5254551	673	822	149	RIGHT	J55a.EDF	J55	1
45	5255266	5255324	1537	1595	58	RIGHT	J55a.EDF	J55	1
46	5263427	5263479	58	110	52	RIGHT	J55a.EDF	J55	1
47	5272051	5272137	972	1058	86	RIGHT	J55a.EDF	J55	1
48	5278660	5278789	58	187	129	RIGHT	J55a.EDF	J55	1
48	5279202	5279303	600	701	101	RIGHT	J55a.EDF	J55	1
48	5285390	5285427	6788	6825	37	RIGHT	J55a.EDF	J55	1
49	5288511	5288617	629	735	106	RIGHT	J55a.EDF	J55	1
50	5296643	5296722	556	635	79	RIGHT	J55a.EDF	J55	1
51	5305968	5306080	1383	1495	112	RIGHT	J55a.EDF	J55	1
52	5313421	5313518	543	640	97	RIGHT	J55a.EDF	J55	1
52	5314282	5314372	1404	1494	90	RIGHT	J55a.EDF	J55	1
53	5321483	5321592	130	239	109	RIGHT	J55a.EDF	J55	1
54	5331538	5331702	57	221	164	RIGHT	J55a.EDF	J55	1
54	5332713	5332818	1232	1337	105	RIGHT	J55a.EDF	J55	1
55	5340706	5340797	569	660	91	RIGHT	J55a.EDF	J55	1
56	5349325	5349402	562	639	77	RIGHT	J55a.EDF	J55	1
58	5367632	5367668	58	94	36	RIGHT	J55a.EDF	J55	1
58	5368517	5368661	943	1087	144	RIGHT	J55a.EDF	J55	1
59	5376923	5377005	576	658	82	RIGHT	J55a.EDF	J55	1
59	5380341	5380437	3994	4090	96	RIGHT	J55a.EDF	J55	1
60	5385364	5385495	729	860	131	RIGHT	J55a.EDF	J55	1
60	5390461	5390527	5826	5892	66	RIGHT	J55a.EDF	J55	1
61	5394207	5394293	596	682	86	RIGHT	J55a.EDF	J55	1
62	5402481	5402543	1390	1452	62	RIGHT	J55a.EDF	J55	1
62	5406588	5406656	5497	5565	68	RIGHT	J55a.EDF	J55	1
63	5410953	5411044	607	698	91	RIGHT	J55a.EDF	J55	1
64	5418432	5418460	58	86	28	RIGHT	J55a.EDF	J55	1
64	5420278	5420347	1904	1973	69	RIGHT	J55a.EDF	J55	1
65	5427767	5427842	524	599	75	RIGHT	J55a.EDF	J55	1
66	5435452	5435552	58	158	100	RIGHT	J55a.EDF	J55	1
67	5444555	5444653	814	912	98	RIGHT	J55a.EDF	J55	1
67	5449596	5449703	5855	5962	107	RIGHT	J55a.EDF	J55	1
68	5452913	5453054	58	199	141	RIGHT	J55a.EDF	J55	1
68	5453796	5453908	941	1053	112	RIGHT	J55a.EDF	J55	1
70	5469990	5470091	523	624	101	RIGHT	J55a.EDF	J55	1
70	5471016	5471099	1549	1632	83	RIGHT	J55a.EDF	J55	1
71	5478144	5478256	256	368	112	RIGHT	J55a.EDF	J55	1
71	5478653	5478775	765	887	122	RIGHT	J55a.EDF	J55	1
71	5479370	5479452	1482	1564	82	RIGHT	J55a.EDF	J55	1
72	5486641	5486666	58	83	25	RIGHT	J55a.EDF	J55	1
72	5487133	5487215	550	632	82	RIGHT	J55a.EDF	J55	1
73	5496209	5496298	527	616	89	RIGHT	J55a.EDF	J55	1
73	5497160	5497264	1478	1582	104	RIGHT	J55a.EDF	J55	1
74	5505643	5505758	333	448	115	RIGHT	J55a.EDF	J55	1
74	5506570	5506654	1260	1344	84	RIGHT	J55a.EDF	J55	1
75	5514794	5514904	599	709	110	RIGHT	J55a.EDF	J55	1
76	5522303	5522409	517	623	106	RIGHT	J55a.EDF	J55	1
76	5525145	5525216	3359	3430	71	RIGHT	J55a.EDF	J55	1
77	5531200	5531319	596	715	119	RIGHT	J55a.EDF	J55	1
77	5531989	5532092	1385	1488	103	RIGHT	J55a.EDF	J55	1
78	5539428	5539510	58	140	82	RIGHT	J55a.EDF	J55	1
78	5539912	5539988	542	618	76	RIGHT	J55a.EDF	J55	1
79	5548730	5548830	518	618	100	RIGHT	J55a.EDF	J55	1
80	5557407	5557498	377	468	91	RIGHT	J55a.EDF	J55	1
81	5565902	5566012	478	588	110	RIGHT	J55a.EDF	J55	1
81	5566858	5566859	1434	1435	1	RIGHT	J55a.EDF	J55	1
81	5566882	5566909	1458	1485	27	RIGHT	J55a.EDF	J55	1
81	5566931	5566967	1507	1543	36	RIGHT	J55a.EDF	J55	1
81	5567185	5567371	1761	1947	186	RIGHT	J55a.EDF	J55	1
81	5567443	5567477	2019	2053	34	RIGHT	J55a.EDF	J55	1
81	5568409	5568487	2985	3063	78	RIGHT	J55a.EDF	J55	1
81	5569492	5569584	4068	4160	92	RIGHT	J55a.EDF	J55	1
81	5570313	5570413	4889	4989	100	RIGHT	J55a.EDF	J55	1
82	5572966	5573071	485	590	105	RIGHT	J55a.EDF	J55	1
82	5573896	5573962	1415	1481	66	RIGHT	J55a.EDF	J55	1
83	5580003	5580095	591	683	92	RIGHT	J55a.EDF	J55	1
84	5587033	5587149	98	214	116	RIGHT	J55a.EDF	J55	1
84	5587471	5587585	536	650	114	RIGHT	J55a.EDF	J55	1
85	5594385	5594481	531	627	96	RIGHT	J55a.EDF	J55	1
86	5603473	5603556	527	610	83	RIGHT	J55a.EDF	J55	1
86	5606023	5606103	3077	3157	80	RIGHT	J55a.EDF	J55	1
87	5612480	5612566	104	190	86	RIGHT	J55a.EDF	J55	1
87	5613351	5613455	975	1079	104	RIGHT	J55a.EDF	J55	1
88	5620380	5620413	58	91	33	RIGHT	J55a.EDF	J55	1
88	5621250	5621366	928	1044	116	RIGHT	J55a.EDF	J55	1
89	5628959	5629084	621	746	125	RIGHT	J55a.EDF	J55	1
90	5636649	5636750	503	604	101	RIGHT	J55a.EDF	J55	1
91	5644498	5644588	57	147	90	RIGHT	J55a.EDF	J55	1
91	5645005	5645092	564	651	87	RIGHT	J55a.EDF	J55	1
91	5649876	5649943	5435	5502	67	RIGHT	J55a.EDF	J55	1
91	5651365	5651416	6924	6975	51	RIGHT	J55a.EDF	J55	1
92	5655133	5655224	1263	1354	91	RIGHT	J55a.EDF	J55	1
93	5663590	5663785	57	252	195	RIGHT	J55a.EDF	J55	1
93	5664483	5664570	950	1037	87	RIGHT	J55a.EDF	J55	1
94	5671397	5671470	575	648	73	RIGHT	J55a.EDF	J55	1
94	5675196	5675260	4374	4438	64	RIGHT	J55a.EDF	J55	1
95	5679025	5679108	105	188	83	RIGHT	J55a.EDF	J55	1
95	5679751	5679836	831	916	85	RIGHT	J55a.EDF	J55	1
96	5686918	5687001	537	620	83	RIGHT	J55a.EDF	J55	1
96	5690829	5690900	4448	4519	71	RIGHT	J55a.EDF	J55	1
97	5695551	5695673	611	733	122	RIGHT	J55a.EDF	J55	1
98	5702848	5702932	919	1003	84	RIGHT	J55a.EDF	J55	1
99	5711729	5711829	753	853	100	RIGHT	J55a.EDF	J55	1
99	5715156	5715242	4180	4266	86	RIGHT	J55a.EDF	J55	1
100	5718513	5718604	976	1067	91	RIGHT	J55a.EDF	J55	1
101	5725819	5725909	554	644	90	RIGHT	J55a.EDF	J55	1
101	5726695	5726794	1430	1529	99	RIGHT	J55a.EDF	J55	1
101	5728414	5728464	3149	3199	50	RIGHT	J55a.EDF	J55	1
101	5728506	5728593	3241	3328	87	RIGHT	J55a.EDF	J55	1
101	5728616	5728629	3351	3364	13	RIGHT	J55a.EDF	J55	1
101	5728679	5728680	3414	3415	1	RIGHT	J55a.EDF	J55	1
101	5728703	5728755	3438	3490	52	RIGHT	J55a.EDF	J55	1
102	5733502	5733617	546	661	115	RIGHT	J55a.EDF	J55	1
102	5734445	5734464	1489	1508	19	RIGHT	J55a.EDF	J55	1
102	5734782	5734802	1826	1846	20	RIGHT	J55a.EDF	J55	1
102	5736250	5736352	3294	3396	102	RIGHT	J55a.EDF	J55	1
103	5745940	5746018	5206	5284	78	RIGHT	J55a.EDF	J55	1
104	5749423	5749520	534	631	97	RIGHT	J55a.EDF	J55	1
104	5751950	5752033	3061	3144	83	RIGHT	J55a.EDF	J55	1
106	5765025	5765141	57	173	116	RIGHT	J55a.EDF	J55	1
106	5765594	5765651	626	683	57	RIGHT	J55a.EDF	J55	1
106	5766030	5766721	1062	1753	691	RIGHT	J55a.EDF	J55	1
106	5766772	5766824	1804	1856	52	RIGHT	J55a.EDF	J55	1
106	5769063	5770301	4095	5333	1238	RIGHT	J55a.EDF	J55	1
107	5772624	5775578	803	3757	2954	RIGHT	J55a.EDF	J55	1
107	5775621	5776006	3800	4185	385	RIGHT	J55a.EDF	J55	1
107	5776233	5778306	4412	6485	2073	RIGHT	J55a.EDF	J55	1
108	5780898	5784163	58	3323	3265	RIGHT	J55a.EDF	J55	1
108	5784269	5787001	3429	6161	2732	RIGHT	J55a.EDF	J55	1
109	5788987	5794245	58	5316	5258	RIGHT	J55a.EDF	J55	1
110	5796616	5803022	58	6464	6406	RIGHT	J55a.EDF	J55	1
111	5804741	5810756	58	6073	6015	RIGHT	J55a.EDF	J55	1
112	5812827	5819001	58	6232	6174	RIGHT	J55a.EDF	J55	1
113	5821463	5826386	57	4980	4923	RIGHT	J55a.EDF	J55	1
114	5828364	5833050	59	4745	4686	RIGHT	J55a.EDF	J55	1
115	5834877	5840284	58	5465	5407	RIGHT	J55a.EDF	J55	1
116	5842093	5843704	57	1668	1611	RIGHT	J55a.EDF	J55	1
116	5844241	5848990	2205	6954	4749	RIGHT	J55a.EDF	J55	1
117	5851260	5856564	58	5362	5304	RIGHT	J55a.EDF	J55	1
118	5858535	5859026	57	548	491	RIGHT	J55a.EDF	J55	1
118	5859642	5859719	1164	1241	77	RIGHT	J55a.EDF	J55	1
119	5867343	5867444	523	624	101	RIGHT	J55a.EDF	J55	1
119	5868214	5868323	1394	1503	109	RIGHT	J55a.EDF	J55	1
119	5871867	5871941	5047	5121	74	RIGHT	J55a.EDF	J55	1
120	5876185	5876283	587	685	98	RIGHT	J55a.EDF	J55	1
2	7752425	7752466	59	100	41	RIGHT	J55b.EDF	J55	2
2	7753880	7753909	1514	1543	29	RIGHT	J55b.EDF	J55	2
3	7761193	7761283	74	164	90	RIGHT	J55b.EDF	J55	2
4	7771060	7771120	589	649	60	RIGHT	J55b.EDF	J55	2
5	7778092	7778228	58	194	136	RIGHT	J55b.EDF	J55	2
5	7779163	7779258	1129	1224	95	RIGHT	J55b.EDF	J55	2
6	7787716	7787791	58	133	75	RIGHT	J55b.EDF	J55	2
6	7788498	7788566	840	908	68	RIGHT	J55b.EDF	J55	2
8	7802959	7803086	60	187	127	RIGHT	J55b.EDF	J55	2
9	7811709	7811759	58	108	50	RIGHT	J55b.EDF	J55	2
10	7819565	7819670	58	163	105	RIGHT	J55b.EDF	J55	2
11	7829480	7829556	59	135	76	RIGHT	J55b.EDF	J55	2
11	7830642	7830686	1221	1265	44	RIGHT	J55b.EDF	J55	2
12	7839157	7839220	58	121	63	RIGHT	J55b.EDF	J55	2
12	7840590	7840653	1491	1554	63	RIGHT	J55b.EDF	J55	2
13	7847392	7847588	58	254	196	RIGHT	J55b.EDF	J55	2
15	7866404	7866486	322	404	82	RIGHT	J55b.EDF	J55	2
16	7874932	7874953	59	80	21	RIGHT	J55b.EDF	J55	2
17	7883983	7884121	129	267	138	RIGHT	J55b.EDF	J55	2
17	7884881	7884960	1027	1106	79	RIGHT	J55b.EDF	J55	2
18	7893254	7893354	226	326	100	RIGHT	J55b.EDF	J55	2
19	7900546	7900666	201	321	120	RIGHT	J55b.EDF	J55	2
20	7909168	7909274	57	163	106	RIGHT	J55b.EDF	J55	2
20	7910095	7910195	984	1084	100	RIGHT	J55b.EDF	J55	2
23	7932585	7932701	247	363	116	RIGHT	J55b.EDF	J55	2
23	7935716	7935786	3378	3448	70	RIGHT	J55b.EDF	J55	2
24	7940846	7940959	402	515	113	RIGHT	J55b.EDF	J55	2
24	7941641	7941759	1197	1315	118	RIGHT	J55b.EDF	J55	2
25	7948402	7948518	299	415	116	RIGHT	J55b.EDF	J55	2
26	7954632	7954758	212	338	126	RIGHT	J55b.EDF	J55	2
27	7961754	7961822	572	640	68	RIGHT	J55b.EDF	J55	2
28	7970628	7970649	57	78	21	RIGHT	J55b.EDF	J55	2
28	7971105	7971189	534	618	84	RIGHT	J55b.EDF	J55	2
29	7978710	7978858	58	206	148	RIGHT	J55b.EDF	J55	2
29	7982296	7982399	3644	3747	103	RIGHT	J55b.EDF	J55	2
30	7987412	7987537	74	199	125	RIGHT	J55b.EDF	J55	2
30	7987963	7988092	625	754	129	RIGHT	J55b.EDF	J55	2
31	7996569	7996654	957	1042	85	RIGHT	J55b.EDF	J55	2
32	8005427	8005521	478	572	94	RIGHT	J55b.EDF	J55	2
33	8013773	8013857	577	661	84	RIGHT	J55b.EDF	J55	2
34	8022844	8022914	58	128	70	RIGHT	J55b.EDF	J55	2
34	8023350	8023486	564	700	136	RIGHT	J55b.EDF	J55	2
34	8027084	8027163	4298	4377	79	RIGHT	J55b.EDF	J55	2
35	8031817	8031880	58	121	63	RIGHT	J55b.EDF	J55	2
35	8032324	8032435	565	676	111	RIGHT	J55b.EDF	J55	2
36	8039824	8039916	554	646	92	RIGHT	J55b.EDF	J55	2
37	8049821	8049922	582	683	101	RIGHT	J55b.EDF	J55	2
38	8058991	8059094	293	396	103	RIGHT	J55b.EDF	J55	2
38	8061564	8061658	2866	2960	94	RIGHT	J55b.EDF	J55	2
39	8067776	8067874	999	1097	98	RIGHT	J55b.EDF	J55	2
40	8076617	8076741	500	624	124	RIGHT	J55b.EDF	J55	2
41	8085051	8085195	103	247	144	RIGHT	J55b.EDF	J55	2
41	8086596	8086680	1648	1732	84	RIGHT	J55b.EDF	J55	2
42	8095462	8095565	598	701	103	RIGHT	J55b.EDF	J55	2
43	8105106	8105209	574	677	103	RIGHT	J55b.EDF	J55	2
43	8106036	8106113	1504	1581	77	RIGHT	J55b.EDF	J55	2
44	8113420	8113513	554	647	93	RIGHT	J55b.EDF	J55	2
45	8121185	8121319	85	219	134	RIGHT	J55b.EDF	J55	2
45	8122048	8122142	948	1042	94	RIGHT	J55b.EDF	J55	2
46	8129336	8129420	548	632	84	RIGHT	J55b.EDF	J55	2
46	8132578	8132682	3790	3894	104	RIGHT	J55b.EDF	J55	2
47	8137703	8137812	807	916	109	RIGHT	J55b.EDF	J55	2
48	8145056	8145172	530	646	116	RIGHT	J55b.EDF	J55	2
49	8152976	8153092	527	643	116	RIGHT	J55b.EDF	J55	2
50	8161764	8161858	610	704	94	RIGHT	J55b.EDF	J55	2
51	8171635	8171742	334	441	107	RIGHT	J55b.EDF	J55	2
51	8172562	8172632	1261	1331	70	RIGHT	J55b.EDF	J55	2
52	8179070	8179181	569	680	111	RIGHT	J55b.EDF	J55	2
53	8185944	8186061	484	601	117	RIGHT	J55b.EDF	J55	2
54	8194263	8194368	808	913	105	RIGHT	J55b.EDF	J55	2
55	8201678	8201782	379	483	104	RIGHT	J55b.EDF	J55	2
56	8208861	8208947	627	713	86	RIGHT	J55b.EDF	J55	2
57	8216651	8216714	533	596	63	RIGHT	J55b.EDF	J55	2
58	8225069	8225148	1046	1125	79	RIGHT	J55b.EDF	J55	2
59	8231911	8232034	359	482	123	RIGHT	J55b.EDF	J55	2
59	8232682	8232793	1130	1241	111	RIGHT	J55b.EDF	J55	2
60	8240251	8240363	58	170	112	RIGHT	J55b.EDF	J55	2
60	8240805	8240950	612	757	145	RIGHT	J55b.EDF	J55	2
61	8247690	8247812	499	621	122	RIGHT	J55b.EDF	J55	2
62	8255015	8255092	633	710	77	RIGHT	J55b.EDF	J55	2
63	8262664	8262797	57	190	133	RIGHT	J55b.EDF	J55	2
63	8263162	8263272	555	665	110	RIGHT	J55b.EDF	J55	2
63	8263817	8263900	1210	1293	83	RIGHT	J55b.EDF	J55	2
64	8272375	8272410	58	93	35	RIGHT	J55b.EDF	J55	2
64	8273113	8273207	796	890	94	RIGHT	J55b.EDF	J55	2
65	8281107	8281215	468	576	108	RIGHT	J55b.EDF	J55	2
65	8283599	8283695	2960	3056	96	RIGHT	J55b.EDF	J55	2
66	8289551	8289686	734	869	135	RIGHT	J55b.EDF	J55	2
67	8299076	8299181	874	979	105	RIGHT	J55b.EDF	J55	2
68	8307710	8307848	853	991	138	RIGHT	J55b.EDF	J55	2
69	8316017	8316136	307	426	119	RIGHT	J55b.EDF	J55	2
70	8324204	8324377	136	309	173	RIGHT	J55b.EDF	J55	2
71	8332267	8332494	118	345	227	RIGHT	J55b.EDF	J55	2
72	8341934	8342068	528	662	134	RIGHT	J55b.EDF	J55	2
73	8350729	8350890	58	219	161	RIGHT	J55b.EDF	J55	2
73	8351557	8351647	886	976	90	RIGHT	J55b.EDF	J55	2
74	8360902	8360991	555	644	89	RIGHT	J55b.EDF	J55	2
75	8368210	8368289	58	137	79	RIGHT	J55b.EDF	J55	2
75	8369040	8369126	888	974	86	RIGHT	J55b.EDF	J55	2
76	8375874	8375955	543	624	81	RIGHT	J55b.EDF	J55	2
77	8384773	8384905	884	1016	132	RIGHT	J55b.EDF	J55	2
78	8394609	8394691	1350	1432	82	RIGHT	J55b.EDF	J55	2
79	8400802	8400916	540	654	114	RIGHT	J55b.EDF	J55	2
79	8401773	8401839	1511	1577	66	RIGHT	J55b.EDF	J55	2
80	8411100	8411214	692	806	114	RIGHT	J55b.EDF	J55	2
81	8419814	8419917	479	582	103	RIGHT	J55b.EDF	J55	2
82	8429100	8429220	240	360	120	RIGHT	J55b.EDF	J55	2
83	8436855	8436951	834	930	96	RIGHT	J55b.EDF	J55	2
84	8444207	8444306	58	157	99	RIGHT	J55b.EDF	J55	2
84	8444970	8445070	821	921	100	RIGHT	J55b.EDF	J55	2
85	8453134	8453256	540	662	122	RIGHT	J55b.EDF	J55	2
86	8462085	8462212	384	511	127	RIGHT	J55b.EDF	J55	2
86	8462660	8462759	959	1058	99	RIGHT	J55b.EDF	J55	2
87	8470403	8470453	59	109	50	RIGHT	J55b.EDF	J55	2
87	8471021	8471147	677	803	126	RIGHT	J55b.EDF	J55	2
87	8473038	8473123	2694	2779	85	RIGHT	J55b.EDF	J55	2
88	8479234	8479338	728	832	104	RIGHT	J55b.EDF	J55	2
89	8486921	8487013	307	399	92	RIGHT	J55b.EDF	J55	2
89	8487547	8487660	933	1046	113	RIGHT	J55b.EDF	J55	2
90	8495286	8495400	746	860	114	RIGHT	J55b.EDF	J55	2
91	8503358	8503502	398	542	144	RIGHT	J55b.EDF	J55	2
91	8504064	8504199	1104	1239	135	RIGHT	J55b.EDF	J55	2
92	8510842	8510959	703	820	117	RIGHT	J55b.EDF	J55	2
93	8517964	8517995	58	89	31	RIGHT	J55b.EDF	J55	2
94	8527301	8527482	170	351	181	RIGHT	J55b.EDF	J55	2
95	8535531	8535642	641	752	111	RIGHT	J55b.EDF	J55	2
96	8542858	8542973	58	173	115	RIGHT	J55b.EDF	J55	2
96	8543490	8543591	690	791	101	RIGHT	J55b.EDF	J55	2
96	8547632	8547703	4832	4903	71	RIGHT	J55b.EDF	J55	2
97	8549822	8549864	58	100	42	RIGHT	J55b.EDF	J55	2
98	8559452	8559548	880	976	96	RIGHT	J55b.EDF	J55	2
98	8560162	8560183	1590	1611	21	RIGHT	J55b.EDF	J55	2
98	8560210	8560210	1638	1638	0	RIGHT	J55b.EDF	J55	2
99	8567575	8567697	651	773	122	RIGHT	J55b.EDF	J55	2
100	8575118	8575266	595	743	148	RIGHT	J55b.EDF	J55	2
100	8581293	8581382	6770	6859	89	RIGHT	J55b.EDF	J55	2
101	8584830	8584887	1561	1618	57	RIGHT	J55b.EDF	J55	2
102	8592114	8592219	563	668	105	RIGHT	J55b.EDF	J55	2
103	8601317	8601430	58	171	113	RIGHT	J55b.EDF	J55	2
103	8601801	8601824	542	565	23	RIGHT	J55b.EDF	J55	2
103	8602151	8602249	892	990	98	RIGHT	J55b.EDF	J55	2
104	8609640	8609733	499	592	93	RIGHT	J55b.EDF	J55	2
104	8614532	8614611	5391	5470	79	RIGHT	J55b.EDF	J55	2
105	8617311	8617411	553	653	100	RIGHT	J55b.EDF	J55	2
105	8618397	8618479	1639	1721	82	RIGHT	J55b.EDF	J55	2
106	8626010	8626121	468	579	111	RIGHT	J55b.EDF	J55	2
107	8634222	8634337	292	407	115	RIGHT	J55b.EDF	J55	2
108	8641359	8641562	58	261	203	RIGHT	J55b.EDF	J55	2
109	8648696	8648805	58	167	109	RIGHT	J55b.EDF	J55	2
109	8649286	8649432	648	794	146	RIGHT	J55b.EDF	J55	2
109	8652832	8652917	4194	4279	85	RIGHT	J55b.EDF	J55	2
110	8656681	8656787	688	794	106	RIGHT	J55b.EDF	J55	2
111	8665660	8665763	996	1099	103	RIGHT	J55b.EDF	J55	2
112	8673845	8673947	1315	1417	102	RIGHT	J55b.EDF	J55	2
113	8680656	8680755	58	157	99	RIGHT	J55b.EDF	J55	2
114	8688618	8688681	57	120	63	RIGHT	J55b.EDF	J55	2
114	8689507	8689628	946	1067	121	RIGHT	J55b.EDF	J55	2
115	8696668	8696761	1242	1335	93	RIGHT	J55b.EDF	J55	2
116	8703377	8703403	58	84	26	RIGHT	J55b.EDF	J55	2
116	8703911	8704011	592	692	100	RIGHT	J55b.EDF	J55	2
117	8711847	8711962	729	844	115	RIGHT	J55b.EDF	J55	2
118	8720933	8721022	464	553	89	RIGHT	J55b.EDF	J55	2
118	8721628	8721723	1159	1254	95	RIGHT	J55b.EDF	J55	2
119	8729133	8729273	616	756	140	RIGHT	J55b.EDF	J55	2
120	8738223	8738316	522	615	93	RIGHT	J55b.EDF	J55	2
2	8851990	8852059	976	1045	69	RIGHT	J55c.EDF	J55	3
3	8860541	8860658	807	924	117	RIGHT	J55c.EDF	J55	3
4	8867279	8867348	908	977	69	RIGHT	J55c.EDF	J55	3
5	8876010	8876101	743	834	91	RIGHT	J55c.EDF	J55	3
6	8883435	8883537	58	160	102	RIGHT	J55c.EDF	J55	3
6	8884042	8884157	665	780	115	RIGHT	J55c.EDF	J55	3
6	8888673	8888752	5296	5375	79	RIGHT	J55c.EDF	J55	3
7	8892302	8892377	542	617	75	RIGHT	J55c.EDF	J55	3
7	8893255	8893353	1495	1593	98	RIGHT	J55c.EDF	J55	3
8	8900691	8900831	810	950	140	RIGHT	J55c.EDF	J55	3
8	8904943	8905064	5062	5183	121	RIGHT	J55c.EDF	J55	3
9	8907306	8907343	59	96	37	RIGHT	J55c.EDF	J55	3
9	8908041	8908179	794	932	138	RIGHT	J55c.EDF	J55	3
10	8915322	8915404	59	141	82	RIGHT	J55c.EDF	J55	3
10	8916271	8916356	1008	1093	85	RIGHT	J55c.EDF	J55	3
11	8923458	8923563	710	815	105	RIGHT	J55c.EDF	J55	3
12	8931157	8931287	97	227	130	RIGHT	J55c.EDF	J55	3
12	8931993	8932087	933	1027	94	RIGHT	J55c.EDF	J55	3
13	8938166	8938250	224	308	84	RIGHT	J55c.EDF	J55	3
14	8946867	8946905	57	95	38	RIGHT	J55c.EDF	J55	3
15	8953523	8953608	57	142	85	RIGHT	J55c.EDF	J55	3
16	8962518	8962606	58	146	88	RIGHT	J55c.EDF	J55	3
18	8980774	8980798	59	83	24	RIGHT	J55c.EDF	J55	3
18	8981241	8981359	526	644	118	RIGHT	J55c.EDF	J55	3
19	8989293	8989397	398	502	104	RIGHT	J55c.EDF	J55	3
19	8990006	8990109	1111	1214	103	RIGHT	J55c.EDF	J55	3
20	8996938	8997032	639	733	94	RIGHT	J55c.EDF	J55	3
21	9004826	9004912	660	746	86	RIGHT	J55c.EDF	J55	3
22	9013047	9013162	654	769	115	RIGHT	J55c.EDF	J55	3
22	9015430	9015516	3037	3123	86	RIGHT	J55c.EDF	J55	3
22	9018238	9018328	5845	5935	90	RIGHT	J55c.EDF	J55	3
23	9022529	9022611	640	722	82	RIGHT	J55c.EDF	J55	3
24	9029702	9029828	500	626	126	RIGHT	J55c.EDF	J55	3
25	9038849	9038947	547	645	98	RIGHT	J55c.EDF	J55	3
26	9046512	9046611	320	419	99	RIGHT	J55c.EDF	J55	3
26	9047529	9047621	1337	1429	92	RIGHT	J55c.EDF	J55	3
27	9054931	9055013	843	925	82	RIGHT	J55c.EDF	J55	3
28	9062549	9062662	58	171	113	RIGHT	J55c.EDF	J55	3
28	9063941	9064012	1450	1521	71	RIGHT	J55c.EDF	J55	3
29	9072243	9072268	58	83	25	RIGHT	J55c.EDF	J55	3
29	9073008	9073108	823	923	100	RIGHT	J55c.EDF	J55	3
30	9081731	9081841	610	720	110	RIGHT	J55c.EDF	J55	3
31	9088495	9088599	212	316	104	RIGHT	J55c.EDF	J55	3
31	9089001	9089092	718	809	91	RIGHT	J55c.EDF	J55	3
31	9089874	9089949	1591	1666	75	RIGHT	J55c.EDF	J55	3
32	9096832	9096917	889	974	85	RIGHT	J55c.EDF	J55	3
33	9104417	9104524	583	690	107	RIGHT	J55c.EDF	J55	3
34	9111884	9111988	111	215	104	RIGHT	J55c.EDF	J55	3
34	9112425	9112511	652	738	86	RIGHT	J55c.EDF	J55	3
35	9120406	9120510	586	690	104	RIGHT	J55c.EDF	J55	3
36	9127975	9128051	571	647	76	RIGHT	J55c.EDF	J55	3
37	9135703	9135779	58	134	76	RIGHT	J55c.EDF	J55	3
37	9136234	9136343	589	698	109	RIGHT	J55c.EDF	J55	3
37	9137157	9137238	1512	1593	81	RIGHT	J55c.EDF	J55	3
37	9141429	9141516	5784	5871	87	RIGHT	J55c.EDF	J55	3
38	9145555	9145635	501	581	80	RIGHT	J55c.EDF	J55	3
38	9146669	9146730	1615	1676	61	RIGHT	J55c.EDF	J55	3
39	9154781	9154895	524	638	114	RIGHT	J55c.EDF	J55	3
40	9162534	9162636	618	720	102	RIGHT	J55c.EDF	J55	3
41	9169865	9169941	530	606	76	RIGHT	J55c.EDF	J55	3
42	9177505	9177654	121	270	149	RIGHT	J55c.EDF	J55	3
42	9178004	9178062	620	678	58	RIGHT	J55c.EDF	J55	3
43	9185757	9185859	588	690	102	RIGHT	J55c.EDF	J55	3
44	9193467	9193651	59	243	184	RIGHT	J55c.EDF	J55	3
44	9194213	9194330	805	922	117	RIGHT	J55c.EDF	J55	3
45	9200665	9200752	887	974	87	RIGHT	J55c.EDF	J55	3
46	9207213	9207289	57	133	76	RIGHT	J55c.EDF	J55	3
47	9215532	9215587	58	113	55	RIGHT	J55c.EDF	J55	3
47	9216109	9216199	635	725	90	RIGHT	J55c.EDF	J55	3
48	9224102	9224259	609	766	157	RIGHT	J55c.EDF	J55	3
48	9224921	9225012	1428	1519	91	RIGHT	J55c.EDF	J55	3
49	9230759	9230840	122	203	81	RIGHT	J55c.EDF	J55	3
49	9231336	9231440	699	803	104	RIGHT	J55c.EDF	J55	3
50	9240110	9240176	627	693	66	RIGHT	J55c.EDF	J55	3
51	9247505	9247632	378	505	127	RIGHT	J55c.EDF	J55	3
52	9254975	9255107	485	617	132	RIGHT	J55c.EDF	J55	3
52	9255800	9255925	1310	1435	125	RIGHT	J55c.EDF	J55	3
52	9259022	9259079	4532	4589	57	RIGHT	J55c.EDF	J55	3
53	9263052	9263185	486	619	133	RIGHT	J55c.EDF	J55	3
53	9264081	9264180	1515	1614	99	RIGHT	J55c.EDF	J55	3
54	9269365	9269478	84	197	113	RIGHT	J55c.EDF	J55	3
54	9270092	9270197	811	916	105	RIGHT	J55c.EDF	J55	3
55	9279002	9279104	565	667	102	RIGHT	J55c.EDF	J55	3
56	9285673	9285778	544	649	105	RIGHT	J55c.EDF	J55	3
56	9286704	9286806	1575	1677	102	RIGHT	J55c.EDF	J55	3
57	9294419	9294535	475	591	116	RIGHT	J55c.EDF	J55	3
58	9301386	9301525	307	446	139	RIGHT	J55c.EDF	J55	3
58	9302061	9302168	982	1089	107	RIGHT	J55c.EDF	J55	3
58	9303818	9303909	2739	2830	91	RIGHT	J55c.EDF	J55	3
58	9306919	9306995	5840	5916	76	RIGHT	J55c.EDF	J55	3
59	9309096	9309206	584	694	110	RIGHT	J55c.EDF	J55	3
60	9318650	9318728	58	136	78	RIGHT	J55c.EDF	J55	3
60	9319127	9319231	535	639	104	RIGHT	J55c.EDF	J55	3
60	9319957	9320061	1365	1469	104	RIGHT	J55c.EDF	J55	3
60	9322553	9322630	3961	4038	77	RIGHT	J55c.EDF	J55	3
61	9328115	9328235	456	576	120	RIGHT	J55c.EDF	J55	3
61	9329521	9329634	1862	1975	113	RIGHT	J55c.EDF	J55	3
62	9336161	9336269	519	627	108	RIGHT	J55c.EDF	J55	3
62	9337240	9337320	1598	1678	80	RIGHT	J55c.EDF	J55	3
63	9342723	9342888	76	241	165	RIGHT	J55c.EDF	J55	3
63	9343415	9343520	768	873	105	RIGHT	J55c.EDF	J55	3
64	9351866	9351950	58	142	84	RIGHT	J55c.EDF	J55	3
64	9352347	9352453	539	645	106	RIGHT	J55c.EDF	J55	3
65	9361392	9361543	605	756	151	RIGHT	J55c.EDF	J55	3
66	9369607	9369725	595	713	118	RIGHT	J55c.EDF	J55	3
67	9375873	9375988	479	594	115	RIGHT	J55c.EDF	J55	3
68	9383221	9383317	578	674	96	RIGHT	J55c.EDF	J55	3
68	9384978	9385110	2335	2467	132	RIGHT	J55c.EDF	J55	3
69	9391282	9391310	57	85	28	RIGHT	J55c.EDF	J55	3
69	9391777	9391871	552	646	94	RIGHT	J55c.EDF	J55	3
70	9398575	9398715	559	699	140	RIGHT	J55c.EDF	J55	3
71	9407290	9407412	484	606	122	RIGHT	J55c.EDF	J55	3
71	9408341	9408417	1535	1611	76	RIGHT	J55c.EDF	J55	3
72	9415951	9416049	530	628	98	RIGHT	J55c.EDF	J55	3
74	9432611	9432716	612	717	105	RIGHT	J55c.EDF	J55	3
74	9435115	9435189	3116	3190	74	RIGHT	J55c.EDF	J55	3
76	9447338	9447406	601	669	68	RIGHT	J55c.EDF	J55	3
77	9455286	9455395	524	633	109	RIGHT	J55c.EDF	J55	3
77	9456216	9456315	1454	1553	99	RIGHT	J55c.EDF	J55	3
78	9462482	9462588	540	646	106	RIGHT	J55c.EDF	J55	3
79	9471432	9471594	426	588	162	RIGHT	J55c.EDF	J55	3
80	9479304	9479400	628	724	96	RIGHT	J55c.EDF	J55	3
81	9486826	9486903	530	607	77	RIGHT	J55c.EDF	J55	3
82	9494930	9495027	582	679	97	RIGHT	J55c.EDF	J55	3
83	9504136	9504254	614	732	118	RIGHT	J55c.EDF	J55	3
84	9510837	9510940	638	741	103	RIGHT	J55c.EDF	J55	3
85	9518775	9518795	58	78	20	RIGHT	J55c.EDF	J55	3
85	9519305	9519420	588	703	115	RIGHT	J55c.EDF	J55	3
86	9527548	9527657	919	1028	109	RIGHT	J55c.EDF	J55	3
87	9534559	9534667	565	673	108	RIGHT	J55c.EDF	J55	3
88	9541053	9541222	709	878	169	RIGHT	J55c.EDF	J55	3
89	9549605	9549728	572	695	123	RIGHT	J55c.EDF	J55	3
90	9557382	9557502	569	689	120	RIGHT	J55c.EDF	J55	3
90	9558329	9558426	1516	1613	97	RIGHT	J55c.EDF	J55	3
92	9573218	9573320	699	801	102	RIGHT	J55c.EDF	J55	3
94	9587430	9587571	528	669	141	RIGHT	J55c.EDF	J55	3
95	9594405	9594568	506	669	163	RIGHT	J55c.EDF	J55	3
96	9603931	9604047	546	662	116	RIGHT	J55c.EDF	J55	3
96	9606339	9606428	2954	3043	89	RIGHT	J55c.EDF	J55	3
96	9607619	9607715	4234	4330	96	RIGHT	J55c.EDF	J55	3
97	9611124	9611206	743	825	82	RIGHT	J55c.EDF	J55	3
99	9627136	9627265	450	579	129	RIGHT	J55c.EDF	J55	3
99	9628174	9628259	1488	1573	85	RIGHT	J55c.EDF	J55	3
100	9634952	9635130	620	798	178	RIGHT	J55c.EDF	J55	3
101	9647949	9647959	4827	4837	10	RIGHT	J55c.EDF	J55	3
101	9647980	9647986	4858	4864	6	RIGHT	J55c.EDF	J55	3
101	9648020	9648024	4898	4902	4	RIGHT	J55c.EDF	J55	3
101	9648090	9648228	4968	5106	138	RIGHT	J55c.EDF	J55	3
101	9648317	9648433	5195	5311	116	RIGHT	J55c.EDF	J55	3
101	9648601	9648626	5479	5504	25	RIGHT	J55c.EDF	J55	3
101	9648739	9648774	5617	5652	35	RIGHT	J55c.EDF	J55	3
101	9648810	9648843	5688	5721	33	RIGHT	J55c.EDF	J55	3
101	9648929	9648939	5807	5817	10	RIGHT	J55c.EDF	J55	3
101	9648969	9648977	5847	5855	8	RIGHT	J55c.EDF	J55	3
101	9649001	9649165	5879	6043	164	RIGHT	J55c.EDF	J55	3
101	9649230	9649254	6108	6132	24	RIGHT	J55c.EDF	J55	3
101	9649275	9649294	6153	6172	19	RIGHT	J55c.EDF	J55	3
101	9649371	9649399	6249	6277	28	RIGHT	J55c.EDF	J55	3
102	9652064	9652185	558	679	121	RIGHT	J55c.EDF	J55	3
104	9668444	9668631	458	645	187	RIGHT	J55c.EDF	J55	3
104	9672005	9672087	4019	4101	82	RIGHT	J55c.EDF	J55	3
105	9675720	9675841	533	654	121	RIGHT	J55c.EDF	J55	3
106	9683858	9684013	485	640	155	RIGHT	J55c.EDF	J55	3
107	9693531	9693635	959	1063	104	RIGHT	J55c.EDF	J55	3
108	9701569	9701680	542	653	111	RIGHT	J55c.EDF	J55	3
109	9709289	9709346	58	115	57	RIGHT	J55c.EDF	J55	3
109	9709744	9709880	513	649	136	RIGHT	J55c.EDF	J55	3
110	9716720	9716874	456	610	154	RIGHT	J55c.EDF	J55	3
111	9723707	9723830	628	751	123	RIGHT	J55c.EDF	J55	3
112	9731128	9731224	596	692	96	RIGHT	J55c.EDF	J55	3
113	9738430	9738565	451	586	135	RIGHT	J55c.EDF	J55	3
114	9745989	9746089	485	585	100	RIGHT	J55c.EDF	J55	3
114	9747163	9747232	1659	1728	69	RIGHT	J55c.EDF	J55	3
115	9753265	9753377	508	620	112	RIGHT	J55c.EDF	J55	3
115	9755906	9756006	3149	3249	100	RIGHT	J55c.EDF	J55	3
115	9757500	9757569	4743	4812	69	RIGHT	J55c.EDF	J55	3
116	9760272	9760365	613	706	93	RIGHT	J55c.EDF	J55	3
117	9769394	9769531	469	606	137	RIGHT	J55c.EDF	J55	3
118	9776930	9777034	337	441	104	RIGHT	J55c.EDF	J55	3
119	9787624	9787742	456	574	118	RIGHT	J55c.EDF	J55	3
120	9796114	9796331	303	520	217	RIGHT	J55c.EDF	J55	3
1	4498834	4498901	1497	1564	67	RIGHT	J56.EDF	J56	.
2	4537657	4537722	1037	1102	65	RIGHT	J56.EDF	J56	.
3	4597800	4597891	879	970	91	RIGHT	J56.EDF	J56	.
4	4646056	4646144	796	884	88	RIGHT	J56.EDF	J56	.
5	4661567	4661643	252	328	76	RIGHT	J56.EDF	J56	.
5	4662916	4662979	1601	1664	63	RIGHT	J56.EDF	J56	.
6	4682173	4682244	707	778	71	RIGHT	J56.EDF	J56	.
6	4685298	4685348	3832	3882	50	RIGHT	J56.EDF	J56	.
6	4687345	4687396	5879	5930	51	RIGHT	J56.EDF	J56	.
7	4718681	4718748	863	930	67	RIGHT	J56.EDF	J56	.
8	4732027	4732121	769	863	94	RIGHT	J56.EDF	J56	.
9	4758826	4758920	599	693	94	RIGHT	J56.EDF	J56	.
1	10440500	10440567	119	186	67	RIGHT	J56a.EDF	J56	1
2	10460414	10460476	604	666	62	RIGHT	J56a.EDF	J56	1
2	10460664	10460721	854	911	57	RIGHT	J56a.EDF	J56	1
3	10470641	10470692	301	352	51	RIGHT	J56a.EDF	J56	1
3	10471346	10471394	1006	1054	48	RIGHT	J56a.EDF	J56	1
4	10478918	10478970	804	856	52	RIGHT	J56a.EDF	J56	1
5	10487483	10487507	1291	1315	24	RIGHT	J56a.EDF	J56	1
6	10495863	10495919	830	886	56	RIGHT	J56a.EDF	J56	1
7	10502612	10502670	793	851	58	RIGHT	J56a.EDF	J56	1
7	10503097	10503166	1278	1347	69	RIGHT	J56a.EDF	J56	1
8	10510659	10510702	1286	1329	43	RIGHT	J56a.EDF	J56	1
9	10520864	10520906	530	572	42	RIGHT	J56a.EDF	J56	1
9	10521606	10521678	1272	1344	72	RIGHT	J56a.EDF	J56	1
10	10529975	10530032	763	820	57	RIGHT	J56a.EDF	J56	1
10	10530363	10530423	1151	1211	60	RIGHT	J56a.EDF	J56	1
11	10537311	10537386	1169	1244	75	RIGHT	J56a.EDF	J56	1
12	10546292	10546341	897	946	49	RIGHT	J56a.EDF	J56	1
12	10546916	10546985	1521	1590	69	RIGHT	J56a.EDF	J56	1
13	10559090	10559116	5310	5336	26	RIGHT	J56a.EDF	J56	1
13	10559149	10559176	5369	5396	27	RIGHT	J56a.EDF	J56	1
13	10560158	10560176	6378	6396	18	RIGHT	J56a.EDF	J56	1
13	10560207	10560213	6427	6433	6	RIGHT	J56a.EDF	J56	1
14	10562642	10562671	58	87	29	RIGHT	J56a.EDF	J56	1
14	10563414	10563463	830	879	49	RIGHT	J56a.EDF	J56	1
14	10563719	10563789	1135	1205	70	RIGHT	J56a.EDF	J56	1
14	10564080	10564131	1496	1547	51	RIGHT	J56a.EDF	J56	1
14	10568753	10568962	6169	6378	209	RIGHT	J56a.EDF	J56	1
14	10569047	10569149	6463	6565	102	RIGHT	J56a.EDF	J56	1
15	10572769	10573547	57	835	778	RIGHT	J56a.EDF	J56	1
15	10573825	10573892	1113	1180	67	RIGHT	J56a.EDF	J56	1
15	10574071	10574100	1359	1388	29	RIGHT	J56a.EDF	J56	1
15	10577294	10577498	4582	4786	204	RIGHT	J56a.EDF	J56	1
15	10577662	10577662	4950	4950	0	RIGHT	J56a.EDF	J56	1
15	10577864	10579641	5152	6929	1777	RIGHT	J56a.EDF	J56	1
16	10582762	10583022	57	317	260	RIGHT	J56a.EDF	J56	1
16	10583757	10583823	1052	1118	66	RIGHT	J56a.EDF	J56	1
16	10584390	10584455	1685	1750	65	RIGHT	J56a.EDF	J56	1
16	10585686	10588223	2981	5518	2537	RIGHT	J56a.EDF	J56	1
17	10591640	10591747	262	369	107	RIGHT	J56a.EDF	J56	1
17	10591867	10592751	489	1373	884	RIGHT	J56a.EDF	J56	1
17	10592773	10592839	1395	1461	66	RIGHT	J56a.EDF	J56	1
17	10595505	10596276	4127	4898	771	RIGHT	J56a.EDF	J56	1
18	10599115	10600163	57	1105	1048	RIGHT	J56a.EDF	J56	1
18	10604473	10604557	5415	5499	84	RIGHT	J56a.EDF	J56	1
18	10604947	10605021	5889	5963	74	RIGHT	J56a.EDF	J56	1
19	10607299	10608382	151	1234	1083	RIGHT	J56a.EDF	J56	1
19	10608412	10608670	1264	1522	258	RIGHT	J56a.EDF	J56	1
19	10609008	10609070	1860	1922	62	RIGHT	J56a.EDF	J56	1
19	10609326	10609362	2178	2214	36	RIGHT	J56a.EDF	J56	1
19	10609451	10609478	2303	2330	27	RIGHT	J56a.EDF	J56	1
19	10609511	10609523	2363	2375	12	RIGHT	J56a.EDF	J56	1
19	10609905	10609910	2757	2762	5	RIGHT	J56a.EDF	J56	1
19	10609934	10614207	2786	7059	4273	RIGHT	J56a.EDF	J56	1
20	10616006	10617677	58	1729	1671	RIGHT	J56a.EDF	J56	1
20	10617976	10620741	2028	4793	2765	RIGHT	J56a.EDF	J56	1
21	10624071	10628765	58	4752	4694	RIGHT	J56a.EDF	J56	1
22	10630576	10637761	57	7242	7185	RIGHT	J56a.EDF	J56	1
23	10641410	10647687	57	6334	6277	RIGHT	J56a.EDF	J56	1
24	10650128	10655872	58	5802	5744	RIGHT	J56a.EDF	J56	1
25	10658583	10664127	57	5601	5544	RIGHT	J56a.EDF	J56	1
26	10667367	10673172	58	5863	5805	RIGHT	J56a.EDF	J56	1
27	10676704	10682939	57	6292	6235	RIGHT	J56a.EDF	J56	1
28	10685226	10690324	57	5155	5098	RIGHT	J56a.EDF	J56	1
29	10693673	10700580	57	6964	6907	RIGHT	J56a.EDF	J56	1
30	10702629	10708755	57	6183	6126	RIGHT	J56a.EDF	J56	1
31	10710824	10717510	58	6744	6686	RIGHT	J56a.EDF	J56	1
32	10719839	10725075	57	5293	5236	RIGHT	J56a.EDF	J56	1
33	10727937	10732680	58	4801	4743	RIGHT	J56a.EDF	J56	1
34	10735440	10741424	57	6041	5984	RIGHT	J56a.EDF	J56	1
35	10744462	10750260	58	5856	5798	RIGHT	J56a.EDF	J56	1
36	10753161	10759876	57	6772	6715	RIGHT	J56a.EDF	J56	1
37	10761901	10768741	57	6897	6840	RIGHT	J56a.EDF	J56	1
38	10772291	10778528	59	6296	6237	RIGHT	J56a.EDF	J56	1
39	10780328	10786343	59	6074	6015	RIGHT	J56a.EDF	J56	1
40	10788524	10793487	58	5021	4963	RIGHT	J56a.EDF	J56	1
41	10795933	10803363	58	7488	7430	RIGHT	J56a.EDF	J56	1
42	10805654	10812729	58	7133	7075	RIGHT	J56a.EDF	J56	1
43	10814809	10820033	58	5282	5224	RIGHT	J56a.EDF	J56	1
44	10822383	10827598	58	5273	5215	RIGHT	J56a.EDF	J56	1
45	10830016	10835052	58	5094	5036	RIGHT	J56a.EDF	J56	1
46	10838744	10843977	58	5291	5233	RIGHT	J56a.EDF	J56	1
47	10846095	10850962	58	4925	4867	RIGHT	J56a.EDF	J56	1
48	10853360	10859117	58	5815	5757	RIGHT	J56a.EDF	J56	1
49	10861308	10868462	58	7212	7154	RIGHT	J56a.EDF	J56	1
50	10871263	10876608	58	5403	5345	RIGHT	J56a.EDF	J56	1
51	10878786	10885013	57	6284	6227	RIGHT	J56a.EDF	J56	1
52	10886669	10893548	58	6937	6879	RIGHT	J56a.EDF	J56	1
53	10896198	10903054	57	6913	6856	RIGHT	J56a.EDF	J56	1
54	10905785	10912380	59	6654	6595	RIGHT	J56a.EDF	J56	1
55	10914480	10920594	58	6172	6114	RIGHT	J56a.EDF	J56	1
56	10922803	10928600	58	5855	5797	RIGHT	J56a.EDF	J56	1
57	10930437	10936395	57	6015	5958	RIGHT	J56a.EDF	J56	1
58	10939524	10944280	57	4813	4756	RIGHT	J56a.EDF	J56	1
59	10947447	10953616	58	6227	6169	RIGHT	J56a.EDF	J56	1
60	10956326	10962331	58	6063	6005	RIGHT	J56a.EDF	J56	1
61	10964519	10970405	57	5943	5886	RIGHT	J56a.EDF	J56	1
62	10972836	10979331	57	6552	6495	RIGHT	J56a.EDF	J56	1
63	10981709	10987897	58	6246	6188	RIGHT	J56a.EDF	J56	1
64	10990395	10995741	58	5404	5346	RIGHT	J56a.EDF	J56	1
65	10997806	11003496	58	5748	5690	RIGHT	J56a.EDF	J56	1
66	11006325	11012772	57	6504	6447	RIGHT	J56a.EDF	J56	1
67	11014812	11021317	58	6563	6505	RIGHT	J56a.EDF	J56	1
68	11024688	11030553	58	5923	5865	RIGHT	J56a.EDF	J56	1
69	11032998	11038928	58	5988	5930	RIGHT	J56a.EDF	J56	1
70	11041016	11046842	58	5884	5826	RIGHT	J56a.EDF	J56	1
71	11048903	11053887	58	5042	4984	RIGHT	J56a.EDF	J56	1
72	11055817	11061452	57	5692	5635	RIGHT	J56a.EDF	J56	1
73	11063542	11068286	57	4801	4744	RIGHT	J56a.EDF	J56	1
74	11071127	11076161	58	5092	5034	RIGHT	J56a.EDF	J56	1
75	11078641	11081491	57	2907	2850	RIGHT	J56a.EDF	J56	1
75	11082901	11082975	4317	4391	74	RIGHT	J56a.EDF	J56	1
76	11087030	11087295	100	365	265	RIGHT	J56a.EDF	J56	1
76	11087384	11092821	454	5891	5437	RIGHT	J56a.EDF	J56	1
77	11095261	11101447	57	6243	6186	RIGHT	J56a.EDF	J56	1
78	11103988	11110983	58	7053	6995	RIGHT	J56a.EDF	J56	1
79	11113812	11119067	57	5312	5255	RIGHT	J56a.EDF	J56	1
80	11121698	11128934	58	7294	7236	RIGHT	J56a.EDF	J56	1
81	11131014	11137489	57	6532	6475	RIGHT	J56a.EDF	J56	1
82	11139628	11146034	57	6463	6406	RIGHT	J56a.EDF	J56	1
83	11148382	11153788	58	5464	5406	RIGHT	J56a.EDF	J56	1
84	11156267	11163175	58	6966	6908	RIGHT	J56a.EDF	J56	1
85	11167905	11173191	57	5343	5286	RIGHT	J56a.EDF	J56	1
86	11175211	11182326	57	7172	7115	RIGHT	J56a.EDF	J56	1
87	11184836	11190942	58	6164	6106	RIGHT	J56a.EDF	J56	1
88	11193824	11201128	59	7363	7304	RIGHT	J56a.EDF	J56	1
89	11203478	11209663	58	6243	6185	RIGHT	J56a.EDF	J56	1
90	11212244	11218609	58	6423	6365	RIGHT	J56a.EDF	J56	1
91	11221338	11228365	58	7085	7027	RIGHT	J56a.EDF	J56	1
92	11231034	11238310	57	7333	7276	RIGHT	J56a.EDF	J56	1
93	11240179	11245535	58	5414	5356	RIGHT	J56a.EDF	J56	1
94	11248304	11255121	57	6874	6817	RIGHT	J56a.EDF	J56	1
95	11257078	11263566	58	6546	6488	RIGHT	J56a.EDF	J56	1
96	11266005	11272402	57	6454	6397	RIGHT	J56a.EDF	J56	1
97	11275002	11280927	58	5983	5925	RIGHT	J56a.EDF	J56	1
98	11284829	11291564	58	6793	6735	RIGHT	J56a.EDF	J56	1
99	11293751	11300799	56	7104	7048	RIGHT	J56a.EDF	J56	1
100	11304497	11310946	57	6506	6449	RIGHT	J56a.EDF	J56	1
101	11312972	11319251	58	6337	6279	RIGHT	J56a.EDF	J56	1
102	11323652	11329397	59	5804	5745	RIGHT	J56a.EDF	J56	1
103	11331276	11337631	57	6412	6355	RIGHT	J56a.EDF	J56	1
104	11339616	11346107	57	6548	6491	RIGHT	J56a.EDF	J56	1
105	11348627	11353331	57	4761	4704	RIGHT	J56a.EDF	J56	1
106	11355488	11361337	58	5907	5849	RIGHT	J56a.EDF	J56	1
107	11362927	11368101	57	5231	5174	RIGHT	J56a.EDF	J56	1
108	11370140	11375405	58	5323	5265	RIGHT	J56a.EDF	J56	1
109	11378041	11384361	57	6377	6320	RIGHT	J56a.EDF	J56	1
110	11386742	11393216	59	6533	6474	RIGHT	J56a.EDF	J56	1
111	11395445	11401501	57	6113	6056	RIGHT	J56a.EDF	J56	1
112	11404117	11409006	57	4946	4889	RIGHT	J56a.EDF	J56	1
113	11411100	11417491	57	6448	6391	RIGHT	J56a.EDF	J56	1
114	11419579	11426727	58	7206	7148	RIGHT	J56a.EDF	J56	1
115	11428717	11433541	58	4882	4824	RIGHT	J56a.EDF	J56	1
116	11436411	11441586	58	5233	5175	RIGHT	J56a.EDF	J56	1
117	11443966	11450261	58	6353	6295	RIGHT	J56a.EDF	J56	1
118	11453778	11460468	57	6747	6690	RIGHT	J56a.EDF	J56	1
119	11463355	11469994	57	6696	6639	RIGHT	J56a.EDF	J56	1
120	11472303	11478379	56	6132	6076	RIGHT	J56a.EDF	J56	1
1	11687053	11687123	869	939	70	RIGHT	J56b.EDF	J56	2
1	11687957	11688020	1773	1836	63	RIGHT	J56b.EDF	J56	2
2	11696267	11696322	780	835	55	RIGHT	J56b.EDF	J56	2
2	11696627	11696691	1140	1204	64	RIGHT	J56b.EDF	J56	2
2	11697062	11697134	1575	1647	72	RIGHT	J56b.EDF	J56	2
3	11705082	11705139	224	281	57	RIGHT	J56b.EDF	J56	2
3	11705550	11705609	692	751	59	RIGHT	J56b.EDF	J56	2
3	11705859	11705938	1001	1080	79	RIGHT	J56b.EDF	J56	2
3	11706263	11706337	1405	1479	74	RIGHT	J56b.EDF	J56	2
4	11714186	11714256	932	1002	70	RIGHT	J56b.EDF	J56	2
4	11714586	11714630	1332	1376	44	RIGHT	J56b.EDF	J56	2
4	11717558	11717587	4304	4333	29	RIGHT	J56b.EDF	J56	2
5	11721528	11721587	778	837	59	RIGHT	J56b.EDF	J56	2
5	11721833	11721914	1083	1164	81	RIGHT	J56b.EDF	J56	2
6	11730873	11730946	866	939	73	RIGHT	J56b.EDF	J56	2
6	11731217	11731311	1210	1304	94	RIGHT	J56b.EDF	J56	2
6	11731586	11731661	1579	1654	75	RIGHT	J56b.EDF	J56	2
6	11734917	11734976	4910	4969	59	RIGHT	J56b.EDF	J56	2
6	11735571	11735655	5564	5648	84	RIGHT	J56b.EDF	J56	2
6	11736494	11736563	6487	6556	69	RIGHT	J56b.EDF	J56	2
7	11739391	11739410	790	809	19	RIGHT	J56b.EDF	J56	2
7	11739562	11739633	961	1032	71	RIGHT	J56b.EDF	J56	2
7	11739885	11739966	1284	1365	81	RIGHT	J56b.EDF	J56	2
8	11747607	11747673	564	630	66	RIGHT	J56b.EDF	J56	2
8	11747942	11748011	899	968	69	RIGHT	J56b.EDF	J56	2
8	11748681	11748766	1638	1723	85	RIGHT	J56b.EDF	J56	2
9	11754901	11754987	780	866	86	RIGHT	J56b.EDF	J56	2
9	11755332	11755424	1211	1303	92	RIGHT	J56b.EDF	J56	2
9	11758593	11758651	4472	4530	58	RIGHT	J56b.EDF	J56	2
10	11761456	11761526	760	830	70	RIGHT	J56b.EDF	J56	2
10	11761789	11761876	1093	1180	87	RIGHT	J56b.EDF	J56	2
10	11762216	11762298	1520	1602	82	RIGHT	J56b.EDF	J56	2
11	11769693	11769773	777	857	80	RIGHT	J56b.EDF	J56	2
11	11770015	11770097	1099	1181	82	RIGHT	J56b.EDF	J56	2
12	11776752	11776778	439	465	26	RIGHT	J56b.EDF	J56	2
12	11776954	11777028	641	715	74	RIGHT	J56b.EDF	J56	2
12	11777215	11777309	902	996	94	RIGHT	J56b.EDF	J56	2
12	11777717	11777809	1404	1496	92	RIGHT	J56b.EDF	J56	2
13	11784368	11784451	739	822	83	RIGHT	J56b.EDF	J56	2
13	11784842	11784914	1213	1285	72	RIGHT	J56b.EDF	J56	2
14	11792075	11792158	772	855	83	RIGHT	J56b.EDF	J56	2
14	11792433	11792517	1130	1214	84	RIGHT	J56b.EDF	J56	2
15	11800813	11800856	796	839	43	RIGHT	J56b.EDF	J56	2
15	11803740	11803799	3723	3782	59	RIGHT	J56b.EDF	J56	2
16	11808897	11808968	871	942	71	RIGHT	J56b.EDF	J56	2
16	11809195	11809269	1169	1243	74	RIGHT	J56b.EDF	J56	2
16	11809557	11809642	1531	1616	85	RIGHT	J56b.EDF	J56	2
17	11815963	11816026	705	768	63	RIGHT	J56b.EDF	J56	2
17	11816589	11816669	1331	1411	80	RIGHT	J56b.EDF	J56	2
18	11825809	11825882	946	1019	73	RIGHT	J56b.EDF	J56	2
18	11826244	11826323	1381	1460	79	RIGHT	J56b.EDF	J56	2
19	11833759	11833827	1262	1330	68	RIGHT	J56b.EDF	J56	2
20	11840219	11840289	417	487	70	RIGHT	J56b.EDF	J56	2
20	11840770	11840846	968	1044	76	RIGHT	J56b.EDF	J56	2
20	11841127	11841211	1325	1409	84	RIGHT	J56b.EDF	J56	2
22	11858252	11858300	860	908	48	RIGHT	J56b.EDF	J56	2
22	11858665	11858746	1273	1354	81	RIGHT	J56b.EDF	J56	2
22	11862432	11862482	5040	5090	50	RIGHT	J56b.EDF	J56	2
23	11867171	11867219	556	604	48	RIGHT	J56b.EDF	J56	2
23	11867551	11867627	936	1012	76	RIGHT	J56b.EDF	J56	2
23	11867922	11868006	1307	1391	84	RIGHT	J56b.EDF	J56	2
24	11875646	11875705	453	512	59	RIGHT	J56b.EDF	J56	2
24	11876048	11876135	855	942	87	RIGHT	J56b.EDF	J56	2
24	11876637	11876711	1444	1518	74	RIGHT	J56b.EDF	J56	2
25	11883783	11883824	496	537	41	RIGHT	J56b.EDF	J56	2
25	11884247	11884341	960	1054	94	RIGHT	J56b.EDF	J56	2
25	11884707	11884797	1420	1510	90	RIGHT	J56b.EDF	J56	2
26	11890690	11890765	186	261	75	RIGHT	J56b.EDF	J56	2
26	11891181	11891268	677	764	87	RIGHT	J56b.EDF	J56	2
26	11891603	11891686	1099	1182	83	RIGHT	J56b.EDF	J56	2
27	11898757	11898828	420	491	71	RIGHT	J56b.EDF	J56	2
27	11899205	11899284	868	947	79	RIGHT	J56b.EDF	J56	2
28	11907009	11907067	430	488	58	RIGHT	J56b.EDF	J56	2
28	11907557	11907612	978	1033	55	RIGHT	J56b.EDF	J56	2
29	11915662	11915722	664	724	60	RIGHT	J56b.EDF	J56	2
29	11915912	11916000	914	1002	88	RIGHT	J56b.EDF	J56	2
29	11916379	11916458	1381	1460	79	RIGHT	J56b.EDF	J56	2
30	11924216	11924288	482	554	72	RIGHT	J56b.EDF	J56	2
30	11924846	11924940	1112	1206	94	RIGHT	J56b.EDF	J56	2
30	11925546	11925627	1812	1893	81	RIGHT	J56b.EDF	J56	2
31	11934317	11934382	411	476	65	RIGHT	J56b.EDF	J56	2
31	11935279	11935337	1373	1431	58	RIGHT	J56b.EDF	J56	2
32	11942846	11942922	676	752	76	RIGHT	J56b.EDF	J56	2
32	11943241	11943311	1071	1141	70	RIGHT	J56b.EDF	J56	2
32	11943673	11943750	1503	1580	77	RIGHT	J56b.EDF	J56	2
33	11950925	11950989	266	330	64	RIGHT	J56b.EDF	J56	2
33	11951465	11951537	806	878	72	RIGHT	J56b.EDF	J56	2
33	11952097	11952169	1438	1510	72	RIGHT	J56b.EDF	J56	2
34	11959072	11959126	819	873	54	RIGHT	J56b.EDF	J56	2
34	11959718	11959791	1465	1538	73	RIGHT	J56b.EDF	J56	2
35	11965852	11965908	733	789	56	RIGHT	J56b.EDF	J56	2
35	11966379	11966448	1260	1329	69	RIGHT	J56b.EDF	J56	2
36	11973121	11973168	581	628	47	RIGHT	J56b.EDF	J56	2
36	11973425	11973502	885	962	77	RIGHT	J56b.EDF	J56	2
36	11973750	11973832	1210	1292	82	RIGHT	J56b.EDF	J56	2
36	11974159	11974228	1619	1688	69	RIGHT	J56b.EDF	J56	2
37	11982158	11982208	470	520	50	RIGHT	J56b.EDF	J56	2
37	11982542	11982609	854	921	67	RIGHT	J56b.EDF	J56	2
37	11982916	11982998	1228	1310	82	RIGHT	J56b.EDF	J56	2
37	11983266	11983354	1578	1666	88	RIGHT	J56b.EDF	J56	2
37	11985706	11985784	4018	4096	78	RIGHT	J56b.EDF	J56	2
37	11986445	11986488	4757	4800	43	RIGHT	J56b.EDF	J56	2
37	11987911	11987988	6223	6300	77	RIGHT	J56b.EDF	J56	2
37	11988700	11988743	7012	7055	43	RIGHT	J56b.EDF	J56	2
38	11992211	11992267	1036	1092	56	RIGHT	J56b.EDF	J56	2
39	12000299	12000365	429	495	66	RIGHT	J56b.EDF	J56	2
39	12000872	12000951	1002	1081	79	RIGHT	J56b.EDF	J56	2
39	12001282	12001363	1412	1493	81	RIGHT	J56b.EDF	J56	2
40	12008284	12008350	221	287	66	RIGHT	J56b.EDF	J56	2
40	12008691	12008779	628	716	88	RIGHT	J56b.EDF	J56	2
40	12008998	12009083	935	1020	85	RIGHT	J56b.EDF	J56	2
41	12015370	12015439	500	569	69	RIGHT	J56b.EDF	J56	2
41	12015797	12015871	927	1001	74	RIGHT	J56b.EDF	J56	2
41	12016356	12016404	1486	1534	48	RIGHT	J56b.EDF	J56	2
42	12023956	12024031	901	976	75	RIGHT	J56b.EDF	J56	2
42	12024473	12024550	1418	1495	77	RIGHT	J56b.EDF	J56	2
43	12033197	12033258	301	362	61	RIGHT	J56b.EDF	J56	2
43	12033822	12033885	926	989	63	RIGHT	J56b.EDF	J56	2
43	12039039	12039076	6143	6180	37	RIGHT	J56b.EDF	J56	2
44	12042302	12042512	186	396	210	RIGHT	J56b.EDF	J56	2
44	12043242	12043337	1126	1221	95	RIGHT	J56b.EDF	J56	2
45	12051819	12051885	227	293	66	RIGHT	J56b.EDF	J56	2
45	12052505	12052563	913	971	58	RIGHT	J56b.EDF	J56	2
45	12052887	12052953	1295	1361	66	RIGHT	J56b.EDF	J56	2
46	12060620	12060671	213	264	51	RIGHT	J56b.EDF	J56	2
46	12061152	12061228	745	821	76	RIGHT	J56b.EDF	J56	2
46	12061686	12061749	1279	1342	63	RIGHT	J56b.EDF	J56	2
46	12061913	12062123	1506	1716	210	RIGHT	J56b.EDF	J56	2
47	12067761	12070270	58	2567	2509	RIGHT	J56b.EDF	J56	2
47	12074069	12074118	6366	6415	49	RIGHT	J56b.EDF	J56	2
48	12077103	12078784	408	2089	1681	RIGHT	J56b.EDF	J56	2
49	12083839	12083896	637	694	57	RIGHT	J56b.EDF	J56	2
49	12084309	12084406	1107	1204	97	RIGHT	J56b.EDF	J56	2
50	12090427	12090491	251	315	64	RIGHT	J56b.EDF	J56	2
50	12091006	12091114	830	938	108	RIGHT	J56b.EDF	J56	2
50	12091382	12091479	1206	1303	97	RIGHT	J56b.EDF	J56	2
51	12099841	12099900	730	789	59	RIGHT	J56b.EDF	J56	2
51	12100324	12100432	1213	1321	108	RIGHT	J56b.EDF	J56	2
51	12100699	12100717	1588	1606	18	RIGHT	J56b.EDF	J56	2
52	12107760	12107851	753	844	91	RIGHT	J56b.EDF	J56	2
52	12108677	12108758	1670	1751	81	RIGHT	J56b.EDF	J56	2
53	12114495	12114561	265	331	66	RIGHT	J56b.EDF	J56	2
53	12115174	12115246	944	1016	72	RIGHT	J56b.EDF	J56	2
54	12123593	12123641	1338	1386	48	RIGHT	J56b.EDF	J56	2
54	12124125	12124186	1870	1931	61	RIGHT	J56b.EDF	J56	2
54	12127160	12127200	4905	4945	40	RIGHT	J56b.EDF	J56	2
54	12127522	12127614	5267	5359	92	RIGHT	J56b.EDF	J56	2
54	12128364	12128385	6109	6130	21	RIGHT	J56b.EDF	J56	2
54	12128570	12128647	6315	6392	77	RIGHT	J56b.EDF	J56	2
54	12128854	12128957	6599	6702	103	RIGHT	J56b.EDF	J56	2
54	12129204	12129329	6949	7074	125	RIGHT	J56b.EDF	J56	2
55	12132000	12132060	1030	1090	60	RIGHT	J56b.EDF	J56	2
56	12138945	12139010	1008	1073	65	RIGHT	J56b.EDF	J56	2
57	12144990	12145046	403	459	56	RIGHT	J56b.EDF	J56	2
58	12155072	12155113	516	557	41	RIGHT	J56b.EDF	J56	2
58	12155376	12155439	820	883	63	RIGHT	J56b.EDF	J56	2
59	12164682	12164718	472	508	36	RIGHT	J56b.EDF	J56	2
59	12165083	12165165	873	955	82	RIGHT	J56b.EDF	J56	2
60	12172385	12172406	198	219	21	RIGHT	J56b.EDF	J56	2
60	12173152	12173208	965	1021	56	RIGHT	J56b.EDF	J56	2
61	12181304	12181338	803	837	34	RIGHT	J56b.EDF	J56	2
61	12181619	12181677	1118	1176	58	RIGHT	J56b.EDF	J56	2
61	12186702	12186745	6201	6244	43	RIGHT	J56b.EDF	J56	2
61	12187103	12187165	6602	6664	62	RIGHT	J56b.EDF	J56	2
62	12190226	12190283	412	469	57	RIGHT	J56b.EDF	J56	2
62	12190714	12190790	900	976	76	RIGHT	J56b.EDF	J56	2
62	12191073	12191137	1259	1323	64	RIGHT	J56b.EDF	J56	2
63	12199492	12199556	570	634	64	RIGHT	J56b.EDF	J56	2
63	12199776	12199860	854	938	84	RIGHT	J56b.EDF	J56	2
63	12200018	12200164	1096	1242	146	RIGHT	J56b.EDF	J56	2
63	12200241	12200372	1319	1450	131	RIGHT	J56b.EDF	J56	2
63	12200484	12200590	1562	1668	106	RIGHT	J56b.EDF	J56	2
63	12203804	12203828	4882	4906	24	RIGHT	J56b.EDF	J56	2
63	12204233	12204311	5311	5389	78	RIGHT	J56b.EDF	J56	2
64	12207755	12207810	240	295	55	RIGHT	J56b.EDF	J56	2
64	12208585	12208653	1070	1138	68	RIGHT	J56b.EDF	J56	2
64	12209045	12209121	1530	1606	76	RIGHT	J56b.EDF	J56	2
65	12218282	12218301	507	526	19	RIGHT	J56b.EDF	J56	2
65	12218531	12218604	756	829	73	RIGHT	J56b.EDF	J56	2
66	12226800	12226855	510	565	55	RIGHT	J56b.EDF	J56	2
66	12227292	12227388	1002	1098	96	RIGHT	J56b.EDF	J56	2
66	12227702	12227771	1412	1481	69	RIGHT	J56b.EDF	J56	2
67	12234671	12234745	399	473	74	RIGHT	J56b.EDF	J56	2
67	12235343	12235408	1071	1136	65	RIGHT	J56b.EDF	J56	2
67	12235715	12235803	1443	1531	88	RIGHT	J56b.EDF	J56	2
68	12243860	12243930	399	469	70	RIGHT	J56b.EDF	J56	2
68	12244322	12244408	861	947	86	RIGHT	J56b.EDF	J56	2
68	12244947	12245015	1486	1554	68	RIGHT	J56b.EDF	J56	2
68	12248107	12248151	4646	4690	44	RIGHT	J56b.EDF	J56	2
69	12250709	12250761	244	296	52	RIGHT	J56b.EDF	J56	2
69	12251648	12251704	1183	1239	56	RIGHT	J56b.EDF	J56	2
69	12253974	12253993	3509	3528	19	RIGHT	J56b.EDF	J56	2
69	12254990	12255046	4525	4581	56	RIGHT	J56b.EDF	J56	2
70	12258578	12258649	381	452	71	RIGHT	J56b.EDF	J56	2
70	12258968	12259049	771	852	81	RIGHT	J56b.EDF	J56	2
70	12259381	12259428	1184	1231	47	RIGHT	J56b.EDF	J56	2
70	12259638	12259679	1441	1482	41	RIGHT	J56b.EDF	J56	2
71	12267455	12267481	470	496	26	RIGHT	J56b.EDF	J56	2
71	12267705	12267760	720	775	55	RIGHT	J56b.EDF	J56	2
71	12268059	12268123	1074	1138	64	RIGHT	J56b.EDF	J56	2
72	12275100	12275148	412	460	48	RIGHT	J56b.EDF	J56	2
72	12275664	12275708	976	1020	44	RIGHT	J56b.EDF	J56	2
73	12283721	12283783	807	869	62	RIGHT	J56b.EDF	J56	2
73	12284145	12284199	1231	1285	54	RIGHT	J56b.EDF	J56	2
74	12291035	12291087	416	468	52	RIGHT	J56b.EDF	J56	2
74	12291452	12291539	833	920	87	RIGHT	J56b.EDF	J56	2
74	12291823	12291904	1204	1285	81	RIGHT	J56b.EDF	J56	2
74	12292204	12292276	1585	1657	72	RIGHT	J56b.EDF	J56	2
75	12299211	12299276	531	596	65	RIGHT	J56b.EDF	J56	2
75	12299631	12299706	951	1026	75	RIGHT	J56b.EDF	J56	2
75	12300193	12300263	1513	1583	70	RIGHT	J56b.EDF	J56	2
75	12302382	12302810	3702	4130	428	RIGHT	J56b.EDF	J56	2
76	12306485	12306490	125	130	5	RIGHT	J56b.EDF	J56	2
76	12306537	12306635	177	275	98	RIGHT	J56b.EDF	J56	2
76	12307014	12307101	654	741	87	RIGHT	J56b.EDF	J56	2
76	12307525	12307620	1165	1260	95	RIGHT	J56b.EDF	J56	2
76	12312268	12312829	5908	6469	561	RIGHT	J56b.EDF	J56	2
77	12317000	12317000	486	486	0	RIGHT	J56b.EDF	J56	2
77	12317193	12317267	679	753	74	RIGHT	J56b.EDF	J56	2
77	12317896	12317927	1382	1413	31	RIGHT	J56b.EDF	J56	2
77	12318165	12318217	1651	1703	52	RIGHT	J56b.EDF	J56	2
78	12323751	12323812	251	312	61	RIGHT	J56b.EDF	J56	2
78	12324157	12324327	657	827	170	RIGHT	J56b.EDF	J56	2
78	12324389	12325473	889	1973	1084	RIGHT	J56b.EDF	J56	2
78	12325970	12330233	2470	6733	4263	RIGHT	J56b.EDF	J56	2
79	12332004	12337838	58	5892	5834	RIGHT	J56b.EDF	J56	2
80	12340544	12345152	58	4666	4608	RIGHT	J56b.EDF	J56	2
81	12347413	12352027	58	4672	4614	RIGHT	J56b.EDF	J56	2
82	12354406	12356001	58	1653	1595	RIGHT	J56b.EDF	J56	2
82	12356397	12361352	2049	7004	4955	RIGHT	J56b.EDF	J56	2
83	12363440	12369937	58	6555	6497	RIGHT	J56b.EDF	J56	2
84	12372449	12373273	59	883	824	RIGHT	J56b.EDF	J56	2
84	12373554	12373622	1164	1232	68	RIGHT	J56b.EDF	J56	2
84	12374930	12375739	2540	3349	809	RIGHT	J56b.EDF	J56	2
84	12375769	12375800	3379	3410	31	RIGHT	J56b.EDF	J56	2
84	12375839	12375849	3449	3459	10	RIGHT	J56b.EDF	J56	2
84	12377356	12378173	4966	5783	817	RIGHT	J56b.EDF	J56	2
85	12382485	12383437	58	1010	952	RIGHT	J56b.EDF	J56	2
85	12383532	12383632	1105	1205	100	RIGHT	J56b.EDF	J56	2
85	12383656	12387788	1229	5361	4132	RIGHT	J56b.EDF	J56	2
86	12389356	12394963	58	5665	5607	RIGHT	J56b.EDF	J56	2
87	12397483	12402107	57	4681	4624	RIGHT	J56b.EDF	J56	2
88	12403974	12410743	57	6826	6769	RIGHT	J56b.EDF	J56	2
89	12412502	12419067	58	6623	6565	RIGHT	J56b.EDF	J56	2
90	12420997	12426232	58	5293	5235	RIGHT	J56b.EDF	J56	2
91	12427879	12432986	59	5166	5107	RIGHT	J56b.EDF	J56	2
92	12434837	12435419	58	640	582	RIGHT	J56b.EDF	J56	2
92	12435865	12435939	1086	1160	74	RIGHT	J56b.EDF	J56	2
92	12436115	12436118	1336	1339	3	RIGHT	J56b.EDF	J56	2
92	12436200	12440731	1421	5952	4531	RIGHT	J56b.EDF	J56	2
93	12443291	12444174	57	940	883	RIGHT	J56b.EDF	J56	2
93	12444205	12444270	971	1036	65	RIGHT	J56b.EDF	J56	2
93	12444475	12444520	1241	1286	45	RIGHT	J56b.EDF	J56	2
93	12447902	12447922	4668	4688	20	RIGHT	J56b.EDF	J56	2
93	12447984	12449677	4750	6443	1693	RIGHT	J56b.EDF	J56	2
94	12451773	12453542	58	1827	1769	RIGHT	J56b.EDF	J56	2
94	12454335	12454544	2620	2829	209	RIGHT	J56b.EDF	J56	2
94	12455095	12455845	3380	4130	750	RIGHT	J56b.EDF	J56	2
94	12455987	12457010	4272	5295	1023	RIGHT	J56b.EDF	J56	2
95	12459360	12459438	319	397	78	RIGHT	J56b.EDF	J56	2
95	12459525	12459598	484	557	73	RIGHT	J56b.EDF	J56	2
95	12459627	12459627	586	586	0	RIGHT	J56b.EDF	J56	2
95	12459788	12459866	747	825	78	RIGHT	J56b.EDF	J56	2
95	12459943	12460615	902	1574	672	RIGHT	J56b.EDF	J56	2
95	12460869	12462589	1828	3548	1720	RIGHT	J56b.EDF	J56	2
95	12462803	12465537	3762	6496	2734	RIGHT	J56b.EDF	J56	2
96	12467505	12468085	187	767	580	RIGHT	J56b.EDF	J56	2
96	12468406	12468474	1088	1156	68	RIGHT	J56b.EDF	J56	2
96	12469791	12469886	2473	2568	95	RIGHT	J56b.EDF	J56	2
96	12470531	12470532	3213	3214	1	RIGHT	J56b.EDF	J56	2
96	12470637	12470730	3319	3412	93	RIGHT	J56b.EDF	J56	2
96	12471612	12471842	4294	4524	230	RIGHT	J56b.EDF	J56	2
96	12472140	12473431	4822	6113	1291	RIGHT	J56b.EDF	J56	2
97	12475510	12480836	57	5383	5326	RIGHT	J56b.EDF	J56	2
98	12483453	12488360	58	4965	4907	RIGHT	J56b.EDF	J56	2
99	12491421	12497796	58	6433	6375	RIGHT	J56b.EDF	J56	2
100	12499964	12507102	58	7196	7138	RIGHT	J56b.EDF	J56	2
101	12508931	12514807	57	5933	5876	RIGHT	J56b.EDF	J56	2
102	12517238	12524453	58	7273	7215	RIGHT	J56b.EDF	J56	2
103	12526979	12527998	57	1076	1019	RIGHT	J56b.EDF	J56	2
103	12528282	12528353	1360	1431	71	RIGHT	J56b.EDF	J56	2
103	12529406	12533457	2484	6535	4051	RIGHT	J56b.EDF	J56	2
104	12535318	12542284	57	7023	6966	RIGHT	J56b.EDF	J56	2
105	12543972	12549148	57	5233	5176	RIGHT	J56b.EDF	J56	2
106	12551116	12552523	166	1573	1407	RIGHT	J56b.EDF	J56	2
106	12552647	12557543	1697	6593	4896	RIGHT	J56b.EDF	J56	2
107	12560110	12566348	57	6295	6238	RIGHT	J56b.EDF	J56	2
108	12568747	12569814	57	1124	1067	RIGHT	J56b.EDF	J56	2
108	12570226	12574796	1536	6106	4570	RIGHT	J56b.EDF	J56	2
108	12575116	12575214	6426	6524	98	RIGHT	J56b.EDF	J56	2
109	12577215	12577567	217	569	352	RIGHT	J56b.EDF	J56	2
109	12578228	12579567	1230	2569	1339	RIGHT	J56b.EDF	J56	2
109	12579811	12580201	2813	3203	390	RIGHT	J56b.EDF	J56	2
110	12586217	12586274	1206	1263	57	RIGHT	J56b.EDF	J56	2
110	12588880	12588914	3869	3903	34	RIGHT	J56b.EDF	J56	2
110	12588987	12589859	3976	4848	872	RIGHT	J56b.EDF	J56	2
110	12590288	12590384	5277	5373	96	RIGHT	J56b.EDF	J56	2
110	12590611	12590783	5600	5772	172	RIGHT	J56b.EDF	J56	2
111	12592863	12593074	188	399	211	RIGHT	J56b.EDF	J56	2
111	12593442	12593524	767	849	82	RIGHT	J56b.EDF	J56	2
111	12593745	12598378	1070	5703	4633	RIGHT	J56b.EDF	J56	2
112	12600276	12602158	58	1940	1882	RIGHT	J56b.EDF	J56	2
112	12604019	12604082	3801	3864	63	RIGHT	J56b.EDF	J56	2
113	12608733	12608821	1118	1206	88	RIGHT	J56b.EDF	J56	2
113	12609293	12609355	1678	1740	62	RIGHT	J56b.EDF	J56	2
113	12611317	12611523	3702	3908	206	RIGHT	J56b.EDF	J56	2
113	12613829	12613869	6214	6254	40	RIGHT	J56b.EDF	J56	2
114	12617520	12617605	79	164	85	RIGHT	J56b.EDF	J56	2
114	12618370	12618462	929	1021	92	RIGHT	J56b.EDF	J56	2
114	12618798	12618883	1357	1442	85	RIGHT	J56b.EDF	J56	2
114	12620140	12620202	2699	2761	62	RIGHT	J56b.EDF	J56	2
114	12620223	12620225	2782	2784	2	RIGHT	J56b.EDF	J56	2
114	12620249	12620324	2808	2883	75	RIGHT	J56b.EDF	J56	2
114	12620583	12620585	3142	3144	2	RIGHT	J56b.EDF	J56	2
114	12620635	12622362	3194	4921	1727	RIGHT	J56b.EDF	J56	2
115	12624227	12624579	162	514	352	RIGHT	J56b.EDF	J56	2
115	12624801	12624855	736	790	54	RIGHT	J56b.EDF	J56	2
115	12625498	12625564	1433	1499	66	RIGHT	J56b.EDF	J56	2
115	12627308	12627315	3243	3250	7	RIGHT	J56b.EDF	J56	2
115	12627341	12628021	3276	3956	680	RIGHT	J56b.EDF	J56	2
115	12628271	12628454	4206	4389	183	RIGHT	J56b.EDF	J56	2
115	12629053	12629081	4988	5016	28	RIGHT	J56b.EDF	J56	2
115	12629317	12630948	5252	6883	1631	RIGHT	J56b.EDF	J56	2
116	12634160	12634229	58	127	69	RIGHT	J56b.EDF	J56	2
116	12634583	12634653	481	551	70	RIGHT	J56b.EDF	J56	2
116	12635108	12635192	1006	1090	84	RIGHT	J56b.EDF	J56	2
116	12635555	12635647	1453	1545	92	RIGHT	J56b.EDF	J56	2
116	12638369	12639519	4267	5417	1150	RIGHT	J56b.EDF	J56	2
117	12641944	12642009	438	503	65	RIGHT	J56b.EDF	J56	2
117	12642675	12642747	1169	1241	72	RIGHT	J56b.EDF	J56	2
117	12644313	12646398	2807	4892	2085	RIGHT	J56b.EDF	J56	2
118	12648304	12654982	58	6736	6678	RIGHT	J56b.EDF	J56	2
119	12659511	12659998	57	544	487	RIGHT	J56b.EDF	J56	2
119	12660383	12660459	929	1005	76	RIGHT	J56b.EDF	J56	2
119	12660783	12660849	1329	1395	66	RIGHT	J56b.EDF	J56	2
120	12667566	12667627	294	355	61	RIGHT	J56b.EDF	J56	2
120	12668007	12668089	735	817	82	RIGHT	J56b.EDF	J56	2
120	12668863	12668941	1591	1669	78	RIGHT	J56b.EDF	J56	2
120	12670693	12671849	3421	4577	1156	RIGHT	J56b.EDF	J56	2
120	12672297	12672489	5025	5217	192	RIGHT	J56b.EDF	J56	2
120	12672666	12673132	5394	5860	466	RIGHT	J56b.EDF	J56	2
1	13888051	13888138	281	368	87	RIGHT	J57.EDF	J57	.
2	13935473	13935498	6625	6650	25	RIGHT	J57.EDF	J57	.
5	13998876	13998965	658	747	89	RIGHT	J57.EDF	J57	.
5	13999514	13999584	1296	1366	70	RIGHT	J57.EDF	J57	.
6	14023080	14023147	924	991	67	RIGHT	J57.EDF	J57	.
7	14044307	14044376	823	892	69	RIGHT	J57.EDF	J57	.
8	14058829	14058882	675	728	53	RIGHT	J57.EDF	J57	.
8	14059414	14059508	1260	1354	94	RIGHT	J57.EDF	J57	.
9	14072155	14072187	673	705	32	RIGHT	J57.EDF	J57	.
9	14072722	14072820	1240	1338	98	RIGHT	J57.EDF	J57	.
9	14072847	14072849	1365	1367	2	RIGHT	J57.EDF	J57	.
1	14150137	14150198	1300	1361	61	RIGHT	J57a.EDF	J57	1
2	14160525	14160573	270	318	48	RIGHT	J57a.EDF	J57	1
2	14161128	14161201	873	946	73	RIGHT	J57a.EDF	J57	1
2	14161687	14161751	1432	1496	64	RIGHT	J57a.EDF	J57	1
3	14170076	14170140	61	125	64	RIGHT	J57a.EDF	J57	1
3	14170716	14170791	701	776	75	RIGHT	J57a.EDF	J57	1
4	14180582	14180668	749	835	86	RIGHT	J57a.EDF	J57	1
4	14180984	14181071	1151	1238	87	RIGHT	J57a.EDF	J57	1
5	14187632	14187703	68	139	71	RIGHT	J57a.EDF	J57	1
5	14188600	14188664	1036	1100	64	RIGHT	J57a.EDF	J57	1
6	14197090	14197174	261	345	84	RIGHT	J57a.EDF	J57	1
6	14197473	14197592	644	763	119	RIGHT	J57a.EDF	J57	1
6	14198036	14198048	1207	1219	12	RIGHT	J57a.EDF	J57	1
7	14205612	14205666	58	112	54	RIGHT	J57a.EDF	J57	1
7	14205920	14205983	366	429	63	RIGHT	J57a.EDF	J57	1
7	14206767	14206824	1213	1270	57	RIGHT	J57a.EDF	J57	1
8	14216831	14216945	119	233	114	RIGHT	J57a.EDF	J57	1
8	14217412	14217484	700	772	72	RIGHT	J57a.EDF	J57	1
8	14217936	14217950	1224	1238	14	RIGHT	J57a.EDF	J57	1
9	14225671	14225785	146	260	114	RIGHT	J57a.EDF	J57	1
9	14226417	14226516	892	991	99	RIGHT	J57a.EDF	J57	1
9	14226556	14226558	1031	1033	2	RIGHT	J57a.EDF	J57	1
10	14234417	14234507	98	188	90	RIGHT	J57a.EDF	J57	1
10	14235410	14235468	1091	1149	58	RIGHT	J57a.EDF	J57	1
11	14242625	14242695	695	765	70	RIGHT	J57a.EDF	J57	1
11	14243248	14243338	1318	1408	90	RIGHT	J57a.EDF	J57	1
12	14251549	14251609	59	119	60	RIGHT	J57a.EDF	J57	1
12	14252109	14252224	619	734	115	RIGHT	J57a.EDF	J57	1
12	14252537	14252633	1047	1143	96	RIGHT	J57a.EDF	J57	1
12	14252667	14252670	1177	1180	3	RIGHT	J57a.EDF	J57	1
13	14260709	14260803	635	729	94	RIGHT	J57a.EDF	J57	1
13	14261058	14261188	984	1114	130	RIGHT	J57a.EDF	J57	1
13	14265572	14265611	5498	5537	39	RIGHT	J57a.EDF	J57	1
13	14266067	14266133	5993	6059	66	RIGHT	J57a.EDF	J57	1
13	14266171	14266173	6097	6099	2	RIGHT	J57a.EDF	J57	1
14	14271422	14271527	75	180	105	RIGHT	J57a.EDF	J57	1
14	14271764	14271863	417	516	99	RIGHT	J57a.EDF	J57	1
15	14281691	14281779	792	880	88	RIGHT	J57a.EDF	J57	1
15	14281815	14281824	916	925	9	RIGHT	J57a.EDF	J57	1
15	14282124	14282231	1225	1332	107	RIGHT	J57a.EDF	J57	1
15	14282267	14282274	1368	1375	7	RIGHT	J57a.EDF	J57	1
15	14282591	14282673	1692	1774	82	RIGHT	J57a.EDF	J57	1
15	14282712	14282714	1813	1815	2	RIGHT	J57a.EDF	J57	1
16	14288625	14288760	156	291	135	RIGHT	J57a.EDF	J57	1
16	14288929	14289040	460	571	111	RIGHT	J57a.EDF	J57	1
16	14289171	14289287	702	818	116	RIGHT	J57a.EDF	J57	1
16	14289567	14289673	1098	1204	106	RIGHT	J57a.EDF	J57	1
16	14290123	14290144	1654	1675	21	RIGHT	J57a.EDF	J57	1
17	14295991	14296063	58	130	72	RIGHT	J57a.EDF	J57	1
17	14296299	14296405	366	472	106	RIGHT	J57a.EDF	J57	1
17	14296781	14296885	848	952	104	RIGHT	J57a.EDF	J57	1
17	14297073	14297201	1140	1268	128	RIGHT	J57a.EDF	J57	1
17	14299891	14299922	3958	3989	31	RIGHT	J57a.EDF	J57	1
18	14303694	14303838	104	248	144	RIGHT	J57a.EDF	J57	1
18	14304028	14304137	438	547	109	RIGHT	J57a.EDF	J57	1
18	14304540	14304626	950	1036	86	RIGHT	J57a.EDF	J57	1
18	14305008	14305103	1418	1513	95	RIGHT	J57a.EDF	J57	1
19	14311028	14311094	100	166	66	RIGHT	J57a.EDF	J57	1
19	14311472	14311555	544	627	83	RIGHT	J57a.EDF	J57	1
19	14311807	14311941	879	1013	134	RIGHT	J57a.EDF	J57	1
19	14312210	14312347	1282	1419	137	RIGHT	J57a.EDF	J57	1
20	14319879	14320033	58	212	154	RIGHT	J57a.EDF	J57	1
20	14321035	14321140	1214	1319	105	RIGHT	J57a.EDF	J57	1
21	14328024	14328153	67	196	129	RIGHT	J57a.EDF	J57	1
21	14329471	14329561	1514	1604	90	RIGHT	J57a.EDF	J57	1
21	14332556	14332596	4599	4639	40	RIGHT	J57a.EDF	J57	1
22	14336122	14336233	274	385	111	RIGHT	J57a.EDF	J57	1
22	14336844	14336939	996	1091	95	RIGHT	J57a.EDF	J57	1
22	14337238	14337352	1390	1504	114	RIGHT	J57a.EDF	J57	1
23	14343930	14343950	58	78	20	RIGHT	J57a.EDF	J57	1
23	14344162	14344269	290	397	107	RIGHT	J57a.EDF	J57	1
24	14353243	14353362	64	183	119	RIGHT	J57a.EDF	J57	1
24	14353772	14353843	593	664	71	RIGHT	J57a.EDF	J57	1
24	14354189	14354292	1010	1113	103	RIGHT	J57a.EDF	J57	1
25	14362263	14362392	150	279	129	RIGHT	J57a.EDF	J57	1
25	14362587	14362700	474	587	113	RIGHT	J57a.EDF	J57	1
25	14363029	14363138	916	1025	109	RIGHT	J57a.EDF	J57	1
26	14370595	14370632	58	95	37	RIGHT	J57a.EDF	J57	1
26	14371839	14371922	1302	1385	83	RIGHT	J57a.EDF	J57	1
27	14378961	14379043	213	295	82	RIGHT	J57a.EDF	J57	1
27	14379244	14379326	496	578	82	RIGHT	J57a.EDF	J57	1
27	14379729	14379811	981	1063	82	RIGHT	J57a.EDF	J57	1
28	14386744	14386798	58	112	54	RIGHT	J57a.EDF	J57	1
28	14387875	14387945	1189	1259	70	RIGHT	J57a.EDF	J57	1
29	14394089	14394204	130	245	115	RIGHT	J57a.EDF	J57	1
29	14394468	14394574	509	615	106	RIGHT	J57a.EDF	J57	1
29	14395061	14395153	1102	1194	92	RIGHT	J57a.EDF	J57	1
30	14403377	14403489	266	378	112	RIGHT	J57a.EDF	J57	1
30	14404212	14404273	1101	1162	61	RIGHT	J57a.EDF	J57	1
30	14404799	14404846	1688	1735	47	RIGHT	J57a.EDF	J57	1
31	14412030	14412149	58	177	119	RIGHT	J57a.EDF	J57	1
31	14412725	14412841	753	869	116	RIGHT	J57a.EDF	J57	1
32	14418908	14419060	302	454	152	RIGHT	J57a.EDF	J57	1
32	14419191	14419257	585	651	66	RIGHT	J57a.EDF	J57	1
32	14419718	14419832	1112	1226	114	RIGHT	J57a.EDF	J57	1
33	14427180	14427351	77	248	171	RIGHT	J57a.EDF	J57	1
33	14427592	14427725	489	622	133	RIGHT	J57a.EDF	J57	1
33	14427872	14428010	769	907	138	RIGHT	J57a.EDF	J57	1
33	14428532	14428615	1429	1512	83	RIGHT	J57a.EDF	J57	1
34	14434652	14434690	58	96	38	RIGHT	J57a.EDF	J57	1
34	14435200	14435320	606	726	120	RIGHT	J57a.EDF	J57	1
34	14435670	14435792	1076	1198	122	RIGHT	J57a.EDF	J57	1
34	14439813	14439836	5219	5242	23	RIGHT	J57a.EDF	J57	1
35	14443608	14443700	58	150	92	RIGHT	J57a.EDF	J57	1
35	14443860	14443992	310	442	132	RIGHT	J57a.EDF	J57	1
35	14444412	14444488	862	938	76	RIGHT	J57a.EDF	J57	1
35	14448898	14448913	5348	5363	15	RIGHT	J57a.EDF	J57	1
36	14452350	14452460	646	756	110	RIGHT	J57a.EDF	J57	1
36	14452792	14452909	1088	1205	117	RIGHT	J57a.EDF	J57	1
36	14456832	14456865	5128	5161	33	RIGHT	J57a.EDF	J57	1
37	14458912	14459033	177	298	121	RIGHT	J57a.EDF	J57	1
37	14459503	14459589	768	854	86	RIGHT	J57a.EDF	J57	1
37	14460011	14460087	1276	1352	76	RIGHT	J57a.EDF	J57	1
38	14465275	14465362	58	145	87	RIGHT	J57a.EDF	J57	1
38	14465590	14465679	373	462	89	RIGHT	J57a.EDF	J57	1
38	14466465	14466543	1248	1326	78	RIGHT	J57a.EDF	J57	1
39	14472624	14472732	228	336	108	RIGHT	J57a.EDF	J57	1
39	14472978	14473096	582	700	118	RIGHT	J57a.EDF	J57	1
40	14481520	14481633	64	177	113	RIGHT	J57a.EDF	J57	1
40	14482155	14482274	699	818	119	RIGHT	J57a.EDF	J57	1
41	14489648	14489776	121	249	128	RIGHT	J57a.EDF	J57	1
41	14489964	14490096	437	569	132	RIGHT	J57a.EDF	J57	1
41	14490220	14490353	693	826	133	RIGHT	J57a.EDF	J57	1
41	14490615	14490730	1088	1203	115	RIGHT	J57a.EDF	J57	1
41	14494112	14494125	4585	4598	13	RIGHT	J57a.EDF	J57	1
41	14495385	14495453	5858	5926	68	RIGHT	J57a.EDF	J57	1
42	14497646	14497753	229	336	107	RIGHT	J57a.EDF	J57	1
42	14498286	14498388	869	971	102	RIGHT	J57a.EDF	J57	1
42	14502566	14502591	5149	5174	25	RIGHT	J57a.EDF	J57	1
43	14506022	14506112	965	1055	90	RIGHT	J57a.EDF	J57	1
43	14506150	14506150	1093	1093	0	RIGHT	J57a.EDF	J57	1
44	14512876	14512992	133	249	116	RIGHT	J57a.EDF	J57	1
44	14513278	14513353	535	610	75	RIGHT	J57a.EDF	J57	1
44	14513620	14513726	877	983	106	RIGHT	J57a.EDF	J57	1
45	14522382	14522544	107	269	162	RIGHT	J57a.EDF	J57	1
45	14523084	14523244	809	969	160	RIGHT	J57a.EDF	J57	1
46	14531171	14531268	58	155	97	RIGHT	J57a.EDF	J57	1
46	14531489	14531613	376	500	124	RIGHT	J57a.EDF	J57	1
46	14532036	14532195	923	1082	159	RIGHT	J57a.EDF	J57	1
47	14538014	14538185	63	234	171	RIGHT	J57a.EDF	J57	1
47	14538655	14538804	704	853	149	RIGHT	J57a.EDF	J57	1
47	14539377	14539523	1426	1572	146	RIGHT	J57a.EDF	J57	1
48	14547071	14547278	99	306	207	RIGHT	J57a.EDF	J57	1
48	14547385	14547538	413	566	153	RIGHT	J57a.EDF	J57	1
48	14547850	14548044	878	1072	194	RIGHT	J57a.EDF	J57	1
48	14548238	14548387	1266	1415	149	RIGHT	J57a.EDF	J57	1
48	14550846	14550951	3874	3979	105	RIGHT	J57a.EDF	J57	1
48	14551847	14551956	4875	4984	109	RIGHT	J57a.EDF	J57	1
48	14551982	14551982	5010	5010	0	RIGHT	J57a.EDF	J57	1
48	14552199	14552343	5227	5371	144	RIGHT	J57a.EDF	J57	1
49	14555254	14555380	143	269	126	RIGHT	J57a.EDF	J57	1
49	14555781	14555868	670	757	87	RIGHT	J57a.EDF	J57	1
49	14556155	14556270	1044	1159	115	RIGHT	J57a.EDF	J57	1
49	14556300	14556302	1189	1191	2	RIGHT	J57a.EDF	J57	1
49	14556669	14556789	1558	1678	120	RIGHT	J57a.EDF	J57	1
50	14564549	14564697	84	232	148	RIGHT	J57a.EDF	J57	1
50	14564720	14564723	255	258	3	RIGHT	J57a.EDF	J57	1
50	14564849	14564991	384	526	142	RIGHT	J57a.EDF	J57	1
50	14565243	14565350	778	885	107	RIGHT	J57a.EDF	J57	1
50	14565386	14565386	921	921	0	RIGHT	J57a.EDF	J57	1
51	14571825	14571845	67	87	20	RIGHT	J57a.EDF	J57	1
51	14571889	14571890	131	132	1	RIGHT	J57a.EDF	J57	1
51	14572006	14572141	248	383	135	RIGHT	J57a.EDF	J57	1
51	14572188	14572191	430	433	3	RIGHT	J57a.EDF	J57	1
51	14572304	14572415	546	657	111	RIGHT	J57a.EDF	J57	1
51	14572450	14572451	692	693	1	RIGHT	J57a.EDF	J57	1
51	14572612	14572742	854	984	130	RIGHT	J57a.EDF	J57	1
51	14572931	14573062	1173	1304	131	RIGHT	J57a.EDF	J57	1
51	14573093	14573093	1335	1335	0	RIGHT	J57a.EDF	J57	1
52	14578801	14578908	58	165	107	RIGHT	J57a.EDF	J57	1
52	14579077	14579205	334	462	128	RIGHT	J57a.EDF	J57	1
52	14579574	14579713	831	970	139	RIGHT	J57a.EDF	J57	1
52	14580035	14580151	1292	1408	116	RIGHT	J57a.EDF	J57	1
53	14587460	14587553	59	152	93	RIGHT	J57a.EDF	J57	1
53	14587579	14587580	178	179	1	RIGHT	J57a.EDF	J57	1
53	14587691	14587826	290	425	135	RIGHT	J57a.EDF	J57	1
53	14587847	14587848	446	447	1	RIGHT	J57a.EDF	J57	1
53	14588057	14588160	656	759	103	RIGHT	J57a.EDF	J57	1
53	14588193	14588196	792	795	3	RIGHT	J57a.EDF	J57	1
54	14597207	14597218	96	107	11	RIGHT	J57a.EDF	J57	1
54	14597282	14597468	171	357	186	RIGHT	J57a.EDF	J57	1
54	14597502	14597506	391	395	4	RIGHT	J57a.EDF	J57	1
54	14597941	14598027	830	916	86	RIGHT	J57a.EDF	J57	1
54	14598059	14598062	948	951	3	RIGHT	J57a.EDF	J57	1
54	14598477	14598583	1366	1472	106	RIGHT	J57a.EDF	J57	1
54	14598619	14598621	1508	1510	2	RIGHT	J57a.EDF	J57	1
54	14600928	14600976	3817	3865	48	RIGHT	J57a.EDF	J57	1
54	14601024	14601028	3913	3917	4	RIGHT	J57a.EDF	J57	1
54	14601423	14601534	4312	4423	111	RIGHT	J57a.EDF	J57	1
54	14601567	14601575	4456	4464	8	RIGHT	J57a.EDF	J57	1
55	14604306	14604472	75	241	166	RIGHT	J57a.EDF	J57	1
55	14604508	14604510	277	279	2	RIGHT	J57a.EDF	J57	1
55	14607928	14607990	3697	3759	62	RIGHT	J57a.EDF	J57	1
55	14609007	14609136	4776	4905	129	RIGHT	J57a.EDF	J57	1
55	14610561	14610584	6330	6353	23	RIGHT	J57a.EDF	J57	1
56	14613096	14613215	133	252	119	RIGHT	J57a.EDF	J57	1
56	14613428	14613561	465	598	133	RIGHT	J57a.EDF	J57	1
57	14621530	14621677	58	205	147	RIGHT	J57a.EDF	J57	1
57	14621700	14621711	228	239	11	RIGHT	J57a.EDF	J57	1
57	14621835	14621942	363	470	107	RIGHT	J57a.EDF	J57	1
57	14621967	14621972	495	500	5	RIGHT	J57a.EDF	J57	1
57	14622183	14622280	711	808	97	RIGHT	J57a.EDF	J57	1
57	14622309	14622316	837	844	7	RIGHT	J57a.EDF	J57	1
58	14629424	14629641	58	275	217	RIGHT	J57a.EDF	J57	1
58	14629747	14629893	381	527	146	RIGHT	J57a.EDF	J57	1
58	14629920	14629928	554	562	8	RIGHT	J57a.EDF	J57	1
58	14630205	14630351	839	985	146	RIGHT	J57a.EDF	J57	1
58	14630377	14630384	1011	1018	7	RIGHT	J57a.EDF	J57	1
58	14630644	14630832	1278	1466	188	RIGHT	J57a.EDF	J57	1
59	14637448	14637532	59	143	84	RIGHT	J57a.EDF	J57	1
59	14637567	14637741	178	352	174	RIGHT	J57a.EDF	J57	1
59	14637762	14637964	373	575	202	RIGHT	J57a.EDF	J57	1
59	14638038	14638197	649	808	159	RIGHT	J57a.EDF	J57	1
59	14638228	14638247	839	858	19	RIGHT	J57a.EDF	J57	1
59	14638592	14638716	1203	1327	124	RIGHT	J57a.EDF	J57	1
59	14638743	14638758	1354	1369	15	RIGHT	J57a.EDF	J57	1
60	14645816	14645943	58	185	127	RIGHT	J57a.EDF	J57	1
60	14646656	14646781	898	1023	125	RIGHT	J57a.EDF	J57	1
61	14655060	14655146	128	214	86	RIGHT	J57a.EDF	J57	1
61	14655169	14655179	237	247	10	RIGHT	J57a.EDF	J57	1
61	14655925	14655985	993	1053	60	RIGHT	J57a.EDF	J57	1
61	14656011	14656030	1079	1098	19	RIGHT	J57a.EDF	J57	1
62	14663068	14663180	59	171	112	RIGHT	J57a.EDF	J57	1
62	14663209	14663213	200	204	4	RIGHT	J57a.EDF	J57	1
62	14663337	14663485	328	476	148	RIGHT	J57a.EDF	J57	1
62	14663862	14664020	853	1011	158	RIGHT	J57a.EDF	J57	1
63	14671354	14671358	75	79	4	RIGHT	J57a.EDF	J57	1
63	14671500	14671661	221	382	161	RIGHT	J57a.EDF	J57	1
63	14671902	14672037	623	758	135	RIGHT	J57a.EDF	J57	1
63	14672333	14672455	1054	1176	122	RIGHT	J57a.EDF	J57	1
63	14672478	14672487	1199	1208	9	RIGHT	J57a.EDF	J57	1
64	14680532	14680680	57	205	148	RIGHT	J57a.EDF	J57	1
64	14680768	14680972	293	497	204	RIGHT	J57a.EDF	J57	1
64	14681241	14681374	766	899	133	RIGHT	J57a.EDF	J57	1
64	14681610	14681761	1135	1286	151	RIGHT	J57a.EDF	J57	1
65	14687069	14687240	58	229	171	RIGHT	J57a.EDF	J57	1
65	14687628	14687787	617	776	159	RIGHT	J57a.EDF	J57	1
65	14693946	14693984	6935	6973	38	RIGHT	J57a.EDF	J57	1
66	14696376	14696397	57	78	21	RIGHT	J57a.EDF	J57	1
66	14696419	14696433	100	114	14	RIGHT	J57a.EDF	J57	1
66	14696603	14696727	284	408	124	RIGHT	J57a.EDF	J57	1
66	14697280	14697396	961	1077	116	RIGHT	J57a.EDF	J57	1
66	14697422	14697430	1103	1111	8	RIGHT	J57a.EDF	J57	1
66	14697751	14697910	1432	1591	159	RIGHT	J57a.EDF	J57	1
67	14706000	14706146	453	599	146	RIGHT	J57a.EDF	J57	1
67	14706298	14706470	751	923	172	RIGHT	J57a.EDF	J57	1
67	14706931	14707091	1384	1544	160	RIGHT	J57a.EDF	J57	1
68	14713189	14713313	58	182	124	RIGHT	J57a.EDF	J57	1
68	14713741	14713866	610	735	125	RIGHT	J57a.EDF	J57	1
68	14714253	14714397	1122	1266	144	RIGHT	J57a.EDF	J57	1
68	14714861	14715028	1730	1897	167	RIGHT	J57a.EDF	J57	1
69	14721335	14721495	62	222	160	RIGHT	J57a.EDF	J57	1
69	14721619	14721773	346	500	154	RIGHT	J57a.EDF	J57	1
69	14722304	14722449	1031	1176	145	RIGHT	J57a.EDF	J57	1
70	14729651	14729822	156	327	171	RIGHT	J57a.EDF	J57	1
70	14730100	14730229	605	734	129	RIGHT	J57a.EDF	J57	1
70	14730253	14730259	758	764	6	RIGHT	J57a.EDF	J57	1
70	14730489	14730645	994	1150	156	RIGHT	J57a.EDF	J57	1
71	14736615	14736760	70	215	145	RIGHT	J57a.EDF	J57	1
71	14736916	14737040	371	495	124	RIGHT	J57a.EDF	J57	1
71	14737341	14737487	796	942	146	RIGHT	J57a.EDF	J57	1
71	14738016	14738135	1471	1590	119	RIGHT	J57a.EDF	J57	1
72	14745102	14745196	58	152	94	RIGHT	J57a.EDF	J57	1
72	14745303	14745424	259	380	121	RIGHT	J57a.EDF	J57	1
72	14745464	14745472	420	428	8	RIGHT	J57a.EDF	J57	1
72	14745906	14746005	862	961	99	RIGHT	J57a.EDF	J57	1
72	14746027	14746051	983	1007	24	RIGHT	J57a.EDF	J57	1
72	14746425	14746602	1381	1558	177	RIGHT	J57a.EDF	J57	1
73	14753064	14753132	59	127	68	RIGHT	J57a.EDF	J57	1
73	14753167	14753167	162	162	0	RIGHT	J57a.EDF	J57	1
73	14753966	14754061	961	1056	95	RIGHT	J57a.EDF	J57	1
73	14754087	14754101	1082	1096	14	RIGHT	J57a.EDF	J57	1
74	14760245	14760330	57	142	85	RIGHT	J57a.EDF	J57	1
74	14760366	14760390	178	202	24	RIGHT	J57a.EDF	J57	1
74	14760417	14760554	229	366	137	RIGHT	J57a.EDF	J57	1
74	14760765	14760931	577	743	166	RIGHT	J57a.EDF	J57	1
74	14761349	14761445	1161	1257	96	RIGHT	J57a.EDF	J57	1
74	14761479	14761494	1291	1306	15	RIGHT	J57a.EDF	J57	1
75	14769011	14769062	58	109	51	RIGHT	J57a.EDF	J57	1
75	14769091	14769099	138	146	8	RIGHT	J57a.EDF	J57	1
75	14769206	14769326	253	373	120	RIGHT	J57a.EDF	J57	1
75	14769357	14769365	404	412	8	RIGHT	J57a.EDF	J57	1
75	14769579	14769752	626	799	173	RIGHT	J57a.EDF	J57	1
76	14776389	14776496	96	203	107	RIGHT	J57a.EDF	J57	1
76	14776528	14776542	235	249	14	RIGHT	J57a.EDF	J57	1
77	14786033	14786169	200	336	136	RIGHT	J57a.EDF	J57	1
77	14786309	14786448	476	615	139	RIGHT	J57a.EDF	J57	1
77	14786862	14786980	1029	1147	118	RIGHT	J57a.EDF	J57	1
77	14787013	14787027	1180	1194	14	RIGHT	J57a.EDF	J57	1
77	14787396	14787479	1563	1646	83	RIGHT	J57a.EDF	J57	1
77	14787513	14787522	1680	1689	9	RIGHT	J57a.EDF	J57	1
78	14794190	14794282	58	150	92	RIGHT	J57a.EDF	J57	1
78	14794316	14794322	184	190	6	RIGHT	J57a.EDF	J57	1
78	14794405	14794559	273	427	154	RIGHT	J57a.EDF	J57	1
78	14794601	14794606	469	474	5	RIGHT	J57a.EDF	J57	1
78	14794729	14794870	597	738	141	RIGHT	J57a.EDF	J57	1
78	14794906	14794925	774	793	19	RIGHT	J57a.EDF	J57	1
78	14795263	14795385	1131	1253	122	RIGHT	J57a.EDF	J57	1
78	14795412	14795417	1280	1285	5	RIGHT	J57a.EDF	J57	1
78	14795861	14796013	1729	1881	152	RIGHT	J57a.EDF	J57	1
78	14796043	14796053	1911	1921	10	RIGHT	J57a.EDF	J57	1
79	14802732	14802805	59	132	73	RIGHT	J57a.EDF	J57	1
79	14802988	14803090	315	417	102	RIGHT	J57a.EDF	J57	1
79	14803124	14803124	451	451	0	RIGHT	J57a.EDF	J57	1
79	14803388	14803484	715	811	96	RIGHT	J57a.EDF	J57	1
79	14803992	14804066	1319	1393	74	RIGHT	J57a.EDF	J57	1
79	14807192	14807269	4519	4596	77	RIGHT	J57a.EDF	J57	1
79	14807318	14807328	4645	4655	10	RIGHT	J57a.EDF	J57	1
80	14809614	14809771	57	214	157	RIGHT	J57a.EDF	J57	1
80	14809812	14809820	255	263	8	RIGHT	J57a.EDF	J57	1
80	14810320	14810430	763	873	110	RIGHT	J57a.EDF	J57	1
80	14810474	14810478	917	921	4	RIGHT	J57a.EDF	J57	1
80	14810915	14811021	1358	1464	106	RIGHT	J57a.EDF	J57	1
80	14814844	14814887	5287	5330	43	RIGHT	J57a.EDF	J57	1
82	14825907	14825974	58	125	67	RIGHT	J57a.EDF	J57	1
82	14826018	14826018	169	169	0	RIGHT	J57a.EDF	J57	1
82	14826246	14826351	397	502	105	RIGHT	J57a.EDF	J57	1
82	14826394	14826397	545	548	3	RIGHT	J57a.EDF	J57	1
83	14833376	14833454	57	135	78	RIGHT	J57a.EDF	J57	1
83	14833487	14833497	168	178	10	RIGHT	J57a.EDF	J57	1
83	14834477	14834569	1158	1250	92	RIGHT	J57a.EDF	J57	1
83	14834592	14834612	1273	1293	20	RIGHT	J57a.EDF	J57	1
84	14841733	14841812	59	138	79	RIGHT	J57a.EDF	J57	1
84	14841841	14841853	167	179	12	RIGHT	J57a.EDF	J57	1
84	14842429	14842517	755	843	88	RIGHT	J57a.EDF	J57	1
84	14842552	14842558	878	884	6	RIGHT	J57a.EDF	J57	1
84	14842916	14843028	1242	1354	112	RIGHT	J57a.EDF	J57	1
84	14843064	14843077	1390	1403	13	RIGHT	J57a.EDF	J57	1
85	14849437	14849859	58	480	422	RIGHT	J57a.EDF	J57	1
85	14849925	14850084	546	705	159	RIGHT	J57a.EDF	J57	1
85	14850111	14850123	732	744	12	RIGHT	J57a.EDF	J57	1
85	14850628	14850704	1249	1325	76	RIGHT	J57a.EDF	J57	1
85	14850740	14850749	1361	1370	9	RIGHT	J57a.EDF	J57	1
86	14858350	14858527	63	240	177	RIGHT	J57a.EDF	J57	1
86	14858616	14858784	329	497	168	RIGHT	J57a.EDF	J57	1
86	14858816	14858829	529	542	13	RIGHT	J57a.EDF	J57	1
86	14859064	14859185	777	898	121	RIGHT	J57a.EDF	J57	1
86	14859218	14859231	931	944	13	RIGHT	J57a.EDF	J57	1
87	14867660	14867733	57	130	73	RIGHT	J57a.EDF	J57	1
87	14867775	14867776	172	173	1	RIGHT	J57a.EDF	J57	1
88	14876438	14876506	139	207	68	RIGHT	J57a.EDF	J57	1
89	14885158	14885559	64	465	401	RIGHT	J57a.EDF	J57	1
89	14885602	14885609	508	515	7	RIGHT	J57a.EDF	J57	1
89	14885717	14885717	623	623	0	RIGHT	J57a.EDF	J57	1
89	14885739	14885859	645	765	120	RIGHT	J57a.EDF	J57	1
89	14885889	14885908	795	814	19	RIGHT	J57a.EDF	J57	1
89	14886248	14886362	1154	1268	114	RIGHT	J57a.EDF	J57	1
89	14886391	14886409	1297	1315	18	RIGHT	J57a.EDF	J57	1
90	14893605	14893699	74	168	94	RIGHT	J57a.EDF	J57	1
90	14893735	14893744	204	213	9	RIGHT	J57a.EDF	J57	1
90	14894164	14894278	633	747	114	RIGHT	J57a.EDF	J57	1
90	14894320	14894334	789	803	14	RIGHT	J57a.EDF	J57	1
90	14894870	14894932	1339	1401	62	RIGHT	J57a.EDF	J57	1
90	14894968	14894971	1437	1440	3	RIGHT	J57a.EDF	J57	1
91	14902422	14902510	57	145	88	RIGHT	J57a.EDF	J57	1
91	14902540	14902545	175	180	5	RIGHT	J57a.EDF	J57	1
91	14902726	14902834	361	469	108	RIGHT	J57a.EDF	J57	1
91	14902862	14902865	497	500	3	RIGHT	J57a.EDF	J57	1
91	14903149	14903271	784	906	122	RIGHT	J57a.EDF	J57	1
91	14903310	14903315	945	950	5	RIGHT	J57a.EDF	J57	1
92	14911146	14911223	655	732	77	RIGHT	J57a.EDF	J57	1
92	14911263	14911266	772	775	3	RIGHT	J57a.EDF	J57	1
92	14911786	14911865	1295	1374	79	RIGHT	J57a.EDF	J57	1
92	14911906	14911916	1415	1425	10	RIGHT	J57a.EDF	J57	1
93	14917532	14917599	58	125	67	RIGHT	J57a.EDF	J57	1
93	14917642	14917645	168	171	3	RIGHT	J57a.EDF	J57	1
93	14918279	14918359	805	885	80	RIGHT	J57a.EDF	J57	1
93	14918392	14918406	918	932	14	RIGHT	J57a.EDF	J57	1
93	14918771	14918864	1297	1390	93	RIGHT	J57a.EDF	J57	1
93	14918897	14918912	1423	1438	15	RIGHT	J57a.EDF	J57	1
94	14926454	14926556	105	207	102	RIGHT	J57a.EDF	J57	1
94	14926592	14926595	243	246	3	RIGHT	J57a.EDF	J57	1
94	14926727	14926827	378	478	100	RIGHT	J57a.EDF	J57	1
94	14926860	14926862	511	513	2	RIGHT	J57a.EDF	J57	1
94	14927037	14927134	688	785	97	RIGHT	J57a.EDF	J57	1
94	14927164	14927172	815	823	8	RIGHT	J57a.EDF	J57	1
94	14927574	14927657	1225	1308	83	RIGHT	J57a.EDF	J57	1
94	14927693	14927703	1344	1354	10	RIGHT	J57a.EDF	J57	1
95	14934064	14934151	57	144	87	RIGHT	J57a.EDF	J57	1
95	14934187	14934189	180	182	2	RIGHT	J57a.EDF	J57	1
95	14934360	14934448	353	441	88	RIGHT	J57a.EDF	J57	1
95	14934475	14934485	468	478	10	RIGHT	J57a.EDF	J57	1
95	14934633	14934799	626	792	166	RIGHT	J57a.EDF	J57	1
95	14935204	14935309	1197	1302	105	RIGHT	J57a.EDF	J57	1
95	14935333	14935363	1326	1356	30	RIGHT	J57a.EDF	J57	1
96	14943155	14943275	87	207	120	RIGHT	J57a.EDF	J57	1
96	14943302	14943323	234	255	21	RIGHT	J57a.EDF	J57	1
96	14943457	14943600	389	532	143	RIGHT	J57a.EDF	J57	1
96	14943629	14943682	561	614	53	RIGHT	J57a.EDF	J57	1
96	14943895	14944024	827	956	129	RIGHT	J57a.EDF	J57	1
96	14944059	14944089	991	1021	30	RIGHT	J57a.EDF	J57	1
96	14944567	14944603	1499	1535	36	RIGHT	J57a.EDF	J57	1
96	14947607	14947628	4539	4560	21	RIGHT	J57a.EDF	J57	1
96	14948355	14948463	5287	5395	108	RIGHT	J57a.EDF	J57	1
96	14949050	14949160	5982	6092	110	RIGHT	J57a.EDF	J57	1
97	14951138	14951223	57	142	85	RIGHT	J57a.EDF	J57	1
97	14952033	14952101	952	1020	68	RIGHT	J57a.EDF	J57	1
97	14952127	14952146	1046	1065	19	RIGHT	J57a.EDF	J57	1
97	14952337	14952487	1256	1406	150	RIGHT	J57a.EDF	J57	1
97	14953941	14953996	2860	2915	55	RIGHT	J57a.EDF	J57	1
98	14960416	14960494	58	136	78	RIGHT	J57a.EDF	J57	1
98	14960612	14960780	254	422	168	RIGHT	J57a.EDF	J57	1
98	14960946	14961100	588	742	154	RIGHT	J57a.EDF	J57	1
99	14969247	14969415	89	257	168	RIGHT	J57a.EDF	J57	1
99	14969518	14969706	360	548	188	RIGHT	J57a.EDF	J57	1
100	14977306	14977462	86	242	156	RIGHT	J57a.EDF	J57	1
100	14977607	14977756	387	536	149	RIGHT	J57a.EDF	J57	1
101	14984484	14984606	58	180	122	RIGHT	J57a.EDF	J57	1
101	14984635	14984663	209	237	28	RIGHT	J57a.EDF	J57	1
101	14984771	14984927	345	501	156	RIGHT	J57a.EDF	J57	1
101	14985157	14985261	731	835	104	RIGHT	J57a.EDF	J57	1
101	14985283	14985313	857	887	30	RIGHT	J57a.EDF	J57	1
101	14985638	14985786	1212	1360	148	RIGHT	J57a.EDF	J57	1
101	14988487	14988550	4061	4124	63	RIGHT	J57a.EDF	J57	1
102	14992201	14992481	60	340	280	RIGHT	J57a.EDF	J57	1
102	14993113	14993113	972	972	0	RIGHT	J57a.EDF	J57	1
102	14993138	14993237	997	1096	99	RIGHT	J57a.EDF	J57	1
102	14997024	14997028	4883	4887	4	RIGHT	J57a.EDF	J57	1
102	14997056	14997079	4915	4938	23	RIGHT	J57a.EDF	J57	1
102	14997105	14997140	4964	4999	35	RIGHT	J57a.EDF	J57	1
103	14999939	15000093	57	211	154	RIGHT	J57a.EDF	J57	1
103	15000473	15000632	591	750	159	RIGHT	J57a.EDF	J57	1
104	15007808	15007968	69	229	160	RIGHT	J57a.EDF	J57	1
104	15008456	15008624	717	885	168	RIGHT	J57a.EDF	J57	1
105	15016509	15016656	98	245	147	RIGHT	J57a.EDF	J57	1
105	15016793	15016961	382	550	168	RIGHT	J57a.EDF	J57	1
105	15016983	15017029	572	618	46	RIGHT	J57a.EDF	J57	1
105	15017427	15017428	1016	1017	1	RIGHT	J57a.EDF	J57	1
105	15017451	15017504	1040	1093	53	RIGHT	J57a.EDF	J57	1
105	15017531	15017545	1120	1134	14	RIGHT	J57a.EDF	J57	1
105	15017775	15017860	1364	1449	85	RIGHT	J57a.EDF	J57	1
105	15017881	15017896	1470	1485	15	RIGHT	J57a.EDF	J57	1
106	15024769	15024940	58	229	171	RIGHT	J57a.EDF	J57	1
106	15025034	15025228	323	517	194	RIGHT	J57a.EDF	J57	1
106	15030557	15030630	5846	5919	73	RIGHT	J57a.EDF	J57	1
107	15033264	15033364	59	159	100	RIGHT	J57a.EDF	J57	1
107	15033385	15033430	180	225	45	RIGHT	J57a.EDF	J57	1
107	15033636	15033830	431	625	194	RIGHT	J57a.EDF	J57	1
107	15034288	15034458	1083	1253	170	RIGHT	J57a.EDF	J57	1
107	15036209	15036368	3004	3163	159	RIGHT	J57a.EDF	J57	1
107	15038538	15038712	5333	5507	174	RIGHT	J57a.EDF	J57	1
107	15040023	15040155	6818	6950	132	RIGHT	J57a.EDF	J57	1
108	15042718	15042907	617	806	189	RIGHT	J57a.EDF	J57	1
109	15049631	15050248	58	675	617	RIGHT	J57a.EDF	J57	1
109	15050741	15050843	1168	1270	102	RIGHT	J57a.EDF	J57	1
109	15050865	15050897	1292	1324	32	RIGHT	J57a.EDF	J57	1
110	15058530	15058603	58	131	73	RIGHT	J57a.EDF	J57	1
110	15058627	15058640	155	168	13	RIGHT	J57a.EDF	J57	1
110	15059059	15059223	587	751	164	RIGHT	J57a.EDF	J57	1
111	15065706	15065872	65	231	166	RIGHT	J57a.EDF	J57	1
111	15066751	15066945	1110	1304	194	RIGHT	J57a.EDF	J57	1
112	15072880	15073185	58	363	305	RIGHT	J57a.EDF	J57	1
112	15073240	15073437	418	615	197	RIGHT	J57a.EDF	J57	1
112	15074041	15074226	1219	1404	185	RIGHT	J57a.EDF	J57	1
113	15081730	15081842	58	170	112	RIGHT	J57a.EDF	J57	1
113	15081973	15082141	301	469	168	RIGHT	J57a.EDF	J57	1
113	15082532	15082699	860	1027	167	RIGHT	J57a.EDF	J57	1
114	15090928	15091092	121	285	164	RIGHT	J57a.EDF	J57	1
114	15091170	15091389	363	582	219	RIGHT	J57a.EDF	J57	1
114	15091503	15091520	696	713	17	RIGHT	J57a.EDF	J57	1
114	15091794	15091993	987	1186	199	RIGHT	J57a.EDF	J57	1
115	15100418	15100582	59	223	164	RIGHT	J57a.EDF	J57	1
115	15100720	15100874	361	515	154	RIGHT	J57a.EDF	J57	1
115	15101441	15101531	1082	1172	90	RIGHT	J57a.EDF	J57	1
115	15101552	15101581	1193	1222	29	RIGHT	J57a.EDF	J57	1
116	15108752	15109117	58	423	365	RIGHT	J57a.EDF	J57	1
116	15109187	15109402	493	708	215	RIGHT	J57a.EDF	J57	1
116	15109704	15109875	1010	1181	171	RIGHT	J57a.EDF	J57	1
117	15117887	15118012	58	183	125	RIGHT	J57a.EDF	J57	1
117	15118443	15118627	614	798	184	RIGHT	J57a.EDF	J57	1
117	15119180	15119349	1351	1520	169	RIGHT	J57a.EDF	J57	1
118	15126317	15126896	57	636	579	RIGHT	J57a.EDF	J57	1
118	15127516	15127673	1256	1413	157	RIGHT	J57a.EDF	J57	1
118	15127828	15128005	1568	1745	177	RIGHT	J57a.EDF	J57	1
119	15133402	15133493	57	148	91	RIGHT	J57a.EDF	J57	1
119	15134343	15134496	998	1151	153	RIGHT	J57a.EDF	J57	1
120	15142841	15143028	181	368	187	RIGHT	J57a.EDF	J57	1
120	15143150	15143333	490	673	183	RIGHT	J57a.EDF	J57	1
120	15143657	15143841	997	1181	184	RIGHT	J57a.EDF	J57	1
120	15147003	15147064	4343	4404	61	RIGHT	J57a.EDF	J57	1
1	15256782	15256865	1177	1260	83	RIGHT	J57b.EDF	J57	2
2	15264524	15264611	58	145	87	RIGHT	J57b.EDF	J57	2
2	15265099	15265189	633	723	90	RIGHT	J57b.EDF	J57	2
2	15265494	15265564	1028	1098	70	RIGHT	J57b.EDF	J57	2
3	15272024	15272160	229	365	136	RIGHT	J57b.EDF	J57	2
4	15279571	15279661	174	264	90	RIGHT	J57b.EDF	J57	2
4	15279879	15280017	482	620	138	RIGHT	J57b.EDF	J57	2
4	15280186	15280277	789	880	91	RIGHT	J57b.EDF	J57	2
4	15280616	15280715	1219	1318	99	RIGHT	J57b.EDF	J57	2
5	15287442	15287505	57	120	63	RIGHT	J57b.EDF	J57	2
5	15287637	15287761	252	376	124	RIGHT	J57b.EDF	J57	2
5	15288366	15288439	981	1054	73	RIGHT	J57b.EDF	J57	2
6	15294753	15294804	58	109	51	RIGHT	J57b.EDF	J57	2
6	15294971	15295080	276	385	109	RIGHT	J57b.EDF	J57	2
6	15295278	15295385	583	690	107	RIGHT	J57b.EDF	J57	2
6	15295582	15295693	887	998	111	RIGHT	J57b.EDF	J57	2
6	15295963	15296056	1268	1361	93	RIGHT	J57b.EDF	J57	2
7	15302569	15302666	59	156	97	RIGHT	J57b.EDF	J57	2
7	15303123	15303241	613	731	118	RIGHT	J57b.EDF	J57	2
7	15303525	15303647	1015	1137	122	RIGHT	J57b.EDF	J57	2
8	15311272	15311319	58	105	47	RIGHT	J57b.EDF	J57	2
8	15311505	15311594	291	380	89	RIGHT	J57b.EDF	J57	2
8	15311836	15311938	622	724	102	RIGHT	J57b.EDF	J57	2
9	15319522	15319628	59	165	106	RIGHT	J57b.EDF	J57	2
9	15319822	15319931	359	468	109	RIGHT	J57b.EDF	J57	2
9	15320112	15320230	649	767	118	RIGHT	J57b.EDF	J57	2
9	15320509	15320624	1046	1161	115	RIGHT	J57b.EDF	J57	2
10	15327365	15327526	58	219	161	RIGHT	J57b.EDF	J57	2
10	15327663	15327808	356	501	145	RIGHT	J57b.EDF	J57	2
11	15334668	15335076	58	466	408	RIGHT	J57b.EDF	J57	2
12	15343642	15343707	1126	1191	65	RIGHT	J57b.EDF	J57	2
12	15344198	15344268	1682	1752	70	RIGHT	J57b.EDF	J57	2
13	15351043	15351134	140	231	91	RIGHT	J57b.EDF	J57	2
13	15351596	15351700	693	797	104	RIGHT	J57b.EDF	J57	2
14	15360091	15360175	58	142	84	RIGHT	J57b.EDF	J57	2
14	15360398	15360503	365	470	105	RIGHT	J57b.EDF	J57	2
14	15360729	15360840	696	807	111	RIGHT	J57b.EDF	J57	2
14	15361395	15361475	1362	1442	80	RIGHT	J57b.EDF	J57	2
15	15369159	15369297	90	228	138	RIGHT	J57b.EDF	J57	2
15	15369436	15369579	367	510	143	RIGHT	J57b.EDF	J57	2
15	15369773	15369900	704	831	127	RIGHT	J57b.EDF	J57	2
15	15370264	15370382	1195	1313	118	RIGHT	J57b.EDF	J57	2
16	15376495	15376724	57	286	229	RIGHT	J57b.EDF	J57	2
16	15377014	15377119	576	681	105	RIGHT	J57b.EDF	J57	2
16	15377523	15377615	1085	1177	92	RIGHT	J57b.EDF	J57	2
17	15384901	15385000	59	158	99	RIGHT	J57b.EDF	J57	2
17	15385569	15385685	727	843	116	RIGHT	J57b.EDF	J57	2
17	15385935	15386063	1093	1221	128	RIGHT	J57b.EDF	J57	2
17	15386398	15386503	1556	1661	105	RIGHT	J57b.EDF	J57	2
18	15393544	15393655	57	168	111	RIGHT	J57b.EDF	J57	2
18	15394151	15394236	664	749	85	RIGHT	J57b.EDF	J57	2
19	15401238	15401321	57	140	83	RIGHT	J57b.EDF	J57	2
19	15402064	15402140	883	959	76	RIGHT	J57b.EDF	J57	2
19	15402445	15402558	1264	1377	113	RIGHT	J57b.EDF	J57	2
20	15410230	15410316	57	143	86	RIGHT	J57b.EDF	J57	2
20	15410952	15411029	779	856	77	RIGHT	J57b.EDF	J57	2
20	15411376	15411462	1203	1289	86	RIGHT	J57b.EDF	J57	2
20	15411778	15411879	1605	1706	101	RIGHT	J57b.EDF	J57	2
21	15416850	15416887	58	95	37	RIGHT	J57b.EDF	J57	2
21	15417033	15417173	241	381	140	RIGHT	J57b.EDF	J57	2
21	15417265	15417410	473	618	145	RIGHT	J57b.EDF	J57	2
21	15417676	15417771	884	979	95	RIGHT	J57b.EDF	J57	2
21	15421018	15421085	4226	4293	67	RIGHT	J57b.EDF	J57	2
22	15424846	15424870	58	82	24	RIGHT	J57b.EDF	J57	2
22	15425358	15425481	570	693	123	RIGHT	J57b.EDF	J57	2
22	15425750	15425875	962	1087	125	RIGHT	J57b.EDF	J57	2
22	15426373	15426454	1585	1666	81	RIGHT	J57b.EDF	J57	2
23	15433183	15433275	122	214	92	RIGHT	J57b.EDF	J57	2
23	15433480	15433592	419	531	112	RIGHT	J57b.EDF	J57	2
23	15433847	15433953	786	892	106	RIGHT	J57b.EDF	J57	2
23	15434519	15434612	1458	1551	93	RIGHT	J57b.EDF	J57	2
24	15441357	15441465	191	299	108	RIGHT	J57b.EDF	J57	2
24	15441646	15441754	480	588	108	RIGHT	J57b.EDF	J57	2
24	15442210	15442312	1044	1146	102	RIGHT	J57b.EDF	J57	2
24	15446163	15446219	4997	5053	56	RIGHT	J57b.EDF	J57	2
25	15448421	15448550	149	278	129	RIGHT	J57b.EDF	J57	2
25	15448843	15448965	571	693	122	RIGHT	J57b.EDF	J57	2
25	15449420	15449535	1148	1263	115	RIGHT	J57b.EDF	J57	2
26	15459180	15459256	1244	1320	76	RIGHT	J57b.EDF	J57	2
27	15467629	15467711	205	287	82	RIGHT	J57b.EDF	J57	2
27	15468319	15468413	895	989	94	RIGHT	J57b.EDF	J57	2
28	15475692	15475820	107	235	128	RIGHT	J57b.EDF	J57	2
28	15476032	15476129	447	544	97	RIGHT	J57b.EDF	J57	2
28	15476370	15476466	785	881	96	RIGHT	J57b.EDF	J57	2
28	15476688	15476802	1103	1217	114	RIGHT	J57b.EDF	J57	2
29	15484968	15485076	305	413	108	RIGHT	J57b.EDF	J57	2
29	15485226	15485387	563	724	161	RIGHT	J57b.EDF	J57	2
29	15485966	15486079	1303	1416	113	RIGHT	J57b.EDF	J57	2
30	15492245	15492345	58	158	100	RIGHT	J57b.EDF	J57	2
30	15492433	15492509	246	322	76	RIGHT	J57b.EDF	J57	2
30	15493411	15493518	1224	1331	107	RIGHT	J57b.EDF	J57	2
30	15493786	15493881	1599	1694	95	RIGHT	J57b.EDF	J57	2
31	15500225	15500296	579	650	71	RIGHT	J57b.EDF	J57	2
32	15507153	15507293	173	313	140	RIGHT	J57b.EDF	J57	2
32	15507908	15507996	928	1016	88	RIGHT	J57b.EDF	J57	2
33	15514260	15514358	58	156	98	RIGHT	J57b.EDF	J57	2
33	15514848	15514933	646	731	85	RIGHT	J57b.EDF	J57	2
33	15515322	15515407	1120	1205	85	RIGHT	J57b.EDF	J57	2
33	15518755	15518773	4553	4571	18	RIGHT	J57b.EDF	J57	2
34	15521630	15521701	58	129	71	RIGHT	J57b.EDF	J57	2
34	15522425	15522518	853	946	93	RIGHT	J57b.EDF	J57	2
34	15522774	15522887	1202	1315	113	RIGHT	J57b.EDF	J57	2
35	15528965	15529063	57	155	98	RIGHT	J57b.EDF	J57	2
35	15529443	15529562	535	654	119	RIGHT	J57b.EDF	J57	2
36	15538483	15538594	126	237	111	RIGHT	J57b.EDF	J57	2
36	15539464	15539535	1107	1178	71	RIGHT	J57b.EDF	J57	2
37	15546379	15546449	58	128	70	RIGHT	J57b.EDF	J57	2
37	15547180	15547272	859	951	92	RIGHT	J57b.EDF	J57	2
37	15547638	15547739	1317	1418	101	RIGHT	J57b.EDF	J57	2
38	15556137	15556265	161	289	128	RIGHT	J57b.EDF	J57	2
38	15556548	15556681	572	705	133	RIGHT	J57b.EDF	J57	2
38	15557628	15557706	1652	1730	78	RIGHT	J57b.EDF	J57	2
39	15565193	15565256	59	122	63	RIGHT	J57b.EDF	J57	2
39	15565725	15565861	591	727	136	RIGHT	J57b.EDF	J57	2
39	15566658	15566757	1524	1623	99	RIGHT	J57b.EDF	J57	2
40	15574403	15574649	58	304	246	RIGHT	J57b.EDF	J57	2
40	15575455	15575580	1110	1235	125	RIGHT	J57b.EDF	J57	2
41	15581821	15581882	58	119	61	RIGHT	J57b.EDF	J57	2
41	15582284	15582448	521	685	164	RIGHT	J57b.EDF	J57	2
41	15584946	15585049	3183	3286	103	RIGHT	J57b.EDF	J57	2
41	15586524	15586607	4761	4844	83	RIGHT	J57b.EDF	J57	2
42	15589161	15589290	113	242	129	RIGHT	J57b.EDF	J57	2
42	15589865	15589997	817	949	132	RIGHT	J57b.EDF	J57	2
42	15594352	15594460	5304	5412	108	RIGHT	J57b.EDF	J57	2
43	15596675	15596820	224	369	145	RIGHT	J57b.EDF	J57	2
43	15597777	15597890	1326	1439	113	RIGHT	J57b.EDF	J57	2
43	15600119	15600196	3668	3745	77	RIGHT	J57b.EDF	J57	2
44	15603644	15603759	57	172	115	RIGHT	J57b.EDF	J57	2
44	15604464	15604562	877	975	98	RIGHT	J57b.EDF	J57	2
45	15610689	15610795	67	173	106	RIGHT	J57b.EDF	J57	2
45	15611289	15611391	667	769	102	RIGHT	J57b.EDF	J57	2
46	15618826	15618898	170	242	72	RIGHT	J57b.EDF	J57	2
46	15619155	15619230	499	574	75	RIGHT	J57b.EDF	J57	2
46	15623474	15623564	4818	4908	90	RIGHT	J57b.EDF	J57	2
47	15626271	15626384	570	683	113	RIGHT	J57b.EDF	J57	2
48	15634240	15634340	173	273	100	RIGHT	J57b.EDF	J57	2
48	15634584	15634688	517	621	104	RIGHT	J57b.EDF	J57	2
48	15635243	15635348	1176	1281	105	RIGHT	J57b.EDF	J57	2
49	15642055	15642143	80	168	88	RIGHT	J57b.EDF	J57	2
50	15650232	15650287	58	113	55	RIGHT	J57b.EDF	J57	2
50	15650977	15651073	803	899	96	RIGHT	J57b.EDF	J57	2
51	15659330	15659371	78	119	41	RIGHT	J57b.EDF	J57	2
51	15659708	15659806	456	554	98	RIGHT	J57b.EDF	J57	2
52	15668249	15668336	306	393	87	RIGHT	J57b.EDF	J57	2
53	15675326	15675395	126	195	69	RIGHT	J57b.EDF	J57	2
53	15675686	15675773	486	573	87	RIGHT	J57b.EDF	J57	2
53	15676519	15676550	1319	1350	31	RIGHT	J57b.EDF	J57	2
54	15681677	15681777	132	232	100	RIGHT	J57b.EDF	J57	2
55	15690533	15690646	253	366	113	RIGHT	J57b.EDF	J57	2
55	15690872	15690961	592	681	89	RIGHT	J57b.EDF	J57	2
55	15691579	15691671	1299	1391	92	RIGHT	J57b.EDF	J57	2
55	15694773	15694795	4493	4515	22	RIGHT	J57b.EDF	J57	2
56	15698426	15698539	60	173	113	RIGHT	J57b.EDF	J57	2
56	15699153	15699267	787	901	114	RIGHT	J57b.EDF	J57	2
56	15699572	15699697	1206	1331	125	RIGHT	J57b.EDF	J57	2
57	15705586	15705712	57	183	126	RIGHT	J57b.EDF	J57	2
57	15706843	15706961	1314	1432	118	RIGHT	J57b.EDF	J57	2
57	15710005	15710051	4476	4522	46	RIGHT	J57b.EDF	J57	2
57	15711039	15711129	5510	5600	90	RIGHT	J57b.EDF	J57	2
58	15714908	15715005	484	581	97	RIGHT	J57b.EDF	J57	2
58	15715493	15715616	1069	1192	123	RIGHT	J57b.EDF	J57	2
58	15715885	15715978	1461	1554	93	RIGHT	J57b.EDF	J57	2
59	15722989	15723138	222	371	149	RIGHT	J57b.EDF	J57	2
59	15723367	15723458	600	691	91	RIGHT	J57b.EDF	J57	2
59	15723900	15724060	1133	1293	160	RIGHT	J57b.EDF	J57	2
59	15724238	15724386	1471	1619	148	RIGHT	J57b.EDF	J57	2
60	15729963	15730035	58	130	72	RIGHT	J57b.EDF	J57	2
60	15730575	15730696	670	791	121	RIGHT	J57b.EDF	J57	2
61	15739527	15739597	603	673	70	RIGHT	J57b.EDF	J57	2
62	15747380	15747406	58	84	26	RIGHT	J57b.EDF	J57	2
62	15749054	15749124	1732	1802	70	RIGHT	J57b.EDF	J57	2
63	15756523	15756636	132	245	113	RIGHT	J57b.EDF	J57	2
63	15757471	15757594	1080	1203	123	RIGHT	J57b.EDF	J57	2
64	15766388	15766505	921	1038	117	RIGHT	J57b.EDF	J57	2
65	15774474	15774556	71	153	82	RIGHT	J57b.EDF	J57	2
65	15774898	15774969	495	566	71	RIGHT	J57b.EDF	J57	2
65	15775440	15775512	1037	1109	72	RIGHT	J57b.EDF	J57	2
66	15783182	15783355	95	268	173	RIGHT	J57b.EDF	J57	2
66	15783650	15783685	563	598	35	RIGHT	J57b.EDF	J57	2
66	15784740	15784808	1653	1721	68	RIGHT	J57b.EDF	J57	2
67	15791529	15791631	286	388	102	RIGHT	J57b.EDF	J57	2
68	15799269	15799338	156	225	69	RIGHT	J57b.EDF	J57	2
69	15807765	15807773	122	130	8	RIGHT	J57b.EDF	J57	2
69	15808733	15808799	1090	1156	66	RIGHT	J57b.EDF	J57	2
70	15815789	15815866	170	247	77	RIGHT	J57b.EDF	J57	2
70	15816169	15816237	550	618	68	RIGHT	J57b.EDF	J57	2
71	15824958	15825058	725	825	100	RIGHT	J57b.EDF	J57	2
72	15831229	15831322	182	275	93	RIGHT	J57b.EDF	J57	2
72	15831647	15831756	600	709	109	RIGHT	J57b.EDF	J57	2
72	15831970	15832069	923	1022	99	RIGHT	J57b.EDF	J57	2
72	15832504	15832625	1457	1578	121	RIGHT	J57b.EDF	J57	2
73	15838486	15838518	58	90	32	RIGHT	J57b.EDF	J57	2
73	15839024	15839111	596	683	87	RIGHT	J57b.EDF	J57	2
73	15839734	15839812	1306	1384	78	RIGHT	J57b.EDF	J57	2
74	15846820	15846930	66	176	110	RIGHT	J57b.EDF	J57	2
75	15854328	15854411	63	146	83	RIGHT	J57b.EDF	J57	2
76	15861454	15861540	80	166	86	RIGHT	J57b.EDF	J57	2
76	15861768	15861873	394	499	105	RIGHT	J57b.EDF	J57	2
76	15866297	15866332	4923	4958	35	RIGHT	J57b.EDF	J57	2
77	15868508	15868595	58	145	87	RIGHT	J57b.EDF	J57	2
78	15875504	15875621	570	687	117	RIGHT	J57b.EDF	J57	2
78	15876066	15876153	1132	1219	87	RIGHT	J57b.EDF	J57	2
79	15883682	15883782	103	203	100	RIGHT	J57b.EDF	J57	2
80	15890662	15890756	57	151	94	RIGHT	J57b.EDF	J57	2
80	15894674	15894719	4069	4114	45	RIGHT	J57b.EDF	J57	2
81	15899015	15899117	537	639	102	RIGHT	J57b.EDF	J57	2
81	15899914	15899956	1436	1478	42	RIGHT	J57b.EDF	J57	2
82	15907184	15907262	552	630	78	RIGHT	J57b.EDF	J57	2
83	15913812	15913882	58	128	70	RIGHT	J57b.EDF	J57	2
83	15914788	15914848	1034	1094	60	RIGHT	J57b.EDF	J57	2
83	15915134	15915237	1380	1483	103	RIGHT	J57b.EDF	J57	2
84	15921838	15921901	58	121	63	RIGHT	J57b.EDF	J57	2
84	15923472	15923516	1692	1736	44	RIGHT	J57b.EDF	J57	2
85	15931350	15931429	932	1011	79	RIGHT	J57b.EDF	J57	2
85	15933143	15933191	2725	2773	48	RIGHT	J57b.EDF	J57	2
85	15935025	15935075	4607	4657	50	RIGHT	J57b.EDF	J57	2
86	15937904	15938028	691	815	124	RIGHT	J57b.EDF	J57	2
87	15946528	15946622	144	238	94	RIGHT	J57b.EDF	J57	2
87	15948098	15948203	1714	1819	105	RIGHT	J57b.EDF	J57	2
88	15952938	15953051	98	211	113	RIGHT	J57b.EDF	J57	2
88	15953879	15954001	1039	1161	122	RIGHT	J57b.EDF	J57	2
89	15961376	15961473	143	240	97	RIGHT	J57b.EDF	J57	2
89	15962060	15962156	827	923	96	RIGHT	J57b.EDF	J57	2
90	15970440	15970545	381	486	105	RIGHT	J57b.EDF	J57	2
90	15970820	15970886	761	827	66	RIGHT	J57b.EDF	J57	2
90	15972520	15972611	2461	2552	91	RIGHT	J57b.EDF	J57	2
90	15973567	15973665	3508	3606	98	RIGHT	J57b.EDF	J57	2
90	15973886	15973975	3827	3916	89	RIGHT	J57b.EDF	J57	2
90	15976864	15976943	6805	6884	79	RIGHT	J57b.EDF	J57	2
91	15979617	15979698	57	138	81	RIGHT	J57b.EDF	J57	2
91	15980190	15980287	630	727	97	RIGHT	J57b.EDF	J57	2
92	15987236	15987336	58	158	100	RIGHT	J57b.EDF	J57	2
92	15988556	15988655	1378	1477	99	RIGHT	J57b.EDF	J57	2
92	15992769	15992821	5591	5643	52	RIGHT	J57b.EDF	J57	2
93	15995726	15995838	151	263	112	RIGHT	J57b.EDF	J57	2
93	15996375	15996491	800	916	116	RIGHT	J57b.EDF	J57	2
94	16004138	16004280	155	297	142	RIGHT	J57b.EDF	J57	2
94	16004868	16004975	885	992	107	RIGHT	J57b.EDF	J57	2
95	16012749	16012868	163	282	119	RIGHT	J57b.EDF	J57	2
95	16013517	16013627	931	1041	110	RIGHT	J57b.EDF	J57	2
96	16020839	16020929	68	158	90	RIGHT	J57b.EDF	J57	2
96	16021139	16021315	368	544	176	RIGHT	J57b.EDF	J57	2
96	16021435	16021596	664	825	161	RIGHT	J57b.EDF	J57	2
96	16022015	16022152	1244	1381	137	RIGHT	J57b.EDF	J57	2
96	16025485	16025542	4714	4771	57	RIGHT	J57b.EDF	J57	2
97	16029447	16029569	417	539	122	RIGHT	J57b.EDF	J57	2
97	16030114	16030215	1084	1185	101	RIGHT	J57b.EDF	J57	2
98	16035968	16036088	67	187	120	RIGHT	J57b.EDF	J57	2
98	16037254	16037351	1353	1450	97	RIGHT	J57b.EDF	J57	2
99	16044440	16044556	379	495	116	RIGHT	J57b.EDF	J57	2
99	16045078	16045184	1017	1123	106	RIGHT	J57b.EDF	J57	2
99	16045611	16045709	1550	1648	98	RIGHT	J57b.EDF	J57	2
100	16053573	16053714	68	209	141	RIGHT	J57b.EDF	J57	2
100	16054033	16054107	528	602	74	RIGHT	J57b.EDF	J57	2
100	16054998	16055094	1493	1589	96	RIGHT	J57b.EDF	J57	2
101	16062370	16062486	60	176	116	RIGHT	J57b.EDF	J57	2
101	16062779	16062875	469	565	96	RIGHT	J57b.EDF	J57	2
102	16072392	16072461	510	579	69	RIGHT	J57b.EDF	J57	2
102	16072739	16072821	857	939	82	RIGHT	J57b.EDF	J57	2
102	16073346	16073441	1464	1559	95	RIGHT	J57b.EDF	J57	2
102	16076048	16076132	4166	4250	84	RIGHT	J57b.EDF	J57	2
103	16080499	16080630	239	370	131	RIGHT	J57b.EDF	J57	2
103	16080910	16081035	650	775	125	RIGHT	J57b.EDF	J57	2
104	16088103	16088206	1004	1107	103	RIGHT	J57b.EDF	J57	2
105	16097238	16097330	644	736	92	RIGHT	J57b.EDF	J57	2
105	16097655	16097756	1061	1162	101	RIGHT	J57b.EDF	J57	2
106	16105531	16105625	114	208	94	RIGHT	J57b.EDF	J57	2
106	16105919	16106017	502	600	98	RIGHT	J57b.EDF	J57	2
107	16112790	16112863	58	131	73	RIGHT	J57b.EDF	J57	2
108	16121782	16121890	145	253	108	RIGHT	J57b.EDF	J57	2
108	16122151	16122269	514	632	118	RIGHT	J57b.EDF	J57	2
109	16129025	16129082	57	114	57	RIGHT	J57b.EDF	J57	2
109	16130819	16130873	1851	1905	54	RIGHT	J57b.EDF	J57	2
110	16136591	16136763	217	389	172	RIGHT	J57b.EDF	J57	2
110	16137007	16137119	633	745	112	RIGHT	J57b.EDF	J57	2
111	16143023	16143129	429	535	106	RIGHT	J57b.EDF	J57	2
111	16146327	16146397	3733	3803	70	RIGHT	J57b.EDF	J57	2
112	16150128	16150231	162	265	103	RIGHT	J57b.EDF	J57	2
112	16150677	16150774	711	808	97	RIGHT	J57b.EDF	J57	2
112	16153709	16153778	3743	3812	69	RIGHT	J57b.EDF	J57	2
112	16154364	16154461	4398	4495	97	RIGHT	J57b.EDF	J57	2
113	16158280	16158388	965	1073	108	RIGHT	J57b.EDF	J57	2
113	16158778	16158920	1463	1605	142	RIGHT	J57b.EDF	J57	2
114	16166411	16166553	233	375	142	RIGHT	J57b.EDF	J57	2
114	16167570	16167673	1392	1495	103	RIGHT	J57b.EDF	J57	2
115	16174050	16174147	132	229	97	RIGHT	J57b.EDF	J57	2
115	16174536	16174648	618	730	112	RIGHT	J57b.EDF	J57	2
115	16174875	16174999	957	1081	124	RIGHT	J57b.EDF	J57	2
115	16178558	16178655	4640	4737	97	RIGHT	J57b.EDF	J57	2
116	16182301	16182370	58	127	69	RIGHT	J57b.EDF	J57	2
116	16183100	16183177	857	934	77	RIGHT	J57b.EDF	J57	2
116	16186153	16186256	3910	4013	103	RIGHT	J57b.EDF	J57	2
116	16187364	16187466	5121	5223	102	RIGHT	J57b.EDF	J57	2
116	16187876	16187995	5633	5752	119	RIGHT	J57b.EDF	J57	2
117	16190936	16191052	368	484	116	RIGHT	J57b.EDF	J57	2
117	16194298	16194362	3730	3794	64	RIGHT	J57b.EDF	J57	2
118	16197889	16197992	65	168	103	RIGHT	J57b.EDF	J57	2
118	16198623	16198697	799	873	74	RIGHT	J57b.EDF	J57	2
118	16199281	16199376	1457	1552	95	RIGHT	J57b.EDF	J57	2
119	16205285	16205394	130	239	109	RIGHT	J57b.EDF	J57	2
119	16210075	16210099	4920	4944	24	RIGHT	J57b.EDF	J57	2
120	16213609	16213721	595	707	112	RIGHT	J57b.EDF	J57	2
1	13537321	13537381	245	305	60	RIGHT	J68a.EDF	J68	1
1	13538291	13538349	1215	1273	58	RIGHT	J68a.EDF	J68	1
2	13546909	13546948	826	865	39	RIGHT	J68a.EDF	J68	1
3	13555687	13555733	1140	1186	46	RIGHT	J68a.EDF	J68	1
5	13576834	13576843	1058	1067	9	RIGHT	J68a.EDF	J68	1
7	13593487	13593545	620	678	58	RIGHT	J68a.EDF	J68	1
7	13594199	13594246	1332	1379	47	RIGHT	J68a.EDF	J68	1
8	13600791	13600824	640	673	33	RIGHT	J68a.EDF	J68	1
13	13644859	13644917	889	947	58	RIGHT	J68a.EDF	J68	1
14	13651503	13651556	294	347	53	RIGHT	J68a.EDF	J68	1
17	13680573	13680581	2954	2962	8	RIGHT	J68a.EDF	J68	1
19	13695829	13695858	320	349	29	RIGHT	J68a.EDF	J68	1
19	13696082	13696148	573	639	66	RIGHT	J68a.EDF	J68	1
20	13705215	13705245	100	130	30	RIGHT	J68a.EDF	J68	1
20	13705924	13706012	809	897	88	RIGHT	J68a.EDF	J68	1
23	13728385	13728474	318	407	89	RIGHT	J68a.EDF	J68	1
24	13738032	13738101	228	297	69	RIGHT	J68a.EDF	J68	1
24	13738438	13738524	634	720	86	RIGHT	J68a.EDF	J68	1
25	13747148	13747227	828	907	79	RIGHT	J68a.EDF	J68	1
26	13755197	13755290	91	184	93	RIGHT	J68a.EDF	J68	1
26	13755835	13755913	729	807	78	RIGHT	J68a.EDF	J68	1
27	13762971	13763052	304	385	81	RIGHT	J68a.EDF	J68	1
29	13776815	13776877	207	269	62	RIGHT	J68a.EDF	J68	1
29	13777583	13777662	975	1054	79	RIGHT	J68a.EDF	J68	1
30	13784699	13784769	1197	1267	70	RIGHT	J68a.EDF	J68	1
31	13795385	13795464	3672	3751	79	RIGHT	J68a.EDF	J68	1
32	13800531	13800618	1051	1138	87	RIGHT	J68a.EDF	J68	1
33	13807883	13807970	356	443	87	RIGHT	J68a.EDF	J68	1
34	13816930	13817024	217	311	94	RIGHT	J68a.EDF	J68	1
35	13826748	13826836	342	430	88	RIGHT	J68a.EDF	J68	1
35	13827068	13827183	662	777	115	RIGHT	J68a.EDF	J68	1
36	13834055	13834135	233	313	80	RIGHT	J68a.EDF	J68	1
36	13835189	13835267	1367	1445	78	RIGHT	J68a.EDF	J68	1
37	13841854	13841931	244	321	77	RIGHT	J68a.EDF	J68	1
38	13850032	13850131	942	1041	99	RIGHT	J68a.EDF	J68	1
39	13856635	13856744	686	795	109	RIGHT	J68a.EDF	J68	1
40	13866199	13866281	1119	1201	82	RIGHT	J68a.EDF	J68	1
42	13882041	13882133	204	296	92	RIGHT	J68a.EDF	J68	1
42	13882340	13882452	503	615	112	RIGHT	J68a.EDF	J68	1
42	13883029	13883141	1192	1304	112	RIGHT	J68a.EDF	J68	1
42	13883946	13883989	2109	2152	43	RIGHT	J68a.EDF	J68	1
43	13891404	13891427	68	91	23	RIGHT	J68a.EDF	J68	1
43	13892125	13892212	789	876	87	RIGHT	J68a.EDF	J68	1
43	13892554	13892638	1218	1302	84	RIGHT	J68a.EDF	J68	1
46	13916840	13916940	225	325	100	RIGHT	J68a.EDF	J68	1
47	13923999	13924052	58	111	53	RIGHT	J68a.EDF	J68	1
47	13924687	13924777	746	836	90	RIGHT	J68a.EDF	J68	1
47	13927038	13927130	3097	3189	92	RIGHT	J68a.EDF	J68	1
49	13939412	13939499	114	201	87	RIGHT	J68a.EDF	J68	1
49	13939926	13940025	628	727	99	RIGHT	J68a.EDF	J68	1
49	13940635	13940714	1337	1416	79	RIGHT	J68a.EDF	J68	1
49	13942019	13942080	2721	2782	61	RIGHT	J68a.EDF	J68	1
50	13948124	13948240	270	386	116	RIGHT	J68a.EDF	J68	1
50	13948710	13948811	856	957	101	RIGHT	J68a.EDF	J68	1
51	13954277	13954342	57	122	65	RIGHT	J68a.EDF	J68	1
52	13963064	13963161	781	878	97	RIGHT	J68a.EDF	J68	1
53	13971418	13971489	439	510	71	RIGHT	J68a.EDF	J68	1
53	13971946	13972042	967	1063	96	RIGHT	J68a.EDF	J68	1
54	13979801	13979896	253	348	95	RIGHT	J68a.EDF	J68	1
55	13987911	13988010	96	195	99	RIGHT	J68a.EDF	J68	1
55	13988510	13988563	695	748	53	RIGHT	J68a.EDF	J68	1
56	13998781	13998815	3567	3601	34	RIGHT	J68a.EDF	J68	1
57	14006052	14006082	2694	2724	30	RIGHT	J68a.EDF	J68	1
57	14008413	14008447	5055	5089	34	RIGHT	J68a.EDF	J68	1
58	14012871	14012915	477	521	44	RIGHT	J68a.EDF	J68	1
59	14020325	14020355	58	88	30	RIGHT	J68a.EDF	J68	1
60	14029610	14029658	276	324	48	RIGHT	J68a.EDF	J68	1
61	14038056	14038107	287	338	51	RIGHT	J68a.EDF	J68	1
62	14047000	14047056	198	254	56	RIGHT	J68a.EDF	J68	1
64	14064051	14064111	638	698	60	RIGHT	J68a.EDF	J68	1
65	14071176	14071238	59	121	62	RIGHT	J68a.EDF	J68	1
65	14071689	14071799	572	682	110	RIGHT	J68a.EDF	J68	1
65	14072086	14072178	969	1061	92	RIGHT	J68a.EDF	J68	1
66	14078259	14078292	375	408	33	RIGHT	J68a.EDF	J68	1
67	14088358	14088398	394	434	40	RIGHT	J68a.EDF	J68	1
67	14090849	14090871	2885	2907	22	RIGHT	J68a.EDF	J68	1
69	14103925	14103959	58	92	34	RIGHT	J68a.EDF	J68	1
69	14103984	14103985	117	118	1	RIGHT	J68a.EDF	J68	1
71	14120281	14120336	701	756	55	RIGHT	J68a.EDF	J68	1
72	14128823	14128870	98	145	47	RIGHT	J68a.EDF	J68	1
72	14129927	14129970	1202	1245	43	RIGHT	J68a.EDF	J68	1
72	14134094	14134105	5369	5380	11	RIGHT	J68a.EDF	J68	1
72	14134141	14134142	5416	5417	1	RIGHT	J68a.EDF	J68	1
74	14146713	14146778	414	479	65	RIGHT	J68a.EDF	J68	1
74	14147187	14147257	888	958	70	RIGHT	J68a.EDF	J68	1
74	14149530	14149576	3231	3277	46	RIGHT	J68a.EDF	J68	1
76	14161452	14161527	699	774	75	RIGHT	J68a.EDF	J68	1
77	14169137	14169154	226	243	17	RIGHT	J68a.EDF	J68	1
77	14169578	14169663	667	752	85	RIGHT	J68a.EDF	J68	1
78	14178566	14178617	751	802	51	RIGHT	J68a.EDF	J68	1
79	14190009	14190054	1080	1125	45	RIGHT	J68a.EDF	J68	1
79	14192492	14192534	3563	3605	42	RIGHT	J68a.EDF	J68	1
80	14197081	14197083	419	421	2	RIGHT	J68a.EDF	J68	1
80	14197432	14197492	770	830	60	RIGHT	J68a.EDF	J68	1
81	14204335	14204387	316	368	52	RIGHT	J68a.EDF	J68	1
81	14204820	14204865	801	846	45	RIGHT	J68a.EDF	J68	1
84	14231306	14231359	2498	2551	53	RIGHT	J68a.EDF	J68	1
85	14236080	14236146	299	365	66	RIGHT	J68a.EDF	J68	1
85	14236392	14236459	611	678	67	RIGHT	J68a.EDF	J68	1
87	14253774	14253839	752	817	65	RIGHT	J68a.EDF	J68	1
88	14262288	14262358	1123	1193	70	RIGHT	J68a.EDF	J68	1
91	14287067	14287102	644	679	35	RIGHT	J68a.EDF	J68	1
92	14294439	14294483	310	354	44	RIGHT	J68a.EDF	J68	1
92	14294919	14294979	790	850	60	RIGHT	J68a.EDF	J68	1
92	14295321	14295395	1192	1266	74	RIGHT	J68a.EDF	J68	1
93	14301929	14302038	197	306	109	RIGHT	J68a.EDF	J68	1
93	14302378	14302460	646	728	82	RIGHT	J68a.EDF	J68	1
93	14303114	14303174	1382	1442	60	RIGHT	J68a.EDF	J68	1
98	14342112	14342166	306	360	54	RIGHT	J68a.EDF	J68	1
98	14342590	14342639	784	833	49	RIGHT	J68a.EDF	J68	1
98	14345336	14345358	3530	3552	22	RIGHT	J68a.EDF	J68	1
99	14349740	14349822	187	269	82	RIGHT	J68a.EDF	J68	1
99	14350210	14350294	657	741	84	RIGHT	J68a.EDF	J68	1
99	14350320	14350332	767	779	12	RIGHT	J68a.EDF	J68	1
99	14351110	14351171	1557	1618	61	RIGHT	J68a.EDF	J68	1
100	14359153	14359210	638	695	57	RIGHT	J68a.EDF	J68	1
101	14365994	14366037	242	285	43	RIGHT	J68a.EDF	J68	1
101	14366857	14366914	1105	1162	57	RIGHT	J68a.EDF	J68	1
105	14397172	14397216	425	469	44	RIGHT	J68a.EDF	J68	1
106	14406028	14406068	290	330	40	RIGHT	J68a.EDF	J68	1
106	14406609	14406667	871	929	58	RIGHT	J68a.EDF	J68	1
111	14444837	14444951	67	181	114	RIGHT	J68a.EDF	J68	1
111	14445522	14445616	752	846	94	RIGHT	J68a.EDF	J68	1
112	14452184	14452231	492	539	47	RIGHT	J68a.EDF	J68	1
112	14452255	14452270	563	578	15	RIGHT	J68a.EDF	J68	1
114	14465573	14465642	509	578	69	RIGHT	J68a.EDF	J68	1
115	14473476	14473576	198	298	100	RIGHT	J68a.EDF	J68	1
115	14474241	14474332	963	1054	91	RIGHT	J68a.EDF	J68	1
116	14480984	14481044	121	181	60	RIGHT	J68a.EDF	J68	1
117	14489100	14489195	370	465	95	RIGHT	J68a.EDF	J68	1
119	14504914	14505045	620	751	131	RIGHT	J68a.EDF	J68	1
120	14511994	14512096	611	713	102	RIGHT	J68a.EDF	J68	1
120	14512876	14512938	1493	1555	62	RIGHT	J68a.EDF	J68	1
2	15492851	15492899	685	733	48	RIGHT	J68b.EDF	J68	2
3	15501289	15501359	488	558	70	RIGHT	J68b.EDF	J68	2
3	15501609	15501674	808	873	65	RIGHT	J68b.EDF	J68	2
4	15510202	15510248	726	772	46	RIGHT	J68b.EDF	J68	2
7	15535576	15535642	243	309	66	RIGHT	J68b.EDF	J68	2
7	15540625	15540625	5292	5292	0	RIGHT	J68b.EDF	J68	2
7	15540676	15540676	5343	5343	0	RIGHT	J68b.EDF	J68	2
8	15544371	15544428	1272	1329	57	RIGHT	J68b.EDF	J68	2
10	15560533	15560594	365	426	61	RIGHT	J68b.EDF	J68	2
10	15560867	15560966	699	798	99	RIGHT	J68b.EDF	J68	2
14	15591985	15592010	58	83	25	RIGHT	J68b.EDF	J68	2
14	15592247	15592311	320	384	64	RIGHT	J68b.EDF	J68	2
15	15600349	15600417	207	275	68	RIGHT	J68b.EDF	J68	2
17	15614841	15614908	754	821	67	RIGHT	J68b.EDF	J68	2
18	15622635	15622709	82	156	74	RIGHT	J68b.EDF	J68	2
19	15629846	15629929	315	398	83	RIGHT	J68b.EDF	J68	2
19	15630141	15630255	610	724	114	RIGHT	J68b.EDF	J68	2
19	15630525	15630594	994	1063	69	RIGHT	J68b.EDF	J68	2
20	15638876	15638952	341	417	76	RIGHT	J68b.EDF	J68	2
20	15639048	15639164	513	629	116	RIGHT	J68b.EDF	J68	2
20	15639565	15639640	1030	1105	75	RIGHT	J68b.EDF	J68	2
22	15654111	15654182	685	756	71	RIGHT	J68b.EDF	J68	2
23	15661622	15661708	411	497	86	RIGHT	J68b.EDF	J68	2
24	15670794	15670874	608	688	80	RIGHT	J68b.EDF	J68	2
25	15679405	15679440	294	329	35	RIGHT	J68b.EDF	J68	2
26	15686658	15686732	172	246	74	RIGHT	J68b.EDF	J68	2
28	15702260	15702331	58	129	71	RIGHT	J68b.EDF	J68	2
29	15709349	15709389	59	99	40	RIGHT	J68b.EDF	J68	2
32	15732354	15732434	196	276	80	RIGHT	J68b.EDF	J68	2
33	15738685	15738741	58	114	56	RIGHT	J68b.EDF	J68	2
36	15761272	15761313	710	751	41	RIGHT	J68b.EDF	J68	2
37	15769746	15769832	688	774	86	RIGHT	J68b.EDF	J68	2
38	15778883	15778938	1461	1516	55	RIGHT	J68b.EDF	J68	2
39	15784986	15785067	179	260	81	RIGHT	J68b.EDF	J68	2
40	15794857	15794906	318	367	49	RIGHT	J68b.EDF	J68	2
40	15795974	15796053	1435	1514	79	RIGHT	J68b.EDF	J68	2
41	15803519	15803582	683	746	63	RIGHT	J68b.EDF	J68	2
43	15821087	15821139	1461	1513	52	RIGHT	J68b.EDF	J68	2
44	15826719	15826745	447	473	26	RIGHT	J68b.EDF	J68	2
45	15834970	15835042	494	566	72	RIGHT	J68b.EDF	J68	2
45	15835275	15835361	799	885	86	RIGHT	J68b.EDF	J68	2
46	15842295	15842337	143	185	42	RIGHT	J68b.EDF	J68	2
49	15866677	15866742	124	189	65	RIGHT	J68b.EDF	J68	2
51	15882773	15882839	58	124	66	RIGHT	J68b.EDF	J68	2
53	15898243	15898304	167	228	61	RIGHT	J68b.EDF	J68	2
54	15908149	15908182	307	340	33	RIGHT	J68b.EDF	J68	2
55	15916345	15916406	283	344	61	RIGHT	J68b.EDF	J68	2
55	15919406	15919452	3344	3390	46	RIGHT	J68b.EDF	J68	2
57	15932390	15932424	603	637	34	RIGHT	J68b.EDF	J68	2
59	15947399	15947461	175	237	62	RIGHT	J68b.EDF	J68	2
59	15947735	15947824	511	600	89	RIGHT	J68b.EDF	J68	2
59	15948024	15948130	800	906	106	RIGHT	J68b.EDF	J68	2
59	15948594	15948647	1370	1423	53	RIGHT	J68b.EDF	J68	2
60	15956298	15956355	257	314	57	RIGHT	J68b.EDF	J68	2
61	15964770	15964842	106	178	72	RIGHT	J68b.EDF	J68	2
61	15965241	15965296	577	632	55	RIGHT	J68b.EDF	J68	2
61	15967705	15967733	3041	3069	28	RIGHT	J68b.EDF	J68	2
61	15969376	15969391	4712	4727	15	RIGHT	J68b.EDF	J68	2
61	15969912	15969941	5248	5277	29	RIGHT	J68b.EDF	J68	2
63	15982419	15982479	582	642	60	RIGHT	J68b.EDF	J68	2
64	15989615	15989650	515	550	35	RIGHT	J68b.EDF	J68	2
64	15990302	15990375	1202	1275	73	RIGHT	J68b.EDF	J68	2
65	15997571	15997634	113	176	63	RIGHT	J68b.EDF	J68	2
65	15998273	15998330	815	872	57	RIGHT	J68b.EDF	J68	2
66	16005245	16005325	153	233	80	RIGHT	J68b.EDF	J68	2
67	16014068	16014148	199	279	80	RIGHT	J68b.EDF	J68	2
67	16014700	16014769	831	900	69	RIGHT	J68b.EDF	J68	2
67	16016987	16017038	3118	3169	51	RIGHT	J68b.EDF	J68	2
69	16028142	16028161	57	76	19	RIGHT	J68b.EDF	J68	2
69	16028721	16028788	636	703	67	RIGHT	J68b.EDF	J68	2
70	16035815	16035855	127	167	40	RIGHT	J68b.EDF	J68	2
70	16036153	16036259	465	571	106	RIGHT	J68b.EDF	J68	2
71	16044014	16044036	57	79	22	RIGHT	J68b.EDF	J68	2
71	16044815	16044876	858	919	61	RIGHT	J68b.EDF	J68	2
72	16052290	16052329	102	141	39	RIGHT	J68b.EDF	J68	2
73	16058986	16059033	114	161	47	RIGHT	J68b.EDF	J68	2
74	16067894	16067969	875	950	75	RIGHT	J68b.EDF	J68	2
75	16076206	16076280	220	294	74	RIGHT	J68b.EDF	J68	2
77	16091491	16091572	67	148	81	RIGHT	J68b.EDF	J68	2
78	16099341	16099398	460	517	57	RIGHT	J68b.EDF	J68	2
79	16107286	16107386	212	312	100	RIGHT	J68b.EDF	J68	2
79	16107694	16107778	620	704	84	RIGHT	J68b.EDF	J68	2
79	16108682	16108731	1608	1657	49	RIGHT	J68b.EDF	J68	2
80	16115356	16115429	296	369	73	RIGHT	J68b.EDF	J68	2
81	16124695	16124779	691	775	84	RIGHT	J68b.EDF	J68	2
82	16133002	16133086	372	456	84	RIGHT	J68b.EDF	J68	2
82	16133369	16133459	739	829	90	RIGHT	J68b.EDF	J68	2
83	16140847	16140913	315	381	66	RIGHT	J68b.EDF	J68	2
84	16148480	16148548	122	190	68	RIGHT	J68b.EDF	J68	2
86	16163265	16163352	184	271	87	RIGHT	J68b.EDF	J68	2
86	16163896	16163961	815	880	65	RIGHT	J68b.EDF	J68	2
87	16170287	16170337	232	282	50	RIGHT	J68b.EDF	J68	2
88	16176833	16176879	57	103	46	RIGHT	J68b.EDF	J68	2
88	16177028	16177126	252	350	98	RIGHT	J68b.EDF	J68	2
88	16177432	16177538	656	762	106	RIGHT	J68b.EDF	J68	2
88	16177748	16177871	972	1095	123	RIGHT	J68b.EDF	J68	2
89	16187319	16187404	1157	1242	85	RIGHT	J68b.EDF	J68	2
91	16202674	16202767	571	664	93	RIGHT	J68b.EDF	J68	2
92	16210936	16211002	337	403	66	RIGHT	J68b.EDF	J68	2
92	16211440	16211548	841	949	108	RIGHT	J68b.EDF	J68	2
93	16219219	16219279	57	117	60	RIGHT	J68b.EDF	J68	2
93	16219530	16219628	368	466	98	RIGHT	J68b.EDF	J68	2
93	16219810	16219910	648	748	100	RIGHT	J68b.EDF	J68	2
93	16220101	16220215	939	1053	114	RIGHT	J68b.EDF	J68	2
93	16221949	16222026	2787	2864	77	RIGHT	J68b.EDF	J68	2
93	16223111	16223172	3949	4010	61	RIGHT	J68b.EDF	J68	2
95	16233167	16233259	138	230	92	RIGHT	J68b.EDF	J68	2
96	16239907	16240003	271	367	96	RIGHT	J68b.EDF	J68	2
97	16248650	16248731	439	520	81	RIGHT	J68b.EDF	J68	2
98	16255438	16255541	119	222	103	RIGHT	J68b.EDF	J68	2
100	16272345	16272421	571	647	76	RIGHT	J68b.EDF	J68	2
100	16273046	16273136	1272	1362	90	RIGHT	J68b.EDF	J68	2
101	16279008	16279083	387	462	75	RIGHT	J68b.EDF	J68	2
101	16279288	16279393	667	772	105	RIGHT	J68b.EDF	J68	2
101	16280901	16283943	2280	5322	3042	RIGHT	J68b.EDF	J68	2
102	16285501	16285678	57	234	177	RIGHT	J68b.EDF	J68	2
102	16285760	16285815	316	371	55	RIGHT	J68b.EDF	J68	2
103	16293288	16293349	609	670	61	RIGHT	J68b.EDF	J68	2
104	16300844	16300916	771	843	72	RIGHT	J68b.EDF	J68	2
105	16306732	16306808	212	288	76	RIGHT	J68b.EDF	J68	2
106	16314179	16314248	196	265	69	RIGHT	J68b.EDF	J68	2
106	16314610	16314690	627	707	80	RIGHT	J68b.EDF	J68	2
107	16321657	16321699	322	364	42	RIGHT	J68b.EDF	J68	2
108	16329368	16329451	158	241	83	RIGHT	J68b.EDF	J68	2
110	16345039	16345132	317	410	93	RIGHT	J68b.EDF	J68	2
112	16360141	16360248	272	379	107	RIGHT	J68b.EDF	J68	2
113	16367013	16367117	121	225	104	RIGHT	J68b.EDF	J68	2
114	16376042	16376113	402	473	71	RIGHT	J68b.EDF	J68	2
115	16383366	16383468	253	355	102	RIGHT	J68b.EDF	J68	2
118	16408090	16408198	57	165	108	RIGHT	J68b.EDF	J68	2
118	16409130	16409212	1097	1179	82	RIGHT	J68b.EDF	J68	2
120	16422863	16422980	164	281	117	RIGHT	J68b.EDF	J68	2
1	17277804	17277858	1050	1104	54	RIGHT	J68c.EDF	J68	3
1	17278053	17278127	1299	1373	74	RIGHT	J68c.EDF	J68	3
2	17286437	17286460	57	80	23	RIGHT	J68c.EDF	J68	3
2	17287032	17287127	652	747	95	RIGHT	J68c.EDF	J68	3
2	17287214	17287529	834	1149	315	RIGHT	J68c.EDF	J68	3
3	17294496	17294598	549	651	102	RIGHT	J68c.EDF	J68	3
4	17302811	17302892	671	752	81	RIGHT	J68c.EDF	J68	3
5	17309530	17309619	401	490	89	RIGHT	J68c.EDF	J68	3
6	17317360	17317414	1518	1572	54	RIGHT	J68c.EDF	J68	3
7	17324335	17324435	321	421	100	RIGHT	J68c.EDF	J68	3
7	17324677	17324777	663	763	100	RIGHT	J68c.EDF	J68	3
9	17338160	17338244	255	339	84	RIGHT	J68c.EDF	J68	3
9	17338407	17338523	502	618	116	RIGHT	J68c.EDF	J68	3
9	17338704	17338812	799	907	108	RIGHT	J68c.EDF	J68	3
9	17338834	17338835	929	930	1	RIGHT	J68c.EDF	J68	3
9	17339481	17339574	1576	1669	93	RIGHT	J68c.EDF	J68	3
11	17354523	17354557	58	92	34	RIGHT	J68c.EDF	J68	3
11	17354889	17354988	424	523	99	RIGHT	J68c.EDF	J68	3
11	17355285	17355387	820	922	102	RIGHT	J68c.EDF	J68	3
12	17364129	17364235	358	464	106	RIGHT	J68c.EDF	J68	3
14	17381542	17381637	192	287	95	RIGHT	J68c.EDF	J68	3
14	17381884	17382017	534	667	133	RIGHT	J68c.EDF	J68	3
14	17382336	17382344	986	994	8	RIGHT	J68c.EDF	J68	3
14	17382398	17382626	1048	1276	228	RIGHT	J68c.EDF	J68	3
14	17382663	17382772	1313	1422	109	RIGHT	J68c.EDF	J68	3
14	17382799	17382838	1449	1488	39	RIGHT	J68c.EDF	J68	3
14	17383214	17383231	1864	1881	17	RIGHT	J68c.EDF	J68	3
14	17383267	17383268	1917	1918	1	RIGHT	J68c.EDF	J68	3
14	17383292	17384655	1942	3305	1363	RIGHT	J68c.EDF	J68	3
14	17384684	17384685	3334	3335	1	RIGHT	J68c.EDF	J68	3
14	17384839	17384839	3489	3489	0	RIGHT	J68c.EDF	J68	3
14	17384959	17384959	3609	3609	0	RIGHT	J68c.EDF	J68	3
14	17385033	17385034	3683	3684	1	RIGHT	J68c.EDF	J68	3
14	17385065	17385090	3715	3740	25	RIGHT	J68c.EDF	J68	3
14	17385158	17385158	3808	3808	0	RIGHT	J68c.EDF	J68	3
14	17385953	17385956	4603	4606	3	RIGHT	J68c.EDF	J68	3
14	17386033	17386033	4683	4683	0	RIGHT	J68c.EDF	J68	3
15	17388473	17388499	258	284	26	RIGHT	J68c.EDF	J68	3
15	17388567	17389217	352	1002	650	RIGHT	J68c.EDF	J68	3
15	17389301	17393340	1086	5125	4039	RIGHT	J68c.EDF	J68	3
15	17393364	17393369	5149	5154	5	RIGHT	J68c.EDF	J68	3
15	17393402	17393435	5187	5220	33	RIGHT	J68c.EDF	J68	3
15	17393458	17393575	5243	5360	117	RIGHT	J68c.EDF	J68	3
15	17393621	17393634	5406	5419	13	RIGHT	J68c.EDF	J68	3
15	17393737	17393737	5522	5522	0	RIGHT	J68c.EDF	J68	3
15	17393800	17393803	5585	5588	3	RIGHT	J68c.EDF	J68	3
15	17393984	17393991	5769	5776	7	RIGHT	J68c.EDF	J68	3
15	17394130	17394131	5915	5916	1	RIGHT	J68c.EDF	J68	3
16	17398086	17398248	1369	1531	162	RIGHT	J68c.EDF	J68	3
16	17398271	17398417	1554	1700	146	RIGHT	J68c.EDF	J68	3
16	17398443	17399158	1726	2441	715	RIGHT	J68c.EDF	J68	3
16	17399187	17399190	2470	2473	3	RIGHT	J68c.EDF	J68	3
16	17399214	17399220	2497	2503	6	RIGHT	J68c.EDF	J68	3
16	17399256	17399258	2539	2541	2	RIGHT	J68c.EDF	J68	3
16	17399487	17399499	2770	2782	12	RIGHT	J68c.EDF	J68	3
16	17399637	17399638	2920	2921	1	RIGHT	J68c.EDF	J68	3
17	17404522	17404724	141	343	202	RIGHT	J68c.EDF	J68	3
17	17405190	17405190	809	809	0	RIGHT	J68c.EDF	J68	3
17	17405249	17405269	868	888	20	RIGHT	J68c.EDF	J68	3
17	17405295	17405307	914	926	12	RIGHT	J68c.EDF	J68	3
17	17405342	17405369	961	988	27	RIGHT	J68c.EDF	J68	3
17	17405414	17405414	1033	1033	0	RIGHT	J68c.EDF	J68	3
17	17405452	17405456	1071	1075	4	RIGHT	J68c.EDF	J68	3
17	17405572	17405586	1191	1205	14	RIGHT	J68c.EDF	J68	3
17	17405642	17405642	1261	1261	0	RIGHT	J68c.EDF	J68	3
17	17405694	17405695	1313	1314	1	RIGHT	J68c.EDF	J68	3
17	17406540	17406559	2159	2178	19	RIGHT	J68c.EDF	J68	3
17	17406875	17406875	2494	2494	0	RIGHT	J68c.EDF	J68	3
17	17406920	17406926	2539	2545	6	RIGHT	J68c.EDF	J68	3
18	17412597	17412764	157	324	167	RIGHT	J68c.EDF	J68	3
18	17413030	17413223	590	783	193	RIGHT	J68c.EDF	J68	3
18	17414048	17414048	1608	1608	0	RIGHT	J68c.EDF	J68	3
18	17414111	17414186	1671	1746	75	RIGHT	J68c.EDF	J68	3
18	17414212	17414956	1772	2516	744	RIGHT	J68c.EDF	J68	3
19	17420758	17421464	73	779	706	RIGHT	J68c.EDF	J68	3
19	17421523	17421523	838	838	0	RIGHT	J68c.EDF	J68	3
19	17421578	17424455	893	3770	2877	RIGHT	J68c.EDF	J68	3
19	17424478	17424494	3793	3809	16	RIGHT	J68c.EDF	J68	3
19	17424518	17424518	3833	3833	0	RIGHT	J68c.EDF	J68	3
19	17424715	17424717	4030	4032	2	RIGHT	J68c.EDF	J68	3
19	17424748	17424755	4063	4070	7	RIGHT	J68c.EDF	J68	3
19	17424823	17424839	4138	4154	16	RIGHT	J68c.EDF	J68	3
19	17425401	17425417	4716	4732	16	RIGHT	J68c.EDF	J68	3
19	17425478	17425479	4793	4794	1	RIGHT	J68c.EDF	J68	3
20	17428726	17428726	318	318	0	RIGHT	J68c.EDF	J68	3
20	17428987	17428987	579	579	0	RIGHT	J68c.EDF	J68	3
20	17429060	17429072	652	664	12	RIGHT	J68c.EDF	J68	3
20	17429110	17429239	702	831	129	RIGHT	J68c.EDF	J68	3
20	17429342	17429342	934	934	0	RIGHT	J68c.EDF	J68	3
20	17429489	17430291	1081	1883	802	RIGHT	J68c.EDF	J68	3
20	17430345	17430347	1937	1939	2	RIGHT	J68c.EDF	J68	3
20	17430378	17430379	1970	1971	1	RIGHT	J68c.EDF	J68	3
20	17430425	17431180	2017	2772	755	RIGHT	J68c.EDF	J68	3
20	17431218	17431218	2810	2810	0	RIGHT	J68c.EDF	J68	3
20	17431240	17431267	2832	2859	27	RIGHT	J68c.EDF	J68	3
20	17431292	17431317	2884	2909	25	RIGHT	J68c.EDF	J68	3
20	17431344	17431346	2936	2938	2	RIGHT	J68c.EDF	J68	3
20	17431374	17431390	2966	2982	16	RIGHT	J68c.EDF	J68	3
20	17431436	17431438	3028	3030	2	RIGHT	J68c.EDF	J68	3
20	17431517	17431535	3109	3127	18	RIGHT	J68c.EDF	J68	3
20	17431801	17431801	3393	3393	0	RIGHT	J68c.EDF	J68	3
20	17432281	17432283	3873	3875	2	RIGHT	J68c.EDF	J68	3
20	17432314	17432330	3906	3922	16	RIGHT	J68c.EDF	J68	3
20	17432371	17432393	3963	3985	22	RIGHT	J68c.EDF	J68	3
21	17441294	17441432	3831	3969	138	RIGHT	J68c.EDF	J68	3
21	17441464	17441465	4001	4002	1	RIGHT	J68c.EDF	J68	3
21	17441496	17441584	4033	4121	88	RIGHT	J68c.EDF	J68	3
21	17441609	17441609	4146	4146	0	RIGHT	J68c.EDF	J68	3
21	17441637	17441846	4174	4383	209	RIGHT	J68c.EDF	J68	3
21	17441876	17441888	4413	4425	12	RIGHT	J68c.EDF	J68	3
22	17445456	17447250	65	1859	1794	RIGHT	J68c.EDF	J68	3
22	17447272	17448085	1881	2694	813	RIGHT	J68c.EDF	J68	3
22	17448120	17448133	2729	2742	13	RIGHT	J68c.EDF	J68	3
22	17448155	17448155	2764	2764	0	RIGHT	J68c.EDF	J68	3
22	17448998	17449000	3607	3609	2	RIGHT	J68c.EDF	J68	3
22	17449033	17449056	3642	3665	23	RIGHT	J68c.EDF	J68	3
22	17449080	17449133	3689	3742	53	RIGHT	J68c.EDF	J68	3
22	17449156	17449172	3765	3781	16	RIGHT	J68c.EDF	J68	3
22	17449196	17449354	3805	3963	158	RIGHT	J68c.EDF	J68	3
22	17449398	17449406	4007	4015	8	RIGHT	J68c.EDF	J68	3
22	17449427	17449450	4036	4059	23	RIGHT	J68c.EDF	J68	3
22	17449473	17449476	4082	4085	3	RIGHT	J68c.EDF	J68	3
22	17449504	17449504	4113	4113	0	RIGHT	J68c.EDF	J68	3
22	17449535	17449536	4144	4145	1	RIGHT	J68c.EDF	J68	3
22	17449600	17449601	4209	4210	1	RIGHT	J68c.EDF	J68	3
22	17449673	17449674	4282	4283	1	RIGHT	J68c.EDF	J68	3
22	17449723	17449735	4332	4344	12	RIGHT	J68c.EDF	J68	3
22	17449816	17449818	4425	4427	2	RIGHT	J68c.EDF	J68	3
22	17449859	17449875	4468	4484	16	RIGHT	J68c.EDF	J68	3
22	17449911	17449957	4520	4566	46	RIGHT	J68c.EDF	J68	3
23	17452564	17453052	63	551	488	RIGHT	J68c.EDF	J68	3
23	17453248	17453249	747	748	1	RIGHT	J68c.EDF	J68	3
23	17456500	17456516	3999	4015	16	RIGHT	J68c.EDF	J68	3
23	17456546	17456548	4045	4047	2	RIGHT	J68c.EDF	J68	3
23	17456628	17456629	4127	4128	1	RIGHT	J68c.EDF	J68	3
23	17456689	17456690	4188	4189	1	RIGHT	J68c.EDF	J68	3
23	17456718	17456718	4217	4217	0	RIGHT	J68c.EDF	J68	3
23	17456760	17456765	4259	4264	5	RIGHT	J68c.EDF	J68	3
23	17456807	17456807	4306	4306	0	RIGHT	J68c.EDF	J68	3
24	17460334	17460673	61	400	339	RIGHT	J68c.EDF	J68	3
24	17460694	17461212	421	939	518	RIGHT	J68c.EDF	J68	3
24	17461993	17461993	1720	1720	0	RIGHT	J68c.EDF	J68	3
24	17462126	17462147	1853	1874	21	RIGHT	J68c.EDF	J68	3
24	17462173	17462331	1900	2058	158	RIGHT	J68c.EDF	J68	3
24	17462373	17462384	2100	2111	11	RIGHT	J68c.EDF	J68	3
24	17462420	17462421	2147	2148	1	RIGHT	J68c.EDF	J68	3
24	17462451	17462470	2178	2197	19	RIGHT	J68c.EDF	J68	3
24	17462493	17462493	2220	2220	0	RIGHT	J68c.EDF	J68	3
24	17462521	17462542	2248	2269	21	RIGHT	J68c.EDF	J68	3
24	17462589	17462593	2316	2320	4	RIGHT	J68c.EDF	J68	3
24	17462617	17462659	2344	2386	42	RIGHT	J68c.EDF	J68	3
25	17466836	17467454	63	681	618	RIGHT	J68c.EDF	J68	3
25	17467489	17467555	716	782	66	RIGHT	J68c.EDF	J68	3
25	17467582	17467582	809	809	0	RIGHT	J68c.EDF	J68	3
25	17467614	17467707	841	934	93	RIGHT	J68c.EDF	J68	3
25	17467730	17467760	957	987	30	RIGHT	J68c.EDF	J68	3
25	17467799	17467802	1026	1029	3	RIGHT	J68c.EDF	J68	3
25	17467865	17469521	1092	2748	1656	RIGHT	J68c.EDF	J68	3
25	17469546	17469585	2773	2812	39	RIGHT	J68c.EDF	J68	3
25	17469878	17469878	3105	3105	0	RIGHT	J68c.EDF	J68	3
25	17471637	17471638	4864	4865	1	RIGHT	J68c.EDF	J68	3
25	17471696	17471698	4923	4925	2	RIGHT	J68c.EDF	J68	3
25	17471768	17471822	4995	5049	54	RIGHT	J68c.EDF	J68	3
25	17471847	17471849	5074	5076	2	RIGHT	J68c.EDF	J68	3
25	17472234	17472234	5461	5461	0	RIGHT	J68c.EDF	J68	3
26	17476061	17476107	72	118	46	RIGHT	J68c.EDF	J68	3
26	17476201	17477365	212	1376	1164	RIGHT	J68c.EDF	J68	3
26	17477844	17483062	1855	7073	5218	RIGHT	J68c.EDF	J68	3
27	17484727	17484729	412	414	2	RIGHT	J68c.EDF	J68	3
27	17484986	17485091	671	776	105	RIGHT	J68c.EDF	J68	3
27	17485535	17485541	1220	1226	6	RIGHT	J68c.EDF	J68	3
27	17485575	17485575	1260	1260	0	RIGHT	J68c.EDF	J68	3
28	17492555	17492668	219	332	113	RIGHT	J68c.EDF	J68	3
30	17508813	17508928	924	1039	115	RIGHT	J68c.EDF	J68	3
31	17515042	17515136	74	168	94	RIGHT	J68c.EDF	J68	3
32	17524030	17524117	533	620	87	RIGHT	J68c.EDF	J68	3
34	17540541	17540646	142	247	105	RIGHT	J68c.EDF	J68	3
34	17543496	17543561	3097	3162	65	RIGHT	J68c.EDF	J68	3
35	17547564	17547634	105	175	70	RIGHT	J68c.EDF	J68	3
36	17555235	17555304	98	167	69	RIGHT	J68c.EDF	J68	3
39	17581004	17581091	61	148	87	RIGHT	J68c.EDF	J68	3
39	17581584	17581649	641	706	65	RIGHT	J68c.EDF	J68	3
41	17597375	17597445	121	191	70	RIGHT	J68c.EDF	J68	3
42	17606510	17606576	612	678	66	RIGHT	J68c.EDF	J68	3
44	17620976	17621060	151	235	84	RIGHT	J68c.EDF	J68	3
44	17621565	17621651	740	826	86	RIGHT	J68c.EDF	J68	3
45	17629340	17629388	348	396	48	RIGHT	J68c.EDF	J68	3
45	17629703	17629783	711	791	80	RIGHT	J68c.EDF	J68	3
46	17635981	17636029	92	140	48	RIGHT	J68c.EDF	J68	3
47	17644590	17644625	469	504	35	RIGHT	J68c.EDF	J68	3
47	17645014	17645080	893	959	66	RIGHT	J68c.EDF	J68	3
49	17661000	17661064	128	192	64	RIGHT	J68c.EDF	J68	3
50	17668010	17668087	73	150	77	RIGHT	J68c.EDF	J68	3
51	17675103	17675141	92	130	38	RIGHT	J68c.EDF	J68	3
54	17697736	17697804	201	269	68	RIGHT	J68c.EDF	J68	3
54	17698228	17698284	693	749	56	RIGHT	J68c.EDF	J68	3
57	17721019	17721058	79	118	39	RIGHT	J68c.EDF	J68	3
59	17735874	17735923	208	257	49	RIGHT	J68c.EDF	J68	3
62	17762505	17762541	289	325	36	RIGHT	J68c.EDF	J68	3
63	17771257	17771471	115	329	214	RIGHT	J68c.EDF	J68	3
63	17771587	17771597	445	455	10	RIGHT	J68c.EDF	J68	3
63	17771623	17771660	481	518	37	RIGHT	J68c.EDF	J68	3
63	17771750	17771907	608	765	157	RIGHT	J68c.EDF	J68	3
63	17771928	17772002	786	860	74	RIGHT	J68c.EDF	J68	3
63	17772110	17772367	968	1225	257	RIGHT	J68c.EDF	J68	3
63	17772808	17773037	1666	1895	229	RIGHT	J68c.EDF	J68	3
63	17773259	17773329	2117	2187	70	RIGHT	J68c.EDF	J68	3
63	17773666	17773785	2524	2643	119	RIGHT	J68c.EDF	J68	3
63	17774095	17774140	2953	2998	45	RIGHT	J68c.EDF	J68	3
63	17774611	17774704	3469	3562	93	RIGHT	J68c.EDF	J68	3
65	17786673	17786802	82	211	129	RIGHT	J68c.EDF	J68	3
66	17793517	17793594	63	140	77	RIGHT	J68c.EDF	J68	3
67	17803672	17803786	772	886	114	RIGHT	J68c.EDF	J68	3
67	17804648	17804723	1748	1823	75	RIGHT	J68c.EDF	J68	3
67	17806457	17806530	3557	3630	73	RIGHT	J68c.EDF	J68	3
67	17806553	17806554	3653	3654	1	RIGHT	J68c.EDF	J68	3
67	17807137	17807204	4237	4304	67	RIGHT	J68c.EDF	J68	3
67	17808456	17808539	5556	5639	83	RIGHT	J68c.EDF	J68	3
69	17820093	17820221	163	291	128	RIGHT	J68c.EDF	J68	3
70	17828103	17828171	876	944	68	RIGHT	J68c.EDF	J68	3
71	17836046	17836124	345	423	78	RIGHT	J68c.EDF	J68	3
71	17836162	17836882	461	1181	720	RIGHT	J68c.EDF	J68	3
72	17845137	17845263	659	785	126	RIGHT	J68c.EDF	J68	3
73	17852865	17852992	373	500	127	RIGHT	J68c.EDF	J68	3
73	17853560	17853655	1068	1163	95	RIGHT	J68c.EDF	J68	3
74	17861119	17861247	193	321	128	RIGHT	J68c.EDF	J68	3
74	17861538	17861693	612	767	155	RIGHT	J68c.EDF	J68	3
75	17871948	17872055	269	376	107	RIGHT	J68c.EDF	J68	3
75	17872422	17872532	743	853	110	RIGHT	J68c.EDF	J68	3
76	17880153	17880257	767	871	104	RIGHT	J68c.EDF	J68	3
77	17887398	17887520	136	258	122	RIGHT	J68c.EDF	J68	3
77	17888003	17888115	741	853	112	RIGHT	J68c.EDF	J68	3
78	17895855	17895995	77	217	140	RIGHT	J68c.EDF	J68	3
78	17896340	17896484	562	706	144	RIGHT	J68c.EDF	J68	3
78	17898583	17898693	2805	2915	110	RIGHT	J68c.EDF	J68	3
79	17903330	17903439	519	628	109	RIGHT	J68c.EDF	J68	3
80	17912117	17912209	399	491	92	RIGHT	J68c.EDF	J68	3
81	17920768	17920926	75	233	158	RIGHT	J68c.EDF	J68	3
81	17921334	17921479	641	786	145	RIGHT	J68c.EDF	J68	3
82	17928876	17928941	480	545	65	RIGHT	J68c.EDF	J68	3
85	17951718	17951806	395	483	88	RIGHT	J68c.EDF	J68	3
85	17953843	17953932	2520	2609	89	RIGHT	J68c.EDF	J68	3
85	17956946	17957033	5623	5710	87	RIGHT	J68c.EDF	J68	3
87	17968488	17968600	266	378	112	RIGHT	J68c.EDF	J68	3
89	17983352	17983461	802	911	109	RIGHT	J68c.EDF	J68	3
90	17991467	17991569	260	362	102	RIGHT	J68c.EDF	J68	3
90	17991862	17991982	655	775	120	RIGHT	J68c.EDF	J68	3
90	17992346	17992453	1139	1246	107	RIGHT	J68c.EDF	J68	3
91	17999216	17999320	76	180	104	RIGHT	J68c.EDF	J68	3
91	17999343	17999346	203	206	3	RIGHT	J68c.EDF	J68	3
91	17999867	17999978	727	838	111	RIGHT	J68c.EDF	J68	3
91	18004184	18004216	5044	5076	32	RIGHT	J68c.EDF	J68	3
91	18004241	18004241	5101	5101	0	RIGHT	J68c.EDF	J68	3
92	18006791	18006873	83	165	82	RIGHT	J68c.EDF	J68	3
92	18007300	18007391	592	683	91	RIGHT	J68c.EDF	J68	3
95	18028289	18028412	535	658	123	RIGHT	J68c.EDF	J68	3
95	18028654	18028757	900	1003	103	RIGHT	J68c.EDF	J68	3
96	18036852	18036955	295	398	103	RIGHT	J68c.EDF	J68	3
97	18043326	18043452	57	183	126	RIGHT	J68c.EDF	J68	3
98	18052852	18052967	105	220	115	RIGHT	J68c.EDF	J68	3
98	18053292	18053371	545	624	79	RIGHT	J68c.EDF	J68	3
99	18060938	18061078	246	386	140	RIGHT	J68c.EDF	J68	3
99	18067251	18067260	6559	6568	9	RIGHT	J68c.EDF	J68	3
99	18067325	18067342	6633	6650	17	RIGHT	J68c.EDF	J68	3
100	18069752	18069890	141	279	138	RIGHT	J68c.EDF	J68	3
100	18070154	18070288	543	677	134	RIGHT	J68c.EDF	J68	3
100	18072512	18072564	2901	2953	52	RIGHT	J68c.EDF	J68	3
101	18077505	18077627	57	179	122	RIGHT	J68c.EDF	J68	3
101	18077918	18078061	470	613	143	RIGHT	J68c.EDF	J68	3
101	18078089	18078095	641	647	6	RIGHT	J68c.EDF	J68	3
101	18078175	18078355	727	907	180	RIGHT	J68c.EDF	J68	3
102	18086182	18086346	210	374	164	RIGHT	J68c.EDF	J68	3
104	18103783	18104209	207	633	426	RIGHT	J68c.EDF	J68	3
104	18105410	18105411	1834	1835	1	RIGHT	J68c.EDF	J68	3
105	18112246	18112390	365	509	144	RIGHT	J68c.EDF	J68	3
105	18112671	18112806	790	925	135	RIGHT	J68c.EDF	J68	3
111	18158825	18158956	76	207	131	RIGHT	J68c.EDF	J68	3
111	18159090	18159179	341	430	89	RIGHT	J68c.EDF	J68	3
111	18159268	18159361	519	612	93	RIGHT	J68c.EDF	J68	3
112	18166222	18166340	129	247	118	RIGHT	J68c.EDF	J68	3
114	18185569	18185670	191	292	101	RIGHT	J68c.EDF	J68	3
115	18194730	18194867	769	906	137	RIGHT	J68c.EDF	J68	3
116	18202437	18202570	541	674	133	RIGHT	J68c.EDF	J68	3
117	18215556	18215635	3872	3951	79	RIGHT	J68c.EDF	J68	3
118	18218825	18219076	57	308	251	RIGHT	J68c.EDF	J68	3
118	18219117	18219339	349	571	222	RIGHT	J68c.EDF	J68	3
118	18219523	18224318	755	5550	4795	RIGHT	J68c.EDF	J68	3
120	18234137	18234201	867	931	64	RIGHT	J68c.EDF	J68	3
3	1951517	1951528	106	117	11	RIGHT	K21a.EDF	K21	1
5	1967386	1967491	1006	1111	105	RIGHT	K21a.EDF	K21	1
9	1999998	2000052	166	220	54	RIGHT	K21a.EDF	K21	1
17	2066502	2066544	108	150	42	RIGHT	K21a.EDF	K21	1
18	2076092	2076449	57	414	357	RIGHT	K21a.EDF	K21	1
18	2076727	2076799	692	764	72	RIGHT	K21a.EDF	K21	1
21	2099886	2099929	283	326	43	RIGHT	K21a.EDF	K21	1
22	2107790	2107825	125	160	35	RIGHT	K21a.EDF	K21	1
22	2107987	2108119	322	454	132	RIGHT	K21a.EDF	K21	1
25	2132595	2132662	221	288	67	RIGHT	K21a.EDF	K21	1
25	2132876	2132940	502	566	64	RIGHT	K21a.EDF	K21	1
32	2190460	2190494	184	218	34	RIGHT	K21a.EDF	K21	1
33	2200885	2200893	2204	2212	8	RIGHT	K21a.EDF	K21	1
37	2229517	2229559	114	156	42	RIGHT	K21a.EDF	K21	1
38	2236810	2236855	101	146	45	RIGHT	K21a.EDF	K21	1
44	2284744	2284807	57	120	63	RIGHT	K21a.EDF	K21	1
46	2300272	2300321	57	106	49	RIGHT	K21a.EDF	K21	1
46	2300491	2300537	276	322	46	RIGHT	K21a.EDF	K21	1
46	2301047	2301120	832	905	73	RIGHT	K21a.EDF	K21	1
50	2333973	2334020	255	302	47	RIGHT	K21a.EDF	K21	1
71	2498099	2498109	70	80	10	RIGHT	K21a.EDF	K21	1
71	2498282	2498310	253	281	28	RIGHT	K21a.EDF	K21	1
73	2514286	2514311	219	244	25	RIGHT	K21a.EDF	K21	1
78	2554208	2554293	138	223	85	RIGHT	K21a.EDF	K21	1
78	2554445	2554489	375	419	44	RIGHT	K21a.EDF	K21	1
81	2577556	2577586	57	87	30	RIGHT	K21a.EDF	K21	1
90	2646041	2646089	184	232	48	RIGHT	K21a.EDF	K21	1
90	2648223	2648317	2366	2460	94	RIGHT	K21a.EDF	K21	1
90	2648470	2648549	2613	2692	79	RIGHT	K21a.EDF	K21	1
90	2649531	2649605	3674	3748	74	RIGHT	K21a.EDF	K21	1
4	159266	159322	261	317	56	RIGHT	K21b.EDF	K21	2
5	167196	167223	57	84	27	RIGHT	K21b.EDF	K21	2
11	215774	215860	749	835	86	RIGHT	K21b.EDF	K21	2
11	217394	217475	2369	2450	81	RIGHT	K21b.EDF	K21	2
11	218441	218509	3416	3484	68	RIGHT	K21b.EDF	K21	2
13	231336	231377	547	588	41	RIGHT	K21b.EDF	K21	2
14	240027	240127	583	683	100	RIGHT	K21b.EDF	K21	2
16	258744	258822	2313	2391	78	RIGHT	K21b.EDF	K21	2
16	261333	261376	4902	4945	43	RIGHT	K21b.EDF	K21	2
16	261839	261910	5408	5479	71	RIGHT	K21b.EDF	K21	2
18	272854	272927	410	483	73	RIGHT	K21b.EDF	K21	2
19	278883	278974	57	148	91	RIGHT	K21b.EDF	K21	2
19	279149	279224	323	398	75	RIGHT	K21b.EDF	K21	2
20	287262	287329	592	659	67	RIGHT	K21b.EDF	K21	2
21	296770	296835	2091	2156	65	RIGHT	K21b.EDF	K21	2
21	299017	299090	4338	4411	73	RIGHT	K21b.EDF	K21	2
22	303057	303160	794	897	103	RIGHT	K21b.EDF	K21	2
25	325927	325972	464	509	45	RIGHT	K21b.EDF	K21	2
28	349649	349716	548	615	67	RIGHT	K21b.EDF	K21	2
28	351451	351556	2350	2455	105	RIGHT	K21b.EDF	K21	2
28	351687	351776	2586	2675	89	RIGHT	K21b.EDF	K21	2
30	366514	366562	2284	2332	48	RIGHT	K21b.EDF	K21	2
31	372905	372963	208	266	58	RIGHT	K21b.EDF	K21	2
32	381891	381933	632	674	42	RIGHT	K21b.EDF	K21	2
35	406872	406925	2497	2550	53	RIGHT	K21b.EDF	K21	2
35	407432	407477	3057	3102	45	RIGHT	K21b.EDF	K21	2
35	408379	408456	4004	4081	77	RIGHT	K21b.EDF	K21	2
37	421945	421950	2335	2340	5	RIGHT	K21b.EDF	K21	2
39	437968	438016	2377	2425	48	RIGHT	K21b.EDF	K21	2
39	438037	438040	2446	2449	3	RIGHT	K21b.EDF	K21	2
40	442907	442968	291	352	61	RIGHT	K21b.EDF	K21	2
41	451592	451659	229	296	67	RIGHT	K21b.EDF	K21	2
42	457865	457947	156	238	82	RIGHT	K21b.EDF	K21	2
42	458447	464333	738	6624	5886	RIGHT	K21b.EDF	K21	2
43	468127	468197	2332	2402	70	RIGHT	K21b.EDF	K21	2
43	468900	468921	3105	3126	21	RIGHT	K21b.EDF	K21	2
43	469253	469334	3458	3539	81	RIGHT	K21b.EDF	K21	2
44	473926	473990	782	846	64	RIGHT	K21b.EDF	K21	2
47	496476	496505	374	403	29	RIGHT	K21b.EDF	K21	2
50	519319	519411	264	356	92	RIGHT	K21b.EDF	K21	2
50	520092	520213	1037	1158	121	RIGHT	K21b.EDF	K21	2
51	529360	529405	2261	2306	45	RIGHT	K21b.EDF	K21	2
51	531591	531625	4492	4526	34	RIGHT	K21b.EDF	K21	2
52	536309	536331	517	539	22	RIGHT	K21b.EDF	K21	2
53	546467	546468	2800	2801	1	RIGHT	K21b.EDF	K21	2
54	552706	552793	190	277	87	RIGHT	K21b.EDF	K21	2
55	561172	561339	379	546	167	RIGHT	K21b.EDF	K21	2
59	594476	594586	275	385	110	RIGHT	K21b.EDF	K21	2
61	608514	608579	184	249	65	RIGHT	K21b.EDF	K21	2
63	622905	623000	195	290	95	RIGHT	K21b.EDF	K21	2
64	631740	635829	1056	5145	4089	RIGHT	K21b.EDF	K21	2
65	637753	640302	57	2606	2549	RIGHT	K21b.EDF	K21	2
67	654152	654280	428	556	128	RIGHT	K21b.EDF	K21	2
69	669492	669601	398	507	109	RIGHT	K21b.EDF	K21	2
71	685297	685348	57	108	51	RIGHT	K21b.EDF	K21	2
71	687659	687753	2419	2513	94	RIGHT	K21b.EDF	K21	2
71	688595	688706	3355	3466	111	RIGHT	K21b.EDF	K21	2
72	696242	696301	2403	2462	59	RIGHT	K21b.EDF	K21	2
73	702495	702622	812	939	127	RIGHT	K21b.EDF	K21	2
75	714974	715083	63	172	109	RIGHT	K21b.EDF	K21	2
75	715109	715115	198	204	6	RIGHT	K21b.EDF	K21	2
75	715391	715524	480	613	133	RIGHT	K21b.EDF	K21	2
76	722522	722603	290	371	81	RIGHT	K21b.EDF	K21	2
76	724314	724407	2082	2175	93	RIGHT	K21b.EDF	K21	2
76	724601	724740	2369	2508	139	RIGHT	K21b.EDF	K21	2
76	725406	725532	3174	3300	126	RIGHT	K21b.EDF	K21	2
77	730804	730915	638	749	111	RIGHT	K21b.EDF	K21	2
78	736819	736912	290	383	93	RIGHT	K21b.EDF	K21	2
78	739105	739212	2576	2683	107	RIGHT	K21b.EDF	K21	2
78	739371	739479	2842	2950	108	RIGHT	K21b.EDF	K21	2
78	740456	740562	3927	4033	106	RIGHT	K21b.EDF	K21	2
78	742707	742783	6178	6254	76	RIGHT	K21b.EDF	K21	2
79	744922	745119	150	347	197	RIGHT	K21b.EDF	K21	2
81	760377	760468	175	266	91	RIGHT	K21b.EDF	K21	2
81	762966	763026	2764	2824	60	RIGHT	K21b.EDF	K21	2
83	775107	775219	382	494	112	RIGHT	K21b.EDF	K21	2
84	781865	781921	111	167	56	RIGHT	K21b.EDF	K21	2
86	795812	795870	349	407	58	RIGHT	K21b.EDF	K21	2
87	803201	803267	181	247	66	RIGHT	K21b.EDF	K21	2
88	811242	811407	127	292	165	RIGHT	K21b.EDF	K21	2
88	811787	811946	672	831	159	RIGHT	K21b.EDF	K21	2
90	824803	824891	133	221	88	RIGHT	K21b.EDF	K21	2
91	831838	831895	910	967	57	RIGHT	K21b.EDF	K21	2
92	837717	837826	239	348	109	RIGHT	K21b.EDF	K21	2
93	845211	845327	248	364	116	RIGHT	K21b.EDF	K21	2
94	853141	853254	460	573	113	RIGHT	K21b.EDF	K21	2
94	854816	854936	2135	2255	120	RIGHT	K21b.EDF	K21	2
94	855307	855439	2626	2758	132	RIGHT	K21b.EDF	K21	2
95	861482	861555	727	800	73	RIGHT	K21b.EDF	K21	2
96	869087	869166	116	195	79	RIGHT	K21b.EDF	K21	2
96	869389	869528	418	557	139	RIGHT	K21b.EDF	K21	2
3	1151362	1151427	2439	2504	65	RIGHT	K21c.EDF	K21	3
4	1160111	1160118	2482	2489	7	RIGHT	K21c.EDF	K21	3
4	1161675	1161751	4046	4122	76	RIGHT	K21c.EDF	K21	3
5	1167107	1167214	1024	1131	107	RIGHT	K21c.EDF	K21	3
8	1192065	1192178	678	791	113	RIGHT	K21c.EDF	K21	3
9	1198551	1198673	205	327	122	RIGHT	K21c.EDF	K21	3
13	1228206	1228293	618	705	87	RIGHT	K21c.EDF	K21	3
14	1236197	1236224	58	85	27	RIGHT	K21c.EDF	K21	3
15	1246613	1246685	2425	2497	72	RIGHT	K21c.EDF	K21	3
16	1255310	1255364	2907	2961	54	RIGHT	K21c.EDF	K21	3
17	1259395	1259434	58	97	39	RIGHT	K21c.EDF	K21	3
17	1262488	1262517	3151	3180	29	RIGHT	K21c.EDF	K21	3
19	1273917	1274005	94	182	88	RIGHT	K21c.EDF	K21	3
20	1282748	1282831	83	166	83	RIGHT	K21c.EDF	K21	3
20	1283156	1283228	491	563	72	RIGHT	K21c.EDF	K21	3
21	1293777	1293853	3341	3417	76	RIGHT	K21c.EDF	K21	3
24	1312859	1312923	148	212	64	RIGHT	K21c.EDF	K21	3
25	1323205	1323231	2766	2792	26	RIGHT	K21c.EDF	K21	3
31	1368560	1368650	249	339	90	RIGHT	K21c.EDF	K21	3
33	1384831	1384883	542	594	52	RIGHT	K21c.EDF	K21	3
33	1385126	1385236	837	947	110	RIGHT	K21c.EDF	K21	3
34	1391720	1391754	191	225	34	RIGHT	K21c.EDF	K21	3
35	1400644	1400688	2868	2912	44	RIGHT	K21c.EDF	K21	3
36	1405165	1405235	216	286	70	RIGHT	K21c.EDF	K21	3
36	1406969	1407092	2020	2143	123	RIGHT	K21c.EDF	K21	3
36	1407471	1407611	2522	2662	140	RIGHT	K21c.EDF	K21	3
36	1408360	1408477	3411	3528	117	RIGHT	K21c.EDF	K21	3
37	1412504	1412601	461	558	97	RIGHT	K21c.EDF	K21	3
38	1421413	1421451	2966	3004	38	RIGHT	K21c.EDF	K21	3
40	1432682	1432727	204	249	45	RIGHT	K21c.EDF	K21	3
42	1446108	1446152	151	195	44	RIGHT	K21c.EDF	K21	3
42	1448587	1448674	2630	2717	87	RIGHT	K21c.EDF	K21	3
42	1449998	1450082	4041	4125	84	RIGHT	K21c.EDF	K21	3
44	1461930	1461996	592	658	66	RIGHT	K21c.EDF	K21	3
45	1468860	1468950	503	593	90	RIGHT	K21c.EDF	K21	3
47	1482508	1482584	142	218	76	RIGHT	K21c.EDF	K21	3
48	1489303	1489309	80	86	6	RIGHT	K21c.EDF	K21	3
48	1491532	1491616	2309	2393	84	RIGHT	K21c.EDF	K21	3
48	1491641	1491643	2418	2420	2	RIGHT	K21c.EDF	K21	3
48	1492515	1492616	3292	3393	101	RIGHT	K21c.EDF	K21	3
49	1495898	1496002	276	380	104	RIGHT	K21c.EDF	K21	3
50	1503209	1503295	116	202	86	RIGHT	K21c.EDF	K21	3
51	1511188	1511481	58	351	293	RIGHT	K21c.EDF	K21	3
51	1511602	1511706	472	576	104	RIGHT	K21c.EDF	K21	3
51	1513406	1513506	2276	2376	100	RIGHT	K21c.EDF	K21	3
51	1515809	1515862	4679	4732	53	RIGHT	K21c.EDF	K21	3
53	1526718	1526827	262	371	109	RIGHT	K21c.EDF	K21	3
53	1528827	1528883	2371	2427	56	RIGHT	K21c.EDF	K21	3
57	1555940	1555996	57	113	56	RIGHT	K21c.EDF	K21	3
57	1559474	1559497	3591	3614	23	RIGHT	K21c.EDF	K21	3
60	1579552	1579627	213	288	75	RIGHT	K21c.EDF	K21	3
62	1595724	1595842	216	334	118	RIGHT	K21c.EDF	K21	3
64	1609047	1609128	293	374	81	RIGHT	K21c.EDF	K21	3
65	1617073	1617205	100	232	132	RIGHT	K21c.EDF	K21	3
70	1652470	1652538	57	125	68	RIGHT	K21c.EDF	K21	3
70	1652671	1652744	258	331	73	RIGHT	K21c.EDF	K21	3
71	1660333	1660364	58	89	31	RIGHT	K21c.EDF	K21	3
71	1660891	1661007	616	732	116	RIGHT	K21c.EDF	K21	3
72	1668662	1668805	399	542	143	RIGHT	K21c.EDF	K21	3
73	1675859	1675942	370	453	83	RIGHT	K21c.EDF	K21	3
74	1683660	1683779	477	596	119	RIGHT	K21c.EDF	K21	3
75	1690362	1690409	529	576	47	RIGHT	K21c.EDF	K21	3
75	1692412	1692551	2579	2718	139	RIGHT	K21c.EDF	K21	3
75	1692784	1692863	2951	3030	79	RIGHT	K21c.EDF	K21	3
75	1693749	1693846	3916	4013	97	RIGHT	K21c.EDF	K21	3
76	1696860	1696954	59	153	94	RIGHT	K21c.EDF	K21	3
77	1706843	1706911	2596	2664	68	RIGHT	K21c.EDF	K21	3
79	1722733	1722829	225	321	96	RIGHT	K21c.EDF	K21	3
79	1725438	1725468	2930	2960	30	RIGHT	K21c.EDF	K21	3
81	1739163	1739224	336	397	61	RIGHT	K21c.EDF	K21	3
82	1748536	1748643	727	834	107	RIGHT	K21c.EDF	K21	3
83	1755484	1755557	57	130	73	RIGHT	K21c.EDF	K21	3
84	1764246	1764383	418	555	137	RIGHT	K21c.EDF	K21	3
85	1771512	1771618	137	243	106	RIGHT	K21c.EDF	K21	3
86	1780567	1780638	194	265	71	RIGHT	K21c.EDF	K21	3
86	1783265	1783341	2892	2968	76	RIGHT	K21c.EDF	K21	3
86	1785099	1785222	4726	4849	123	RIGHT	K21c.EDF	K21	3
87	1786904	1786987	90	173	83	RIGHT	K21c.EDF	K21	3
88	1796248	1796359	637	748	111	RIGHT	K21c.EDF	K21	3
88	1798158	1798218	2547	2607	60	RIGHT	K21c.EDF	K21	3
88	1798241	1798245	2630	2634	4	RIGHT	K21c.EDF	K21	3
89	1804611	1804637	57	83	26	RIGHT	K21c.EDF	K21	3
89	1804911	1805016	357	462	105	RIGHT	K21c.EDF	K21	3
91	1822418	1822523	69	174	105	RIGHT	K21c.EDF	K21	3
92	1830781	1830806	57	82	25	RIGHT	K21c.EDF	K21	3
92	1831206	1831328	482	604	122	RIGHT	K21c.EDF	K21	3
92	1833210	1833368	2486	2644	158	RIGHT	K21c.EDF	K21	3
92	1834275	1834385	3551	3661	110	RIGHT	K21c.EDF	K21	3
96	1860200	1860289	137	226	89	RIGHT	K21c.EDF	K21	3
1	14184356	14184358	1203	1205	2	RIGHT	K27.EDF	K27	.
1	14184576	14184653	1423	1500	77	RIGHT	K27.EDF	K27	.
2	14190888	14190992	57	161	104	RIGHT	K27.EDF	K27	.
2	14191356	14191507	525	676	151	RIGHT	K27.EDF	K27	.
2	14191749	14191809	918	978	60	RIGHT	K27.EDF	K27	.
2	14192070	14192115	1239	1284	45	RIGHT	K27.EDF	K27	.
2	14192454	14192473	1623	1642	19	RIGHT	K27.EDF	K27	.
3	14198324	14198736	57	469	412	RIGHT	K27.EDF	K27	.
4	14207462	14207556	70	164	94	RIGHT	K27.EDF	K27	.
4	14207648	14207748	256	356	100	RIGHT	K27.EDF	K27	.
4	14207869	14207934	477	542	65	RIGHT	K27.EDF	K27	.
4	14208071	14208140	679	748	69	RIGHT	K27.EDF	K27	.
4	14208295	14208380	903	988	85	RIGHT	K27.EDF	K27	.
5	14216497	14216596	58	157	99	RIGHT	K27.EDF	K27	.
5	14217008	14217072	569	633	64	RIGHT	K27.EDF	K27	.
6	14223182	14223182	175	175	0	RIGHT	K27.EDF	K27	.
6	14223365	14223378	358	371	13	RIGHT	K27.EDF	K27	.
6	14223746	14223755	739	748	9	RIGHT	K27.EDF	K27	.
6	14223783	14223810	776	803	27	RIGHT	K27.EDF	K27	.
6	14223959	14224034	952	1027	75	RIGHT	K27.EDF	K27	.
6	14224171	14224235	1164	1228	64	RIGHT	K27.EDF	K27	.
6	14224510	14224593	1503	1586	83	RIGHT	K27.EDF	K27	.
6	14229254	14229257	6247	6250	3	RIGHT	K27.EDF	K27	.
6	14229278	14229284	6271	6277	6	RIGHT	K27.EDF	K27	.
7	14231091	14231171	212	292	80	RIGHT	K27.EDF	K27	.
8	14237977	14238126	57	206	149	RIGHT	K27.EDF	K27	.
8	14238375	14238525	455	605	150	RIGHT	K27.EDF	K27	.
9	14245466	14245894	57	485	428	RIGHT	K27.EDF	K27	.
9	14246434	14246509	1025	1100	75	RIGHT	K27.EDF	K27	.
9	14246531	14246536	1122	1127	5	RIGHT	K27.EDF	K27	.
9	14250954	14250981	5545	5572	27	RIGHT	K27.EDF	K27	.
10	14258162	14258230	2857	2925	68	RIGHT	K27.EDF	K27	.
11	14263984	14264585	58	659	601	RIGHT	K27.EDF	K27	.
12	14272574	14272866	75	367	292	RIGHT	K27.EDF	K27	.
12	14272917	14273437	418	938	520	RIGHT	K27.EDF	K27	.
12	14273480	14273563	981	1064	83	RIGHT	K27.EDF	K27	.
13	14279824	14279939	57	172	115	RIGHT	K27.EDF	K27	.
13	14280143	14280201	376	434	58	RIGHT	K27.EDF	K27	.
13	14280223	14280227	456	460	4	RIGHT	K27.EDF	K27	.
13	14280254	14280434	487	667	180	RIGHT	K27.EDF	K27	.
13	14280494	14280647	727	880	153	RIGHT	K27.EDF	K27	.
13	14282418	14282482	2651	2715	64	RIGHT	K27.EDF	K27	.
14	14286637	14286696	58	117	59	RIGHT	K27.EDF	K27	.
14	14286825	14286916	246	337	91	RIGHT	K27.EDF	K27	.
14	14287091	14287155	512	576	64	RIGHT	K27.EDF	K27	.
15	14293879	14294293	58	472	414	RIGHT	K27.EDF	K27	.
15	14294720	14294809	899	988	89	RIGHT	K27.EDF	K27	.
16	14302201	14302241	651	691	40	RIGHT	K27.EDF	K27	.
16	14302262	14302273	712	723	11	RIGHT	K27.EDF	K27	.
17	14310102	14310136	688	722	34	RIGHT	K27.EDF	K27	.
17	14312078	14312139	2664	2725	61	RIGHT	K27.EDF	K27	.
18	14317974	14318069	124	219	95	RIGHT	K27.EDF	K27	.
18	14318190	14318267	340	417	77	RIGHT	K27.EDF	K27	.
18	14318734	14318767	884	917	33	RIGHT	K27.EDF	K27	.
18	14319072	14319112	1222	1262	40	RIGHT	K27.EDF	K27	.
19	14325193	14325290	78	175	97	RIGHT	K27.EDF	K27	.
19	14325406	14325510	291	395	104	RIGHT	K27.EDF	K27	.
20	14333817	14333894	170	247	77	RIGHT	K27.EDF	K27	.
20	14334141	14334170	494	523	29	RIGHT	K27.EDF	K27	.
21	14341827	14341853	543	569	26	RIGHT	K27.EDF	K27	.
21	14342132	14342196	848	912	64	RIGHT	K27.EDF	K27	.
21	14344861	14344915	3577	3631	54	RIGHT	K27.EDF	K27	.
23	14356593	14356995	58	460	402	RIGHT	K27.EDF	K27	.
23	14357617	14357698	1082	1163	81	RIGHT	K27.EDF	K27	.
24	14365262	14365608	250	596	346	RIGHT	K27.EDF	K27	.
24	14365830	14365920	818	908	90	RIGHT	K27.EDF	K27	.
25	14374117	14374173	297	353	56	RIGHT	K27.EDF	K27	.
25	14374372	14374412	552	592	40	RIGHT	K27.EDF	K27	.
26	14382009	14382289	57	337	280	RIGHT	K27.EDF	K27	.
26	14382582	14382665	630	713	83	RIGHT	K27.EDF	K27	.
27	14390722	14390802	237	317	80	RIGHT	K27.EDF	K27	.
27	14391199	14391245	714	760	46	RIGHT	K27.EDF	K27	.
27	14391399	14391466	914	981	67	RIGHT	K27.EDF	K27	.
27	14391723	14391777	1238	1292	54	RIGHT	K27.EDF	K27	.
27	14392001	14392001	1516	1516	0	RIGHT	K27.EDF	K27	.
27	14392044	14392047	1559	1562	3	RIGHT	K27.EDF	K27	.
27	14392091	14392091	1606	1606	0	RIGHT	K27.EDF	K27	.
27	14392113	14392125	1628	1640	12	RIGHT	K27.EDF	K27	.
27	14392765	14392820	2280	2335	55	RIGHT	K27.EDF	K27	.
27	14393136	14393209	2651	2724	73	RIGHT	K27.EDF	K27	.
27	14393525	14393592	3040	3107	67	RIGHT	K27.EDF	K27	.
27	14393823	14393897	3338	3412	74	RIGHT	K27.EDF	K27	.
29	14408223	14408301	245	323	78	RIGHT	K27.EDF	K27	.
29	14408484	14408595	506	617	111	RIGHT	K27.EDF	K27	.
30	14417185	14417228	593	636	43	RIGHT	K27.EDF	K27	.
31	14424026	14424108	57	139	82	RIGHT	K27.EDF	K27	.
31	14424556	14424572	587	603	16	RIGHT	K27.EDF	K27	.
31	14424613	14424683	644	714	70	RIGHT	K27.EDF	K27	.
31	14424714	14424833	745	864	119	RIGHT	K27.EDF	K27	.
31	14424880	14424915	911	946	35	RIGHT	K27.EDF	K27	.
31	14424956	14424978	987	1009	22	RIGHT	K27.EDF	K27	.
32	14431590	14431609	90	109	19	RIGHT	K27.EDF	K27	.
32	14431899	14431932	399	432	33	RIGHT	K27.EDF	K27	.
32	14432258	14432471	758	971	213	RIGHT	K27.EDF	K27	.
33	14440678	14440834	785	941	156	RIGHT	K27.EDF	K27	.
34	14449110	14449385	57	332	275	RIGHT	K27.EDF	K27	.
34	14449605	14449771	552	718	166	RIGHT	K27.EDF	K27	.
35	14457059	14457101	402	444	42	RIGHT	K27.EDF	K27	.
35	14457132	14457310	475	653	178	RIGHT	K27.EDF	K27	.
36	14463631	14463663	260	292	32	RIGHT	K27.EDF	K27	.
36	14463849	14463899	478	528	50	RIGHT	K27.EDF	K27	.
37	14471161	14472231	57	1127	1070	RIGHT	K27.EDF	K27	.
38	14479829	14480108	57	336	279	RIGHT	K27.EDF	K27	.
38	14480230	14480619	458	847	389	RIGHT	K27.EDF	K27	.
39	14486793	14487261	58	526	468	RIGHT	K27.EDF	K27	.
39	14487305	14487409	570	674	104	RIGHT	K27.EDF	K27	.
39	14488142	14488142	1407	1407	0	RIGHT	K27.EDF	K27	.
40	14495268	14495324	57	113	56	RIGHT	K27.EDF	K27	.
40	14495367	14495395	156	184	28	RIGHT	K27.EDF	K27	.
40	14495513	14495518	302	307	5	RIGHT	K27.EDF	K27	.
40	14495589	14495726	378	515	137	RIGHT	K27.EDF	K27	.
40	14495927	14496067	716	856	140	RIGHT	K27.EDF	K27	.
40	14496294	14496410	1083	1199	116	RIGHT	K27.EDF	K27	.
41	14503176	14503262	86	172	86	RIGHT	K27.EDF	K27	.
41	14503402	14503482	312	392	80	RIGHT	K27.EDF	K27	.
41	14503610	14503666	520	576	56	RIGHT	K27.EDF	K27	.
41	14503805	14503895	715	805	90	RIGHT	K27.EDF	K27	.
41	14504196	14504299	1106	1209	103	RIGHT	K27.EDF	K27	.
41	14504489	14504562	1399	1472	73	RIGHT	K27.EDF	K27	.
42	14510321	14510402	101	182	81	RIGHT	K27.EDF	K27	.
42	14510696	14510756	476	536	60	RIGHT	K27.EDF	K27	.
42	14511289	14511443	1069	1223	154	RIGHT	K27.EDF	K27	.
42	14511481	14511504	1261	1284	23	RIGHT	K27.EDF	K27	.
43	14518193	14519141	58	1006	948	RIGHT	K27.EDF	K27	.
44	14525256	14525396	57	197	140	RIGHT	K27.EDF	K27	.
44	14525447	14525572	248	373	125	RIGHT	K27.EDF	K27	.
44	14525656	14525946	457	747	290	RIGHT	K27.EDF	K27	.
44	14528975	14528984	3776	3785	9	RIGHT	K27.EDF	K27	.
45	14534890	14534999	633	742	109	RIGHT	K27.EDF	K27	.
46	14540701	14540785	56	140	84	RIGHT	K27.EDF	K27	.
46	14541143	14541252	498	607	109	RIGHT	K27.EDF	K27	.
47	14547971	14548076	58	163	105	RIGHT	K27.EDF	K27	.
47	14548390	14548499	477	586	109	RIGHT	K27.EDF	K27	.
47	14548533	14548566	620	653	33	RIGHT	K27.EDF	K27	.
47	14548805	14548911	892	998	106	RIGHT	K27.EDF	K27	.
47	14548934	14548964	1021	1051	30	RIGHT	K27.EDF	K27	.
47	14549119	14549272	1206	1359	153	RIGHT	K27.EDF	K27	.
48	14555006	14555056	119	169	50	RIGHT	K27.EDF	K27	.
48	14555081	14555091	194	204	10	RIGHT	K27.EDF	K27	.
48	14555222	14555295	335	408	73	RIGHT	K27.EDF	K27	.
48	14555316	14555374	429	487	58	RIGHT	K27.EDF	K27	.
48	14555411	14555606	524	719	195	RIGHT	K27.EDF	K27	.
48	14555632	14555814	745	927	182	RIGHT	K27.EDF	K27	.
49	14562142	14562198	271	327	56	RIGHT	K27.EDF	K27	.
49	14562466	14562603	595	732	137	RIGHT	K27.EDF	K27	.
50	14570950	14570976	57	83	26	RIGHT	K27.EDF	K27	.
50	14571400	14571567	507	674	167	RIGHT	K27.EDF	K27	.
51	14579198	14579234	58	94	36	RIGHT	K27.EDF	K27	.
51	14579345	14579466	205	326	121	RIGHT	K27.EDF	K27	.
51	14579580	14580178	440	1038	598	RIGHT	K27.EDF	K27	.
52	14587686	14588338	57	709	652	RIGHT	K27.EDF	K27	.
53	14596087	14596219	57	189	132	RIGHT	K27.EDF	K27	.
53	14596242	14596363	212	333	121	RIGHT	K27.EDF	K27	.
53	14596396	14596445	366	415	49	RIGHT	K27.EDF	K27	.
53	14596474	14596640	444	610	166	RIGHT	K27.EDF	K27	.
53	14596764	14596767	734	737	3	RIGHT	K27.EDF	K27	.
53	14596793	14596848	763	818	55	RIGHT	K27.EDF	K27	.
54	14603234	14603356	57	179	122	RIGHT	K27.EDF	K27	.
54	14603556	14603724	379	547	168	RIGHT	K27.EDF	K27	.
55	14611689	14611779	58	148	90	RIGHT	K27.EDF	K27	.
56	14619232	14619410	637	815	178	RIGHT	K27.EDF	K27	.
57	14627476	14627584	58	166	108	RIGHT	K27.EDF	K27	.
57	14627633	14627654	215	236	21	RIGHT	K27.EDF	K27	.
57	14627722	14627769	304	351	47	RIGHT	K27.EDF	K27	.
57	14627798	14628026	380	608	228	RIGHT	K27.EDF	K27	.
57	14628049	14628195	631	777	146	RIGHT	K27.EDF	K27	.
58	14635253	14635312	57	116	59	RIGHT	K27.EDF	K27	.
58	14635604	14635747	408	551	143	RIGHT	K27.EDF	K27	.
58	14635785	14635785	589	589	0	RIGHT	K27.EDF	K27	.
58	14635808	14635811	612	615	3	RIGHT	K27.EDF	K27	.
61	14660744	14661087	121	464	343	RIGHT	K27.EDF	K27	.
61	14661267	14661361	644	738	94	RIGHT	K27.EDF	K27	.
61	14661607	14661663	984	1040	56	RIGHT	K27.EDF	K27	.
61	14662256	14662429	1633	1806	173	RIGHT	K27.EDF	K27	.
62	14670453	14670456	206	209	3	RIGHT	K27.EDF	K27	.
62	14670483	14670489	236	242	6	RIGHT	K27.EDF	K27	.
63	14678077	14678098	57	78	21	RIGHT	K27.EDF	K27	.
63	14678238	14678247	218	227	9	RIGHT	K27.EDF	K27	.
63	14678664	14678791	644	771	127	RIGHT	K27.EDF	K27	.
64	14687724	14688652	564	1492	928	RIGHT	K27.EDF	K27	.
65	14694972	14695016	79	123	44	RIGHT	K27.EDF	K27	.
65	14695081	14695090	188	197	9	RIGHT	K27.EDF	K27	.
65	14695125	14695550	232	657	425	RIGHT	K27.EDF	K27	.
66	14703461	14703505	57	101	44	RIGHT	K27.EDF	K27	.
66	14703686	14703779	282	375	93	RIGHT	K27.EDF	K27	.
66	14703887	14703975	483	571	88	RIGHT	K27.EDF	K27	.
66	14704230	14704313	826	909	83	RIGHT	K27.EDF	K27	.
67	14710820	14710878	58	116	58	RIGHT	K27.EDF	K27	.
68	14717427	14717510	57	140	83	RIGHT	K27.EDF	K27	.
68	14717854	14717943	484	573	89	RIGHT	K27.EDF	K27	.
69	14724575	14724587	102	114	12	RIGHT	K27.EDF	K27	.
69	14724724	14724831	251	358	107	RIGHT	K27.EDF	K27	.
69	14724940	14725105	467	632	165	RIGHT	K27.EDF	K27	.
69	14725135	14725176	662	703	41	RIGHT	K27.EDF	K27	.
70	14731458	14731600	269	411	142	RIGHT	K27.EDF	K27	.
70	14733353	14733474	2164	2285	121	RIGHT	K27.EDF	K27	.
71	14740491	14740569	704	782	78	RIGHT	K27.EDF	K27	.
71	14740854	14740922	1067	1135	68	RIGHT	K27.EDF	K27	.
71	14741120	14741181	1333	1394	61	RIGHT	K27.EDF	K27	.
71	14741508	14741561	1721	1774	53	RIGHT	K27.EDF	K27	.
71	14741848	14741903	2061	2116	55	RIGHT	K27.EDF	K27	.
71	14744725	14744810	4938	5023	85	RIGHT	K27.EDF	K27	.
72	14747075	14747184	79	188	109	RIGHT	K27.EDF	K27	.
72	14747343	14747453	347	457	110	RIGHT	K27.EDF	K27	.
72	14747660	14747755	664	759	95	RIGHT	K27.EDF	K27	.
72	14751449	14751547	4453	4551	98	RIGHT	K27.EDF	K27	.
73	14753655	14753692	57	94	37	RIGHT	K27.EDF	K27	.
73	14753892	14753999	294	401	107	RIGHT	K27.EDF	K27	.
73	14754404	14754503	806	905	99	RIGHT	K27.EDF	K27	.
73	14754787	14754891	1189	1293	104	RIGHT	K27.EDF	K27	.
74	14760821	14761266	57	502	445	RIGHT	K27.EDF	K27	.
74	14762048	14762100	1284	1336	52	RIGHT	K27.EDF	K27	.
74	14762259	14762298	1495	1534	39	RIGHT	K27.EDF	K27	.
75	14767885	14767948	298	361	63	RIGHT	K27.EDF	K27	.
75	14768086	14768205	499	618	119	RIGHT	K27.EDF	K27	.
75	14768298	14768412	711	825	114	RIGHT	K27.EDF	K27	.
75	14768596	14768706	1009	1119	110	RIGHT	K27.EDF	K27	.
76	14774110	14774202	58	150	92	RIGHT	K27.EDF	K27	.
76	14774340	14774483	288	431	143	RIGHT	K27.EDF	K27	.
77	14781065	14781154	90	179	89	RIGHT	K27.EDF	K27	.
77	14781362	14781414	387	439	52	RIGHT	K27.EDF	K27	.
78	14789438	14789654	58	274	216	RIGHT	K27.EDF	K27	.
78	14789719	14789832	339	452	113	RIGHT	K27.EDF	K27	.
78	14790082	14790209	702	829	127	RIGHT	K27.EDF	K27	.
78	14791543	14791600	2163	2220	57	RIGHT	K27.EDF	K27	.
79	14797535	14797719	128	312	184	RIGHT	K27.EDF	K27	.
79	14797779	14798137	372	730	358	RIGHT	K27.EDF	K27	.
79	14799864	14799954	2457	2547	90	RIGHT	K27.EDF	K27	.
79	14800034	14800549	2627	3142	515	RIGHT	K27.EDF	K27	.
80	14805888	14806283	57	452	395	RIGHT	K27.EDF	K27	.
80	14806427	14806513	596	682	86	RIGHT	K27.EDF	K27	.
81	14813456	14813637	58	239	181	RIGHT	K27.EDF	K27	.
81	14813941	14814245	543	847	304	RIGHT	K27.EDF	K27	.
82	14822816	14822919	555	658	103	RIGHT	K27.EDF	K27	.
82	14824862	14824862	2601	2601	0	RIGHT	K27.EDF	K27	.
83	14831573	14831625	57	109	52	RIGHT	K27.EDF	K27	.
83	14831812	14831899	296	383	87	RIGHT	K27.EDF	K27	.
83	14832083	14832205	567	689	122	RIGHT	K27.EDF	K27	.
84	14839808	14840041	57	290	233	RIGHT	K27.EDF	K27	.
84	14840184	14840281	433	530	97	RIGHT	K27.EDF	K27	.
84	14840410	14840813	659	1062	403	RIGHT	K27.EDF	K27	.
84	14840844	14840939	1093	1188	95	RIGHT	K27.EDF	K27	.
85	14847985	14848168	67	250	183	RIGHT	K27.EDF	K27	.
85	14848219	14848354	301	436	135	RIGHT	K27.EDF	K27	.
85	14848433	14848594	515	676	161	RIGHT	K27.EDF	K27	.
85	14848802	14848804	884	886	2	RIGHT	K27.EDF	K27	.
85	14848829	14848929	911	1011	100	RIGHT	K27.EDF	K27	.
85	14848987	14849004	1069	1086	17	RIGHT	K27.EDF	K27	.
86	14856863	14856926	80	143	63	RIGHT	K27.EDF	K27	.
87	14864429	14864785	58	414	356	RIGHT	K27.EDF	K27	.
87	14864811	14864889	440	518	78	RIGHT	K27.EDF	K27	.
87	14865158	14865252	787	881	94	RIGHT	K27.EDF	K27	.
88	14871549	14871653	187	291	104	RIGHT	K27.EDF	K27	.
88	14871795	14871889	433	527	94	RIGHT	K27.EDF	K27	.
89	14879778	14879790	92	104	12	RIGHT	K27.EDF	K27	.
89	14879943	14880512	257	826	569	RIGHT	K27.EDF	K27	.
89	14880686	14880761	1000	1075	75	RIGHT	K27.EDF	K27	.
89	14881123	14881206	1437	1520	83	RIGHT	K27.EDF	K27	.
89	14884813	14884866	5127	5180	53	RIGHT	K27.EDF	K27	.
90	14887034	14887110	534	610	76	RIGHT	K27.EDF	K27	.
90	14887310	14887393	810	893	83	RIGHT	K27.EDF	K27	.
90	14887689	14887779	1189	1279	90	RIGHT	K27.EDF	K27	.
91	14893605	14893700	550	645	95	RIGHT	K27.EDF	K27	.
91	14893951	14894009	896	954	58	RIGHT	K27.EDF	K27	.
91	14894822	14894898	1767	1843	76	RIGHT	K27.EDF	K27	.
91	14895321	14895429	2266	2374	108	RIGHT	K27.EDF	K27	.
91	14895559	14895645	2504	2590	86	RIGHT	K27.EDF	K27	.
91	14895768	14896264	2713	3209	496	RIGHT	K27.EDF	K27	.
91	14896384	14896471	3329	3416	87	RIGHT	K27.EDF	K27	.
91	14897165	14897254	4110	4199	89	RIGHT	K27.EDF	K27	.
91	14897394	14897504	4339	4449	110	RIGHT	K27.EDF	K27	.
91	14897607	14897729	4552	4674	122	RIGHT	K27.EDF	K27	.
92	14901701	14901782	63	144	81	RIGHT	K27.EDF	K27	.
92	14901960	14902081	322	443	121	RIGHT	K27.EDF	K27	.
92	14902327	14902434	689	796	107	RIGHT	K27.EDF	K27	.
93	14909884	14910252	58	426	368	RIGHT	K27.EDF	K27	.
93	14910280	14910291	454	465	11	RIGHT	K27.EDF	K27	.
93	14910323	14910378	497	552	55	RIGHT	K27.EDF	K27	.
93	14910487	14910698	661	872	211	RIGHT	K27.EDF	K27	.
93	14910999	14911095	1173	1269	96	RIGHT	K27.EDF	K27	.
93	14911314	14911421	1488	1595	107	RIGHT	K27.EDF	K27	.
94	14918279	14918739	58	518	460	RIGHT	K27.EDF	K27	.
94	14919035	14919139	814	918	104	RIGHT	K27.EDF	K27	.
95	14925901	14926044	57	200	143	RIGHT	K27.EDF	K27	.
95	14926080	14926182	236	338	102	RIGHT	K27.EDF	K27	.
95	14926437	14926532	593	688	95	RIGHT	K27.EDF	K27	.
95	14928041	14928117	2197	2273	76	RIGHT	K27.EDF	K27	.
95	14928261	14928364	2417	2520	103	RIGHT	K27.EDF	K27	.
95	14928975	14929051	3131	3207	76	RIGHT	K27.EDF	K27	.
96	14932624	14932740	57	173	116	RIGHT	K27.EDF	K27	.
96	14934477	14934524	1910	1957	47	RIGHT	K27.EDF	K27	.
96	14934660	14934713	2093	2146	53	RIGHT	K27.EDF	K27	.
96	14934874	14934967	2307	2400	93	RIGHT	K27.EDF	K27	.
96	14935398	14935471	2831	2904	73	RIGHT	K27.EDF	K27	.
96	14935795	14935894	3228	3327	99	RIGHT	K27.EDF	K27	.
96	14936240	14936345	3673	3778	105	RIGHT	K27.EDF	K27	.
96	14937007	14937072	4440	4505	65	RIGHT	K27.EDF	K27	.
96	14938201	14938292	5634	5725	91	RIGHT	K27.EDF	K27	.
97	14940685	14940769	220	304	84	RIGHT	K27.EDF	K27	.
97	14940968	14941110	503	645	142	RIGHT	K27.EDF	K27	.
97	14941148	14941399	683	934	251	RIGHT	K27.EDF	K27	.
97	14941509	14941510	1044	1045	1	RIGHT	K27.EDF	K27	.
97	14942310	14942377	1845	1912	67	RIGHT	K27.EDF	K27	.
97	14942693	14942793	2228	2328	100	RIGHT	K27.EDF	K27	.
97	14942849	14943019	2384	2554	170	RIGHT	K27.EDF	K27	.
97	14943071	14943618	2606	3153	547	RIGHT	K27.EDF	K27	.
97	14943737	14943836	3272	3371	99	RIGHT	K27.EDF	K27	.
97	14946417	14946418	5952	5953	1	RIGHT	K27.EDF	K27	.
98	14948295	14948505	227	437	210	RIGHT	K27.EDF	K27	.
98	14948639	14948844	571	776	205	RIGHT	K27.EDF	K27	.
98	14950957	14950966	2889	2898	9	RIGHT	K27.EDF	K27	.
98	14951000	14951015	2932	2947	15	RIGHT	K27.EDF	K27	.
98	14951222	14951288	3154	3220	66	RIGHT	K27.EDF	K27	.
98	14953718	14953718	5650	5650	0	RIGHT	K27.EDF	K27	.
98	14953742	14953749	5674	5681	7	RIGHT	K27.EDF	K27	.
99	14956338	14956817	58	537	479	RIGHT	K27.EDF	K27	.
100	14963247	14963340	135	228	93	RIGHT	K27.EDF	K27	.
100	14963584	14963732	472	620	148	RIGHT	K27.EDF	K27	.
100	14963923	14964022	811	910	99	RIGHT	K27.EDF	K27	.
100	14964266	14964388	1154	1276	122	RIGHT	K27.EDF	K27	.
101	14971712	14971920	57	265	208	RIGHT	K27.EDF	K27	.
101	14971980	14972055	325	400	75	RIGHT	K27.EDF	K27	.
101	14972110	14972221	455	566	111	RIGHT	K27.EDF	K27	.
103	14984646	14984831	58	243	185	RIGHT	K27.EDF	K27	.
104	14992423	14992605	57	239	182	RIGHT	K27.EDF	K27	.
104	14992804	14993059	438	693	255	RIGHT	K27.EDF	K27	.
104	14993137	14993212	771	846	75	RIGHT	K27.EDF	K27	.
104	14993382	14993422	1016	1056	40	RIGHT	K27.EDF	K27	.
105	14998718	14998842	58	182	124	RIGHT	K27.EDF	K27	.
105	14998865	14998897	205	237	32	RIGHT	K27.EDF	K27	.
105	14998918	14998922	258	262	4	RIGHT	K27.EDF	K27	.
105	14998955	14998968	295	308	13	RIGHT	K27.EDF	K27	.
105	14999084	14999383	424	723	299	RIGHT	K27.EDF	K27	.
106	15005922	15006059	57	194	137	RIGHT	K27.EDF	K27	.
106	15006296	15006453	431	588	157	RIGHT	K27.EDF	K27	.
106	15007225	15007258	1360	1393	33	RIGHT	K27.EDF	K27	.
106	15007996	15008003	2131	2138	7	RIGHT	K27.EDF	K27	.
106	15008051	15008055	2186	2190	4	RIGHT	K27.EDF	K27	.
106	15008230	15008295	2365	2430	65	RIGHT	K27.EDF	K27	.
106	15009189	15009242	3324	3377	53	RIGHT	K27.EDF	K27	.
106	15010447	15010497	4582	4632	50	RIGHT	K27.EDF	K27	.
107	15012913	15012996	344	427	83	RIGHT	K27.EDF	K27	.
108	15021255	15021395	94	234	140	RIGHT	K27.EDF	K27	.
108	15021417	15021426	256	265	9	RIGHT	K27.EDF	K27	.
108	15021552	15021571	391	410	19	RIGHT	K27.EDF	K27	.
108	15021606	15021709	445	548	103	RIGHT	K27.EDF	K27	.
108	15021738	15021772	577	611	34	RIGHT	K27.EDF	K27	.
108	15021993	15022082	832	921	89	RIGHT	K27.EDF	K27	.
109	15029815	15029910	147	242	95	RIGHT	K27.EDF	K27	.
109	15030131	15030190	463	522	59	RIGHT	K27.EDF	K27	.
109	15033374	15033429	3706	3761	55	RIGHT	K27.EDF	K27	.
110	15037944	15038120	58	234	176	RIGHT	K27.EDF	K27	.
111	15046987	15047238	266	517	251	RIGHT	K27.EDF	K27	.
111	15047651	15047748	930	1027	97	RIGHT	K27.EDF	K27	.
111	15047969	15048065	1248	1344	96	RIGHT	K27.EDF	K27	.
112	15056585	15056804	58	277	219	RIGHT	K27.EDF	K27	.
112	15057047	15057149	520	622	102	RIGHT	K27.EDF	K27	.
112	15059754	15059836	3227	3309	82	RIGHT	K27.EDF	K27	.
113	15066671	15066713	1692	1734	42	RIGHT	K27.EDF	K27	.
113	15066878	15066949	1899	1970	71	RIGHT	K27.EDF	K27	.
113	15067122	15067209	2143	2230	87	RIGHT	K27.EDF	K27	.
113	15068017	15068104	3038	3125	87	RIGHT	K27.EDF	K27	.
113	15068534	15068588	3555	3609	54	RIGHT	K27.EDF	K27	.
113	15068854	15068960	3875	3981	106	RIGHT	K27.EDF	K27	.
114	15073206	15073358	57	209	152	RIGHT	K27.EDF	K27	.
114	15073633	15073728	484	579	95	RIGHT	K27.EDF	K27	.
114	15073985	15074064	836	915	79	RIGHT	K27.EDF	K27	.
114	15075214	15075214	2065	2065	0	RIGHT	K27.EDF	K27	.
114	15075422	15075494	2273	2345	72	RIGHT	K27.EDF	K27	.
114	15075648	15075763	2499	2614	115	RIGHT	K27.EDF	K27	.
114	15076351	15076445	3202	3296	94	RIGHT	K27.EDF	K27	.
114	15079769	15079830	6620	6681	61	RIGHT	K27.EDF	K27	.
116	15090024	15090180	57	213	156	RIGHT	K27.EDF	K27	.
116	15090267	15090299	300	332	32	RIGHT	K27.EDF	K27	.
116	15090340	15090419	373	452	79	RIGHT	K27.EDF	K27	.
116	15090952	15091001	985	1034	49	RIGHT	K27.EDF	K27	.
116	15092062	15092149	2095	2182	87	RIGHT	K27.EDF	K27	.
117	15097026	15097030	110	114	4	RIGHT	K27.EDF	K27	.
117	15097191	15097335	275	419	144	RIGHT	K27.EDF	K27	.
117	15097475	15097564	559	648	89	RIGHT	K27.EDF	K27	.
117	15097624	15097767	708	851	143	RIGHT	K27.EDF	K27	.
117	15097791	15097818	875	902	27	RIGHT	K27.EDF	K27	.
119	15112585	15112850	57	322	265	RIGHT	K27.EDF	K27	.
119	15113017	15113036	489	508	19	RIGHT	K27.EDF	K27	.
119	15113260	15113353	732	825	93	RIGHT	K27.EDF	K27	.
119	15114518	15114564	1990	2036	46	RIGHT	K27.EDF	K27	.
119	15114590	15114603	2062	2075	13	RIGHT	K27.EDF	K27	.
120	15123051	15123145	58	152	94	RIGHT	K27.EDF	K27	.
120	15123266	15123362	273	369	96	RIGHT	K27.EDF	K27	.
120	15123549	15123629	556	636	80	RIGHT	K27.EDF	K27	.
1	1398241	1398320	721	800	79	RIGHT	K341.EDF	K34	1
2	1408233	1408334	1269	1370	101	RIGHT	K341.EDF	K34	1
3	1416274	1416332	1178	1236	58	RIGHT	K341.EDF	K34	1
4	1430303	1430365	5794	5856	62	RIGHT	K341.EDF	K34	1
4	1430978	1431078	6469	6569	100	RIGHT	K341.EDF	K34	1
7	1455720	1455776	3452	3508	56	RIGHT	K341.EDF	K34	1
8	1461253	1461315	887	949	62	RIGHT	K341.EDF	K34	1
9	1470994	1471058	809	873	64	RIGHT	K341.EDF	K34	1
9	1473646	1473686	3461	3501	40	RIGHT	K341.EDF	K34	1
10	1479724	1479777	932	985	53	RIGHT	K341.EDF	K34	1
10	1480783	1480884	1991	2092	101	RIGHT	K341.EDF	K34	1
10	1481172	1481268	2380	2476	96	RIGHT	K341.EDF	K34	1
10	1483889	1483977	5097	5185	88	RIGHT	K341.EDF	K34	1
10	1484687	1484745	5895	5953	58	RIGHT	K341.EDF	K34	1
11	1492951	1493049	5954	6052	98	RIGHT	K341.EDF	K34	1
12	1498051	1498067	1123	1139	16	RIGHT	K341.EDF	K34	1
13	1506904	1507022	1005	1123	118	RIGHT	K341.EDF	K34	1
13	1507841	1507920	1942	2021	79	RIGHT	K341.EDF	K34	1
14	1516631	1516710	774	853	79	RIGHT	K341.EDF	K34	1
14	1520088	1520181	4231	4324	93	RIGHT	K341.EDF	K34	1
15	1528820	1528860	3781	3821	40	RIGHT	K341.EDF	K34	1
17	1541320	1541370	525	575	50	RIGHT	K341.EDF	K34	1
18	1551647	1551699	806	858	52	RIGHT	K341.EDF	K34	1
18	1551920	1551991	1079	1150	71	RIGHT	K341.EDF	K34	1
18	1553978	1554068	3137	3227	90	RIGHT	K341.EDF	K34	1
19	1561929	1561995	2826	2892	66	RIGHT	K341.EDF	K34	1
22	1584954	1585010	995	1051	56	RIGHT	K341.EDF	K34	1
22	1585234	1585282	1275	1323	48	RIGHT	K341.EDF	K34	1
23	1595583	1595632	2423	2472	49	RIGHT	K341.EDF	K34	1
24	1601680	1601766	1027	1113	86	RIGHT	K341.EDF	K34	1
26	1621569	1621684	1297	1412	115	RIGHT	K341.EDF	K34	1
26	1622153	1622191	1881	1919	38	RIGHT	K341.EDF	K34	1
27	1630540	1630606	894	960	66	RIGHT	K341.EDF	K34	1
27	1630985	1631057	1339	1411	72	RIGHT	K341.EDF	K34	1
28	1639792	1639846	585	639	54	RIGHT	K341.EDF	K34	1
28	1640948	1641043	1741	1836	95	RIGHT	K341.EDF	K34	1
29	1649176	1649251	1580	1655	75	RIGHT	K341.EDF	K34	1
30	1656404	1656499	812	907	95	RIGHT	K341.EDF	K34	1
31	1664755	1664872	1205	1322	117	RIGHT	K341.EDF	K34	1
31	1666000	1666096	2450	2546	96	RIGHT	K341.EDF	K34	1
32	1674492	1674568	1153	1229	76	RIGHT	K341.EDF	K34	1
33	1682598	1682680	287	369	82	RIGHT	K341.EDF	K34	1
33	1683240	1683300	929	989	60	RIGHT	K341.EDF	K34	1
33	1683487	1683578	1176	1267	91	RIGHT	K341.EDF	K34	1
33	1684381	1684473	2070	2162	92	RIGHT	K341.EDF	K34	1
34	1691196	1691302	594	700	106	RIGHT	K341.EDF	K34	1
35	1701070	1701137	907	974	67	RIGHT	K341.EDF	K34	1
36	1709856	1709932	510	586	76	RIGHT	K341.EDF	K34	1
36	1710174	1710261	828	915	87	RIGHT	K341.EDF	K34	1
36	1712963	1713072	3617	3726	109	RIGHT	K341.EDF	K34	1
36	1713316	1713390	3970	4044	74	RIGHT	K341.EDF	K34	1
36	1713707	1713788	4361	4442	81	RIGHT	K341.EDF	K34	1
37	1718986	1719059	768	841	73	RIGHT	K341.EDF	K34	1
37	1719529	1719594	1311	1376	65	RIGHT	K341.EDF	K34	1
39	1734802	1734903	641	742	101	RIGHT	K341.EDF	K34	1
40	1744379	1744412	1765	1798	33	RIGHT	K341.EDF	K34	1
40	1744735	1744795	2121	2181	60	RIGHT	K341.EDF	K34	1
41	1752658	1752769	1074	1185	111	RIGHT	K341.EDF	K34	1
41	1756294	1756334	4710	4750	40	RIGHT	K341.EDF	K34	1
42	1762301	1762439	633	771	138	RIGHT	K341.EDF	K34	1
42	1763035	1763096	1367	1428	61	RIGHT	K341.EDF	K34	1
43	1770220	1770307	761	848	87	RIGHT	K341.EDF	K34	1
45	1788001	1788030	301	330	29	RIGHT	K341.EDF	K34	1
45	1788291	1788383	591	683	92	RIGHT	K341.EDF	K34	1
45	1789323	1789438	1623	1738	115	RIGHT	K341.EDF	K34	1
46	1797216	1797237	57	78	21	RIGHT	K341.EDF	K34	1
46	1798340	1798446	1181	1287	106	RIGHT	K341.EDF	K34	1
47	1807451	1807559	973	1081	108	RIGHT	K341.EDF	K34	1
47	1810754	1810871	4276	4393	117	RIGHT	K341.EDF	K34	1
48	1817014	1817081	911	978	67	RIGHT	K341.EDF	K34	1
48	1817717	1817790	1614	1687	73	RIGHT	K341.EDF	K34	1
48	1819873	1819971	3770	3868	98	RIGHT	K341.EDF	K34	1
48	1820730	1820866	4627	4763	136	RIGHT	K341.EDF	K34	1
50	1833360	1833459	136	235	99	RIGHT	K341.EDF	K34	1
50	1835057	1835125	1833	1901	68	RIGHT	K341.EDF	K34	1
51	1842210	1842353	660	803	143	RIGHT	K341.EDF	K34	1
51	1842653	1842710	1103	1160	57	RIGHT	K341.EDF	K34	1
51	1842999	1843091	1449	1541	92	RIGHT	K341.EDF	K34	1
52	1851055	1851159	686	790	104	RIGHT	K341.EDF	K34	1
52	1851531	1851615	1162	1246	84	RIGHT	K341.EDF	K34	1
53	1859782	1859849	1040	1107	67	RIGHT	K341.EDF	K34	1
53	1860187	1860272	1445	1530	85	RIGHT	K341.EDF	K34	1
54	1868091	1868199	741	849	108	RIGHT	K341.EDF	K34	1
54	1868690	1868772	1340	1422	82	RIGHT	K341.EDF	K34	1
54	1869096	1869194	1746	1844	98	RIGHT	K341.EDF	K34	1
55	1876545	1876623	812	890	78	RIGHT	K341.EDF	K34	1
55	1877057	1877110	1324	1377	53	RIGHT	K341.EDF	K34	1
56	1884028	1884141	940	1053	113	RIGHT	K341.EDF	K34	1
58	1900179	1900265	79	165	86	RIGHT	K341.EDF	K34	1
58	1900761	1900848	661	748	87	RIGHT	K341.EDF	K34	1
58	1901122	1901199	1022	1099	77	RIGHT	K341.EDF	K34	1
58	1901415	1901494	1315	1394	79	RIGHT	K341.EDF	K34	1
59	1909044	1909144	1008	1108	100	RIGHT	K341.EDF	K34	1
60	1917305	1917350	292	337	45	RIGHT	K341.EDF	K34	1
61	1926743	1926803	2148	2208	60	RIGHT	K341.EDF	K34	1
61	1929281	1929370	4686	4775	89	RIGHT	K341.EDF	K34	1
62	1935869	1935965	698	794	96	RIGHT	K341.EDF	K34	1
62	1936709	1936791	1538	1620	82	RIGHT	K341.EDF	K34	1
62	1937210	1937313	2039	2142	103	RIGHT	K341.EDF	K34	1
62	1937499	1937718	2328	2547	219	RIGHT	K341.EDF	K34	1
62	1937931	1937975	2760	2804	44	RIGHT	K341.EDF	K34	1
62	1938141	1938205	2970	3034	64	RIGHT	K341.EDF	K34	1
62	1938454	1938512	3283	3341	58	RIGHT	K341.EDF	K34	1
62	1938813	1938884	3642	3713	71	RIGHT	K341.EDF	K34	1
62	1939645	1939703	4474	4532	58	RIGHT	K341.EDF	K34	1
62	1941146	1941221	5975	6050	75	RIGHT	K341.EDF	K34	1
63	1944724	1944886	186	348	162	RIGHT	K341.EDF	K34	1
63	1945116	1945231	578	693	115	RIGHT	K341.EDF	K34	1
63	1945521	1945609	983	1071	88	RIGHT	K341.EDF	K34	1
63	1945906	1946007	1368	1469	101	RIGHT	K341.EDF	K34	1
64	1954902	1954990	940	1028	88	RIGHT	K341.EDF	K34	1
64	1955670	1955780	1708	1818	110	RIGHT	K341.EDF	K34	1
65	1966730	1966835	2972	3077	105	RIGHT	K341.EDF	K34	1
67	1979678	1979763	199	284	85	RIGHT	K341.EDF	K34	1
67	1980039	1980145	560	666	106	RIGHT	K341.EDF	K34	1
67	1980871	1981007	1392	1528	136	RIGHT	K341.EDF	K34	1
68	1990087	1990141	171	225	54	RIGHT	K341.EDF	K34	1
68	1991406	1991464	1490	1548	58	RIGHT	K341.EDF	K34	1
68	1991836	1991965	1920	2049	129	RIGHT	K341.EDF	K34	1
69	1999380	1999502	833	955	122	RIGHT	K341.EDF	K34	1
69	2000475	2000546	1928	1999	71	RIGHT	K341.EDF	K34	1
69	2002867	2002952	4320	4405	85	RIGHT	K341.EDF	K34	1
69	2003291	2003387	4744	4840	96	RIGHT	K341.EDF	K34	1
69	2003993	2004084	5446	5537	91	RIGHT	K341.EDF	K34	1
70	2008808	2008810	1427	1429	2	RIGHT	K341.EDF	K34	1
70	2009489	2009567	2108	2186	78	RIGHT	K341.EDF	K34	1
71	2015759	2015787	405	433	28	RIGHT	K341.EDF	K34	1
71	2016114	2016173	760	819	59	RIGHT	K341.EDF	K34	1
71	2016530	2016574	1176	1220	44	RIGHT	K341.EDF	K34	1
71	2016758	2016872	1404	1518	114	RIGHT	K341.EDF	K34	1
71	2018711	2018800	3357	3446	89	RIGHT	K341.EDF	K34	1
72	2027792	2027868	4413	4489	76	RIGHT	K341.EDF	K34	1
73	2033440	2033582	593	735	142	RIGHT	K341.EDF	K34	1
74	2042821	2042969	676	824	148	RIGHT	K341.EDF	K34	1
75	2051648	2051772	470	594	124	RIGHT	K341.EDF	K34	1
75	2051956	2052056	778	878	100	RIGHT	K341.EDF	K34	1
75	2052852	2052961	1674	1783	109	RIGHT	K341.EDF	K34	1
75	2053115	2053226	1937	2048	111	RIGHT	K341.EDF	K34	1
76	2061651	2061821	1035	1205	170	RIGHT	K341.EDF	K34	1
77	2069621	2069748	771	898	127	RIGHT	K341.EDF	K34	1
77	2070902	2070961	2052	2111	59	RIGHT	K341.EDF	K34	1
78	2077321	2077489	875	1043	168	RIGHT	K341.EDF	K34	1
79	2085225	2085386	867	1028	161	RIGHT	K341.EDF	K34	1
80	2095081	2095217	737	873	136	RIGHT	K341.EDF	K34	1
80	2095669	2095753	1325	1409	84	RIGHT	K341.EDF	K34	1
80	2096115	2096207	1771	1863	92	RIGHT	K341.EDF	K34	1
81	2104601	2104699	865	963	98	RIGHT	K341.EDF	K34	1
81	2104984	2105084	1248	1348	100	RIGHT	K341.EDF	K34	1
81	2105979	2106101	2243	2365	122	RIGHT	K341.EDF	K34	1
82	2112479	2112624	600	745	145	RIGHT	K341.EDF	K34	1
82	2116178	2116358	4299	4479	180	RIGHT	K341.EDF	K34	1
83	2119848	2119970	733	855	122	RIGHT	K341.EDF	K34	1
83	2122465	2122592	3350	3477	127	RIGHT	K341.EDF	K34	1
84	2130505	2130658	870	1023	153	RIGHT	K341.EDF	K34	1
84	2131887	2131943	2252	2308	56	RIGHT	K341.EDF	K34	1
85	2138508	2138538	57	87	30	RIGHT	K341.EDF	K34	1
85	2139188	2139322	737	871	134	RIGHT	K341.EDF	K34	1
85	2139734	2139808	1283	1357	74	RIGHT	K341.EDF	K34	1
85	2139963	2140068	1512	1617	105	RIGHT	K341.EDF	K34	1
85	2140251	2140307	1800	1856	56	RIGHT	K341.EDF	K34	1
85	2140586	2140655	2135	2204	69	RIGHT	K341.EDF	K34	1
86	2149505	2149607	767	869	102	RIGHT	K341.EDF	K34	1
86	2149679	2149814	941	1076	135	RIGHT	K341.EDF	K34	1
86	2150089	2150183	1351	1445	94	RIGHT	K341.EDF	K34	1
86	2150519	2150593	1781	1855	74	RIGHT	K341.EDF	K34	1
87	2164963	2165044	6859	6940	81	RIGHT	K341.EDF	K34	1
88	2168540	2168631	1414	1505	91	RIGHT	K341.EDF	K34	1
88	2168898	2168999	1772	1873	101	RIGHT	K341.EDF	K34	1
89	2176147	2176260	1045	1158	113	RIGHT	K341.EDF	K34	1
90	2184071	2184183	826	938	112	RIGHT	K341.EDF	K34	1
90	2184691	2184828	1446	1583	137	RIGHT	K341.EDF	K34	1
90	2188784	2188889	5539	5644	105	RIGHT	K341.EDF	K34	1
90	2189574	2189675	6329	6430	101	RIGHT	K341.EDF	K34	1
91	2193690	2193727	971	1008	37	RIGHT	K341.EDF	K34	1
91	2193929	2193971	1210	1252	42	RIGHT	K341.EDF	K34	1
91	2194268	2194368	1549	1649	100	RIGHT	K341.EDF	K34	1
92	2202862	2202963	953	1054	101	RIGHT	K341.EDF	K34	1
93	2210583	2210696	57	170	113	RIGHT	K341.EDF	K34	1
93	2211265	2211387	739	861	122	RIGHT	K341.EDF	K34	1
93	2212689	2212776	2163	2250	87	RIGHT	K341.EDF	K34	1
94	2220559	2220703	663	807	144	RIGHT	K341.EDF	K34	1
94	2225589	2225683	5693	5787	94	RIGHT	K341.EDF	K34	1
95	2228370	2228464	254	348	94	RIGHT	K341.EDF	K34	1
95	2228936	2229033	820	917	97	RIGHT	K341.EDF	K34	1
95	2229255	2229360	1139	1244	105	RIGHT	K341.EDF	K34	1
95	2230577	2230646	2461	2530	69	RIGHT	K341.EDF	K34	1
96	2237083	2237207	973	1097	124	RIGHT	K341.EDF	K34	1
96	2243241	2243250	7131	7140	9	RIGHT	K341.EDF	K34	1
96	2243635	2243707	7525	7597	72	RIGHT	K341.EDF	K34	1
97	2246564	2246678	997	1111	114	RIGHT	K341.EDF	K34	1
98	2256309	2256377	1247	1315	68	RIGHT	K341.EDF	K34	1
98	2257015	2257171	1953	2109	156	RIGHT	K341.EDF	K34	1
99	2264404	2264518	585	699	114	RIGHT	K341.EDF	K34	1
99	2269516	2269626	5697	5807	110	RIGHT	K341.EDF	K34	1
99	2270776	2270894	6957	7075	118	RIGHT	K341.EDF	K34	1
100	2275031	2275163	783	915	132	RIGHT	K341.EDF	K34	1
100	2277141	2277206	2893	2958	65	RIGHT	K341.EDF	K34	1
101	2282193	2282343	91	241	150	RIGHT	K341.EDF	K34	1
101	2282807	2282942	705	840	135	RIGHT	K341.EDF	K34	1
101	2283760	2283883	1658	1781	123	RIGHT	K341.EDF	K34	1
102	2293252	2293347	1325	1420	95	RIGHT	K341.EDF	K34	1
102	2295813	2295921	3886	3994	108	RIGHT	K341.EDF	K34	1
103	2300695	2300748	73	126	53	RIGHT	K341.EDF	K34	1
103	2300971	2301048	349	426	77	RIGHT	K341.EDF	K34	1
103	2301380	2301493	758	871	113	RIGHT	K341.EDF	K34	1
103	2302013	2302073	1391	1451	60	RIGHT	K341.EDF	K34	1
104	2308986	2309129	759	902	143	RIGHT	K341.EDF	K34	1
104	2312944	2313082	4717	4855	138	RIGHT	K341.EDF	K34	1
105	2317422	2317513	155	246	91	RIGHT	K341.EDF	K34	1
105	2317789	2317896	522	629	107	RIGHT	K341.EDF	K34	1
105	2318110	2318377	843	1110	267	RIGHT	K341.EDF	K34	1
106	2324483	2324530	58	105	47	RIGHT	K341.EDF	K34	1
106	2325364	2325483	939	1058	119	RIGHT	K341.EDF	K34	1
106	2330977	2331082	6552	6657	105	RIGHT	K341.EDF	K34	1
107	2334192	2334303	876	987	111	RIGHT	K341.EDF	K34	1
107	2337841	2337940	4525	4624	99	RIGHT	K341.EDF	K34	1
107	2340186	2340288	6870	6972	102	RIGHT	K341.EDF	K34	1
108	2344998	2345093	729	824	95	RIGHT	K341.EDF	K34	1
108	2345723	2345844	1454	1575	121	RIGHT	K341.EDF	K34	1
108	2349393	2349478	5124	5209	85	RIGHT	K341.EDF	K34	1
108	2350900	2351035	6631	6766	135	RIGHT	K341.EDF	K34	1
109	2354380	2354494	194	308	114	RIGHT	K341.EDF	K34	1
109	2354867	2354945	681	759	78	RIGHT	K341.EDF	K34	1
109	2355819	2355904	1633	1718	85	RIGHT	K341.EDF	K34	1
110	2362623	2362752	797	926	129	RIGHT	K341.EDF	K34	1
110	2363138	2363201	1312	1375	63	RIGHT	K341.EDF	K34	1
110	2364868	2364974	3042	3148	106	RIGHT	K341.EDF	K34	1
111	2370264	2370413	899	1048	149	RIGHT	K341.EDF	K34	1
111	2371447	2371635	2082	2270	188	RIGHT	K341.EDF	K34	1
111	2373264	2373385	3899	4020	121	RIGHT	K341.EDF	K34	1
111	2374394	2374516	5029	5151	122	RIGHT	K341.EDF	K34	1
112	2378366	2378487	128	249	121	RIGHT	K341.EDF	K34	1
112	2379806	2379955	1568	1717	149	RIGHT	K341.EDF	K34	1
112	2383314	2383408	5076	5170	94	RIGHT	K341.EDF	K34	1
113	2387064	2387149	1350	1435	85	RIGHT	K341.EDF	K34	1
113	2388673	2388800	2959	3086	127	RIGHT	K341.EDF	K34	1
113	2389317	2389428	3603	3714	111	RIGHT	K341.EDF	K34	1
114	2395780	2395934	788	942	154	RIGHT	K341.EDF	K34	1
115	2404551	2404644	433	526	93	RIGHT	K341.EDF	K34	1
115	2404929	2405054	811	936	125	RIGHT	K341.EDF	K34	1
116	2412472	2412560	581	669	88	RIGHT	K341.EDF	K34	1
116	2412778	2412905	887	1014	127	RIGHT	K341.EDF	K34	1
117	2419948	2420040	984	1076	92	RIGHT	K341.EDF	K34	1
117	2423988	2424097	5024	5133	109	RIGHT	K341.EDF	K34	1
118	2427891	2428026	704	839	135	RIGHT	K341.EDF	K34	1
118	2428550	2428652	1363	1465	102	RIGHT	K341.EDF	K34	1
118	2429362	2429477	2175	2290	115	RIGHT	K341.EDF	K34	1
118	2433286	2433369	6099	6182	83	RIGHT	K341.EDF	K34	1
119	2438479	2438552	584	657	73	RIGHT	K341.EDF	K34	1
119	2439110	2439174	1215	1279	64	RIGHT	K341.EDF	K34	1
119	2439548	2439606	1653	1711	58	RIGHT	K341.EDF	K34	1
120	2446118	2446247	979	1108	129	RIGHT	K341.EDF	K34	1
1	3410400	3410508	1144	1252	108	RIGHT	K342.EDF	K34	2
2	3418752	3418873	707	828	121	RIGHT	K342.EDF	K34	2
3	3427127	3427237	873	983	110	RIGHT	K342.EDF	K34	2
4	3434280	3434358	823	901	78	RIGHT	K342.EDF	K34	2
4	3434472	3434579	1015	1122	107	RIGHT	K342.EDF	K34	2
5	3440487	3440603	373	489	116	RIGHT	K342.EDF	K34	2
5	3440796	3440891	682	777	95	RIGHT	K342.EDF	K34	2
5	3441160	3441253	1046	1139	93	RIGHT	K342.EDF	K34	2
6	3449069	3449161	662	754	92	RIGHT	K342.EDF	K34	2
7	3455961	3456093	727	859	132	RIGHT	K342.EDF	K34	2
8	3463944	3464024	265	345	80	RIGHT	K342.EDF	K34	2
8	3464270	3464379	591	700	109	RIGHT	K342.EDF	K34	2
9	3473137	3473253	593	709	116	RIGHT	K342.EDF	K34	2
9	3473500	3473622	956	1078	122	RIGHT	K342.EDF	K34	2
9	3473974	3474035	1430	1491	61	RIGHT	K342.EDF	K34	2
9	3474257	3474362	1713	1818	105	RIGHT	K342.EDF	K34	2
10	3481614	3481696	575	657	82	RIGHT	K342.EDF	K34	2
10	3482222	3482342	1183	1303	120	RIGHT	K342.EDF	K34	2
11	3490657	3490812	534	689	155	RIGHT	K342.EDF	K34	2
12	3496919	3497092	541	714	173	RIGHT	K342.EDF	K34	2
12	3497288	3497411	910	1033	123	RIGHT	K342.EDF	K34	2
13	3505479	3505614	738	873	135	RIGHT	K342.EDF	K34	2
14	3513371	3513448	715	792	77	RIGHT	K342.EDF	K34	2
15	3523470	3523598	486	614	128	RIGHT	K342.EDF	K34	2
15	3523853	3523941	869	957	88	RIGHT	K342.EDF	K34	2
16	3532384	3532512	577	705	128	RIGHT	K342.EDF	K34	2
16	3532994	3533106	1187	1299	112	RIGHT	K342.EDF	K34	2
17	3541331	3541439	788	896	108	RIGHT	K342.EDF	K34	2
17	3545159	3545202	4616	4659	43	RIGHT	K342.EDF	K34	2
18	3549732	3549881	494	643	149	RIGHT	K342.EDF	K34	2
18	3550078	3550171	840	933	93	RIGHT	K342.EDF	K34	2
19	3558227	3558335	743	851	108	RIGHT	K342.EDF	K34	2
20	3566160	3566242	610	692	82	RIGHT	K342.EDF	K34	2
20	3566491	3566572	941	1022	81	RIGHT	K342.EDF	K34	2
20	3570301	3570393	4751	4843	92	RIGHT	K342.EDF	K34	2
21	3576220	3576266	1637	1683	46	RIGHT	K342.EDF	K34	2
22	3583834	3583979	674	819	145	RIGHT	K342.EDF	K34	2
23	3594164	3594333	2170	2339	169	RIGHT	K342.EDF	K34	2
23	3594627	3594700	2633	2706	73	RIGHT	K342.EDF	K34	2
23	3594871	3594950	2877	2956	79	RIGHT	K342.EDF	K34	2
24	3602304	3602378	3583	3657	74	RIGHT	K342.EDF	K34	2
25	3608132	3608248	1469	1585	116	RIGHT	K342.EDF	K34	2
25	3612451	3612468	5788	5805	17	RIGHT	K342.EDF	K34	2
26	3615771	3615898	1300	1427	127	RIGHT	K342.EDF	K34	2
27	3622825	3622930	953	1058	105	RIGHT	K342.EDF	K34	2
28	3634070	3634112	4013	4055	42	RIGHT	K342.EDF	K34	2
29	3638624	3638722	680	778	98	RIGHT	K342.EDF	K34	2
30	3647296	3647420	677	801	124	RIGHT	K342.EDF	K34	2
30	3647687	3647800	1068	1181	113	RIGHT	K342.EDF	K34	2
30	3648632	3648767	2013	2148	135	RIGHT	K342.EDF	K34	2
30	3649200	3649247	2581	2628	47	RIGHT	K342.EDF	K34	2
30	3649656	3649727	3037	3108	71	RIGHT	K342.EDF	K34	2
31	3654996	3655075	478	557	79	RIGHT	K342.EDF	K34	2
31	3656131	3656217	1613	1699	86	RIGHT	K342.EDF	K34	2
32	3663428	3663528	549	649	100	RIGHT	K342.EDF	K34	2
32	3663731	3663856	852	977	125	RIGHT	K342.EDF	K34	2
32	3668141	3668258	5262	5379	117	RIGHT	K342.EDF	K34	2
34	3679773	3679874	733	834	101	RIGHT	K342.EDF	K34	2
34	3683958	3684055	4918	5015	97	RIGHT	K342.EDF	K34	2
35	3688580	3688697	917	1034	117	RIGHT	K342.EDF	K34	2
36	3697489	3697624	758	893	135	RIGHT	K342.EDF	K34	2
36	3697911	3698004	1180	1273	93	RIGHT	K342.EDF	K34	2
37	3704874	3704919	57	102	45	RIGHT	K342.EDF	K34	2
37	3705693	3705785	876	968	92	RIGHT	K342.EDF	K34	2
37	3710933	3710984	6116	6167	51	RIGHT	K342.EDF	K34	2
38	3713357	3713418	57	118	61	RIGHT	K342.EDF	K34	2
39	3720576	3720690	602	716	114	RIGHT	K342.EDF	K34	2
39	3721202	3721269	1228	1295	67	RIGHT	K342.EDF	K34	2
40	3730351	3730472	711	832	121	RIGHT	K342.EDF	K34	2
40	3730734	3730854	1094	1214	120	RIGHT	K342.EDF	K34	2
42	3745248	3745339	58	149	91	RIGHT	K342.EDF	K34	2
42	3748050	3748182	2860	2992	132	RIGHT	K342.EDF	K34	2
43	3754188	3754293	843	948	105	RIGHT	K342.EDF	K34	2
43	3754571	3754684	1226	1339	113	RIGHT	K342.EDF	K34	2
44	3760248	3760306	57	115	58	RIGHT	K342.EDF	K34	2
44	3760576	3760599	385	408	23	RIGHT	K342.EDF	K34	2
44	3761260	3761392	1069	1201	132	RIGHT	K342.EDF	K34	2
45	3768941	3769045	1007	1111	104	RIGHT	K342.EDF	K34	2
45	3769268	3769368	1334	1434	100	RIGHT	K342.EDF	K34	2
45	3769716	3769725	1782	1791	9	RIGHT	K342.EDF	K34	2
45	3770130	3770258	2196	2324	128	RIGHT	K342.EDF	K34	2
45	3770540	3770621	2606	2687	81	RIGHT	K342.EDF	K34	2
46	3777633	3777720	1165	1252	87	RIGHT	K342.EDF	K34	2
48	3791817	3791911	830	924	94	RIGHT	K342.EDF	K34	2
49	3799503	3799618	353	468	115	RIGHT	K342.EDF	K34	2
49	3799898	3800000	748	850	102	RIGHT	K342.EDF	K34	2
50	3806365	3806479	57	171	114	RIGHT	K342.EDF	K34	2
50	3807544	3807686	1236	1378	142	RIGHT	K342.EDF	K34	2
51	3813859	3813879	57	77	20	RIGHT	K342.EDF	K34	2
51	3814476	3814579	674	777	103	RIGHT	K342.EDF	K34	2
51	3814787	3814903	985	1101	116	RIGHT	K342.EDF	K34	2
51	3818559	3818639	4757	4837	80	RIGHT	K342.EDF	K34	2
52	3823971	3824080	710	819	109	RIGHT	K342.EDF	K34	2
52	3824421	3824525	1160	1264	104	RIGHT	K342.EDF	K34	2
53	3832922	3833035	759	872	113	RIGHT	K342.EDF	K34	2
53	3835263	3835377	3100	3214	114	RIGHT	K342.EDF	K34	2
53	3837573	3837665	5410	5502	92	RIGHT	K342.EDF	K34	2
54	3841616	3841723	709	816	107	RIGHT	K342.EDF	K34	2
54	3843819	3843951	2912	3044	132	RIGHT	K342.EDF	K34	2
54	3844524	3844604	3617	3697	80	RIGHT	K342.EDF	K34	2
55	3850065	3850177	1241	1353	112	RIGHT	K342.EDF	K34	2
56	3857496	3857561	559	624	65	RIGHT	K342.EDF	K34	2
56	3857765	3857895	828	958	130	RIGHT	K342.EDF	K34	2
57	3865856	3865943	1214	1301	87	RIGHT	K342.EDF	K34	2
59	3882798	3882883	987	1072	85	RIGHT	K342.EDF	K34	2
59	3883122	3883232	1311	1421	110	RIGHT	K342.EDF	K34	2
60	3892949	3893067	2421	2539	118	RIGHT	K342.EDF	K34	2
60	3894144	3894292	3616	3764	148	RIGHT	K342.EDF	K34	2
61	3900021	3900129	545	653	108	RIGHT	K342.EDF	K34	2
61	3900421	3900529	945	1053	108	RIGHT	K342.EDF	K34	2
62	3908174	3908291	85	202	117	RIGHT	K342.EDF	K34	2
62	3910169	3910263	2080	2174	94	RIGHT	K342.EDF	K34	2
63	3917411	3917535	428	552	124	RIGHT	K342.EDF	K34	2
63	3917827	3917906	844	923	79	RIGHT	K342.EDF	K34	2
63	3918252	3918355	1269	1372	103	RIGHT	K342.EDF	K34	2
63	3920677	3920777	3694	3794	100	RIGHT	K342.EDF	K34	2
63	3922181	3922254	5198	5271	73	RIGHT	K342.EDF	K34	2
64	3926388	3926507	649	768	119	RIGHT	K342.EDF	K34	2
64	3928361	3928516	2622	2777	155	RIGHT	K342.EDF	K34	2
64	3928946	3929044	3207	3305	98	RIGHT	K342.EDF	K34	2
64	3931663	3931765	5924	6026	102	RIGHT	K342.EDF	K34	2
65	3934693	3934798	1017	1122	105	RIGHT	K342.EDF	K34	2
65	3935021	3935110	1345	1434	89	RIGHT	K342.EDF	K34	2
66	3945650	3945753	4652	4755	103	RIGHT	K342.EDF	K34	2
67	3949519	3949581	1274	1336	62	RIGHT	K342.EDF	K34	2
69	3964657	3964771	650	764	114	RIGHT	K342.EDF	K34	2
69	3965155	3965245	1148	1238	90	RIGHT	K342.EDF	K34	2
69	3966794	3966894	2787	2887	100	RIGHT	K342.EDF	K34	2
70	3973464	3973534	2106	2176	70	RIGHT	K342.EDF	K34	2
71	3981460	3981581	765	886	121	RIGHT	K342.EDF	K34	2
72	3991744	3991818	1643	1717	74	RIGHT	K342.EDF	K34	2
72	3997382	3997483	7281	7382	101	RIGHT	K342.EDF	K34	2
73	4000812	4000912	1416	1516	100	RIGHT	K342.EDF	K34	2
76	4023683	4023809	824	950	126	RIGHT	K342.EDF	K34	2
79	4046095	4046190	939	1034	95	RIGHT	K342.EDF	K34	2
80	4053818	4053913	799	894	95	RIGHT	K342.EDF	K34	2
80	4057192	4057303	4173	4284	111	RIGHT	K342.EDF	K34	2
81	4061402	4061440	58	96	38	RIGHT	K342.EDF	K34	2
81	4062278	4062419	934	1075	141	RIGHT	K342.EDF	K34	2
82	4069110	4069223	762	875	113	RIGHT	K342.EDF	K34	2
82	4069475	4069537	1127	1189	62	RIGHT	K342.EDF	K34	2
83	4078227	4078338	1214	1325	111	RIGHT	K342.EDF	K34	2
83	4078568	4078667	1555	1654	99	RIGHT	K342.EDF	K34	2
84	4086966	4087048	2505	2587	82	RIGHT	K342.EDF	K34	2
85	4095538	4095618	3006	3086	80	RIGHT	K342.EDF	K34	2
85	4095872	4095953	3340	3421	81	RIGHT	K342.EDF	K34	2
86	4102102	4102209	662	769	107	RIGHT	K342.EDF	K34	2
86	4102588	4102692	1148	1252	104	RIGHT	K342.EDF	K34	2
87	4109799	4109894	274	369	95	RIGHT	K342.EDF	K34	2
87	4110369	4110488	844	963	119	RIGHT	K342.EDF	K34	2
87	4110886	4110977	1361	1452	91	RIGHT	K342.EDF	K34	2
87	4114921	4114972	5396	5447	51	RIGHT	K342.EDF	K34	2
88	4117630	4117673	57	100	43	RIGHT	K342.EDF	K34	2
89	4126981	4127053	1056	1128	72	RIGHT	K342.EDF	K34	2
89	4127304	4127388	1379	1463	84	RIGHT	K342.EDF	K34	2
90	4139545	4139621	4985	5061	76	RIGHT	K342.EDF	K34	2
91	4142834	4142945	170	281	111	RIGHT	K342.EDF	K34	2
91	4143406	4143521	742	857	115	RIGHT	K342.EDF	K34	2
91	4146952	4146993	4288	4329	41	RIGHT	K342.EDF	K34	2
92	4152979	4153116	710	847	137	RIGHT	K342.EDF	K34	2
92	4153306	4153405	1037	1136	99	RIGHT	K342.EDF	K34	2
93	4160269	4160383	73	187	114	RIGHT	K342.EDF	K34	2
93	4161406	4161466	1210	1270	60	RIGHT	K342.EDF	K34	2
93	4161719	4161782	1523	1586	63	RIGHT	K342.EDF	K34	2
94	4167626	4167703	57	134	77	RIGHT	K342.EDF	K34	2
94	4168264	4168380	695	811	116	RIGHT	K342.EDF	K34	2
94	4170755	4170868	3186	3299	113	RIGHT	K342.EDF	K34	2
94	4172899	4173061	5330	5492	162	RIGHT	K342.EDF	K34	2
95	4175958	4176014	816	872	56	RIGHT	K342.EDF	K34	2
97	4195524	4195703	4389	4568	179	RIGHT	K342.EDF	K34	2
98	4201684	4201779	893	988	95	RIGHT	K342.EDF	K34	2
99	4208743	4208855	477	589	112	RIGHT	K342.EDF	K34	2
99	4209429	4209524	1163	1258	95	RIGHT	K342.EDF	K34	2
100	4215880	4215972	1393	1485	92	RIGHT	K342.EDF	K34	2
101	4222892	4223003	221	332	111	RIGHT	K342.EDF	K34	2
101	4223327	4223420	656	749	93	RIGHT	K342.EDF	K34	2
101	4224609	4224689	1938	2018	80	RIGHT	K342.EDF	K34	2
102	4231174	4231246	85	157	72	RIGHT	K342.EDF	K34	2
102	4232311	4232422	1222	1333	111	RIGHT	K342.EDF	K34	2
102	4232861	4232937	1772	1848	76	RIGHT	K342.EDF	K34	2
102	4233446	4233510	2357	2421	64	RIGHT	K342.EDF	K34	2
102	4233797	4233870	2708	2781	73	RIGHT	K342.EDF	K34	2
102	4236290	4236351	5201	5262	61	RIGHT	K342.EDF	K34	2
103	4241437	4241543	914	1020	106	RIGHT	K342.EDF	K34	2
103	4241753	4241878	1230	1355	125	RIGHT	K342.EDF	K34	2
104	4250014	4250084	914	984	70	RIGHT	K342.EDF	K34	2
104	4250215	4250222	1115	1122	7	RIGHT	K342.EDF	K34	2
104	4250252	4250340	1152	1240	88	RIGHT	K342.EDF	K34	2
104	4250714	4250793	1614	1693	79	RIGHT	K342.EDF	K34	2
104	4255256	4255343	6156	6243	87	RIGHT	K342.EDF	K34	2
105	4258825	4258925	164	264	100	RIGHT	K342.EDF	K34	2
105	4259686	4259802	1025	1141	116	RIGHT	K342.EDF	K34	2
105	4265578	4265621	6917	6960	43	RIGHT	K342.EDF	K34	2
106	4267222	4267272	61	111	50	RIGHT	K342.EDF	K34	2
106	4267948	4268097	787	936	149	RIGHT	K342.EDF	K34	2
107	4274144	4274261	582	699	117	RIGHT	K342.EDF	K34	2
108	4283909	4284050	975	1116	141	RIGHT	K342.EDF	K34	2
109	4291731	4291809	302	380	78	RIGHT	K342.EDF	K34	2
109	4292158	4292248	729	819	90	RIGHT	K342.EDF	K34	2
109	4294156	4294266	2727	2837	110	RIGHT	K342.EDF	K34	2
109	4294714	4294827	3285	3398	113	RIGHT	K342.EDF	K34	2
109	4297685	4297760	6256	6331	75	RIGHT	K342.EDF	K34	2
110	4300459	4300577	717	835	118	RIGHT	K342.EDF	K34	2
110	4305604	4305661	5862	5919	57	RIGHT	K342.EDF	K34	2
111	4308799	4308945	1081	1227	146	RIGHT	K342.EDF	K34	2
112	4317037	4317120	976	1059	83	RIGHT	K342.EDF	K34	2
113	4323738	4323892	91	245	154	RIGHT	K342.EDF	K34	2
113	4324483	4324550	836	903	67	RIGHT	K342.EDF	K34	2
114	4332292	4332436	600	744	144	RIGHT	K342.EDF	K34	2
115	4339653	4339769	696	812	116	RIGHT	K342.EDF	K34	2
116	4348222	4348356	932	1066	134	RIGHT	K342.EDF	K34	2
117	4356864	4356979	577	692	115	RIGHT	K342.EDF	K34	2
117	4357246	4357275	959	988	29	RIGHT	K342.EDF	K34	2
117	4358462	4358550	2175	2263	88	RIGHT	K342.EDF	K34	2
118	4364092	4364201	650	759	109	RIGHT	K342.EDF	K34	2
119	4371118	4371656	124	662	538	RIGHT	K342.EDF	K34	2
119	4372071	4372126	1077	1132	55	RIGHT	K342.EDF	K34	2
120	4379115	4379223	805	913	108	RIGHT	K342.EDF	K34	2
120	4379448	4379554	1138	1244	106	RIGHT	K342.EDF	K34	2
1	5145078	5145209	945	1076	131	RIGHT	K343.EDF	K34	3
2	5152232	5152401	1144	1313	169	RIGHT	K343.EDF	K34	3
4	5167552	5167680	732	860	128	RIGHT	K343.EDF	K34	3
4	5168351	5168507	1531	1687	156	RIGHT	K343.EDF	K34	3
6	5183017	5183143	527	653	126	RIGHT	K343.EDF	K34	3
8	5197788	5197894	637	743	106	RIGHT	K343.EDF	K34	3
8	5198346	5198478	1195	1327	132	RIGHT	K343.EDF	K34	3
9	5206043	5206170	858	985	127	RIGHT	K343.EDF	K34	3
10	5213944	5214080	565	701	136	RIGHT	K343.EDF	K34	3
11	5222524	5222701	422	599	177	RIGHT	K343.EDF	K34	3
11	5222933	5223077	831	975	144	RIGHT	K343.EDF	K34	3
16	5264889	5264984	3253	3348	95	RIGHT	K343.EDF	K34	3
17	5270504	5270714	558	768	210	RIGHT	K343.EDF	K34	3
18	5278880	5278980	1362	1462	100	RIGHT	K343.EDF	K34	3
19	5286198	5286313	593	708	115	RIGHT	K343.EDF	K34	3
19	5286460	5286587	855	982	127	RIGHT	K343.EDF	K34	3
20	5294096	5294212	87	203	116	RIGHT	K343.EDF	K34	3
21	5300931	5301051	77	197	120	RIGHT	K343.EDF	K34	3
21	5301728	5301834	874	980	106	RIGHT	K343.EDF	K34	3
22	5310455	5310547	737	829	92	RIGHT	K343.EDF	K34	3
23	5321801	5321907	688	794	106	RIGHT	K343.EDF	K34	3
24	5328687	5328748	97	158	61	RIGHT	K343.EDF	K34	3
24	5329127	5329251	537	661	124	RIGHT	K343.EDF	K34	3
24	5329503	5329604	913	1014	101	RIGHT	K343.EDF	K34	3
25	5337881	5337992	624	735	111	RIGHT	K343.EDF	K34	3
25	5338213	5338315	956	1058	102	RIGHT	K343.EDF	K34	3
26	5345508	5345610	1028	1130	102	RIGHT	K343.EDF	K34	3
26	5346845	5346919	2365	2439	74	RIGHT	K343.EDF	K34	3
26	5347132	5347217	2652	2737	85	RIGHT	K343.EDF	K34	3
28	5362315	5362410	698	793	95	RIGHT	K343.EDF	K34	3
29	5369404	5369526	560	682	122	RIGHT	K343.EDF	K34	3
29	5369772	5369873	928	1029	101	RIGHT	K343.EDF	K34	3
29	5370195	5370285	1351	1441	90	RIGHT	K343.EDF	K34	3
31	5386593	5386697	595	699	104	RIGHT	K343.EDF	K34	3
32	5398096	5398179	4507	4590	83	RIGHT	K343.EDF	K34	3
32	5398410	5398503	4821	4914	93	RIGHT	K343.EDF	K34	3
33	5405187	5405272	2931	3016	85	RIGHT	K343.EDF	K34	3
33	5406498	5406601	4242	4345	103	RIGHT	K343.EDF	K34	3
34	5411738	5411870	877	1009	132	RIGHT	K343.EDF	K34	3
34	5412152	5412263	1291	1402	111	RIGHT	K343.EDF	K34	3
34	5413591	5413627	2730	2766	36	RIGHT	K343.EDF	K34	3
35	5418576	5418684	774	882	108	RIGHT	K343.EDF	K34	3
35	5422521	5422588	4719	4786	67	RIGHT	K343.EDF	K34	3
35	5423535	5423590	5733	5788	55	RIGHT	K343.EDF	K34	3
35	5423923	5424010	6121	6208	87	RIGHT	K343.EDF	K34	3
36	5426433	5426509	111	187	76	RIGHT	K343.EDF	K34	3
36	5426674	5426746	352	424	72	RIGHT	K343.EDF	K34	3
36	5427187	5427285	865	963	98	RIGHT	K343.EDF	K34	3
37	5439089	5439200	4501	4612	111	RIGHT	K343.EDF	K34	3
38	5442347	5442446	67	166	99	RIGHT	K343.EDF	K34	3
38	5443062	5443183	782	903	121	RIGHT	K343.EDF	K34	3
39	5450064	5450089	57	82	25	RIGHT	K343.EDF	K34	3
39	5450736	5450810	729	803	74	RIGHT	K343.EDF	K34	3
40	5458855	5458978	870	993	123	RIGHT	K343.EDF	K34	3
40	5462860	5463004	4875	5019	144	RIGHT	K343.EDF	K34	3
40	5463524	5464002	5539	6017	478	RIGHT	K343.EDF	K34	3
41	5467074	5467265	710	901	191	RIGHT	K343.EDF	K34	3
41	5469971	5470083	3607	3719	112	RIGHT	K343.EDF	K34	3
41	5470366	5470482	4002	4118	116	RIGHT	K343.EDF	K34	3
42	5476975	5476996	4365	4386	21	RIGHT	K343.EDF	K34	3
43	5481711	5481868	606	763	157	RIGHT	K343.EDF	K34	3
44	5490355	5490480	679	804	125	RIGHT	K343.EDF	K34	3
44	5494219	5494300	4543	4624	81	RIGHT	K343.EDF	K34	3
45	5498351	5498454	846	949	103	RIGHT	K343.EDF	K34	3
46	5506678	5506807	589	718	129	RIGHT	K343.EDF	K34	3
46	5507342	5507458	1253	1369	116	RIGHT	K343.EDF	K34	3
47	5514585	5514602	92	109	17	RIGHT	K343.EDF	K34	3
47	5515480	5515602	987	1109	122	RIGHT	K343.EDF	K34	3
48	5522524	5522626	933	1035	102	RIGHT	K343.EDF	K34	3
49	5530396	5530487	1220	1311	91	RIGHT	K343.EDF	K34	3
50	5537681	5537759	972	1050	78	RIGHT	K343.EDF	K34	3
50	5539634	5539753	2925	3044	119	RIGHT	K343.EDF	K34	3
50	5540017	5540360	3308	3651	343	RIGHT	K343.EDF	K34	3
51	5545543	5545646	309	412	103	RIGHT	K343.EDF	K34	3
51	5546014	5546164	780	930	150	RIGHT	K343.EDF	K34	3
52	5554565	5554662	708	805	97	RIGHT	K343.EDF	K34	3
53	5562536	5562663	582	709	127	RIGHT	K343.EDF	K34	3
53	5563874	5563998	1920	2044	124	RIGHT	K343.EDF	K34	3
54	5569772	5569913	593	734	141	RIGHT	K343.EDF	K34	3
54	5570587	5570844	1408	1665	257	RIGHT	K343.EDF	K34	3
55	5578606	5578743	581	718	137	RIGHT	K343.EDF	K34	3
55	5579222	5579322	1197	1297	100	RIGHT	K343.EDF	K34	3
55	5579953	5580075	1928	2050	122	RIGHT	K343.EDF	K34	3
57	5593861	5593962	66	167	101	RIGHT	K343.EDF	K34	3
58	5601680	5601770	1132	1222	90	RIGHT	K343.EDF	K34	3
59	5608658	5608720	87	149	62	RIGHT	K343.EDF	K34	3
59	5609076	5609198	505	627	122	RIGHT	K343.EDF	K34	3
59	5609507	5609615	936	1044	108	RIGHT	K343.EDF	K34	3
59	5611496	5611607	2925	3036	111	RIGHT	K343.EDF	K34	3
59	5612173	5612234	3602	3663	61	RIGHT	K343.EDF	K34	3
61	5624060	5624232	788	960	172	RIGHT	K343.EDF	K34	3
61	5627421	5627510	4149	4238	89	RIGHT	K343.EDF	K34	3
61	5627720	5627810	4448	4538	90	RIGHT	K343.EDF	K34	3
62	5631904	5632007	897	1000	103	RIGHT	K343.EDF	K34	3
62	5633930	5634007	2923	3000	77	RIGHT	K343.EDF	K34	3
62	5634830	5634906	3823	3899	76	RIGHT	K343.EDF	K34	3
62	5635657	5635734	4650	4727	77	RIGHT	K343.EDF	K34	3
62	5636190	5636270	5183	5263	80	RIGHT	K343.EDF	K34	3
63	5639068	5639183	709	824	115	RIGHT	K343.EDF	K34	3
63	5639577	5639674	1218	1315	97	RIGHT	K343.EDF	K34	3
64	5646426	5646542	682	798	116	RIGHT	K343.EDF	K34	3
65	5653296	5653433	636	773	137	RIGHT	K343.EDF	K34	3
65	5655213	5655331	2553	2671	118	RIGHT	K343.EDF	K34	3
65	5655799	5655865	3139	3205	66	RIGHT	K343.EDF	K34	3
65	5656145	5656263	3485	3603	118	RIGHT	K343.EDF	K34	3
65	5656942	5657030	4282	4370	88	RIGHT	K343.EDF	K34	3
65	5657310	5657402	4650	4742	92	RIGHT	K343.EDF	K34	3
66	5661683	5661801	1017	1135	118	RIGHT	K343.EDF	K34	3
67	5669000	5670310	432	1742	1310	RIGHT	K343.EDF	K34	3
68	5677001	5677079	985	1063	78	RIGHT	K343.EDF	K34	3
68	5678756	5678793	2740	2777	37	RIGHT	K343.EDF	K34	3
68	5678976	5679920	2960	3904	944	RIGHT	K343.EDF	K34	3
69	5684360	5684462	980	1082	102	RIGHT	K343.EDF	K34	3
70	5691386	5691485	836	935	99	RIGHT	K343.EDF	K34	3
70	5693433	5694204	2883	3654	771	RIGHT	K343.EDF	K34	3
70	5694231	5694259	3681	3709	28	RIGHT	K343.EDF	K34	3
70	5695231	5695321	4681	4771	90	RIGHT	K343.EDF	K34	3
72	5708534	5708610	2050	2126	76	RIGHT	K343.EDF	K34	3
72	5708831	5708942	2347	2458	111	RIGHT	K343.EDF	K34	3
73	5714615	5714781	825	991	166	RIGHT	K343.EDF	K34	3
74	5722382	5722548	728	894	166	RIGHT	K343.EDF	K34	3
75	5730912	5731040	1353	1481	128	RIGHT	K343.EDF	K34	3
75	5734682	5734778	5123	5219	96	RIGHT	K343.EDF	K34	3
77	5746023	5746113	71	161	90	RIGHT	K343.EDF	K34	3
77	5746313	5746437	361	485	124	RIGHT	K343.EDF	K34	3
77	5746727	5746841	775	889	114	RIGHT	K343.EDF	K34	3
77	5747059	5747206	1107	1254	147	RIGHT	K343.EDF	K34	3
77	5753119	5753177	7167	7225	58	RIGHT	K343.EDF	K34	3
78	5755747	5755846	874	973	99	RIGHT	K343.EDF	K34	3
79	5763860	5764036	530	706	176	RIGHT	K343.EDF	K34	3
80	5777074	5777134	5760	5820	60	RIGHT	K343.EDF	K34	3
81	5780843	5780968	664	789	125	RIGHT	K343.EDF	K34	3
81	5781219	5781291	1040	1112	72	RIGHT	K343.EDF	K34	3
81	5781500	5781585	1321	1406	85	RIGHT	K343.EDF	K34	3
82	5791353	5791421	3680	3748	68	RIGHT	K343.EDF	K34	3
82	5792457	5792508	4784	4835	51	RIGHT	K343.EDF	K34	3
83	5796196	5796336	491	631	140	RIGHT	K343.EDF	K34	3
83	5796560	5796661	855	956	101	RIGHT	K343.EDF	K34	3
83	5798608	5798665	2903	2960	57	RIGHT	K343.EDF	K34	3
83	5798869	5798986	3164	3281	117	RIGHT	K343.EDF	K34	3
83	5799267	5799353	3562	3648	86	RIGHT	K343.EDF	K34	3
83	5799785	5799875	4080	4170	90	RIGHT	K343.EDF	K34	3
84	5804276	5804394	672	790	118	RIGHT	K343.EDF	K34	3
84	5806917	5807007	3313	3403	90	RIGHT	K343.EDF	K34	3
84	5807303	5807409	3699	3805	106	RIGHT	K343.EDF	K34	3
84	5808303	5808324	4699	4720	21	RIGHT	K343.EDF	K34	3
85	5812251	5812330	352	431	79	RIGHT	K343.EDF	K34	3
85	5813008	5813104	1109	1205	96	RIGHT	K343.EDF	K34	3
85	5814305	5814435	2406	2536	130	RIGHT	K343.EDF	K34	3
86	5819433	5819550	443	560	117	RIGHT	K343.EDF	K34	3
87	5827733	5827841	804	912	108	RIGHT	K343.EDF	K34	3
87	5829896	5830038	2967	3109	142	RIGHT	K343.EDF	K34	3
87	5831248	5831372	4319	4443	124	RIGHT	K343.EDF	K34	3
88	5835254	5835382	645	773	128	RIGHT	K343.EDF	K34	3
89	5842842	5842990	655	803	148	RIGHT	K343.EDF	K34	3
92	5866677	5866815	624	762	138	RIGHT	K343.EDF	K34	3
92	5867094	5867156	1041	1103	62	RIGHT	K343.EDF	K34	3
93	5875234	5875318	707	791	84	RIGHT	K343.EDF	K34	3
93	5877223	5877356	2696	2829	133	RIGHT	K343.EDF	K34	3
93	5877793	5877909	3266	3382	116	RIGHT	K343.EDF	K34	3
93	5878140	5878221	3613	3694	81	RIGHT	K343.EDF	K34	3
94	5882278	5882353	777	852	75	RIGHT	K343.EDF	K34	3
96	5897550	5897671	910	1031	121	RIGHT	K343.EDF	K34	3
97	5906159	5906264	2376	2481	105	RIGHT	K343.EDF	K34	3
98	5912424	5912564	1534	1674	140	RIGHT	K343.EDF	K34	3
98	5916748	5916760	5858	5870	12	RIGHT	K343.EDF	K34	3
100	5926114	5926163	58	107	49	RIGHT	K343.EDF	K34	3
100	5926677	5926801	621	745	124	RIGHT	K343.EDF	K34	3
100	5927052	5927130	996	1074	78	RIGHT	K343.EDF	K34	3
100	5932103	5932146	6047	6090	43	RIGHT	K343.EDF	K34	3
100	5932498	5932600	6442	6544	102	RIGHT	K343.EDF	K34	3
100	5932936	5933042	6880	6986	106	RIGHT	K343.EDF	K34	3
101	5935589	5935694	532	637	105	RIGHT	K343.EDF	K34	3
101	5935894	5936017	837	960	123	RIGHT	K343.EDF	K34	3
101	5937431	5937515	2374	2458	84	RIGHT	K343.EDF	K34	3
102	5943092	5943233	544	685	141	RIGHT	K343.EDF	K34	3
102	5943437	5943535	889	987	98	RIGHT	K343.EDF	K34	3
102	5945265	5945327	2717	2779	62	RIGHT	K343.EDF	K34	3
102	5945537	5945655	2989	3107	118	RIGHT	K343.EDF	K34	3
102	5946526	5946618	3978	4070	92	RIGHT	K343.EDF	K34	3
102	5947327	5947408	4779	4860	81	RIGHT	K343.EDF	K34	3
102	5947881	5947965	5333	5417	84	RIGHT	K343.EDF	K34	3
103	5950992	5951113	57	178	121	RIGHT	K343.EDF	K34	3
103	5951595	5951733	660	798	138	RIGHT	K343.EDF	K34	3
103	5951981	5952120	1046	1185	139	RIGHT	K343.EDF	K34	3
103	5952636	5952705	1701	1770	69	RIGHT	K343.EDF	K34	3
104	5960471	5960571	372	472	100	RIGHT	K343.EDF	K34	3
104	5960820	5960908	721	809	88	RIGHT	K343.EDF	K34	3
105	5968635	5968787	617	769	152	RIGHT	K343.EDF	K34	3
106	5977328	5977435	538	645	107	RIGHT	K343.EDF	K34	3
107	5986238	5986251	2317	2330	13	RIGHT	K343.EDF	K34	3
108	5991784	5991876	84	176	92	RIGHT	K343.EDF	K34	3
108	5992305	5992432	605	732	127	RIGHT	K343.EDF	K34	3
109	6001646	6001785	332	471	139	RIGHT	K343.EDF	K34	3
109	6002232	6002330	918	1016	98	RIGHT	K343.EDF	K34	3
110	6011663	6011810	481	628	147	RIGHT	K343.EDF	K34	3
110	6012029	6012163	847	981	134	RIGHT	K343.EDF	K34	3
111	6018703	6018805	588	690	102	RIGHT	K343.EDF	K34	3
112	6025495	6025585	293	383	90	RIGHT	K343.EDF	K34	3
112	6025845	6025965	643	763	120	RIGHT	K343.EDF	K34	3
112	6027718	6027730	2516	2528	12	RIGHT	K343.EDF	K34	3
112	6028041	6028130	2839	2928	89	RIGHT	K343.EDF	K34	3
114	6042170	6042239	637	706	69	RIGHT	K343.EDF	K34	3
114	6042588	6042670	1055	1137	82	RIGHT	K343.EDF	K34	3
115	6048701	6048813	574	686	112	RIGHT	K343.EDF	K34	3
115	6050104	6050213	1977	2086	109	RIGHT	K343.EDF	K34	3
115	6051208	6051330	3081	3203	122	RIGHT	K343.EDF	K34	3
115	6051852	6051891	3725	3764	39	RIGHT	K343.EDF	K34	3
116	6059163	6059307	511	655	144	RIGHT	K343.EDF	K34	3
116	6059584	6059653	932	1001	69	RIGHT	K343.EDF	K34	3
116	6061907	6062061	3255	3409	154	RIGHT	K343.EDF	K34	3
117	6070626	6070666	1977	2017	40	RIGHT	K343.EDF	K34	3
117	6071064	6071173	2415	2524	109	RIGHT	K343.EDF	K34	3
117	6074414	6074488	5765	5839	74	RIGHT	K343.EDF	K34	3
117	6074789	6074868	6140	6219	79	RIGHT	K343.EDF	K34	3
118	6079311	6079383	551	623	72	RIGHT	K343.EDF	K34	3
118	6079578	6079691	818	931	113	RIGHT	K343.EDF	K34	3
118	6079876	6079969	1116	1209	93	RIGHT	K343.EDF	K34	3
119	6085433	6085521	59	147	88	RIGHT	K343.EDF	K34	3
119	6088133	6088228	2759	2854	95	RIGHT	K343.EDF	K34	3
120	6097834	6097927	4572	4665	93	RIGHT	K343.EDF	K34	3
120	6100149	6100246	6887	6984	97	RIGHT	K343.EDF	K34	3
120	6100815	6100882	7553	7620	67	RIGHT	K343.EDF	K34	3
2	8409143	8409391	1235	1483	248	RIGHT	L351.EDF	L35	1
3	8417411	8417574	1339	1502	163	RIGHT	L351.EDF	L35	1
3	8422550	8422745	6478	6673	195	RIGHT	L351.EDF	L35	1
4	8425280	8425421	141	282	141	RIGHT	L351.EDF	L35	1
4	8430761	8430940	5622	5801	179	RIGHT	L351.EDF	L35	1
6	8440129	8440357	449	677	228	RIGHT	L351.EDF	L35	1
7	8446926	8447109	57	240	183	RIGHT	L351.EDF	L35	1
7	8448197	8448355	1328	1486	158	RIGHT	L351.EDF	L35	1
8	8455950	8456001	58	109	51	RIGHT	L351.EDF	L35	1
8	8456892	8457091	1000	1199	199	RIGHT	L351.EDF	L35	1
8	8459494	8459810	3602	3918	316	RIGHT	L351.EDF	L35	1
9	8470285	8470476	6401	6592	191	RIGHT	L351.EDF	L35	1
10	8473324	8473472	382	530	148	RIGHT	L351.EDF	L35	1
11	8481679	8481859	823	1003	180	RIGHT	L351.EDF	L35	1
12	8489683	8489831	551	699	148	RIGHT	L351.EDF	L35	1
13	8497414	8497558	1052	1196	144	RIGHT	L351.EDF	L35	1
14	8504140	8504453	762	1075	313	RIGHT	L351.EDF	L35	1
14	8505806	8506119	2428	2741	313	RIGHT	L351.EDF	L35	1
14	8506526	8506773	3148	3395	247	RIGHT	L351.EDF	L35	1
15	8511900	8512088	456	644	188	RIGHT	L351.EDF	L35	1
15	8512822	8513044	1378	1600	222	RIGHT	L351.EDF	L35	1
15	8514564	8514738	3120	3294	174	RIGHT	L351.EDF	L35	1
15	8515862	8516039	4418	4595	177	RIGHT	L351.EDF	L35	1
17	8528143	8528315	1080	1252	172	RIGHT	L351.EDF	L35	1
18	8537629	8537771	1348	1490	142	RIGHT	L351.EDF	L35	1
19	8543234	8543440	170	376	206	RIGHT	L351.EDF	L35	1
20	8551313	8551479	57	223	166	RIGHT	L351.EDF	L35	1
22	8567933	8568107	1122	1296	174	RIGHT	L351.EDF	L35	1
23	8575900	8576093	726	919	193	RIGHT	L351.EDF	L35	1
25	8593338	8593481	1472	1615	143	RIGHT	L351.EDF	L35	1
25	8594200	8599178	2334	7312	4978	RIGHT	L351.EDF	L35	1
26	8601523	8608944	57	7478	7421	RIGHT	L351.EDF	L35	1
27	8611143	8616879	57	5793	5736	RIGHT	L351.EDF	L35	1
28	8618856	8621063	57	2264	2207	RIGHT	L351.EDF	L35	1
28	8621171	8621475	2372	2676	304	RIGHT	L351.EDF	L35	1
28	8622278	8622458	3479	3659	180	RIGHT	L351.EDF	L35	1
28	8623743	8623950	4944	5151	207	RIGHT	L351.EDF	L35	1
29	8627505	8627511	1040	1046	6	RIGHT	L351.EDF	L35	1
29	8627540	8627540	1075	1075	0	RIGHT	L351.EDF	L35	1
29	8627748	8627798	1283	1333	50	RIGHT	L351.EDF	L35	1
29	8627820	8633609	1355	7144	5789	RIGHT	L351.EDF	L35	1
30	8635623	8638239	395	3011	2616	RIGHT	L351.EDF	L35	1
30	8638585	8640243	3357	5015	1658	RIGHT	L351.EDF	L35	1
31	8643055	8643211	1010	1166	156	RIGHT	L351.EDF	L35	1
31	8643987	8647658	1942	5613	3671	RIGHT	L351.EDF	L35	1
32	8649887	8650381	58	552	494	RIGHT	L351.EDF	L35	1
32	8650404	8650424	575	595	20	RIGHT	L351.EDF	L35	1
32	8650455	8650464	626	635	9	RIGHT	L351.EDF	L35	1
32	8650581	8650582	752	753	1	RIGHT	L351.EDF	L35	1
32	8650632	8656123	803	6294	5491	RIGHT	L351.EDF	L35	1
33	8658122	8664288	57	6223	6166	RIGHT	L351.EDF	L35	1
34	8666216	8666240	57	81	24	RIGHT	L351.EDF	L35	1
34	8667160	8670640	1001	4481	3480	RIGHT	L351.EDF	L35	1
34	8670812	8671583	4653	5424	771	RIGHT	L351.EDF	L35	1
35	8673365	8675247	84	1966	1882	RIGHT	L351.EDF	L35	1
35	8675679	8679398	2398	6117	3719	RIGHT	L351.EDF	L35	1
36	8681934	8683247	309	1622	1313	RIGHT	L351.EDF	L35	1
36	8684597	8684716	2972	3091	119	RIGHT	L351.EDF	L35	1
36	8684764	8687272	3139	5647	2508	RIGHT	L351.EDF	L35	1
37	8689308	8689311	454	457	3	RIGHT	L351.EDF	L35	1
37	8689352	8689731	498	877	379	RIGHT	L351.EDF	L35	1
37	8689771	8689799	917	945	28	RIGHT	L351.EDF	L35	1
37	8689847	8689997	993	1143	150	RIGHT	L351.EDF	L35	1
37	8691255	8691376	2401	2522	121	RIGHT	L351.EDF	L35	1
37	8691938	8691940	3084	3086	2	RIGHT	L351.EDF	L35	1
37	8691996	8692117	3142	3263	121	RIGHT	L351.EDF	L35	1
37	8692165	8692180	3311	3326	15	RIGHT	L351.EDF	L35	1
37	8692241	8695728	3387	6874	3487	RIGHT	L351.EDF	L35	1
38	8699478	8699594	1778	1894	116	RIGHT	L351.EDF	L35	1
38	8702072	8702222	4372	4522	150	RIGHT	L351.EDF	L35	1
39	8706230	8706402	65	237	172	RIGHT	L351.EDF	L35	1
39	8709749	8709755	3584	3590	6	RIGHT	L351.EDF	L35	1
39	8709800	8709802	3635	3637	2	RIGHT	L351.EDF	L35	1
39	8709826	8710037	3661	3872	211	RIGHT	L351.EDF	L35	1
39	8710061	8710088	3896	3923	27	RIGHT	L351.EDF	L35	1
39	8710119	8710135	3954	3970	16	RIGHT	L351.EDF	L35	1
39	8710731	8710732	4566	4567	1	RIGHT	L351.EDF	L35	1
39	8710842	8710845	4677	4680	3	RIGHT	L351.EDF	L35	1
39	8710966	8710970	4801	4805	4	RIGHT	L351.EDF	L35	1
39	8711004	8711217	4839	5052	213	RIGHT	L351.EDF	L35	1
39	8711254	8711318	5089	5153	64	RIGHT	L351.EDF	L35	1
39	8711346	8711394	5181	5229	48	RIGHT	L351.EDF	L35	1
39	8711417	8711678	5252	5513	261	RIGHT	L351.EDF	L35	1
40	8713162	8713252	57	147	90	RIGHT	L351.EDF	L35	1
40	8714667	8714795	1562	1690	128	RIGHT	L351.EDF	L35	1
40	8717186	8717347	4081	4242	161	RIGHT	L351.EDF	L35	1
40	8717984	8717985	4879	4880	1	RIGHT	L351.EDF	L35	1
40	8718051	8718061	4946	4956	10	RIGHT	L351.EDF	L35	1
40	8718090	8718091	4985	4986	1	RIGHT	L351.EDF	L35	1
40	8718251	8718552	5146	5447	301	RIGHT	L351.EDF	L35	1
41	8722750	8722751	2429	2430	1	RIGHT	L351.EDF	L35	1
41	8722788	8722865	2467	2544	77	RIGHT	L351.EDF	L35	1
41	8722901	8722919	2580	2598	18	RIGHT	L351.EDF	L35	1
41	8723003	8723263	2682	2942	260	RIGHT	L351.EDF	L35	1
41	8723292	8723490	2971	3169	198	RIGHT	L351.EDF	L35	1
41	8723516	8723562	3195	3241	46	RIGHT	L351.EDF	L35	1
41	8723584	8723663	3263	3342	79	RIGHT	L351.EDF	L35	1
41	8723709	8723747	3388	3426	38	RIGHT	L351.EDF	L35	1
41	8723772	8724023	3451	3702	251	RIGHT	L351.EDF	L35	1
41	8726103	8726125	5782	5804	22	RIGHT	L351.EDF	L35	1
41	8726198	8726239	5877	5918	41	RIGHT	L351.EDF	L35	1
41	8726268	8726547	5947	6226	279	RIGHT	L351.EDF	L35	1
42	8729611	8729615	1114	1118	4	RIGHT	L351.EDF	L35	1
42	8729676	8729821	1179	1324	145	RIGHT	L351.EDF	L35	1
42	8730125	8730310	1628	1813	185	RIGHT	L351.EDF	L35	1
42	8731161	8731169	2664	2672	8	RIGHT	L351.EDF	L35	1
42	8731203	8731281	2706	2784	78	RIGHT	L351.EDF	L35	1
42	8731361	8731410	2864	2913	49	RIGHT	L351.EDF	L35	1
42	8731474	8731490	2977	2993	16	RIGHT	L351.EDF	L35	1
42	8731534	8732097	3037	3600	563	RIGHT	L351.EDF	L35	1
42	8732130	8733761	3633	5264	1631	RIGHT	L351.EDF	L35	1
43	8737092	8737266	1279	1453	174	RIGHT	L351.EDF	L35	1
43	8741226	8741398	5413	5585	172	RIGHT	L351.EDF	L35	1
44	8745858	8746003	954	1099	145	RIGHT	L351.EDF	L35	1
44	8746232	8748593	1328	3689	2361	RIGHT	L351.EDF	L35	1
44	8748658	8748773	3754	3869	115	RIGHT	L351.EDF	L35	1
44	8749078	8749235	4174	4331	157	RIGHT	L351.EDF	L35	1
44	8749723	8749888	4819	4984	165	RIGHT	L351.EDF	L35	1
45	8753776	8753978	312	514	202	RIGHT	L351.EDF	L35	1
45	8758027	8758189	4563	4725	162	RIGHT	L351.EDF	L35	1
46	8764052	8764232	1645	1825	180	RIGHT	L351.EDF	L35	1
46	8766784	8766791	4377	4384	7	RIGHT	L351.EDF	L35	1
46	8766814	8767812	4407	5405	998	RIGHT	L351.EDF	L35	1
47	8769690	8770789	196	1295	1099	RIGHT	L351.EDF	L35	1
47	8773927	8773993	4433	4499	66	RIGHT	L351.EDF	L35	1
47	8774029	8774039	4535	4545	10	RIGHT	L351.EDF	L35	1
47	8774062	8774066	4568	4572	4	RIGHT	L351.EDF	L35	1
47	8774093	8774095	4599	4601	2	RIGHT	L351.EDF	L35	1
47	8774133	8774143	4639	4649	10	RIGHT	L351.EDF	L35	1
47	8774222	8774223	4728	4729	1	RIGHT	L351.EDF	L35	1
48	8778099	8778268	1536	1705	169	RIGHT	L351.EDF	L35	1
49	8784487	8785071	57	641	584	RIGHT	L351.EDF	L35	1
49	8785092	8785095	662	665	3	RIGHT	L351.EDF	L35	1
49	8785452	8785607	1022	1177	155	RIGHT	L351.EDF	L35	1
49	8787038	8787200	2608	2770	162	RIGHT	L351.EDF	L35	1
49	8788390	8788594	3960	4164	204	RIGHT	L351.EDF	L35	1
50	8792821	8792985	58	222	164	RIGHT	L351.EDF	L35	1
50	8796156	8796341	3393	3578	185	RIGHT	L351.EDF	L35	1
51	8802164	8802346	1516	1698	182	RIGHT	L351.EDF	L35	1
51	8806141	8806141	5493	5493	0	RIGHT	L351.EDF	L35	1
51	8806164	8806177	5516	5529	13	RIGHT	L351.EDF	L35	1
51	8806694	8806726	6046	6078	32	RIGHT	L351.EDF	L35	1
52	8810228	8810465	1159	1396	237	RIGHT	L351.EDF	L35	1
52	8812862	8812871	3793	3802	9	RIGHT	L351.EDF	L35	1
52	8812926	8812938	3857	3869	12	RIGHT	L351.EDF	L35	1
52	8812966	8812968	3897	3899	2	RIGHT	L351.EDF	L35	1
52	8813000	8813638	3931	4569	638	RIGHT	L351.EDF	L35	1
52	8813696	8813768	4627	4699	72	RIGHT	L351.EDF	L35	1
52	8813844	8813903	4775	4834	59	RIGHT	L351.EDF	L35	1
52	8813931	8813933	4862	4864	2	RIGHT	L351.EDF	L35	1
52	8814007	8814321	4938	5252	314	RIGHT	L351.EDF	L35	1
53	8817069	8824207	57	7195	7138	RIGHT	L351.EDF	L35	1
54	8827009	8827223	836	1050	214	RIGHT	L351.EDF	L35	1
55	8836813	8837059	1533	1779	246	RIGHT	L351.EDF	L35	1
56	8845192	8845362	1146	1316	170	RIGHT	L351.EDF	L35	1
56	8846405	8846653	2359	2607	248	RIGHT	L351.EDF	L35	1
56	8846677	8846694	2631	2648	17	RIGHT	L351.EDF	L35	1
56	8846757	8850323	2711	6277	3566	RIGHT	L351.EDF	L35	1
57	8852073	8857808	58	5793	5735	RIGHT	L351.EDF	L35	1
58	8859876	8865462	57	5643	5586	RIGHT	L351.EDF	L35	1
59	8867323	8873227	58	5962	5904	RIGHT	L351.EDF	L35	1
60	8875213	8876276	65	1128	1063	RIGHT	L351.EDF	L35	1
60	8876447	8877714	1299	2566	1267	RIGHT	L351.EDF	L35	1
60	8880227	8880228	5079	5080	1	RIGHT	L351.EDF	L35	1
60	8880296	8880302	5148	5154	6	RIGHT	L351.EDF	L35	1
60	8880335	8880360	5187	5212	25	RIGHT	L351.EDF	L35	1
60	8880386	8880480	5238	5332	94	RIGHT	L351.EDF	L35	1
60	8880502	8881532	5354	6384	1030	RIGHT	L351.EDF	L35	1
61	8883754	8889597	619	6462	5843	RIGHT	L351.EDF	L35	1
62	8891452	8896952	58	5558	5500	RIGHT	L351.EDF	L35	1
63	8899849	8901482	57	1690	1633	RIGHT	L351.EDF	L35	1
63	8901629	8903742	1837	3950	2113	RIGHT	L351.EDF	L35	1
63	8903909	8904656	4117	4864	747	RIGHT	L351.EDF	L35	1
64	8906509	8908385	110	1986	1876	RIGHT	L351.EDF	L35	1
64	8909069	8910873	2670	4474	1804	RIGHT	L351.EDF	L35	1
64	8911304	8911550	4905	5151	246	RIGHT	L351.EDF	L35	1
64	8912713	8913312	6314	6913	599	RIGHT	L351.EDF	L35	1
65	8916560	8916706	1588	1734	146	RIGHT	L351.EDF	L35	1
65	8917347	8920086	2375	5114	2739	RIGHT	L351.EDF	L35	1
66	8922926	8922978	232	284	52	RIGHT	L351.EDF	L35	1
66	8924699	8925872	2005	3178	1173	RIGHT	L351.EDF	L35	1
67	8929790	8929823	58	91	33	RIGHT	L351.EDF	L35	1
67	8930137	8931185	405	1453	1048	RIGHT	L351.EDF	L35	1
67	8931316	8931316	1584	1584	0	RIGHT	L351.EDF	L35	1
67	8931345	8931345	1613	1613	0	RIGHT	L351.EDF	L35	1
67	8931384	8931792	1652	2060	408	RIGHT	L351.EDF	L35	1
67	8932402	8932619	2670	2887	217	RIGHT	L351.EDF	L35	1
67	8934472	8934625	4740	4893	153	RIGHT	L351.EDF	L35	1
67	8935284	8935526	5552	5794	242	RIGHT	L351.EDF	L35	1
68	8939732	8939957	1196	1421	225	RIGHT	L351.EDF	L35	1
68	8942819	8942840	4283	4304	21	RIGHT	L351.EDF	L35	1
68	8942886	8943013	4350	4477	127	RIGHT	L351.EDF	L35	1
68	8943049	8943069	4513	4533	20	RIGHT	L351.EDF	L35	1
68	8943124	8943151	4588	4615	27	RIGHT	L351.EDF	L35	1
68	8943200	8943228	4664	4692	28	RIGHT	L351.EDF	L35	1
68	8943260	8943260	4724	4724	0	RIGHT	L351.EDF	L35	1
68	8943296	8943297	4760	4761	1	RIGHT	L351.EDF	L35	1
68	8943466	8943488	4930	4952	22	RIGHT	L351.EDF	L35	1
68	8943547	8943594	5011	5058	47	RIGHT	L351.EDF	L35	1
68	8943626	8943658	5090	5122	32	RIGHT	L351.EDF	L35	1
68	8943756	8944703	5220	6167	947	RIGHT	L351.EDF	L35	1
69	8949544	8949560	1862	1878	16	RIGHT	L351.EDF	L35	1
69	8949650	8949657	1968	1975	7	RIGHT	L351.EDF	L35	1
69	8949822	8951586	2140	3904	1764	RIGHT	L351.EDF	L35	1
69	8952869	8952884	5187	5202	15	RIGHT	L351.EDF	L35	1
69	8953069	8953112	5387	5430	43	RIGHT	L351.EDF	L35	1
69	8953150	8953179	5468	5497	29	RIGHT	L351.EDF	L35	1
69	8953549	8953747	5867	6065	198	RIGHT	L351.EDF	L35	1
70	8958785	8958965	2868	3048	180	RIGHT	L351.EDF	L35	1
70	8959314	8961801	3397	5884	2487	RIGHT	L351.EDF	L35	1
71	8964580	8965644	472	1536	1064	RIGHT	L351.EDF	L35	1
71	8965896	8967697	1788	3589	1801	RIGHT	L351.EDF	L35	1
71	8967867	8967875	3759	3767	8	RIGHT	L351.EDF	L35	1
71	8967902	8969446	3794	5338	1544	RIGHT	L351.EDF	L35	1
72	8971111	8971235	57	181	124	RIGHT	L351.EDF	L35	1
72	8971334	8973000	280	1946	1666	RIGHT	L351.EDF	L35	1
72	8973025	8973033	1971	1979	8	RIGHT	L351.EDF	L35	1
72	8973068	8973546	2014	2492	478	RIGHT	L351.EDF	L35	1
72	8974201	8974216	3147	3162	15	RIGHT	L351.EDF	L35	1
72	8974251	8974312	3197	3258	61	RIGHT	L351.EDF	L35	1
72	8974334	8974347	3280	3293	13	RIGHT	L351.EDF	L35	1
72	8974377	8974392	3323	3338	15	RIGHT	L351.EDF	L35	1
72	8974426	8974442	3372	3388	16	RIGHT	L351.EDF	L35	1
72	8974464	8976190	3410	5136	1726	RIGHT	L351.EDF	L35	1
72	8976257	8977732	5203	6678	1475	RIGHT	L351.EDF	L35	1
73	8979480	8979791	58	369	311	RIGHT	L351.EDF	L35	1
73	8979823	8979825	401	403	2	RIGHT	L351.EDF	L35	1
73	8979864	8979880	442	458	16	RIGHT	L351.EDF	L35	1
73	8979933	8980146	511	724	213	RIGHT	L351.EDF	L35	1
73	8980179	8980181	757	759	2	RIGHT	L351.EDF	L35	1
73	8980202	8980202	780	780	0	RIGHT	L351.EDF	L35	1
73	8980561	8980758	1139	1336	197	RIGHT	L351.EDF	L35	1
73	8981548	8981861	2126	2439	313	RIGHT	L351.EDF	L35	1
73	8983641	8983888	4219	4466	247	RIGHT	L351.EDF	L35	1
74	8989377	8989612	3279	3514	235	RIGHT	L351.EDF	L35	1
75	8996092	8996364	1563	1835	272	RIGHT	L351.EDF	L35	1
75	8997149	8997324	2620	2795	175	RIGHT	L351.EDF	L35	1
75	8999284	8999499	4755	4970	215	RIGHT	L351.EDF	L35	1
76	9004194	9004395	1269	1470	201	RIGHT	L351.EDF	L35	1
76	9005321	9005500	2396	2575	179	RIGHT	L351.EDF	L35	1
76	9007179	9007309	4254	4384	130	RIGHT	L351.EDF	L35	1
76	9009126	9009223	6201	6298	97	RIGHT	L351.EDF	L35	1
76	9009255	9009317	6330	6392	62	RIGHT	L351.EDF	L35	1
77	9013688	9013795	1546	1653	107	RIGHT	L351.EDF	L35	1
77	9016341	9016524	4199	4382	183	RIGHT	L351.EDF	L35	1
78	9024780	9024965	5403	5588	185	RIGHT	L351.EDF	L35	1
79	9034206	9034426	5223	5443	220	RIGHT	L351.EDF	L35	1
80	9039403	9039602	1078	1277	199	RIGHT	L351.EDF	L35	1
80	9040513	9040645	2188	2320	132	RIGHT	L351.EDF	L35	1
80	9040731	9040773	2406	2448	42	RIGHT	L351.EDF	L35	1
80	9040814	9040814	2489	2489	0	RIGHT	L351.EDF	L35	1
80	9040838	9041259	2513	2934	421	RIGHT	L351.EDF	L35	1
80	9041970	9042141	3645	3816	171	RIGHT	L351.EDF	L35	1
81	9051037	9051211	3906	4080	174	RIGHT	L351.EDF	L35	1
81	9053842	9054003	6711	6872	161	RIGHT	L351.EDF	L35	1
82	9057360	9057582	1321	1543	222	RIGHT	L351.EDF	L35	1
82	9061625	9061802	5586	5763	177	RIGHT	L351.EDF	L35	1
84	9073441	9073583	1195	1337	142	RIGHT	L351.EDF	L35	1
84	9076921	9076921	4675	4675	0	RIGHT	L351.EDF	L35	1
84	9076961	9076962	4715	4716	1	RIGHT	L351.EDF	L35	1
84	9077069	9078033	4823	5787	964	RIGHT	L351.EDF	L35	1
85	9081159	9081165	1285	1291	6	RIGHT	L351.EDF	L35	1
85	9081240	9081444	1366	1570	204	RIGHT	L351.EDF	L35	1
85	9082239	9082384	2365	2510	145	RIGHT	L351.EDF	L35	1
85	9082839	9083089	2965	3215	250	RIGHT	L351.EDF	L35	1
87	9100347	9100533	5241	5427	186	RIGHT	L351.EDF	L35	1
88	9104945	9105109	1244	1408	164	RIGHT	L351.EDF	L35	1
88	9106486	9108100	2785	4399	1614	RIGHT	L351.EDF	L35	1
88	9109166	9109397	5465	5696	231	RIGHT	L351.EDF	L35	1
88	9109793	9110633	6092	6932	840	RIGHT	L351.EDF	L35	1
89	9112374	9112693	133	452	319	RIGHT	L351.EDF	L35	1
89	9112958	9112987	717	746	29	RIGHT	L351.EDF	L35	1
89	9113014	9114017	773	1776	1003	RIGHT	L351.EDF	L35	1
89	9114920	9115066	2679	2825	146	RIGHT	L351.EDF	L35	1
89	9115714	9115901	3473	3660	187	RIGHT	L351.EDF	L35	1
89	9117009	9117182	4768	4941	173	RIGHT	L351.EDF	L35	1
90	9122802	9122999	3326	3523	197	RIGHT	L351.EDF	L35	1
91	9130856	9131004	3256	3404	148	RIGHT	L351.EDF	L35	1
91	9132266	9132623	4666	5023	357	RIGHT	L351.EDF	L35	1
92	9136529	9136675	1454	1600	146	RIGHT	L351.EDF	L35	1
92	9137726	9137908	2651	2833	182	RIGHT	L351.EDF	L35	1
92	9139487	9139494	4412	4419	7	RIGHT	L351.EDF	L35	1
92	9139554	9139581	4479	4506	27	RIGHT	L351.EDF	L35	1
92	9139648	9139668	4573	4593	20	RIGHT	L351.EDF	L35	1
92	9139738	9141642	4663	6567	1904	RIGHT	L351.EDF	L35	1
93	9144656	9144867	1127	1338	211	RIGHT	L351.EDF	L35	1
94	9150996	9151151	266	421	155	RIGHT	L351.EDF	L35	1
94	9151174	9151856	444	1126	682	RIGHT	L351.EDF	L35	1
94	9152926	9153081	2196	2351	155	RIGHT	L351.EDF	L35	1
94	9154847	9154847	4117	4117	0	RIGHT	L351.EDF	L35	1
94	9154877	9154878	4147	4148	1	RIGHT	L351.EDF	L35	1
94	9154901	9154964	4171	4234	63	RIGHT	L351.EDF	L35	1
94	9154998	9155024	4268	4294	26	RIGHT	L351.EDF	L35	1
94	9155046	9155701	4316	4971	655	RIGHT	L351.EDF	L35	1
95	9159235	9159235	1446	1446	0	RIGHT	L351.EDF	L35	1
95	9159267	9159413	1478	1624	146	RIGHT	L351.EDF	L35	1
95	9159446	9159633	1657	1844	187	RIGHT	L351.EDF	L35	1
95	9159666	9159677	1877	1888	11	RIGHT	L351.EDF	L35	1
95	9160128	9161104	2339	3315	976	RIGHT	L351.EDF	L35	1
95	9161133	9161162	3344	3373	29	RIGHT	L351.EDF	L35	1
95	9161861	9162048	4072	4259	187	RIGHT	L351.EDF	L35	1
95	9163007	9163156	5218	5367	149	RIGHT	L351.EDF	L35	1
98	9181827	9182019	1627	1819	192	RIGHT	L351.EDF	L35	1
99	9190264	9190460	1175	1371	196	RIGHT	L351.EDF	L35	1
100	9199875	9200047	3747	3919	172	RIGHT	L351.EDF	L35	1
101	9207584	9207838	1541	1795	254	RIGHT	L351.EDF	L35	1
101	9210636	9210835	4593	4792	199	RIGHT	L351.EDF	L35	1
102	9215817	9215982	2626	2791	165	RIGHT	L351.EDF	L35	1
102	9216467	9216804	3276	3613	337	RIGHT	L351.EDF	L35	1
102	9216829	9216936	3638	3745	107	RIGHT	L351.EDF	L35	1
102	9216961	9217156	3770	3965	195	RIGHT	L351.EDF	L35	1
103	9220129	9221514	217	1602	1385	RIGHT	L351.EDF	L35	1
103	9222458	9222518	2546	2606	60	RIGHT	L351.EDF	L35	1
103	9222627	9222646	2715	2734	19	RIGHT	L351.EDF	L35	1
103	9222896	9222966	2984	3054	70	RIGHT	L351.EDF	L35	1
103	9223006	9223011	3094	3099	5	RIGHT	L351.EDF	L35	1
103	9223064	9223166	3152	3254	102	RIGHT	L351.EDF	L35	1
103	9223199	9223645	3287	3733	446	RIGHT	L351.EDF	L35	1
103	9223687	9223789	3775	3877	102	RIGHT	L351.EDF	L35	1
103	9223832	9224297	3920	4385	465	RIGHT	L351.EDF	L35	1
103	9224369	9224382	4457	4470	13	RIGHT	L351.EDF	L35	1
103	9224573	9224594	4661	4682	21	RIGHT	L351.EDF	L35	1
103	9224630	9224644	4718	4732	14	RIGHT	L351.EDF	L35	1
103	9224688	9224754	4776	4842	66	RIGHT	L351.EDF	L35	1
103	9224912	9224913	5000	5001	1	RIGHT	L351.EDF	L35	1
103	9225006	9225021	5094	5109	15	RIGHT	L351.EDF	L35	1
103	9225101	9225241	5189	5329	140	RIGHT	L351.EDF	L35	1
103	9225283	9225368	5371	5456	85	RIGHT	L351.EDF	L35	1
103	9225429	9225434	5517	5522	5	RIGHT	L351.EDF	L35	1
104	9227412	9227697	65	350	285	RIGHT	L351.EDF	L35	1
104	9227798	9227893	451	546	95	RIGHT	L351.EDF	L35	1
104	9227944	9228006	597	659	62	RIGHT	L351.EDF	L35	1
104	9228030	9228049	683	702	19	RIGHT	L351.EDF	L35	1
104	9228097	9228097	750	750	0	RIGHT	L351.EDF	L35	1
104	9228243	9228935	896	1588	692	RIGHT	L351.EDF	L35	1
104	9228968	9229093	1621	1746	125	RIGHT	L351.EDF	L35	1
104	9230194	9230355	2847	3008	161	RIGHT	L351.EDF	L35	1
104	9231657	9231691	4310	4344	34	RIGHT	L351.EDF	L35	1
104	9231722	9231738	4375	4391	16	RIGHT	L351.EDF	L35	1
104	9231800	9231911	4453	4564	111	RIGHT	L351.EDF	L35	1
104	9231943	9231944	4596	4597	1	RIGHT	L351.EDF	L35	1
104	9232278	9232673	4931	5326	395	RIGHT	L351.EDF	L35	1
104	9232853	9232899	5506	5552	46	RIGHT	L351.EDF	L35	1
105	9237070	9237255	1889	2074	185	RIGHT	L351.EDF	L35	1
105	9239204	9239405	4023	4224	201	RIGHT	L351.EDF	L35	1
106	9248523	9248638	4857	4972	115	RIGHT	L351.EDF	L35	1
107	9251438	9251484	365	411	46	RIGHT	L351.EDF	L35	1
107	9251517	9258234	444	7161	6717	RIGHT	L351.EDF	L35	1
108	9260782	9267600	58	6876	6818	RIGHT	L351.EDF	L35	1
109	9269818	9275649	57	5888	5831	RIGHT	L351.EDF	L35	1
109	9275905	9276065	6144	6304	160	RIGHT	L351.EDF	L35	1
109	9276576	9276577	6815	6816	1	RIGHT	L351.EDF	L35	1
109	9276600	9276776	6839	7015	176	RIGHT	L351.EDF	L35	1
110	9279332	9279344	638	650	12	RIGHT	L351.EDF	L35	1
110	9279577	9279603	883	909	26	RIGHT	L351.EDF	L35	1
110	9279671	9281588	977	2894	1917	RIGHT	L351.EDF	L35	1
110	9281610	9281712	2916	3018	102	RIGHT	L351.EDF	L35	1
110	9281855	9282042	3161	3348	187	RIGHT	L351.EDF	L35	1
110	9283021	9283445	4327	4751	424	RIGHT	L351.EDF	L35	1
110	9283479	9284105	4785	5411	626	RIGHT	L351.EDF	L35	1
110	9284728	9284941	6034	6247	213	RIGHT	L351.EDF	L35	1
111	9287651	9287679	821	849	28	RIGHT	L351.EDF	L35	1
111	9288004	9288081	1174	1251	77	RIGHT	L351.EDF	L35	1
111	9288116	9288154	1286	1324	38	RIGHT	L351.EDF	L35	1
111	9288224	9288331	1394	1501	107	RIGHT	L351.EDF	L35	1
111	9288356	9288387	1526	1557	31	RIGHT	L351.EDF	L35	1
111	9288440	9288604	1610	1774	164	RIGHT	L351.EDF	L35	1
111	9288683	9288687	1853	1857	4	RIGHT	L351.EDF	L35	1
111	9288753	9293176	1923	6346	4423	RIGHT	L351.EDF	L35	1
112	9296008	9296181	1019	1192	173	RIGHT	L351.EDF	L35	1
112	9296722	9296865	1733	1876	143	RIGHT	L351.EDF	L35	1
112	9297302	9299441	2313	4452	2139	RIGHT	L351.EDF	L35	1
113	9303101	9303749	58	706	648	RIGHT	L351.EDF	L35	1
113	9304197	9304350	1154	1307	153	RIGHT	L351.EDF	L35	1
113	9307032	9307092	3989	4049	60	RIGHT	L351.EDF	L35	1
113	9307114	9307272	4071	4229	158	RIGHT	L351.EDF	L35	1
113	9307364	9307382	4321	4339	18	RIGHT	L351.EDF	L35	1
113	9307405	9307430	4362	4387	25	RIGHT	L351.EDF	L35	1
113	9307570	9307574	4527	4531	4	RIGHT	L351.EDF	L35	1
113	9307626	9307629	4583	4586	3	RIGHT	L351.EDF	L35	1
113	9307657	9307663	4614	4620	6	RIGHT	L351.EDF	L35	1
113	9307780	9308916	4737	5873	1136	RIGHT	L351.EDF	L35	1
114	9310511	9310521	77	87	10	RIGHT	L351.EDF	L35	1
114	9310950	9316397	516	5963	5447	RIGHT	L351.EDF	L35	1
114	9316850	9317048	6416	6614	198	RIGHT	L351.EDF	L35	1
115	9321199	9321357	1637	1795	158	RIGHT	L351.EDF	L35	1
115	9324503	9324630	4941	5068	127	RIGHT	L351.EDF	L35	1
116	9331274	9331442	3651	3819	168	RIGHT	L351.EDF	L35	1
117	9340369	9340530	4745	4906	161	RIGHT	L351.EDF	L35	1
118	9346562	9346755	943	1136	193	RIGHT	L351.EDF	L35	1
118	9347957	9348147	2338	2528	190	RIGHT	L351.EDF	L35	1
118	9349720	9349910	4101	4291	190	RIGHT	L351.EDF	L35	1
119	9355874	9356051	1590	1767	177	RIGHT	L351.EDF	L35	1
119	9357514	9357711	3230	3427	197	RIGHT	L351.EDF	L35	1
119	9359602	9359803	5318	5519	201	RIGHT	L351.EDF	L35	1
120	9362109	9362135	57	83	26	RIGHT	L351.EDF	L35	1
120	9364931	9365118	2879	3066	187	RIGHT	L351.EDF	L35	1
120	9366215	9366530	4163	4478	315	RIGHT	L351.EDF	L35	1
120	9367572	9367772	5520	5720	200	RIGHT	L351.EDF	L35	1
1	9844828	9844922	63	157	94	RIGHT	L352.EDF	L35	2
3	9862141	9862288	1495	1642	147	RIGHT	L352.EDF	L35	2
5	9876507	9876620	1574	1687	113	RIGHT	L352.EDF	L35	2
5	9876641	9876693	1708	1760	52	RIGHT	L352.EDF	L35	2
5	9878923	9878985	3990	4052	62	RIGHT	L352.EDF	L35	2
5	9879011	9879079	4078	4146	68	RIGHT	L352.EDF	L35	2
6	9883604	9883662	1268	1326	58	RIGHT	L352.EDF	L35	2
6	9883691	9883753	1355	1417	62	RIGHT	L352.EDF	L35	2
6	9887672	9887819	5336	5483	147	RIGHT	L352.EDF	L35	2
6	9887840	9887892	5504	5556	52	RIGHT	L352.EDF	L35	2
6	9887991	9887992	5655	5656	1	RIGHT	L352.EDF	L35	2
7	9893903	9894051	2158	2306	148	RIGHT	L352.EDF	L35	2
7	9895326	9895521	3581	3776	195	RIGHT	L352.EDF	L35	2
8	9906087	9906301	5675	5889	214	RIGHT	L352.EDF	L35	2
9	9909671	9909849	1375	1553	178	RIGHT	L352.EDF	L35	2
10	9918222	9918357	1741	1876	135	RIGHT	L352.EDF	L35	2
11	9927336	9927651	1259	1574	315	RIGHT	L352.EDF	L35	2
12	9938029	9938166	3236	3373	137	RIGHT	L352.EDF	L35	2
12	9939461	9939656	4668	4863	195	RIGHT	L352.EDF	L35	2
13	9945610	9945620	774	784	10	RIGHT	L352.EDF	L35	2
13	9945650	9945971	814	1135	321	RIGHT	L352.EDF	L35	2
13	9946547	9946729	1711	1893	182	RIGHT	L352.EDF	L35	2
14	9954860	9955062	1470	1672	202	RIGHT	L352.EDF	L35	2
14	9956166	9956401	2776	3011	235	RIGHT	L352.EDF	L35	2
14	9957473	9957693	4083	4303	220	RIGHT	L352.EDF	L35	2
14	9958859	9958966	5469	5576	107	RIGHT	L352.EDF	L35	2
14	9958988	9959066	5598	5676	78	RIGHT	L352.EDF	L35	2
15	9962611	9962843	1067	1299	232	RIGHT	L352.EDF	L35	2
15	9966396	9966568	4852	5024	172	RIGHT	L352.EDF	L35	2
15	9967748	9967983	6204	6439	235	RIGHT	L352.EDF	L35	2
15	9968325	9968561	6781	7017	236	RIGHT	L352.EDF	L35	2
16	9974538	9974786	4084	4332	248	RIGHT	L352.EDF	L35	2
17	9980391	9980594	1356	1559	203	RIGHT	L352.EDF	L35	2
17	9983241	9983421	4206	4386	180	RIGHT	L352.EDF	L35	2
18	9987340	9987655	1277	1592	315	RIGHT	L352.EDF	L35	2
18	9989139	9989374	3076	3311	235	RIGHT	L352.EDF	L35	2
18	9990661	9990920	4598	4857	259	RIGHT	L352.EDF	L35	2
19	9995090	9995314	1443	1667	224	RIGHT	L352.EDF	L35	2
19	9996774	9997095	3127	3448	321	RIGHT	L352.EDF	L35	2
19	9997669	9997873	4022	4226	204	RIGHT	L352.EDF	L35	2
21	10011731	10011883	1267	1419	152	RIGHT	L352.EDF	L35	2
22	10021428	10021434	2140	2146	6	RIGHT	L352.EDF	L35	2
22	10021463	10021591	2175	2303	128	RIGHT	L352.EDF	L35	2
22	10021638	10021713	2350	2425	75	RIGHT	L352.EDF	L35	2
22	10023633	10023810	4345	4522	177	RIGHT	L352.EDF	L35	2
23	10026673	10026940	549	816	267	RIGHT	L352.EDF	L35	2
23	10031378	10031695	5254	5571	317	RIGHT	L352.EDF	L35	2
24	10035050	10035251	1051	1252	201	RIGHT	L352.EDF	L35	2
24	10038863	10039053	4864	5054	190	RIGHT	L352.EDF	L35	2
24	10040341	10040375	6342	6376	34	RIGHT	L352.EDF	L35	2
26	10053965	10054120	3686	3841	155	RIGHT	L352.EDF	L35	2
27	10060471	10060610	1899	2038	139	RIGHT	L352.EDF	L35	2
28	10069151	10069309	1325	1483	158	RIGHT	L352.EDF	L35	2
30	10084730	10084883	2052	2205	153	RIGHT	L352.EDF	L35	2
30	10086355	10086356	3677	3678	1	RIGHT	L352.EDF	L35	2
30	10086426	10086601	3748	3923	175	RIGHT	L352.EDF	L35	2
30	10087549	10087716	4871	5038	167	RIGHT	L352.EDF	L35	2
31	10092297	10092477	1614	1794	180	RIGHT	L352.EDF	L35	2
31	10093875	10094071	3192	3388	196	RIGHT	L352.EDF	L35	2
31	10095646	10095804	4963	5121	158	RIGHT	L352.EDF	L35	2
31	10096768	10096775	6085	6092	7	RIGHT	L352.EDF	L35	2
31	10096819	10097010	6136	6327	191	RIGHT	L352.EDF	L35	2
32	10099827	10099856	467	496	29	RIGHT	L352.EDF	L35	2
32	10099905	10101145	545	1785	1240	RIGHT	L352.EDF	L35	2
32	10101229	10101231	1869	1871	2	RIGHT	L352.EDF	L35	2
32	10101743	10104775	2383	5415	3032	RIGHT	L352.EDF	L35	2
33	10106582	10106589	73	80	7	RIGHT	L352.EDF	L35	2
33	10106657	10106661	148	152	4	RIGHT	L352.EDF	L35	2
33	10106682	10106703	173	194	21	RIGHT	L352.EDF	L35	2
33	10106810	10106830	301	321	20	RIGHT	L352.EDF	L35	2
33	10106853	10106891	344	382	38	RIGHT	L352.EDF	L35	2
33	10106941	10107673	432	1164	732	RIGHT	L352.EDF	L35	2
33	10108605	10108611	2096	2102	6	RIGHT	L352.EDF	L35	2
33	10108653	10112000	2144	5491	3347	RIGHT	L352.EDF	L35	2
34	10114657	10114686	459	488	29	RIGHT	L352.EDF	L35	2
34	10114709	10114715	511	517	6	RIGHT	L352.EDF	L35	2
34	10114739	10119024	541	4826	4285	RIGHT	L352.EDF	L35	2
35	10120467	10120835	120	488	368	RIGHT	L352.EDF	L35	2
35	10120872	10120905	525	558	33	RIGHT	L352.EDF	L35	2
35	10121026	10121084	679	737	58	RIGHT	L352.EDF	L35	2
35	10121109	10121109	762	762	0	RIGHT	L352.EDF	L35	2
35	10121168	10126799	821	6452	5631	RIGHT	L352.EDF	L35	2
36	10130659	10130827	1454	1622	168	RIGHT	L352.EDF	L35	2
36	10134980	10135233	5775	6028	253	RIGHT	L352.EDF	L35	2
37	10139133	10139296	950	1113	163	RIGHT	L352.EDF	L35	2
37	10140342	10140479	2159	2296	137	RIGHT	L352.EDF	L35	2
37	10141038	10141246	2855	3063	208	RIGHT	L352.EDF	L35	2
37	10141970	10142176	3787	3993	206	RIGHT	L352.EDF	L35	2
37	10142414	10142740	4231	4557	326	RIGHT	L352.EDF	L35	2
38	10147510	10147717	2223	2430	207	RIGHT	L352.EDF	L35	2
38	10148673	10148828	3386	3541	155	RIGHT	L352.EDF	L35	2
38	10149626	10149822	4339	4535	196	RIGHT	L352.EDF	L35	2
39	10153911	10154137	1760	1986	226	RIGHT	L352.EDF	L35	2
40	10166406	10166533	7146	7273	127	RIGHT	L352.EDF	L35	2
41	10168892	10169012	57	177	120	RIGHT	L352.EDF	L35	2
42	10177209	10177379	1212	1382	170	RIGHT	L352.EDF	L35	2
43	10184462	10184632	1851	2021	170	RIGHT	L352.EDF	L35	2
43	10186590	10186768	3979	4157	178	RIGHT	L352.EDF	L35	2
45	10202139	10202325	4647	4833	186	RIGHT	L352.EDF	L35	2
46	10212588	10212732	6134	6278	144	RIGHT	L352.EDF	L35	2
47	10216919	10217054	2101	2236	135	RIGHT	L352.EDF	L35	2
47	10217850	10218036	3032	3218	186	RIGHT	L352.EDF	L35	2
47	10219117	10219432	4299	4614	315	RIGHT	L352.EDF	L35	2
47	10220160	10220366	5342	5548	206	RIGHT	L352.EDF	L35	2
48	10223253	10223379	73	199	126	RIGHT	L352.EDF	L35	2
48	10225785	10225978	2605	2798	193	RIGHT	L352.EDF	L35	2
48	10226576	10226802	3396	3622	226	RIGHT	L352.EDF	L35	2
48	10227617	10227874	4437	4694	257	RIGHT	L352.EDF	L35	2
49	10231740	10231934	1939	2133	194	RIGHT	L352.EDF	L35	2
49	10234448	10234690	4647	4889	242	RIGHT	L352.EDF	L35	2
50	10241368	10241524	982	1138	156	RIGHT	L352.EDF	L35	2
51	10248568	10248740	926	1098	172	RIGHT	L352.EDF	L35	2
52	10258009	10258117	1408	1516	108	RIGHT	L352.EDF	L35	2
52	10258141	10258203	1540	1602	62	RIGHT	L352.EDF	L35	2
54	10273041	10273151	1790	1900	110	RIGHT	L352.EDF	L35	2
54	10273907	10274083	2656	2832	176	RIGHT	L352.EDF	L35	2
56	10287264	10287396	1411	1543	132	RIGHT	L352.EDF	L35	2
58	10302815	10302970	923	1078	155	RIGHT	L352.EDF	L35	2
58	10307207	10307379	5315	5487	172	RIGHT	L352.EDF	L35	2
59	10311407	10311724	1325	1642	317	RIGHT	L352.EDF	L35	2
60	10319974	10320151	2518	2695	177	RIGHT	L352.EDF	L35	2
60	10320825	10321021	3369	3565	196	RIGHT	L352.EDF	L35	2
60	10321122	10321123	3666	3667	1	RIGHT	L352.EDF	L35	2
60	10322922	10323075	5466	5619	153	RIGHT	L352.EDF	L35	2
60	10324459	10324614	7003	7158	155	RIGHT	L352.EDF	L35	2
62	10335550	10335699	1057	1206	149	RIGHT	L352.EDF	L35	2
63	10345723	10346040	752	1069	317	RIGHT	L352.EDF	L35	2
65	10363127	10363343	563	779	216	RIGHT	L352.EDF	L35	2
65	10364984	10365149	2420	2585	165	RIGHT	L352.EDF	L35	2
66	10376681	10376871	5326	5516	190	RIGHT	L352.EDF	L35	2
67	10380316	10380351	62	97	35	RIGHT	L352.EDF	L35	2
67	10381815	10381974	1561	1720	159	RIGHT	L352.EDF	L35	2
67	10384474	10384653	4220	4399	179	RIGHT	L352.EDF	L35	2
68	10388808	10389127	1110	1429	319	RIGHT	L352.EDF	L35	2
69	10396023	10396050	468	495	27	RIGHT	L352.EDF	L35	2
69	10396966	10397129	1411	1574	163	RIGHT	L352.EDF	L35	2
69	10402483	10402569	6928	7014	86	RIGHT	L352.EDF	L35	2
70	10405165	10405389	753	977	224	RIGHT	L352.EDF	L35	2
71	10415159	10415398	1073	1312	239	RIGHT	L352.EDF	L35	2
72	10423995	10424247	1208	1460	252	RIGHT	L352.EDF	L35	2
72	10425637	10425834	2850	3047	197	RIGHT	L352.EDF	L35	2
73	10434819	10435023	3234	3438	204	RIGHT	L352.EDF	L35	2
73	10435102	10435102	3517	3517	0	RIGHT	L352.EDF	L35	2
73	10436888	10437067	5303	5482	179	RIGHT	L352.EDF	L35	2
74	10440897	10441019	1126	1248	122	RIGHT	L352.EDF	L35	2
76	10460220	10460220	5092	5092	0	RIGHT	L352.EDF	L35	2
76	10460258	10460499	5130	5371	241	RIGHT	L352.EDF	L35	2
77	10462993	10463021	58	86	28	RIGHT	L352.EDF	L35	2
77	10463086	10463086	151	151	0	RIGHT	L352.EDF	L35	2
77	10463107	10463107	172	172	0	RIGHT	L352.EDF	L35	2
77	10464180	10464368	1245	1433	188	RIGHT	L352.EDF	L35	2
77	10467356	10467539	4421	4604	183	RIGHT	L352.EDF	L35	2
77	10468367	10468580	5432	5645	213	RIGHT	L352.EDF	L35	2
78	10471308	10471602	57	351	294	RIGHT	L352.EDF	L35	2
78	10473414	10473565	2163	2314	151	RIGHT	L352.EDF	L35	2
79	10479701	10479731	58	88	30	RIGHT	L352.EDF	L35	2
79	10484949	10485226	5306	5583	277	RIGHT	L352.EDF	L35	2
80	10489997	10490314	1196	1513	317	RIGHT	L352.EDF	L35	2
80	10492298	10492482	3497	3681	184	RIGHT	L352.EDF	L35	2
80	10493817	10494010	5016	5209	193	RIGHT	L352.EDF	L35	2
81	10497688	10498015	1113	1440	327	RIGHT	L352.EDF	L35	2
82	10503712	10503748	73	109	36	RIGHT	L352.EDF	L35	2
83	10514166	10514345	1268	1447	179	RIGHT	L352.EDF	L35	2
83	10515993	10516201	3095	3303	208	RIGHT	L352.EDF	L35	2
84	10524257	10524455	4038	4236	198	RIGHT	L352.EDF	L35	2
84	10524892	10525099	4673	4880	207	RIGHT	L352.EDF	L35	2
84	10526007	10526219	5788	6000	212	RIGHT	L352.EDF	L35	2
85	10528452	10528473	57	78	21	RIGHT	L352.EDF	L35	2
85	10529609	10529768	1214	1373	159	RIGHT	L352.EDF	L35	2
86	10536536	10536556	58	78	20	RIGHT	L352.EDF	L35	2
87	10546359	10546535	1487	1663	176	RIGHT	L352.EDF	L35	2
87	10547526	10547681	2654	2809	155	RIGHT	L352.EDF	L35	2
87	10548521	10548690	3649	3818	169	RIGHT	L352.EDF	L35	2
88	10555433	10555565	1949	2081	132	RIGHT	L352.EDF	L35	2
88	10557814	10558025	4330	4541	211	RIGHT	L352.EDF	L35	2
89	10563208	10563426	2145	2363	218	RIGHT	L352.EDF	L35	2
89	10566086	10566403	5023	5340	317	RIGHT	L352.EDF	L35	2
90	10571298	10571544	1300	1546	246	RIGHT	L352.EDF	L35	2
91	10580413	10580561	1689	1837	148	RIGHT	L352.EDF	L35	2
91	10580704	10580704	1980	1980	0	RIGHT	L352.EDF	L35	2
92	10586507	10586696	967	1156	189	RIGHT	L352.EDF	L35	2
93	10592953	10592974	58	79	21	RIGHT	L352.EDF	L35	2
93	10596660	10596994	3765	4099	334	RIGHT	L352.EDF	L35	2
93	10597111	10597134	4216	4239	23	RIGHT	L352.EDF	L35	2
93	10597163	10597163	4268	4268	0	RIGHT	L352.EDF	L35	2
94	10601162	10601460	1212	1510	298	RIGHT	L352.EDF	L35	2
95	10608324	10608523	436	635	199	RIGHT	L352.EDF	L35	2
96	10615895	10616145	1360	1610	250	RIGHT	L352.EDF	L35	2
97	10625021	10625253	1240	1472	232	RIGHT	L352.EDF	L35	2
97	10628944	10629128	5163	5347	184	RIGHT	L352.EDF	L35	2
98	10630940	10631161	193	414	221	RIGHT	L352.EDF	L35	2
98	10634615	10634894	3868	4147	279	RIGHT	L352.EDF	L35	2
98	10634997	10634997	4250	4250	0	RIGHT	L352.EDF	L35	2
98	10635027	10635109	4280	4362	82	RIGHT	L352.EDF	L35	2
98	10635132	10635160	4385	4413	28	RIGHT	L352.EDF	L35	2
98	10635679	10635991	4932	5244	312	RIGHT	L352.EDF	L35	2
99	10639080	10639156	353	429	76	RIGHT	L352.EDF	L35	2
99	10643647	10643854	4920	5127	207	RIGHT	L352.EDF	L35	2
99	10644016	10644016	5289	5289	0	RIGHT	L352.EDF	L35	2
100	10651507	10651717	4757	4967	210	RIGHT	L352.EDF	L35	2
101	10655858	10656050	1367	1559	192	RIGHT	L352.EDF	L35	2
102	10663771	10663772	1147	1148	1	RIGHT	L352.EDF	L35	2
102	10663813	10664049	1189	1425	236	RIGHT	L352.EDF	L35	2
102	10664143	10664160	1519	1536	17	RIGHT	L352.EDF	L35	2
103	10671396	10671640	1533	1777	244	RIGHT	L352.EDF	L35	2
103	10672408	10672647	2545	2784	239	RIGHT	L352.EDF	L35	2
103	10673463	10673727	3600	3864	264	RIGHT	L352.EDF	L35	2
103	10674391	10674840	4528	4977	449	RIGHT	L352.EDF	L35	2
103	10676025	10676260	6162	6397	235	RIGHT	L352.EDF	L35	2
104	10679831	10680021	1233	1423	190	RIGHT	L352.EDF	L35	2
104	10681552	10681743	2954	3145	191	RIGHT	L352.EDF	L35	2
104	10682600	10682808	4002	4210	208	RIGHT	L352.EDF	L35	2
104	10684020	10684249	5422	5651	229	RIGHT	L352.EDF	L35	2
105	10691305	10691524	4472	4691	219	RIGHT	L352.EDF	L35	2
106	10694905	10695114	1471	1680	209	RIGHT	L352.EDF	L35	2
106	10698183	10698403	4749	4969	220	RIGHT	L352.EDF	L35	2
108	10714015	10714186	2299	2470	171	RIGHT	L352.EDF	L35	2
109	10720586	10720588	283	285	2	RIGHT	L352.EDF	L35	2
109	10720613	10720613	310	310	0	RIGHT	L352.EDF	L35	2
109	10722923	10723472	2620	3169	549	RIGHT	L352.EDF	L35	2
109	10723973	10724308	3670	4005	335	RIGHT	L352.EDF	L35	2
109	10724332	10724422	4029	4119	90	RIGHT	L352.EDF	L35	2
109	10724628	10724742	4325	4439	114	RIGHT	L352.EDF	L35	2
109	10724925	10726258	4622	5955	1333	RIGHT	L352.EDF	L35	2
110	10728254	10728256	183	185	2	RIGHT	L352.EDF	L35	2
110	10728291	10728517	220	446	226	RIGHT	L352.EDF	L35	2
110	10728679	10729394	608	1323	715	RIGHT	L352.EDF	L35	2
110	10730173	10730186	2102	2115	13	RIGHT	L352.EDF	L35	2
110	10730208	10730966	2137	2895	758	RIGHT	L352.EDF	L35	2
110	10731005	10731005	2934	2934	0	RIGHT	L352.EDF	L35	2
110	10731089	10731267	3018	3196	178	RIGHT	L352.EDF	L35	2
110	10731297	10731372	3226	3301	75	RIGHT	L352.EDF	L35	2
110	10731582	10731601	3511	3530	19	RIGHT	L352.EDF	L35	2
110	10731655	10731674	3584	3603	19	RIGHT	L352.EDF	L35	2
110	10732120	10732153	4049	4082	33	RIGHT	L352.EDF	L35	2
110	10732177	10732216	4106	4145	39	RIGHT	L352.EDF	L35	2
110	10733444	10733444	5373	5373	0	RIGHT	L352.EDF	L35	2
111	10735672	10737975	58	2361	2303	RIGHT	L352.EDF	L35	2
112	10744728	10744900	1679	1851	172	RIGHT	L352.EDF	L35	2
112	10747550	10747767	4501	4718	217	RIGHT	L352.EDF	L35	2
113	10751586	10751788	1546	1748	202	RIGHT	L352.EDF	L35	2
113	10751927	10753502	1887	3462	1575	RIGHT	L352.EDF	L35	2
113	10754177	10754385	4137	4345	208	RIGHT	L352.EDF	L35	2
113	10754791	10756387	4751	6347	1596	RIGHT	L352.EDF	L35	2
114	10760341	10760548	2054	2261	207	RIGHT	L352.EDF	L35	2
115	10770904	10770904	5395	5395	0	RIGHT	L352.EDF	L35	2
115	10771471	10771678	5962	6169	207	RIGHT	L352.EDF	L35	2
116	10778707	10778911	3542	3746	204	RIGHT	L352.EDF	L35	2
117	10784064	10784266	1850	2052	202	RIGHT	L352.EDF	L35	2
117	10788061	10788061	5847	5847	0	RIGHT	L352.EDF	L35	2
119	10797840	10798007	57	224	167	RIGHT	L352.EDF	L35	2
119	10799702	10799702	1919	1919	0	RIGHT	L352.EDF	L35	2
119	10800755	10800794	2972	3011	39	RIGHT	L352.EDF	L35	2
119	10800824	10801114	3041	3331	290	RIGHT	L352.EDF	L35	2
119	10801138	10801146	3355	3363	8	RIGHT	L352.EDF	L35	2
119	10801176	10801194	3393	3411	18	RIGHT	L352.EDF	L35	2
119	10801233	10801234	3450	3451	1	RIGHT	L352.EDF	L35	2
119	10801301	10801302	3518	3519	1	RIGHT	L352.EDF	L35	2
119	10801376	10801377	3593	3594	1	RIGHT	L352.EDF	L35	2
119	10801410	10801411	3627	3628	1	RIGHT	L352.EDF	L35	2
119	10802997	10802997	5214	5214	0	RIGHT	L352.EDF	L35	2
119	10803074	10803075	5291	5292	1	RIGHT	L352.EDF	L35	2
119	10803117	10803118	5334	5335	1	RIGHT	L352.EDF	L35	2
119	10803140	10803204	5357	5421	64	RIGHT	L352.EDF	L35	2
119	10803234	10803234	5451	5451	0	RIGHT	L352.EDF	L35	2
119	10803256	10803264	5473	5481	8	RIGHT	L352.EDF	L35	2
119	10803352	10803361	5569	5578	9	RIGHT	L352.EDF	L35	2
119	10803383	10804376	5600	6593	993	RIGHT	L352.EDF	L35	2
120	10808944	10809380	1728	2164	436	RIGHT	L352.EDF	L35	2
120	10810422	10810704	3206	3488	282	RIGHT	L352.EDF	L35	2
120	10812323	10813372	5107	6156	1049	RIGHT	L352.EDF	L35	2
1	11090878	11091020	1170	1312	142	RIGHT	L353.EDF	L35	3
1	11091082	11091084	1374	1376	2	RIGHT	L353.EDF	L35	3
1	11094750	11094893	5042	5185	143	RIGHT	L353.EDF	L35	3
3	11105087	11105311	267	491	224	RIGHT	L353.EDF	L35	3
4	11111784	11111968	326	510	184	RIGHT	L353.EDF	L35	3
5	11119118	11119276	997	1155	158	RIGHT	L353.EDF	L35	3
5	11122692	11122823	4571	4702	131	RIGHT	L353.EDF	L35	3
6	11129066	11129225	3713	3872	159	RIGHT	L353.EDF	L35	3
6	11129938	11130087	4585	4734	149	RIGHT	L353.EDF	L35	3
7	11133873	11134029	1552	1708	156	RIGHT	L353.EDF	L35	3
7	11136787	11136928	4466	4607	141	RIGHT	L353.EDF	L35	3
7	11138201	11138368	5880	6047	167	RIGHT	L353.EDF	L35	3
8	11144077	11144214	1612	1749	137	RIGHT	L353.EDF	L35	3
9	11153532	11153703	3400	3571	171	RIGHT	L353.EDF	L35	3
10	11163691	11163860	4898	5067	169	RIGHT	L353.EDF	L35	3
10	11164945	11165058	6152	6265	113	RIGHT	L353.EDF	L35	3
11	11170184	11170336	3353	3505	152	RIGHT	L353.EDF	L35	3
11	11170838	11171039	4007	4208	201	RIGHT	L353.EDF	L35	3
12	11176585	11176724	1844	1983	139	RIGHT	L353.EDF	L35	3
13	11185335	11185474	1390	1529	139	RIGHT	L353.EDF	L35	3
14	11192936	11193086	1145	1295	150	RIGHT	L353.EDF	L35	3
14	11195871	11196064	4080	4273	193	RIGHT	L353.EDF	L35	3
15	11201277	11201454	1529	1706	177	RIGHT	L353.EDF	L35	3
15	11203474	11203585	3726	3837	111	RIGHT	L353.EDF	L35	3
15	11205395	11205546	5647	5798	151	RIGHT	L353.EDF	L35	3
16	11208940	11209255	1095	1410	315	RIGHT	L353.EDF	L35	3
16	11212057	11212218	4212	4373	161	RIGHT	L353.EDF	L35	3
16	11212674	11212683	4829	4838	9	RIGHT	L353.EDF	L35	3
16	11212719	11213063	4874	5218	344	RIGHT	L353.EDF	L35	3
16	11213126	11213163	5281	5318	37	RIGHT	L353.EDF	L35	3
17	11218500	11218664	2120	2284	164	RIGHT	L353.EDF	L35	3
18	11228216	11228383	3300	3467	167	RIGHT	L353.EDF	L35	3
19	11234601	11234916	1205	1520	315	RIGHT	L353.EDF	L35	3
19	11236694	11236875	3298	3479	181	RIGHT	L353.EDF	L35	3
19	11239048	11239208	5652	5812	160	RIGHT	L353.EDF	L35	3
20	11244152	11244312	2320	2480	160	RIGHT	L353.EDF	L35	3
20	11245789	11245956	3957	4124	167	RIGHT	L353.EDF	L35	3
20	11246659	11246845	4827	5013	186	RIGHT	L353.EDF	L35	3
21	11255703	11255838	5373	5508	135	RIGHT	L353.EDF	L35	3
21	11256630	11256809	6300	6479	179	RIGHT	L353.EDF	L35	3
22	11260562	11260563	449	450	1	RIGHT	L353.EDF	L35	3
22	11260586	11260593	473	480	7	RIGHT	L353.EDF	L35	3
22	11260721	11260721	608	608	0	RIGHT	L353.EDF	L35	3
22	11260747	11260835	634	722	88	RIGHT	L353.EDF	L35	3
22	11261001	11261216	888	1103	215	RIGHT	L353.EDF	L35	3
22	11261275	11261282	1162	1169	7	RIGHT	L353.EDF	L35	3
22	11262057	11262642	1944	2529	585	RIGHT	L353.EDF	L35	3
22	11262679	11262682	2566	2569	3	RIGHT	L353.EDF	L35	3
22	11262726	11262726	2613	2613	0	RIGHT	L353.EDF	L35	3
22	11263136	11263311	3023	3198	175	RIGHT	L353.EDF	L35	3
23	11269931	11270095	1568	1732	164	RIGHT	L353.EDF	L35	3
23	11274759	11274866	6396	6503	107	RIGHT	L353.EDF	L35	3
24	11277281	11277457	58	234	176	RIGHT	L353.EDF	L35	3
24	11281348	11281515	4125	4292	167	RIGHT	L353.EDF	L35	3
24	11282586	11282767	5363	5544	181	RIGHT	L353.EDF	L35	3
25	11286093	11286320	1405	1632	227	RIGHT	L353.EDF	L35	3
25	11288545	11288746	3857	4058	201	RIGHT	L353.EDF	L35	3
25	11290690	11290863	6002	6175	173	RIGHT	L353.EDF	L35	3
27	11302994	11303166	2176	2348	172	RIGHT	L353.EDF	L35	3
29	11319304	11319478	2344	2518	174	RIGHT	L353.EDF	L35	3
31	11334527	11334696	2148	2317	169	RIGHT	L353.EDF	L35	3
31	11334787	11334789	2408	2410	2	RIGHT	L353.EDF	L35	3
32	11343675	11343865	3563	3753	190	RIGHT	L353.EDF	L35	3
32	11343954	11343957	3842	3845	3	RIGHT	L353.EDF	L35	3
32	11346201	11346462	6089	6350	261	RIGHT	L353.EDF	L35	3
33	11350387	11350569	1098	1280	182	RIGHT	L353.EDF	L35	3
34	11360516	11360611	2651	2746	95	RIGHT	L353.EDF	L35	3
34	11360793	11361115	2928	3250	322	RIGHT	L353.EDF	L35	3
35	11371116	11371294	6315	6493	178	RIGHT	L353.EDF	L35	3
38	11389304	11389328	57	81	24	RIGHT	L353.EDF	L35	3
38	11392398	11393184	3151	3937	786	RIGHT	L353.EDF	L35	3
38	11393206	11394519	3959	5272	1313	RIGHT	L353.EDF	L35	3
39	11396488	11397445	140	1097	957	RIGHT	L353.EDF	L35	3
39	11397658	11397676	1310	1328	18	RIGHT	L353.EDF	L35	3
39	11397706	11398050	1358	1702	344	RIGHT	L353.EDF	L35	3
39	11399868	11400036	3520	3688	168	RIGHT	L353.EDF	L35	3
39	11400889	11401060	4541	4712	171	RIGHT	L353.EDF	L35	3
40	11402690	11403085	58	453	395	RIGHT	L353.EDF	L35	3
40	11403108	11403108	476	476	0	RIGHT	L353.EDF	L35	3
40	11404592	11404741	1960	2109	149	RIGHT	L353.EDF	L35	3
40	11404768	11404817	2136	2185	49	RIGHT	L353.EDF	L35	3
40	11404862	11404862	2230	2230	0	RIGHT	L353.EDF	L35	3
40	11404953	11404970	2321	2338	17	RIGHT	L353.EDF	L35	3
40	11405119	11409569	2487	6937	4450	RIGHT	L353.EDF	L35	3
41	11411455	11411906	57	508	451	RIGHT	L353.EDF	L35	3
41	11414168	11414347	2770	2949	179	RIGHT	L353.EDF	L35	3
41	11414975	11416253	3577	4855	1278	RIGHT	L353.EDF	L35	3
42	11418869	11418895	849	875	26	RIGHT	L353.EDF	L35	3
42	11418932	11419000	912	980	68	RIGHT	L353.EDF	L35	3
42	11419041	11419225	1021	1205	184	RIGHT	L353.EDF	L35	3
42	11419404	11419417	1384	1397	13	RIGHT	L353.EDF	L35	3
42	11419450	11424188	1430	6168	4738	RIGHT	L353.EDF	L35	3
43	11425811	11427277	58	1524	1466	RIGHT	L353.EDF	L35	3
43	11428065	11428083	2312	2330	18	RIGHT	L353.EDF	L35	3
43	11428153	11428157	2400	2404	4	RIGHT	L353.EDF	L35	3
43	11428183	11428192	2430	2439	9	RIGHT	L353.EDF	L35	3
43	11428214	11428814	2461	3061	600	RIGHT	L353.EDF	L35	3
43	11428849	11428883	3096	3130	34	RIGHT	L353.EDF	L35	3
43	11428904	11431632	3151	5879	2728	RIGHT	L353.EDF	L35	3
44	11433954	11434448	303	797	494	RIGHT	L353.EDF	L35	3
44	11434472	11434686	821	1035	214	RIGHT	L353.EDF	L35	3
44	11435526	11436219	1875	2568	693	RIGHT	L353.EDF	L35	3
44	11436379	11436383	2728	2732	4	RIGHT	L353.EDF	L35	3
44	11436450	11436515	2799	2864	65	RIGHT	L353.EDF	L35	3
44	11436552	11438547	2901	4896	1995	RIGHT	L353.EDF	L35	3
45	11440372	11446011	57	5696	5639	RIGHT	L353.EDF	L35	3
46	11448128	11449860	57	1789	1732	RIGHT	L353.EDF	L35	3
46	11452955	11453271	4884	5200	316	RIGHT	L353.EDF	L35	3
48	11465990	11466163	3340	3513	173	RIGHT	L353.EDF	L35	3
48	11468558	11468752	5908	6102	194	RIGHT	L353.EDF	L35	3
49	11470551	11470551	89	89	0	RIGHT	L353.EDF	L35	3
49	11471379	11471538	917	1076	159	RIGHT	L353.EDF	L35	3
49	11473405	11473409	2943	2947	4	RIGHT	L353.EDF	L35	3
49	11473891	11473891	3429	3429	0	RIGHT	L353.EDF	L35	3
49	11473927	11475800	3465	5338	1873	RIGHT	L353.EDF	L35	3
49	11475827	11477601	5365	7139	1774	RIGHT	L353.EDF	L35	3
50	11481328	11481477	1156	1305	149	RIGHT	L353.EDF	L35	3
50	11482720	11482883	2548	2711	163	RIGHT	L353.EDF	L35	3
51	11487971	11488391	57	477	420	RIGHT	L353.EDF	L35	3
52	11495907	11496222	924	1239	315	RIGHT	L353.EDF	L35	3
52	11497408	11497591	2425	2608	183	RIGHT	L353.EDF	L35	3
52	11498995	11499254	4012	4271	259	RIGHT	L353.EDF	L35	3
52	11500994	11501168	6011	6185	174	RIGHT	L353.EDF	L35	3
53	11505540	11505710	1556	1726	170	RIGHT	L353.EDF	L35	3
53	11506750	11506944	2766	2960	194	RIGHT	L353.EDF	L35	3
54	11515129	11515259	4501	4631	130	RIGHT	L353.EDF	L35	3
55	11519220	11519387	1306	1473	167	RIGHT	L353.EDF	L35	3
56	11527750	11527952	1684	1886	202	RIGHT	L353.EDF	L35	3
56	11531784	11531967	5718	5901	183	RIGHT	L353.EDF	L35	3
57	11536579	11536748	1392	1561	169	RIGHT	L353.EDF	L35	3
57	11538032	11538197	2845	3010	165	RIGHT	L353.EDF	L35	3
58	11544522	11544725	1414	1617	203	RIGHT	L353.EDF	L35	3
58	11546576	11546811	3468	3703	235	RIGHT	L353.EDF	L35	3
59	11552628	11552774	901	1047	146	RIGHT	L353.EDF	L35	3
59	11554127	11554309	2400	2582	182	RIGHT	L353.EDF	L35	3
59	11554919	11555106	3192	3379	187	RIGHT	L353.EDF	L35	3
59	11557605	11557783	5878	6056	178	RIGHT	L353.EDF	L35	3
60	11561013	11561220	1313	1520	207	RIGHT	L353.EDF	L35	3
62	11576854	11576995	1556	1697	141	RIGHT	L353.EDF	L35	3
62	11578759	11578898	3461	3600	139	RIGHT	L353.EDF	L35	3
62	11580135	11580269	4837	4971	134	RIGHT	L353.EDF	L35	3
63	11585964	11586093	2102	2231	129	RIGHT	L353.EDF	L35	3
64	11592969	11593018	57	106	49	RIGHT	L353.EDF	L35	3
64	11594239	11594427	1327	1515	188	RIGHT	L353.EDF	L35	3
64	11595680	11595865	2768	2953	185	RIGHT	L353.EDF	L35	3
64	11598804	11598988	5892	6076	184	RIGHT	L353.EDF	L35	3
65	11605185	11605356	3461	3632	171	RIGHT	L353.EDF	L35	3
65	11605379	11605395	3655	3671	16	RIGHT	L353.EDF	L35	3
66	11614580	11614583	4331	4334	3	RIGHT	L353.EDF	L35	3
66	11614609	11614616	4360	4367	7	RIGHT	L353.EDF	L35	3
66	11614668	11614699	4419	4450	31	RIGHT	L353.EDF	L35	3
66	11614721	11614759	4472	4510	38	RIGHT	L353.EDF	L35	3
66	11614886	11614886	4637	4637	0	RIGHT	L353.EDF	L35	3
66	11614915	11614915	4666	4666	0	RIGHT	L353.EDF	L35	3
66	11614968	11614978	4719	4729	10	RIGHT	L353.EDF	L35	3
66	11615017	11615316	4768	5067	299	RIGHT	L353.EDF	L35	3
66	11615377	11615378	5128	5129	1	RIGHT	L353.EDF	L35	3
66	11615458	11615458	5209	5209	0	RIGHT	L353.EDF	L35	3
66	11615495	11615511	5246	5262	16	RIGHT	L353.EDF	L35	3
66	11615533	11615757	5284	5508	224	RIGHT	L353.EDF	L35	3
66	11615787	11615992	5538	5743	205	RIGHT	L353.EDF	L35	3
66	11616037	11616059	5788	5810	22	RIGHT	L353.EDF	L35	3
67	11621329	11621628	1624	1923	299	RIGHT	L353.EDF	L35	3
67	11621650	11621834	1945	2129	184	RIGHT	L353.EDF	L35	3
67	11623685	11623689	3980	3984	4	RIGHT	L353.EDF	L35	3
67	11623750	11624317	4045	4612	567	RIGHT	L353.EDF	L35	3
68	11629233	11629367	1554	1688	134	RIGHT	L353.EDF	L35	3
68	11631031	11631181	3352	3502	150	RIGHT	L353.EDF	L35	3
68	11632136	11632278	4457	4599	142	RIGHT	L353.EDF	L35	3
70	11642111	11643223	57	1169	1112	RIGHT	L353.EDF	L35	3
70	11643360	11643540	1306	1486	180	RIGHT	L353.EDF	L35	3
70	11645129	11645277	3075	3223	148	RIGHT	L353.EDF	L35	3
72	11660324	11660517	785	978	193	RIGHT	L353.EDF	L35	3
72	11662750	11662922	3211	3383	172	RIGHT	L353.EDF	L35	3
72	11663742	11663940	4203	4401	198	RIGHT	L353.EDF	L35	3
72	11664654	11664853	5115	5314	199	RIGHT	L353.EDF	L35	3
73	11669009	11669153	1423	1567	144	RIGHT	L353.EDF	L35	3
74	11679041	11679282	4229	4470	241	RIGHT	L353.EDF	L35	3
74	11680537	11680785	5725	5973	248	RIGHT	L353.EDF	L35	3
75	11684456	11684590	1390	1524	134	RIGHT	L353.EDF	L35	3
76	11692869	11693063	1255	1449	194	RIGHT	L353.EDF	L35	3
77	11699785	11699957	70	242	172	RIGHT	L353.EDF	L35	3
79	11715130	11715191	58	119	61	RIGHT	L353.EDF	L35	3
81	11731891	11732042	1793	1944	151	RIGHT	L353.EDF	L35	3
82	11738756	11738961	57	262	205	RIGHT	L353.EDF	L35	3
82	11743072	11743278	4373	4579	206	RIGHT	L353.EDF	L35	3
83	11748069	11748231	1810	1972	162	RIGHT	L353.EDF	L35	3
84	11756203	11756343	2009	2149	140	RIGHT	L353.EDF	L35	3
84	11759548	11759718	5354	5524	170	RIGHT	L353.EDF	L35	3
85	11769126	11769360	6203	6437	234	RIGHT	L353.EDF	L35	3
86	11777611	11777787	5890	6066	176	RIGHT	L353.EDF	L35	3
87	11784159	11784325	3151	3317	166	RIGHT	L353.EDF	L35	3
87	11784944	11785172	3936	4164	228	RIGHT	L353.EDF	L35	3
87	11786049	11786257	5041	5249	208	RIGHT	L353.EDF	L35	3
88	11789156	11789352	293	489	196	RIGHT	L353.EDF	L35	3
88	11789437	11789445	574	582	8	RIGHT	L353.EDF	L35	3
89	11801624	11801835	4669	4880	211	RIGHT	L353.EDF	L35	3
89	11801983	11801983	5028	5028	0	RIGHT	L353.EDF	L35	3
89	11802056	11802056	5101	5101	0	RIGHT	L353.EDF	L35	3
90	11808814	11809019	2704	2909	205	RIGHT	L353.EDF	L35	3
90	11809116	11809116	3006	3006	0	RIGHT	L353.EDF	L35	3
90	11809696	11809932	3586	3822	236	RIGHT	L353.EDF	L35	3
90	11812198	11812391	6088	6281	193	RIGHT	L353.EDF	L35	3
90	11812413	11812421	6303	6311	8	RIGHT	L353.EDF	L35	3
93	11832855	11833046	1689	1880	191	RIGHT	L353.EDF	L35	3
94	11841810	11841983	1740	1913	173	RIGHT	L353.EDF	L35	3
95	11848745	11848942	1266	1463	197	RIGHT	L353.EDF	L35	3
96	11863196	11863504	6431	6739	308	RIGHT	L353.EDF	L35	3
98	11876502	11876819	959	1276	317	RIGHT	L353.EDF	L35	3
98	11880300	11880450	4757	4907	150	RIGHT	L353.EDF	L35	3
99	11882697	11883949	57	1309	1252	RIGHT	L353.EDF	L35	3
99	11884130	11884313	1490	1673	183	RIGHT	L353.EDF	L35	3
99	11885523	11885698	2883	3058	175	RIGHT	L353.EDF	L35	3
99	11886910	11887092	4270	4452	182	RIGHT	L353.EDF	L35	3
99	11887580	11887796	4940	5156	216	RIGHT	L353.EDF	L35	3
99	11888698	11888879	6058	6239	181	RIGHT	L353.EDF	L35	3
100	11897833	11898002	6045	6214	169	RIGHT	L353.EDF	L35	3
102	11909767	11909972	1272	1477	205	RIGHT	L353.EDF	L35	3
103	11916595	11916800	878	1083	205	RIGHT	L353.EDF	L35	3
104	11925507	11925648	2005	2146	141	RIGHT	L353.EDF	L35	3
104	11927303	11927481	3801	3979	178	RIGHT	L353.EDF	L35	3
105	11930469	11930480	77	88	11	RIGHT	L353.EDF	L35	3
105	11933090	11933162	2698	2770	72	RIGHT	L353.EDF	L35	3
107	11950729	11950919	4240	4430	190	RIGHT	L353.EDF	L35	3
108	11956626	11956786	1533	1693	160	RIGHT	L353.EDF	L35	3
108	11957836	11957987	2743	2894	151	RIGHT	L353.EDF	L35	3
108	11960795	11961000	5702	5907	205	RIGHT	L353.EDF	L35	3
109	11963540	11963736	154	350	196	RIGHT	L353.EDF	L35	3
109	11964465	11964661	1079	1275	196	RIGHT	L353.EDF	L35	3
110	11974081	11974251	1739	1909	170	RIGHT	L353.EDF	L35	3
110	11976729	11976927	4387	4585	198	RIGHT	L353.EDF	L35	3
110	11977723	11977928	5381	5586	205	RIGHT	L353.EDF	L35	3
111	11985135	11985266	4223	4354	131	RIGHT	L353.EDF	L35	3
112	11994725	11994830	5587	5692	105	RIGHT	L353.EDF	L35	3
113	11999847	12000043	2657	2853	196	RIGHT	L353.EDF	L35	3
113	12000156	12000195	2966	3005	39	RIGHT	L353.EDF	L35	3
114	12007628	12007771	1524	1667	143	RIGHT	L353.EDF	L35	3
114	12009267	12009437	3163	3333	170	RIGHT	L353.EDF	L35	3
115	12017808	12017957	2287	2436	149	RIGHT	L353.EDF	L35	3
115	12018048	12018068	2527	2547	20	RIGHT	L353.EDF	L35	3
115	12019586	12019732	4065	4211	146	RIGHT	L353.EDF	L35	3
115	12020963	12021118	5442	5597	155	RIGHT	L353.EDF	L35	3
116	12025160	12025294	995	1129	134	RIGHT	L353.EDF	L35	3
118	12042446	12042605	2351	2510	159	RIGHT	L353.EDF	L35	3
118	12042773	12042836	2678	2741	63	RIGHT	L353.EDF	L35	3
118	12045460	12045567	5365	5472	107	RIGHT	L353.EDF	L35	3
1	12047285	12047455	491	661	170	RIGHT	L70a.EDF	L70	1
1	12049676	12051193	2882	4399	1517	RIGHT	L70a.EDF	L70	1
1	12051222	12051269	4428	4475	47	RIGHT	L70a.EDF	L70	1
1	12051315	12051337	4521	4543	22	RIGHT	L70a.EDF	L70	1
1	12051404	12051404	4610	4610	0	RIGHT	L70a.EDF	L70	1
1	12051538	12051538	4744	4744	0	RIGHT	L70a.EDF	L70	1
2	12055520	12055793	85	358	273	RIGHT	L70a.EDF	L70	1
2	12056423	12060848	988	5413	4425	RIGHT	L70a.EDF	L70	1
3	12063819	12063991	58	230	172	RIGHT	L70a.EDF	L70	1
3	12064765	12065854	1004	2093	1089	RIGHT	L70a.EDF	L70	1
3	12066061	12066065	2300	2304	4	RIGHT	L70a.EDF	L70	1
3	12066088	12066644	2327	2883	556	RIGHT	L70a.EDF	L70	1
3	12066671	12066725	2910	2964	54	RIGHT	L70a.EDF	L70	1
3	12066765	12066775	3004	3014	10	RIGHT	L70a.EDF	L70	1
3	12066821	12066821	3060	3060	0	RIGHT	L70a.EDF	L70	1
3	12066871	12066871	3110	3110	0	RIGHT	L70a.EDF	L70	1
3	12066917	12066918	3156	3157	1	RIGHT	L70a.EDF	L70	1
3	12067512	12068793	3751	5032	1281	RIGHT	L70a.EDF	L70	1
4	12071509	12071729	530	750	220	RIGHT	L70a.EDF	L70	1
4	12071847	12071931	868	952	84	RIGHT	L70a.EDF	L70	1
4	12072367	12072474	1388	1495	107	RIGHT	L70a.EDF	L70	1
4	12072497	12072797	1518	1818	300	RIGHT	L70a.EDF	L70	1
4	12073659	12074386	2680	3407	727	RIGHT	L70a.EDF	L70	1
4	12074681	12074682	3702	3703	1	RIGHT	L70a.EDF	L70	1
4	12074716	12074719	3737	3740	3	RIGHT	L70a.EDF	L70	1
4	12074937	12074937	3958	3958	0	RIGHT	L70a.EDF	L70	1
4	12075207	12075208	4228	4229	1	RIGHT	L70a.EDF	L70	1
5	12079320	12079873	58	611	553	RIGHT	L70a.EDF	L70	1
5	12079905	12080012	643	750	107	RIGHT	L70a.EDF	L70	1
5	12080038	12080059	776	797	21	RIGHT	L70a.EDF	L70	1
5	12080118	12080120	856	858	2	RIGHT	L70a.EDF	L70	1
5	12080308	12080308	1046	1046	0	RIGHT	L70a.EDF	L70	1
5	12080894	12081012	1632	1750	118	RIGHT	L70a.EDF	L70	1
5	12081165	12081593	1903	2331	428	RIGHT	L70a.EDF	L70	1
5	12081636	12081721	2374	2459	85	RIGHT	L70a.EDF	L70	1
5	12081764	12081768	2502	2506	4	RIGHT	L70a.EDF	L70	1
5	12081918	12081918	2656	2656	0	RIGHT	L70a.EDF	L70	1
5	12082180	12082203	2918	2941	23	RIGHT	L70a.EDF	L70	1
5	12082388	12082388	3126	3126	0	RIGHT	L70a.EDF	L70	1
5	12082817	12084136	3555	4874	1319	RIGHT	L70a.EDF	L70	1
5	12084189	12084382	4927	5120	193	RIGHT	L70a.EDF	L70	1
6	12086871	12086951	104	184	80	RIGHT	L70a.EDF	L70	1
6	12086988	12086988	221	221	0	RIGHT	L70a.EDF	L70	1
6	12087014	12087068	247	301	54	RIGHT	L70a.EDF	L70	1
6	12087089	12087133	322	366	44	RIGHT	L70a.EDF	L70	1
6	12087157	12087221	390	454	64	RIGHT	L70a.EDF	L70	1
6	12087958	12087958	1191	1191	0	RIGHT	L70a.EDF	L70	1
6	12087986	12087988	1219	1221	2	RIGHT	L70a.EDF	L70	1
6	12088011	12088011	1244	1244	0	RIGHT	L70a.EDF	L70	1
6	12088035	12088641	1268	1874	606	RIGHT	L70a.EDF	L70	1
6	12088680	12088713	1913	1946	33	RIGHT	L70a.EDF	L70	1
6	12088837	12089801	2070	3034	964	RIGHT	L70a.EDF	L70	1
6	12089823	12089848	3056	3081	25	RIGHT	L70a.EDF	L70	1
6	12089946	12090009	3179	3242	63	RIGHT	L70a.EDF	L70	1
6	12090063	12090063	3296	3296	0	RIGHT	L70a.EDF	L70	1
6	12090330	12093288	3563	6521	2958	RIGHT	L70a.EDF	L70	1
7	12095518	12095762	57	301	244	RIGHT	L70a.EDF	L70	1
7	12095858	12095858	397	397	0	RIGHT	L70a.EDF	L70	1
7	12095882	12095971	421	510	89	RIGHT	L70a.EDF	L70	1
7	12095999	12096001	538	540	2	RIGHT	L70a.EDF	L70	1
7	12096024	12096038	563	577	14	RIGHT	L70a.EDF	L70	1
7	12096059	12096107	598	646	48	RIGHT	L70a.EDF	L70	1
7	12096131	12096291	670	830	160	RIGHT	L70a.EDF	L70	1
7	12096312	12096376	851	915	64	RIGHT	L70a.EDF	L70	1
7	12096402	12096403	941	942	1	RIGHT	L70a.EDF	L70	1
7	12097617	12098718	2156	3257	1101	RIGHT	L70a.EDF	L70	1
7	12098741	12098741	3280	3280	0	RIGHT	L70a.EDF	L70	1
7	12098770	12098772	3309	3311	2	RIGHT	L70a.EDF	L70	1
7	12098793	12098858	3332	3397	65	RIGHT	L70a.EDF	L70	1
7	12098880	12098884	3419	3423	4	RIGHT	L70a.EDF	L70	1
7	12098938	12098938	3477	3477	0	RIGHT	L70a.EDF	L70	1
7	12098962	12098979	3501	3518	17	RIGHT	L70a.EDF	L70	1
7	12099002	12099003	3541	3542	1	RIGHT	L70a.EDF	L70	1
7	12099149	12099150	3688	3689	1	RIGHT	L70a.EDF	L70	1
7	12099226	12099250	3765	3789	24	RIGHT	L70a.EDF	L70	1
7	12099275	12100723	3814	5262	1448	RIGHT	L70a.EDF	L70	1
8	12103345	12103823	59	537	478	RIGHT	L70a.EDF	L70	1
8	12103850	12104303	564	1017	453	RIGHT	L70a.EDF	L70	1
8	12105015	12106325	1729	3039	1310	RIGHT	L70a.EDF	L70	1
8	12106346	12106594	3060	3308	248	RIGHT	L70a.EDF	L70	1
8	12106630	12106662	3344	3376	32	RIGHT	L70a.EDF	L70	1
8	12106684	12107686	3398	4400	1002	RIGHT	L70a.EDF	L70	1
8	12108473	12108473	5187	5187	0	RIGHT	L70a.EDF	L70	1
8	12108502	12108503	5216	5217	1	RIGHT	L70a.EDF	L70	1
8	12108858	12108859	5572	5573	1	RIGHT	L70a.EDF	L70	1
8	12110617	12110618	7331	7332	1	RIGHT	L70a.EDF	L70	1
9	12113852	12115079	71	1298	1227	RIGHT	L70a.EDF	L70	1
9	12115108	12115120	1327	1339	12	RIGHT	L70a.EDF	L70	1
9	12115189	12115191	1408	1410	2	RIGHT	L70a.EDF	L70	1
9	12115232	12115232	1451	1451	0	RIGHT	L70a.EDF	L70	1
9	12115266	12115268	1485	1487	2	RIGHT	L70a.EDF	L70	1
9	12115290	12115299	1509	1518	9	RIGHT	L70a.EDF	L70	1
9	12115480	12116729	1699	2948	1249	RIGHT	L70a.EDF	L70	1
9	12116769	12116782	2988	3001	13	RIGHT	L70a.EDF	L70	1
9	12116835	12116835	3054	3054	0	RIGHT	L70a.EDF	L70	1
9	12116886	12116887	3105	3106	1	RIGHT	L70a.EDF	L70	1
9	12116924	12116941	3143	3160	17	RIGHT	L70a.EDF	L70	1
9	12116965	12116997	3184	3216	32	RIGHT	L70a.EDF	L70	1
9	12117051	12117051	3270	3270	0	RIGHT	L70a.EDF	L70	1
9	12117091	12117889	3310	4108	798	RIGHT	L70a.EDF	L70	1
9	12117960	12118253	4179	4472	293	RIGHT	L70a.EDF	L70	1
9	12118288	12118316	4507	4535	28	RIGHT	L70a.EDF	L70	1
9	12118339	12118401	4558	4620	62	RIGHT	L70a.EDF	L70	1
9	12118431	12118444	4650	4663	13	RIGHT	L70a.EDF	L70	1
9	12118480	12118554	4699	4773	74	RIGHT	L70a.EDF	L70	1
9	12118618	12118634	4837	4853	16	RIGHT	L70a.EDF	L70	1
9	12118656	12118679	4875	4898	23	RIGHT	L70a.EDF	L70	1
9	12118728	12118734	4947	4953	6	RIGHT	L70a.EDF	L70	1
9	12118766	12118800	4985	5019	34	RIGHT	L70a.EDF	L70	1
9	12118849	12118849	5068	5068	0	RIGHT	L70a.EDF	L70	1
9	12118886	12118898	5105	5117	12	RIGHT	L70a.EDF	L70	1
9	12118920	12118920	5139	5139	0	RIGHT	L70a.EDF	L70	1
9	12118984	12119014	5203	5233	30	RIGHT	L70a.EDF	L70	1
9	12119085	12119085	5304	5304	0	RIGHT	L70a.EDF	L70	1
9	12119162	12119204	5381	5423	42	RIGHT	L70a.EDF	L70	1
10	12122193	12123307	58	1172	1114	RIGHT	L70a.EDF	L70	1
10	12123437	12123829	1302	1694	392	RIGHT	L70a.EDF	L70	1
10	12123969	12123970	1834	1835	1	RIGHT	L70a.EDF	L70	1
10	12124191	12124216	2056	2081	25	RIGHT	L70a.EDF	L70	1
10	12124238	12125783	2103	3648	1545	RIGHT	L70a.EDF	L70	1
10	12125808	12125905	3673	3770	97	RIGHT	L70a.EDF	L70	1
10	12125928	12125977	3793	3842	49	RIGHT	L70a.EDF	L70	1
10	12126070	12126087	3935	3952	17	RIGHT	L70a.EDF	L70	1
10	12126148	12126168	4013	4033	20	RIGHT	L70a.EDF	L70	1
10	12126410	12126505	4275	4370	95	RIGHT	L70a.EDF	L70	1
10	12126549	12128259	4414	6124	1710	RIGHT	L70a.EDF	L70	1
11	12131551	12132582	57	1088	1031	RIGHT	L70a.EDF	L70	1
11	12132651	12132652	1157	1158	1	RIGHT	L70a.EDF	L70	1
11	12132697	12132723	1203	1229	26	RIGHT	L70a.EDF	L70	1
11	12132756	12132818	1262	1324	62	RIGHT	L70a.EDF	L70	1
11	12132925	12132950	1431	1456	25	RIGHT	L70a.EDF	L70	1
11	12133008	12133020	1514	1526	12	RIGHT	L70a.EDF	L70	1
11	12133046	12133046	1552	1552	0	RIGHT	L70a.EDF	L70	1
11	12133094	12133094	1600	1600	0	RIGHT	L70a.EDF	L70	1
11	12133130	12133198	1636	1704	68	RIGHT	L70a.EDF	L70	1
11	12133229	12133232	1735	1738	3	RIGHT	L70a.EDF	L70	1
11	12133259	12134353	1765	2859	1094	RIGHT	L70a.EDF	L70	1
11	12134418	12134460	2924	2966	42	RIGHT	L70a.EDF	L70	1
11	12134501	12134514	3007	3020	13	RIGHT	L70a.EDF	L70	1
11	12134813	12134813	3319	3319	0	RIGHT	L70a.EDF	L70	1
11	12135232	12135236	3738	3742	4	RIGHT	L70a.EDF	L70	1
11	12135682	12135692	4188	4198	10	RIGHT	L70a.EDF	L70	1
11	12135734	12135737	4240	4243	3	RIGHT	L70a.EDF	L70	1
11	12135824	12135876	4330	4382	52	RIGHT	L70a.EDF	L70	1
11	12135904	12135975	4410	4481	71	RIGHT	L70a.EDF	L70	1
11	12136002	12136029	4508	4535	27	RIGHT	L70a.EDF	L70	1
11	12136308	12136308	4814	4814	0	RIGHT	L70a.EDF	L70	1
11	12136437	12136437	4943	4943	0	RIGHT	L70a.EDF	L70	1
11	12136650	12136650	5156	5156	0	RIGHT	L70a.EDF	L70	1
11	12136934	12136935	5440	5441	1	RIGHT	L70a.EDF	L70	1
11	12137000	12137000	5506	5506	0	RIGHT	L70a.EDF	L70	1
11	12137026	12137034	5532	5540	8	RIGHT	L70a.EDF	L70	1
11	12137127	12137127	5633	5633	0	RIGHT	L70a.EDF	L70	1
11	12137203	12137221	5709	5727	18	RIGHT	L70a.EDF	L70	1
11	12137248	12137575	5754	6081	327	RIGHT	L70a.EDF	L70	1
12	12139765	12139998	58	291	233	RIGHT	L70a.EDF	L70	1
12	12140052	12140053	345	346	1	RIGHT	L70a.EDF	L70	1
12	12140211	12140211	504	504	0	RIGHT	L70a.EDF	L70	1
12	12140264	12140265	557	558	1	RIGHT	L70a.EDF	L70	1
12	12140312	12140313	605	606	1	RIGHT	L70a.EDF	L70	1
12	12140374	12140377	667	670	3	RIGHT	L70a.EDF	L70	1
12	12140429	12140439	722	732	10	RIGHT	L70a.EDF	L70	1
12	12140480	12140480	773	773	0	RIGHT	L70a.EDF	L70	1
12	12140747	12140765	1040	1058	18	RIGHT	L70a.EDF	L70	1
12	12141425	12141425	1718	1718	0	RIGHT	L70a.EDF	L70	1
12	12141465	12141466	1758	1759	1	RIGHT	L70a.EDF	L70	1
12	12141513	12141517	1806	1810	4	RIGHT	L70a.EDF	L70	1
12	12141539	12141578	1832	1871	39	RIGHT	L70a.EDF	L70	1
12	12141775	12142926	2068	3219	1151	RIGHT	L70a.EDF	L70	1
12	12142971	12142981	3264	3274	10	RIGHT	L70a.EDF	L70	1
12	12143068	12143069	3361	3362	1	RIGHT	L70a.EDF	L70	1
12	12143099	12143118	3392	3411	19	RIGHT	L70a.EDF	L70	1
12	12143278	12143278	3571	3571	0	RIGHT	L70a.EDF	L70	1
12	12144947	12144947	5240	5240	0	RIGHT	L70a.EDF	L70	1
12	12145028	12145029	5321	5322	1	RIGHT	L70a.EDF	L70	1
12	12145188	12145188	5481	5481	0	RIGHT	L70a.EDF	L70	1
12	12145217	12145221	5510	5514	4	RIGHT	L70a.EDF	L70	1
12	12145271	12145700	5564	5993	429	RIGHT	L70a.EDF	L70	1
13	12147768	12148587	59	878	819	RIGHT	L70a.EDF	L70	1
13	12148628	12148656	919	947	28	RIGHT	L70a.EDF	L70	1
13	12148750	12148779	1041	1070	29	RIGHT	L70a.EDF	L70	1
13	12148888	12148888	1179	1179	0	RIGHT	L70a.EDF	L70	1
13	12148915	12148926	1206	1217	11	RIGHT	L70a.EDF	L70	1
13	12148991	12149622	1282	1913	631	RIGHT	L70a.EDF	L70	1
13	12149799	12149810	2090	2101	11	RIGHT	L70a.EDF	L70	1
13	12149857	12151032	2148	3323	1175	RIGHT	L70a.EDF	L70	1
13	12151171	12151188	3462	3479	17	RIGHT	L70a.EDF	L70	1
13	12151209	12151249	3500	3540	40	RIGHT	L70a.EDF	L70	1
13	12151573	12151588	3864	3879	15	RIGHT	L70a.EDF	L70	1
13	12151610	12151637	3901	3928	27	RIGHT	L70a.EDF	L70	1
13	12151960	12151960	4251	4251	0	RIGHT	L70a.EDF	L70	1
13	12152150	12152219	4441	4510	69	RIGHT	L70a.EDF	L70	1
13	12152240	12152241	4531	4532	1	RIGHT	L70a.EDF	L70	1
13	12152285	12152600	4576	4891	315	RIGHT	L70a.EDF	L70	1
13	12153414	12153414	5705	5705	0	RIGHT	L70a.EDF	L70	1
13	12153565	12153627	5856	5918	62	RIGHT	L70a.EDF	L70	1
13	12153649	12153706	5940	5997	57	RIGHT	L70a.EDF	L70	1
13	12153781	12153781	6072	6072	0	RIGHT	L70a.EDF	L70	1
13	12153808	12153809	6099	6100	1	RIGHT	L70a.EDF	L70	1
13	12153838	12153839	6129	6130	1	RIGHT	L70a.EDF	L70	1
14	12158014	12158179	59	224	165	RIGHT	L70a.EDF	L70	1
14	12158459	12158460	504	505	1	RIGHT	L70a.EDF	L70	1
14	12158490	12158490	535	535	0	RIGHT	L70a.EDF	L70	1
14	12158511	12158511	556	556	0	RIGHT	L70a.EDF	L70	1
14	12159127	12159494	1172	1539	367	RIGHT	L70a.EDF	L70	1
14	12159810	12159814	1855	1859	4	RIGHT	L70a.EDF	L70	1
14	12159864	12162861	1909	4906	2997	RIGHT	L70a.EDF	L70	1
14	12162897	12162940	4942	4985	43	RIGHT	L70a.EDF	L70	1
14	12162972	12163485	5017	5530	513	RIGHT	L70a.EDF	L70	1
14	12163513	12163921	5558	5966	408	RIGHT	L70a.EDF	L70	1
14	12163946	12164131	5991	6176	185	RIGHT	L70a.EDF	L70	1
15	12168391	12169717	58	1384	1326	RIGHT	L70a.EDF	L70	1
15	12169739	12169839	1406	1506	100	RIGHT	L70a.EDF	L70	1
15	12169861	12169867	1528	1534	6	RIGHT	L70a.EDF	L70	1
15	12169903	12169944	1570	1611	41	RIGHT	L70a.EDF	L70	1
15	12170000	12170004	1667	1671	4	RIGHT	L70a.EDF	L70	1
15	12170069	12170119	1736	1786	50	RIGHT	L70a.EDF	L70	1
15	12170146	12171441	1813	3108	1295	RIGHT	L70a.EDF	L70	1
15	12171506	12171506	3173	3173	0	RIGHT	L70a.EDF	L70	1
15	12171568	12171568	3235	3235	0	RIGHT	L70a.EDF	L70	1
15	12171802	12171850	3469	3517	48	RIGHT	L70a.EDF	L70	1
15	12171907	12171942	3574	3609	35	RIGHT	L70a.EDF	L70	1
15	12171963	12171973	3630	3640	10	RIGHT	L70a.EDF	L70	1
15	12171995	12172005	3662	3672	10	RIGHT	L70a.EDF	L70	1
15	12172047	12172047	3714	3714	0	RIGHT	L70a.EDF	L70	1
15	12172103	12172103	3770	3770	0	RIGHT	L70a.EDF	L70	1
15	12172125	12172125	3792	3792	0	RIGHT	L70a.EDF	L70	1
15	12172154	12172183	3821	3850	29	RIGHT	L70a.EDF	L70	1
15	12172234	12172237	3901	3904	3	RIGHT	L70a.EDF	L70	1
15	12172276	12172832	3943	4499	556	RIGHT	L70a.EDF	L70	1
15	12173190	12173191	4857	4858	1	RIGHT	L70a.EDF	L70	1
15	12173234	12173291	4901	4958	57	RIGHT	L70a.EDF	L70	1
15	12173313	12173578	4980	5245	265	RIGHT	L70a.EDF	L70	1
16	12176530	12177343	57	870	813	RIGHT	L70a.EDF	L70	1
16	12177381	12177386	908	913	5	RIGHT	L70a.EDF	L70	1
16	12177409	12177424	936	951	15	RIGHT	L70a.EDF	L70	1
16	12177518	12177518	1045	1045	0	RIGHT	L70a.EDF	L70	1
16	12177542	12177542	1069	1069	0	RIGHT	L70a.EDF	L70	1
16	12177615	12177620	1142	1147	5	RIGHT	L70a.EDF	L70	1
16	12177728	12177734	1255	1261	6	RIGHT	L70a.EDF	L70	1
16	12177983	12178020	1510	1547	37	RIGHT	L70a.EDF	L70	1
16	12178092	12178229	1619	1756	137	RIGHT	L70a.EDF	L70	1
16	12178305	12180001	1832	3528	1696	RIGHT	L70a.EDF	L70	1
16	12180047	12180049	3574	3576	2	RIGHT	L70a.EDF	L70	1
16	12180072	12180092	3599	3619	20	RIGHT	L70a.EDF	L70	1
16	12180118	12180120	3645	3647	2	RIGHT	L70a.EDF	L70	1
16	12180176	12180213	3703	3740	37	RIGHT	L70a.EDF	L70	1
16	12180262	12180269	3789	3796	7	RIGHT	L70a.EDF	L70	1
16	12180304	12180346	3831	3873	42	RIGHT	L70a.EDF	L70	1
16	12180417	12180654	3944	4181	237	RIGHT	L70a.EDF	L70	1
16	12180685	12180775	4212	4302	90	RIGHT	L70a.EDF	L70	1
16	12180801	12180841	4328	4368	40	RIGHT	L70a.EDF	L70	1
16	12180928	12180928	4455	4455	0	RIGHT	L70a.EDF	L70	1
17	12185231	12186151	58	978	920	RIGHT	L70a.EDF	L70	1
17	12186173	12186812	1000	1639	639	RIGHT	L70a.EDF	L70	1
17	12186855	12186874	1682	1701	19	RIGHT	L70a.EDF	L70	1
17	12186899	12188567	1726	3394	1668	RIGHT	L70a.EDF	L70	1
17	12188590	12188662	3417	3489	72	RIGHT	L70a.EDF	L70	1
17	12188685	12190212	3512	5039	1527	RIGHT	L70a.EDF	L70	1
17	12190233	12190574	5060	5401	341	RIGHT	L70a.EDF	L70	1
17	12190604	12190605	5431	5432	1	RIGHT	L70a.EDF	L70	1
17	12190632	12190632	5459	5459	0	RIGHT	L70a.EDF	L70	1
17	12190671	12190681	5498	5508	10	RIGHT	L70a.EDF	L70	1
17	12190779	12191034	5606	5861	255	RIGHT	L70a.EDF	L70	1
17	12191063	12192008	5890	6835	945	RIGHT	L70a.EDF	L70	1
17	12192034	12192051	6861	6878	17	RIGHT	L70a.EDF	L70	1
17	12192144	12192201	6971	7028	57	RIGHT	L70a.EDF	L70	1
17	12192273	12192274	7100	7101	1	RIGHT	L70a.EDF	L70	1
17	12192301	12192303	7128	7130	2	RIGHT	L70a.EDF	L70	1
17	12192328	12192359	7155	7186	31	RIGHT	L70a.EDF	L70	1
18	12195617	12199132	58	3573	3515	RIGHT	L70a.EDF	L70	1
18	12199200	12199201	3641	3642	1	RIGHT	L70a.EDF	L70	1
18	12199267	12199299	3708	3740	32	RIGHT	L70a.EDF	L70	1
18	12199430	12199485	3871	3926	55	RIGHT	L70a.EDF	L70	1
18	12199620	12199702	4061	4143	82	RIGHT	L70a.EDF	L70	1
18	12199728	12199732	4169	4173	4	RIGHT	L70a.EDF	L70	1
18	12199793	12199793	4234	4234	0	RIGHT	L70a.EDF	L70	1
18	12199901	12199901	4342	4342	0	RIGHT	L70a.EDF	L70	1
18	12200123	12200149	4564	4590	26	RIGHT	L70a.EDF	L70	1
18	12200206	12200249	4647	4690	43	RIGHT	L70a.EDF	L70	1
18	12200306	12200307	4747	4748	1	RIGHT	L70a.EDF	L70	1
18	12200412	12200412	4853	4853	0	RIGHT	L70a.EDF	L70	1
18	12200499	12200563	4940	5004	64	RIGHT	L70a.EDF	L70	1
18	12200604	12200635	5045	5076	31	RIGHT	L70a.EDF	L70	1
18	12200662	12200662	5103	5103	0	RIGHT	L70a.EDF	L70	1
18	12200714	12200714	5155	5155	0	RIGHT	L70a.EDF	L70	1
18	12200742	12200781	5183	5222	39	RIGHT	L70a.EDF	L70	1
18	12200811	12200815	5252	5256	4	RIGHT	L70a.EDF	L70	1
18	12200840	12200847	5281	5288	7	RIGHT	L70a.EDF	L70	1
18	12200939	12200981	5380	5422	42	RIGHT	L70a.EDF	L70	1
18	12201009	12201011	5450	5452	2	RIGHT	L70a.EDF	L70	1
18	12201072	12201074	5513	5515	2	RIGHT	L70a.EDF	L70	1
18	12201195	12201198	5636	5639	3	RIGHT	L70a.EDF	L70	1
18	12201313	12201324	5754	5765	11	RIGHT	L70a.EDF	L70	1
19	12203788	12203835	58	105	47	RIGHT	L70a.EDF	L70	1
19	12204247	12204465	517	735	218	RIGHT	L70a.EDF	L70	1
19	12205665	12205666	1935	1936	1	RIGHT	L70a.EDF	L70	1
19	12205733	12207095	2003	3365	1362	RIGHT	L70a.EDF	L70	1
19	12207307	12207565	3577	3835	258	RIGHT	L70a.EDF	L70	1
19	12207647	12208188	3917	4458	541	RIGHT	L70a.EDF	L70	1
19	12208524	12208531	4794	4801	7	RIGHT	L70a.EDF	L70	1
19	12208828	12208912	5098	5182	84	RIGHT	L70a.EDF	L70	1
19	12208934	12209064	5204	5334	130	RIGHT	L70a.EDF	L70	1
19	12209098	12209669	5368	5939	571	RIGHT	L70a.EDF	L70	1
19	12209708	12209708	5978	5978	0	RIGHT	L70a.EDF	L70	1
19	12209729	12209732	5999	6002	3	RIGHT	L70a.EDF	L70	1
19	12209753	12209787	6023	6057	34	RIGHT	L70a.EDF	L70	1
19	12209828	12209852	6098	6122	24	RIGHT	L70a.EDF	L70	1
19	12209883	12209891	6153	6161	8	RIGHT	L70a.EDF	L70	1
19	12209930	12209930	6200	6200	0	RIGHT	L70a.EDF	L70	1
19	12209960	12210127	6230	6397	167	RIGHT	L70a.EDF	L70	1
19	12210154	12210172	6424	6442	18	RIGHT	L70a.EDF	L70	1
19	12210194	12210262	6464	6532	68	RIGHT	L70a.EDF	L70	1
19	12210406	12210411	6676	6681	5	RIGHT	L70a.EDF	L70	1
19	12210454	12210454	6724	6724	0	RIGHT	L70a.EDF	L70	1
19	12210544	12210545	6814	6815	1	RIGHT	L70a.EDF	L70	1
19	12210633	12210633	6903	6903	0	RIGHT	L70a.EDF	L70	1
19	12210665	12210680	6935	6950	15	RIGHT	L70a.EDF	L70	1
20	12214058	12214885	58	885	827	RIGHT	L70a.EDF	L70	1
20	12214906	12215897	906	1897	991	RIGHT	L70a.EDF	L70	1
20	12215931	12216101	1931	2101	170	RIGHT	L70a.EDF	L70	1
20	12216126	12216311	2126	2311	185	RIGHT	L70a.EDF	L70	1
20	12216334	12216370	2334	2370	36	RIGHT	L70a.EDF	L70	1
20	12216391	12216470	2391	2470	79	RIGHT	L70a.EDF	L70	1
20	12216495	12216503	2495	2503	8	RIGHT	L70a.EDF	L70	1
20	12216525	12216542	2525	2542	17	RIGHT	L70a.EDF	L70	1
20	12216591	12216650	2591	2650	59	RIGHT	L70a.EDF	L70	1
20	12216675	12216691	2675	2691	16	RIGHT	L70a.EDF	L70	1
20	12216714	12216729	2714	2729	15	RIGHT	L70a.EDF	L70	1
20	12216781	12216789	2781	2789	8	RIGHT	L70a.EDF	L70	1
20	12216817	12216821	2817	2821	4	RIGHT	L70a.EDF	L70	1
20	12216844	12220576	2844	6576	3732	RIGHT	L70a.EDF	L70	1
22	12233189	12238477	58	5346	5288	RIGHT	L70a.EDF	L70	1
23	12242900	12244589	58	1747	1689	RIGHT	L70a.EDF	L70	1
23	12246512	12247710	3670	4868	1198	RIGHT	L70a.EDF	L70	1
23	12248002	12248401	5160	5559	399	RIGHT	L70a.EDF	L70	1
23	12248783	12248821	5941	5979	38	RIGHT	L70a.EDF	L70	1
23	12249794	12249795	6952	6953	1	RIGHT	L70a.EDF	L70	1
23	12249823	12249824	6981	6982	1	RIGHT	L70a.EDF	L70	1
23	12249863	12249880	7021	7038	17	RIGHT	L70a.EDF	L70	1
23	12249908	12250025	7066	7183	117	RIGHT	L70a.EDF	L70	1
24	12253492	12253592	58	158	100	RIGHT	L70a.EDF	L70	1
24	12254446	12255109	1012	1675	663	RIGHT	L70a.EDF	L70	1
24	12255165	12255168	1731	1734	3	RIGHT	L70a.EDF	L70	1
24	12255397	12255398	1963	1964	1	RIGHT	L70a.EDF	L70	1
24	12255478	12255592	2044	2158	114	RIGHT	L70a.EDF	L70	1
24	12257703	12257703	4269	4269	0	RIGHT	L70a.EDF	L70	1
24	12257724	12257725	4290	4291	1	RIGHT	L70a.EDF	L70	1
24	12257777	12257788	4343	4354	11	RIGHT	L70a.EDF	L70	1
24	12257812	12257813	4378	4379	1	RIGHT	L70a.EDF	L70	1
24	12257836	12259633	4402	6199	1797	RIGHT	L70a.EDF	L70	1
25	12264207	12264753	1048	1594	546	RIGHT	L70a.EDF	L70	1
25	12265193	12265220	2034	2061	27	RIGHT	L70a.EDF	L70	1
25	12266933	12269117	3774	5958	2184	RIGHT	L70a.EDF	L70	1
26	12271975	12272144	58	227	169	RIGHT	L70a.EDF	L70	1
27	12284984	12285383	3613	4012	399	RIGHT	L70a.EDF	L70	1
27	12285683	12287257	4312	5886	1574	RIGHT	L70a.EDF	L70	1
28	12291509	12291605	57	153	96	RIGHT	L70a.EDF	L70	1
28	12292015	12292436	563	984	421	RIGHT	L70a.EDF	L70	1
29	12299399	12299802	125	528	403	RIGHT	L70a.EDF	L70	1
29	12300524	12301178	1250	1904	654	RIGHT	L70a.EDF	L70	1
29	12306388	12306389	7114	7115	1	RIGHT	L70a.EDF	L70	1
29	12306420	12306420	7146	7146	0	RIGHT	L70a.EDF	L70	1
29	12306470	12306510	7196	7236	40	RIGHT	L70a.EDF	L70	1
30	12309196	12309238	57	99	42	RIGHT	L70a.EDF	L70	1
30	12309975	12311062	836	1923	1087	RIGHT	L70a.EDF	L70	1
30	12312388	12312389	3249	3250	1	RIGHT	L70a.EDF	L70	1
30	12312413	12314664	3274	5525	2251	RIGHT	L70a.EDF	L70	1
31	12317376	12317504	58	186	128	RIGHT	L70a.EDF	L70	1
31	12318892	12318894	1574	1576	2	RIGHT	L70a.EDF	L70	1
31	12318917	12318918	1599	1600	1	RIGHT	L70a.EDF	L70	1
31	12318939	12318958	1621	1640	19	RIGHT	L70a.EDF	L70	1
31	12319016	12319166	1698	1848	150	RIGHT	L70a.EDF	L70	1
31	12319191	12319615	1873	2297	424	RIGHT	L70a.EDF	L70	1
31	12320189	12320189	2871	2871	0	RIGHT	L70a.EDF	L70	1
31	12320225	12323760	2907	6442	3535	RIGHT	L70a.EDF	L70	1
32	12327727	12329188	58	1519	1461	RIGHT	L70a.EDF	L70	1
32	12329263	12329263	1594	1594	0	RIGHT	L70a.EDF	L70	1
32	12332275	12332279	4606	4610	4	RIGHT	L70a.EDF	L70	1
32	12332400	12332636	4731	4967	236	RIGHT	L70a.EDF	L70	1
33	12335924	12336037	58	171	113	RIGHT	L70a.EDF	L70	1
33	12341389	12342441	5523	6575	1052	RIGHT	L70a.EDF	L70	1
34	12345388	12345779	58	449	391	RIGHT	L70a.EDF	L70	1
34	12345827	12345844	497	514	17	RIGHT	L70a.EDF	L70	1
34	12346210	12346212	880	882	2	RIGHT	L70a.EDF	L70	1
34	12346272	12346295	942	965	23	RIGHT	L70a.EDF	L70	1
34	12346328	12346329	998	999	1	RIGHT	L70a.EDF	L70	1
34	12346358	12346766	1028	1436	408	RIGHT	L70a.EDF	L70	1
34	12346797	12346825	1467	1495	28	RIGHT	L70a.EDF	L70	1
34	12346846	12346888	1516	1558	42	RIGHT	L70a.EDF	L70	1
34	12346912	12346955	1582	1625	43	RIGHT	L70a.EDF	L70	1
34	12346976	12346976	1646	1646	0	RIGHT	L70a.EDF	L70	1
34	12346997	12347032	1667	1702	35	RIGHT	L70a.EDF	L70	1
34	12347115	12347133	1785	1803	18	RIGHT	L70a.EDF	L70	1
34	12347160	12347161	1830	1831	1	RIGHT	L70a.EDF	L70	1
34	12347182	12347217	1852	1887	35	RIGHT	L70a.EDF	L70	1
34	12347272	12347274	1942	1944	2	RIGHT	L70a.EDF	L70	1
34	12347319	12347325	1989	1995	6	RIGHT	L70a.EDF	L70	1
34	12347346	12347355	2016	2025	9	RIGHT	L70a.EDF	L70	1
34	12347392	12347392	2062	2062	0	RIGHT	L70a.EDF	L70	1
34	12349252	12349255	3922	3925	3	RIGHT	L70a.EDF	L70	1
34	12349280	12352507	3950	7177	3227	RIGHT	L70a.EDF	L70	1
35	12354318	12354815	57	554	497	RIGHT	L70a.EDF	L70	1
35	12354982	12355600	721	1339	618	RIGHT	L70a.EDF	L70	1
35	12355945	12356258	1684	1997	313	RIGHT	L70a.EDF	L70	1
35	12357490	12359682	3229	5421	2192	RIGHT	L70a.EDF	L70	1
36	12362154	12362399	58	303	245	RIGHT	L70a.EDF	L70	1
36	12362932	12368527	836	6431	5595	RIGHT	L70a.EDF	L70	1
37	12370494	12377153	57	6716	6659	RIGHT	L70a.EDF	L70	1
38	12379288	12381664	57	2433	2376	RIGHT	L70a.EDF	L70	1
38	12381699	12381700	2468	2469	1	RIGHT	L70a.EDF	L70	1
38	12381789	12381944	2558	2713	155	RIGHT	L70a.EDF	L70	1
38	12382349	12382847	3118	3616	498	RIGHT	L70a.EDF	L70	1
38	12382869	12382869	3638	3638	0	RIGHT	L70a.EDF	L70	1
38	12382951	12383060	3720	3829	109	RIGHT	L70a.EDF	L70	1
39	12392363	12392740	4936	5313	377	RIGHT	L70a.EDF	L70	1
39	12392936	12392936	5509	5509	0	RIGHT	L70a.EDF	L70	1
39	12393330	12393805	5903	6378	475	RIGHT	L70a.EDF	L70	1
40	12398867	12399182	58	373	315	RIGHT	L70a.EDF	L70	1
40	12399593	12399652	784	843	59	RIGHT	L70a.EDF	L70	1
40	12399676	12400937	867	2128	1261	RIGHT	L70a.EDF	L70	1
40	12401510	12403979	2701	5170	2469	RIGHT	L70a.EDF	L70	1
41	12406086	12408235	57	2206	2149	RIGHT	L70a.EDF	L70	1
41	12408711	12412395	2682	6366	3684	RIGHT	L70a.EDF	L70	1
42	12414767	12415132	58	423	365	RIGHT	L70a.EDF	L70	1
42	12415167	12415188	458	479	21	RIGHT	L70a.EDF	L70	1
42	12415259	12415259	550	550	0	RIGHT	L70a.EDF	L70	1
42	12415301	12415328	592	619	27	RIGHT	L70a.EDF	L70	1
42	12415352	12415372	643	663	20	RIGHT	L70a.EDF	L70	1
42	12415435	12415674	726	965	239	RIGHT	L70a.EDF	L70	1
42	12415736	12415748	1027	1039	12	RIGHT	L70a.EDF	L70	1
42	12415915	12415915	1206	1206	0	RIGHT	L70a.EDF	L70	1
42	12415956	12416119	1247	1410	163	RIGHT	L70a.EDF	L70	1
42	12416155	12416155	1446	1446	0	RIGHT	L70a.EDF	L70	1
42	12418501	12418505	3792	3796	4	RIGHT	L70a.EDF	L70	1
42	12418560	12418575	3851	3866	15	RIGHT	L70a.EDF	L70	1
42	12418610	12419669	3901	4960	1059	RIGHT	L70a.EDF	L70	1
43	12426463	12427895	3696	5128	1432	RIGHT	L70a.EDF	L70	1
43	12428170	12428177	5403	5410	7	RIGHT	L70a.EDF	L70	1
43	12428257	12428554	5490	5787	297	RIGHT	L70a.EDF	L70	1
44	12430732	12431518	58	844	786	RIGHT	L70a.EDF	L70	1
44	12431542	12432538	868	1864	996	RIGHT	L70a.EDF	L70	1
44	12432563	12432806	1889	2132	243	RIGHT	L70a.EDF	L70	1
44	12433358	12435939	2684	5265	2581	RIGHT	L70a.EDF	L70	1
45	12438734	12442136	57	3459	3402	RIGHT	L70a.EDF	L70	1
45	12442159	12442159	3482	3482	0	RIGHT	L70a.EDF	L70	1
45	12442216	12442218	3539	3541	2	RIGHT	L70a.EDF	L70	1
45	12442256	12442257	3579	3580	1	RIGHT	L70a.EDF	L70	1
45	12442325	12442333	3648	3656	8	RIGHT	L70a.EDF	L70	1
45	12442356	12442359	3679	3682	3	RIGHT	L70a.EDF	L70	1
45	12442419	12442436	3742	3759	17	RIGHT	L70a.EDF	L70	1
45	12442474	12445575	3797	6898	3101	RIGHT	L70a.EDF	L70	1
46	12448454	12448728	58	332	274	RIGHT	L70a.EDF	L70	1
46	12449364	12449366	968	970	2	RIGHT	L70a.EDF	L70	1
46	12449405	12449441	1009	1045	36	RIGHT	L70a.EDF	L70	1
46	12449476	12449498	1080	1102	22	RIGHT	L70a.EDF	L70	1
46	12449601	12449601	1205	1205	0	RIGHT	L70a.EDF	L70	1
46	12450175	12450175	1779	1779	0	RIGHT	L70a.EDF	L70	1
46	12450199	12450504	1803	2108	305	RIGHT	L70a.EDF	L70	1
46	12451553	12455721	3157	7325	4168	RIGHT	L70a.EDF	L70	1
47	12458703	12458820	58	175	117	RIGHT	L70a.EDF	L70	1
47	12458850	12463556	205	4911	4706	RIGHT	L70a.EDF	L70	1
48	12466337	12472802	59	6524	6465	RIGHT	L70a.EDF	L70	1
49	12476061	12481997	58	5994	5936	RIGHT	L70a.EDF	L70	1
50	12486047	12492163	57	6173	6116	RIGHT	L70a.EDF	L70	1
51	12494430	12496738	58	2366	2308	RIGHT	L70a.EDF	L70	1
51	12496777	12496800	2405	2428	23	RIGHT	L70a.EDF	L70	1
51	12496827	12496840	2455	2468	13	RIGHT	L70a.EDF	L70	1
51	12496870	12499698	2498	5326	2828	RIGHT	L70a.EDF	L70	1
52	12502016	12502136	58	178	120	RIGHT	L70a.EDF	L70	1
52	12502514	12504097	556	2139	1583	RIGHT	L70a.EDF	L70	1
52	12506940	12506940	4982	4982	0	RIGHT	L70a.EDF	L70	1
52	12506972	12506978	5014	5020	6	RIGHT	L70a.EDF	L70	1
52	12507046	12507054	5088	5096	8	RIGHT	L70a.EDF	L70	1
52	12507106	12507109	5148	5151	3	RIGHT	L70a.EDF	L70	1
52	12507191	12507206	5233	5248	15	RIGHT	L70a.EDF	L70	1
52	12507231	12507257	5273	5299	26	RIGHT	L70a.EDF	L70	1
52	12507293	12508904	5335	6946	1611	RIGHT	L70a.EDF	L70	1
53	12511535	12513645	57	2167	2110	RIGHT	L70a.EDF	L70	1
53	12514342	12518149	2864	6671	3807	RIGHT	L70a.EDF	L70	1
54	12520186	12526074	58	5946	5888	RIGHT	L70a.EDF	L70	1
55	12529101	12529160	58	117	59	RIGHT	L70a.EDF	L70	1
55	12530664	12530729	1621	1686	65	RIGHT	L70a.EDF	L70	1
55	12532271	12532380	3228	3337	109	RIGHT	L70a.EDF	L70	1
55	12532406	12532457	3363	3414	51	RIGHT	L70a.EDF	L70	1
56	12537938	12540082	69	2213	2144	RIGHT	L70a.EDF	L70	1
56	12540106	12540107	2237	2238	1	RIGHT	L70a.EDF	L70	1
56	12540366	12543955	2497	6086	3589	RIGHT	L70a.EDF	L70	1
57	12546278	12551720	57	5499	5442	RIGHT	L70a.EDF	L70	1
58	12554166	12556002	57	1893	1836	RIGHT	L70a.EDF	L70	1
58	12556577	12560936	2468	6827	4359	RIGHT	L70a.EDF	L70	1
59	12564357	12564394	57	94	37	RIGHT	L70a.EDF	L70	1
59	12564435	12564463	135	163	28	RIGHT	L70a.EDF	L70	1
59	12564731	12564747	431	447	16	RIGHT	L70a.EDF	L70	1
59	12564773	12565679	473	1379	906	RIGHT	L70a.EDF	L70	1
59	12565775	12565808	1475	1508	33	RIGHT	L70a.EDF	L70	1
59	12565862	12565862	1562	1562	0	RIGHT	L70a.EDF	L70	1
59	12566216	12566216	1916	1916	0	RIGHT	L70a.EDF	L70	1
59	12567541	12570132	3241	5832	2591	RIGHT	L70a.EDF	L70	1
60	12572338	12572465	58	185	127	RIGHT	L70a.EDF	L70	1
60	12574784	12575583	2504	3303	799	RIGHT	L70a.EDF	L70	1
60	12577536	12577536	5256	5256	0	RIGHT	L70a.EDF	L70	1
60	12577562	12578340	5282	6060	778	RIGHT	L70a.EDF	L70	1
61	12580430	12583586	57	3213	3156	RIGHT	L70a.EDF	L70	1
61	12583903	12583903	3530	3530	0	RIGHT	L70a.EDF	L70	1
61	12583958	12583969	3585	3596	11	RIGHT	L70a.EDF	L70	1
61	12584020	12584023	3647	3650	3	RIGHT	L70a.EDF	L70	1
61	12584050	12585711	3677	5338	1661	RIGHT	L70a.EDF	L70	1
62	12589112	12594416	57	5361	5304	RIGHT	L70a.EDF	L70	1
63	12596459	12603522	58	7121	7063	RIGHT	L70a.EDF	L70	1
64	12605813	12606379	57	623	566	RIGHT	L70a.EDF	L70	1
64	12606502	12606512	746	756	10	RIGHT	L70a.EDF	L70	1
64	12606533	12607666	777	1910	1133	RIGHT	L70a.EDF	L70	1
64	12608184	12608194	2428	2438	10	RIGHT	L70a.EDF	L70	1
64	12608358	12608377	2602	2621	19	RIGHT	L70a.EDF	L70	1
64	12608399	12608406	2643	2650	7	RIGHT	L70a.EDF	L70	1
64	12608427	12609399	2671	3643	972	RIGHT	L70a.EDF	L70	1
64	12609423	12610686	3667	4930	1263	RIGHT	L70a.EDF	L70	1
65	12614234	12616288	58	2112	2054	RIGHT	L70a.EDF	L70	1
65	12618143	12618144	3967	3968	1	RIGHT	L70a.EDF	L70	1
65	12618195	12618208	4019	4032	13	RIGHT	L70a.EDF	L70	1
65	12618238	12618808	4062	4632	570	RIGHT	L70a.EDF	L70	1
65	12618832	12618847	4656	4671	15	RIGHT	L70a.EDF	L70	1
65	12618895	12620643	4719	6467	1748	RIGHT	L70a.EDF	L70	1
66	12623834	12625100	813	2079	1266	RIGHT	L70a.EDF	L70	1
66	12626093	12626093	3072	3072	0	RIGHT	L70a.EDF	L70	1
66	12626152	12629778	3131	6757	3626	RIGHT	L70a.EDF	L70	1
67	12632601	12634699	58	2156	2098	RIGHT	L70a.EDF	L70	1
67	12635287	12638243	2744	5700	2956	RIGHT	L70a.EDF	L70	1
68	12640915	12643092	58	2235	2177	RIGHT	L70a.EDF	L70	1
68	12643684	12643684	2827	2827	0	RIGHT	L70a.EDF	L70	1
68	12643715	12646999	2858	6142	3284	RIGHT	L70a.EDF	L70	1
69	12648967	12649146	57	236	179	RIGHT	L70a.EDF	L70	1
69	12649170	12649170	260	260	0	RIGHT	L70a.EDF	L70	1
69	12649217	12649217	307	307	0	RIGHT	L70a.EDF	L70	1
69	12649249	12650781	339	1871	1532	RIGHT	L70a.EDF	L70	1
69	12651661	12655394	2751	6484	3733	RIGHT	L70a.EDF	L70	1
70	12657705	12657776	58	129	71	RIGHT	L70a.EDF	L70	1
70	12658132	12658132	485	485	0	RIGHT	L70a.EDF	L70	1
70	12658175	12663889	528	6242	5714	RIGHT	L70a.EDF	L70	1
71	12666089	12670874	58	4843	4785	RIGHT	L70a.EDF	L70	1
72	12674362	12676065	58	1761	1703	RIGHT	L70a.EDF	L70	1
72	12677595	12680869	3291	6565	3274	RIGHT	L70a.EDF	L70	1
73	12683159	12685600	57	2498	2441	RIGHT	L70a.EDF	L70	1
73	12685621	12687954	2519	4852	2333	RIGHT	L70a.EDF	L70	1
74	12691274	12698590	59	7375	7316	RIGHT	L70a.EDF	L70	1
75	12700739	12702668	57	1986	1929	RIGHT	L70a.EDF	L70	1
75	12704065	12706815	3383	6133	2750	RIGHT	L70a.EDF	L70	1
76	12709264	12711060	58	1854	1796	RIGHT	L70a.EDF	L70	1
76	12711993	12713277	2787	4071	1284	RIGHT	L70a.EDF	L70	1
76	12713328	12713335	4122	4129	7	RIGHT	L70a.EDF	L70	1
76	12713362	12713418	4156	4212	56	RIGHT	L70a.EDF	L70	1
76	12713440	12714650	4234	5444	1210	RIGHT	L70a.EDF	L70	1
76	12714696	12714731	5490	5525	35	RIGHT	L70a.EDF	L70	1
76	12714866	12715601	5660	6395	735	RIGHT	L70a.EDF	L70	1
77	12718897	12718897	1347	1347	0	RIGHT	L70a.EDF	L70	1
77	12718942	12718943	1392	1393	1	RIGHT	L70a.EDF	L70	1
77	12718969	12718972	1419	1422	3	RIGHT	L70a.EDF	L70	1
77	12718993	12719870	1443	2320	877	RIGHT	L70a.EDF	L70	1
77	12719969	12719994	2419	2444	25	RIGHT	L70a.EDF	L70	1
77	12720650	12723017	3100	5467	2367	RIGHT	L70a.EDF	L70	1
78	12727703	12729936	58	2291	2233	RIGHT	L70a.EDF	L70	1
78	12730792	12730792	3147	3147	0	RIGHT	L70a.EDF	L70	1
78	12730813	12733272	3168	5627	2459	RIGHT	L70a.EDF	L70	1
79	12735552	12742278	58	6784	6726	RIGHT	L70a.EDF	L70	1
80	12745050	12745705	241	896	655	RIGHT	L70a.EDF	L70	1
80	12745793	12745849	984	1040	56	RIGHT	L70a.EDF	L70	1
80	12745872	12745887	1063	1078	15	RIGHT	L70a.EDF	L70	1
80	12745934	12745938	1125	1129	4	RIGHT	L70a.EDF	L70	1
80	12746601	12746602	1792	1793	1	RIGHT	L70a.EDF	L70	1
80	12746625	12746818	1816	2009	193	RIGHT	L70a.EDF	L70	1
80	12747795	12751463	2986	6654	3668	RIGHT	L70a.EDF	L70	1
81	12753875	12754305	58	488	430	RIGHT	L70a.EDF	L70	1
81	12754352	12754381	535	564	29	RIGHT	L70a.EDF	L70	1
81	12754405	12754406	588	589	1	RIGHT	L70a.EDF	L70	1
81	12754435	12755861	618	2044	1426	RIGHT	L70a.EDF	L70	1
81	12756976	12759228	3159	5411	2252	RIGHT	L70a.EDF	L70	1
82	12761397	12761451	57	111	54	RIGHT	L70a.EDF	L70	1
82	12761618	12762235	278	895	617	RIGHT	L70a.EDF	L70	1
82	12762270	12762272	930	932	2	RIGHT	L70a.EDF	L70	1
82	12762308	12763047	968	1707	739	RIGHT	L70a.EDF	L70	1
82	12766631	12766803	5291	5463	172	RIGHT	L70a.EDF	L70	1
83	12770314	12770314	1578	1578	0	RIGHT	L70a.EDF	L70	1
83	12770340	12770417	1604	1681	77	RIGHT	L70a.EDF	L70	1
83	12771803	12771805	3067	3069	2	RIGHT	L70a.EDF	L70	1
83	12771828	12774067	3092	5331	2239	RIGHT	L70a.EDF	L70	1
84	12776615	12778456	58	1899	1841	RIGHT	L70a.EDF	L70	1
84	12778955	12782482	2398	5925	3527	RIGHT	L70a.EDF	L70	1
84	12782512	12782582	5955	6025	70	RIGHT	L70a.EDF	L70	1
85	12784602	12786765	57	2220	2163	RIGHT	L70a.EDF	L70	1
85	12787281	12789845	2736	5300	2564	RIGHT	L70a.EDF	L70	1
85	12789987	12789988	5442	5443	1	RIGHT	L70a.EDF	L70	1
85	12790462	12791938	5917	7393	1476	RIGHT	L70a.EDF	L70	1
86	12794445	12796362	57	1974	1917	RIGHT	L70a.EDF	L70	1
86	12796399	12796432	2011	2044	33	RIGHT	L70a.EDF	L70	1
86	12796543	12796580	2155	2192	37	RIGHT	L70a.EDF	L70	1
86	12797863	12800433	3475	6045	2570	RIGHT	L70a.EDF	L70	1
87	12802405	12802576	58	229	171	RIGHT	L70a.EDF	L70	1
87	12803866	12804575	1519	2228	709	RIGHT	L70a.EDF	L70	1
87	12805314	12805354	2967	3007	40	RIGHT	L70a.EDF	L70	1
87	12805376	12809469	3029	7122	4093	RIGHT	L70a.EDF	L70	1
88	12811478	12811887	300	709	409	RIGHT	L70a.EDF	L70	1
88	12811913	12811913	735	735	0	RIGHT	L70a.EDF	L70	1
88	12812309	12812311	1131	1133	2	RIGHT	L70a.EDF	L70	1
88	12812339	12813078	1161	1900	739	RIGHT	L70a.EDF	L70	1
88	12814177	12814223	2999	3045	46	RIGHT	L70a.EDF	L70	1
88	12814264	12814264	3086	3086	0	RIGHT	L70a.EDF	L70	1
88	12814313	12814516	3135	3338	203	RIGHT	L70a.EDF	L70	1
88	12814571	12814572	3393	3394	1	RIGHT	L70a.EDF	L70	1
88	12814598	12815370	3420	4192	772	RIGHT	L70a.EDF	L70	1
88	12815552	12816599	4374	5421	1047	RIGHT	L70a.EDF	L70	1
88	12816629	12816664	5451	5486	35	RIGHT	L70a.EDF	L70	1
89	12819347	12819561	57	271	214	RIGHT	L70a.EDF	L70	1
89	12819975	12820517	685	1227	542	RIGHT	L70a.EDF	L70	1
89	12820561	12820561	1271	1271	0	RIGHT	L70a.EDF	L70	1
89	12820621	12820624	1331	1334	3	RIGHT	L70a.EDF	L70	1
89	12820655	12820661	1365	1371	6	RIGHT	L70a.EDF	L70	1
89	12820756	12820756	1466	1466	0	RIGHT	L70a.EDF	L70	1
89	12820787	12821276	1497	1986	489	RIGHT	L70a.EDF	L70	1
89	12821335	12821387	2045	2097	52	RIGHT	L70a.EDF	L70	1
89	12824683	12825349	5393	6059	666	RIGHT	L70a.EDF	L70	1
90	12827869	12829632	58	1821	1763	RIGHT	L70a.EDF	L70	1
90	12829661	12829705	1850	1894	44	RIGHT	L70a.EDF	L70	1
90	12830573	12834454	2762	6643	3881	RIGHT	L70a.EDF	L70	1
91	12836551	12842519	57	6025	5968	RIGHT	L70a.EDF	L70	1
92	12844612	12849884	58	5330	5272	RIGHT	L70a.EDF	L70	1
93	12869450	12875569	57	6176	6119	RIGHT	L70a.EDF	L70	1
94	12877595	12877954	57	416	359	RIGHT	L70a.EDF	L70	1
94	12878482	12884735	944	7197	6253	RIGHT	L70a.EDF	L70	1
95	12887057	12889145	57	2145	2088	RIGHT	L70a.EDF	L70	1
95	12890133	12890383	3133	3383	250	RIGHT	L70a.EDF	L70	1
95	12890421	12892650	3421	5650	2229	RIGHT	L70a.EDF	L70	1
96	12895198	12895940	58	800	742	RIGHT	L70a.EDF	L70	1
96	12896466	12896776	1326	1636	310	RIGHT	L70a.EDF	L70	1
96	12897104	12897105	1964	1965	1	RIGHT	L70a.EDF	L70	1
96	12897157	12897179	2017	2039	22	RIGHT	L70a.EDF	L70	1
96	12897259	12897260	2119	2120	1	RIGHT	L70a.EDF	L70	1
96	12897298	12898421	2158	3281	1123	RIGHT	L70a.EDF	L70	1
96	12898443	12898572	3303	3432	129	RIGHT	L70a.EDF	L70	1
96	12898642	12898707	3502	3567	65	RIGHT	L70a.EDF	L70	1
96	12898751	12898751	3611	3611	0	RIGHT	L70a.EDF	L70	1
96	12898823	12898832	3683	3692	9	RIGHT	L70a.EDF	L70	1
96	12898870	12898911	3730	3771	41	RIGHT	L70a.EDF	L70	1
96	12898946	12898946	3806	3806	0	RIGHT	L70a.EDF	L70	1
96	12898985	12899013	3845	3873	28	RIGHT	L70a.EDF	L70	1
96	12899058	12899084	3918	3944	26	RIGHT	L70a.EDF	L70	1
96	12899106	12899106	3966	3966	0	RIGHT	L70a.EDF	L70	1
96	12899215	12899216	4075	4076	1	RIGHT	L70a.EDF	L70	1
96	12899315	12899337	4175	4197	22	RIGHT	L70a.EDF	L70	1
96	12899365	12899366	4225	4226	1	RIGHT	L70a.EDF	L70	1
96	12899403	12899403	4263	4263	0	RIGHT	L70a.EDF	L70	1
96	12899474	12899474	4334	4334	0	RIGHT	L70a.EDF	L70	1
96	12899560	12899560	4420	4420	0	RIGHT	L70a.EDF	L70	1
96	12899631	12899631	4491	4491	0	RIGHT	L70a.EDF	L70	1
96	12899656	12899658	4516	4518	2	RIGHT	L70a.EDF	L70	1
96	12899785	12899785	4645	4645	0	RIGHT	L70a.EDF	L70	1
96	12899845	12899845	4705	4705	0	RIGHT	L70a.EDF	L70	1
96	12899891	12899905	4751	4765	14	RIGHT	L70a.EDF	L70	1
96	12900535	12900535	5395	5395	0	RIGHT	L70a.EDF	L70	1
96	12900877	12900879	5737	5739	2	RIGHT	L70a.EDF	L70	1
97	12906157	12906157	3323	3323	0	RIGHT	L70a.EDF	L70	1
97	12906195	12906220	3361	3386	25	RIGHT	L70a.EDF	L70	1
97	12906531	12906531	3697	3697	0	RIGHT	L70a.EDF	L70	1
97	12906596	12906604	3762	3770	8	RIGHT	L70a.EDF	L70	1
97	12906883	12906884	4049	4050	1	RIGHT	L70a.EDF	L70	1
97	12907118	12907118	4284	4284	0	RIGHT	L70a.EDF	L70	1
98	12910058	12910144	346	432	86	RIGHT	L70a.EDF	L70	1
98	12910214	12911056	502	1344	842	RIGHT	L70a.EDF	L70	1
98	12911079	12911116	1367	1404	37	RIGHT	L70a.EDF	L70	1
98	12911141	12911208	1429	1496	67	RIGHT	L70a.EDF	L70	1
98	12911237	12911239	1525	1527	2	RIGHT	L70a.EDF	L70	1
98	12911262	12911323	1550	1611	61	RIGHT	L70a.EDF	L70	1
98	12911368	12911372	1656	1660	4	RIGHT	L70a.EDF	L70	1
98	12911424	12911486	1712	1774	62	RIGHT	L70a.EDF	L70	1
98	12912857	12912858	3145	3146	1	RIGHT	L70a.EDF	L70	1
98	12912896	12915434	3184	5722	2538	RIGHT	L70a.EDF	L70	1
99	12918000	12920058	58	2116	2058	RIGHT	L70a.EDF	L70	1
99	12920465	12920487	2523	2545	22	RIGHT	L70a.EDF	L70	1
99	12920511	12920514	2569	2572	3	RIGHT	L70a.EDF	L70	1
99	12921472	12924650	3530	6708	3178	RIGHT	L70a.EDF	L70	1
100	12926538	12926576	58	96	38	RIGHT	L70a.EDF	L70	1
100	12926845	12927127	365	647	282	RIGHT	L70a.EDF	L70	1
100	12927158	12928494	678	2014	1336	RIGHT	L70a.EDF	L70	1
100	12929677	12932265	3197	5785	2588	RIGHT	L70a.EDF	L70	1
101	12934643	12936470	59	1886	1827	RIGHT	L70a.EDF	L70	1
101	12936741	12936742	2157	2158	1	RIGHT	L70a.EDF	L70	1
101	12937379	12939519	2795	4935	2140	RIGHT	L70a.EDF	L70	1
102	12941564	12941564	84	84	0	RIGHT	L70a.EDF	L70	1
102	12941586	12948015	106	6535	6429	RIGHT	L70a.EDF	L70	1
103	12949996	12950029	58	91	33	RIGHT	L70a.EDF	L70	1
103	12950463	12952121	525	2183	1658	RIGHT	L70a.EDF	L70	1
103	12952239	12952248	2301	2310	9	RIGHT	L70a.EDF	L70	1
103	12952273	12952533	2335	2595	260	RIGHT	L70a.EDF	L70	1
103	12952800	12953294	2862	3356	494	RIGHT	L70a.EDF	L70	1
103	12953315	12953315	3377	3377	0	RIGHT	L70a.EDF	L70	1
103	12953730	12954672	3792	4734	942	RIGHT	L70a.EDF	L70	1
103	12954697	12954731	4759	4793	34	RIGHT	L70a.EDF	L70	1
103	12954763	12954776	4825	4838	13	RIGHT	L70a.EDF	L70	1
103	12954803	12955819	4865	5881	1016	RIGHT	L70a.EDF	L70	1
104	12958446	12958490	58	102	44	RIGHT	L70a.EDF	L70	1
104	12959166	12960286	778	1898	1120	RIGHT	L70a.EDF	L70	1
104	12960947	12964184	2559	5796	3237	RIGHT	L70a.EDF	L70	1
105	12967057	12967079	594	616	22	RIGHT	L70a.EDF	L70	1
105	12967114	12967280	651	817	166	RIGHT	L70a.EDF	L70	1
105	12967305	12972029	842	5566	4724	RIGHT	L70a.EDF	L70	1
106	12980435	12980749	5527	5841	314	RIGHT	L70a.EDF	L70	1
106	12981112	12981115	6204	6207	3	RIGHT	L70a.EDF	L70	1
107	12983442	12983991	58	607	549	RIGHT	L70a.EDF	L70	1
107	12984465	12984473	1081	1089	8	RIGHT	L70a.EDF	L70	1
107	12984535	12984944	1151	1560	409	RIGHT	L70a.EDF	L70	1
107	12985009	12985012	1625	1628	3	RIGHT	L70a.EDF	L70	1
107	12985047	12985216	1663	1832	169	RIGHT	L70a.EDF	L70	1
107	12987434	12988682	4050	5298	1248	RIGHT	L70a.EDF	L70	1
107	12988733	12988952	5349	5568	219	RIGHT	L70a.EDF	L70	1
107	12989065	12989067	5681	5683	2	RIGHT	L70a.EDF	L70	1
107	12989110	12989110	5726	5726	0	RIGHT	L70a.EDF	L70	1
107	12989141	12989146	5757	5762	5	RIGHT	L70a.EDF	L70	1
107	12989170	12989171	5786	5787	1	RIGHT	L70a.EDF	L70	1
107	12989202	12989459	5818	6075	257	RIGHT	L70a.EDF	L70	1
108	12992716	12993229	617	1130	513	RIGHT	L70a.EDF	L70	1
108	12996373	12998495	4274	6396	2122	RIGHT	L70a.EDF	L70	1
109	13001263	13002734	57	1528	1471	RIGHT	L70a.EDF	L70	1
109	13002772	13003188	1566	1982	416	RIGHT	L70a.EDF	L70	1
109	13003569	13003599	2363	2393	30	RIGHT	L70a.EDF	L70	1
109	13003653	13004028	2447	2822	375	RIGHT	L70a.EDF	L70	1
109	13004898	13004900	3692	3694	2	RIGHT	L70a.EDF	L70	1
109	13004924	13005690	3718	4484	766	RIGHT	L70a.EDF	L70	1
109	13005711	13006196	4505	4990	485	RIGHT	L70a.EDF	L70	1
109	13006217	13006454	5011	5248	237	RIGHT	L70a.EDF	L70	1
109	13006476	13008132	5270	6926	1656	RIGHT	L70a.EDF	L70	1
110	13010300	13011009	57	766	709	RIGHT	L70a.EDF	L70	1
110	13011085	13012055	842	1812	970	RIGHT	L70a.EDF	L70	1
110	13012928	13015419	2685	5176	2491	RIGHT	L70a.EDF	L70	1
110	13015440	13016907	5197	6664	1467	RIGHT	L70a.EDF	L70	1
111	13018838	13019128	58	348	290	RIGHT	L70a.EDF	L70	1
111	13020461	13020462	1681	1682	1	RIGHT	L70a.EDF	L70	1
111	13020486	13020518	1706	1738	32	RIGHT	L70a.EDF	L70	1
111	13020539	13020582	1759	1802	43	RIGHT	L70a.EDF	L70	1
111	13020605	13020645	1825	1865	40	RIGHT	L70a.EDF	L70	1
111	13022200	13022234	3420	3454	34	RIGHT	L70a.EDF	L70	1
111	13022273	13022822	3493	4042	549	RIGHT	L70a.EDF	L70	1
111	13022843	13023823	4063	5043	980	RIGHT	L70a.EDF	L70	1
111	13023848	13024122	5068	5342	274	RIGHT	L70a.EDF	L70	1
111	13024148	13024151	5368	5371	3	RIGHT	L70a.EDF	L70	1
112	13026813	13026854	58	99	41	RIGHT	L70a.EDF	L70	1
112	13026962	13027140	207	385	178	RIGHT	L70a.EDF	L70	1
112	13027162	13027178	407	423	16	RIGHT	L70a.EDF	L70	1
112	13027271	13027305	516	550	34	RIGHT	L70a.EDF	L70	1
112	13027930	13027941	1175	1186	11	RIGHT	L70a.EDF	L70	1
112	13027975	13028002	1220	1247	27	RIGHT	L70a.EDF	L70	1
112	13028028	13028118	1273	1363	90	RIGHT	L70a.EDF	L70	1
112	13028151	13028158	1396	1403	7	RIGHT	L70a.EDF	L70	1
112	13028211	13028281	1456	1526	70	RIGHT	L70a.EDF	L70	1
112	13028308	13028309	1553	1554	1	RIGHT	L70a.EDF	L70	1
112	13028543	13028543	1788	1788	0	RIGHT	L70a.EDF	L70	1
112	13028659	13028792	1904	2037	133	RIGHT	L70a.EDF	L70	1
112	13029305	13029322	2550	2567	17	RIGHT	L70a.EDF	L70	1
112	13029355	13029833	2600	3078	478	RIGHT	L70a.EDF	L70	1
112	13029884	13029887	3129	3132	3	RIGHT	L70a.EDF	L70	1
112	13029912	13029935	3157	3180	23	RIGHT	L70a.EDF	L70	1
112	13029994	13030023	3239	3268	29	RIGHT	L70a.EDF	L70	1
112	13030044	13030045	3289	3290	1	RIGHT	L70a.EDF	L70	1
112	13030073	13030093	3318	3338	20	RIGHT	L70a.EDF	L70	1
112	13030205	13030220	3450	3465	15	RIGHT	L70a.EDF	L70	1
112	13030243	13030317	3488	3562	74	RIGHT	L70a.EDF	L70	1
112	13030353	13030354	3598	3599	1	RIGHT	L70a.EDF	L70	1
112	13030378	13030456	3623	3701	78	RIGHT	L70a.EDF	L70	1
112	13030497	13030540	3742	3785	43	RIGHT	L70a.EDF	L70	1
112	13030564	13030575	3809	3820	11	RIGHT	L70a.EDF	L70	1
112	13030604	13030797	3849	4042	193	RIGHT	L70a.EDF	L70	1
112	13030818	13031169	4063	4414	351	RIGHT	L70a.EDF	L70	1
112	13031252	13031260	4497	4505	8	RIGHT	L70a.EDF	L70	1
112	13031833	13031833	5078	5078	0	RIGHT	L70a.EDF	L70	1
112	13032118	13032132	5363	5377	14	RIGHT	L70a.EDF	L70	1
112	13032230	13032234	5475	5479	4	RIGHT	L70a.EDF	L70	1
112	13032292	13032308	5537	5553	16	RIGHT	L70a.EDF	L70	1
112	13032338	13032361	5583	5606	23	RIGHT	L70a.EDF	L70	1
112	13032394	13032434	5639	5679	40	RIGHT	L70a.EDF	L70	1
112	13032542	13032542	5787	5787	0	RIGHT	L70a.EDF	L70	1
112	13033627	13033627	6872	6872	0	RIGHT	L70a.EDF	L70	1
113	13036824	13037132	1027	1335	308	RIGHT	L70a.EDF	L70	1
113	13037230	13037275	1433	1478	45	RIGHT	L70a.EDF	L70	1
113	13037307	13037321	1510	1524	14	RIGHT	L70a.EDF	L70	1
113	13037344	13037540	1547	1743	196	RIGHT	L70a.EDF	L70	1
113	13037631	13037663	1834	1866	32	RIGHT	L70a.EDF	L70	1
113	13037799	13038419	2002	2622	620	RIGHT	L70a.EDF	L70	1
113	13038552	13038946	2755	3149	394	RIGHT	L70a.EDF	L70	1
113	13039131	13039209	3334	3412	78	RIGHT	L70a.EDF	L70	1
113	13039243	13039357	3446	3560	114	RIGHT	L70a.EDF	L70	1
113	13039442	13041326	3645	5529	1884	RIGHT	L70a.EDF	L70	1
113	13041360	13041368	5563	5571	8	RIGHT	L70a.EDF	L70	1
113	13041437	13041441	5640	5644	4	RIGHT	L70a.EDF	L70	1
113	13041564	13041694	5767	5897	130	RIGHT	L70a.EDF	L70	1
113	13041725	13041743	5928	5946	18	RIGHT	L70a.EDF	L70	1
113	13041779	13041802	5982	6005	23	RIGHT	L70a.EDF	L70	1
114	13046070	13046070	1198	1198	0	RIGHT	L70a.EDF	L70	1
114	13046100	13046374	1228	1502	274	RIGHT	L70a.EDF	L70	1
114	13046538	13046538	1666	1666	0	RIGHT	L70a.EDF	L70	1
114	13046609	13046939	1737	2067	330	RIGHT	L70a.EDF	L70	1
114	13047816	13048582	2944	3710	766	RIGHT	L70a.EDF	L70	1
114	13048711	13048716	3839	3844	5	RIGHT	L70a.EDF	L70	1
114	13048805	13048805	3933	3933	0	RIGHT	L70a.EDF	L70	1
114	13049018	13049045	4146	4173	27	RIGHT	L70a.EDF	L70	1
114	13049151	13049152	4279	4280	1	RIGHT	L70a.EDF	L70	1
114	13049226	13049228	4354	4356	2	RIGHT	L70a.EDF	L70	1
114	13049356	13049357	4484	4485	1	RIGHT	L70a.EDF	L70	1
114	13049617	13049624	4745	4752	7	RIGHT	L70a.EDF	L70	1
114	13049686	13049686	4814	4814	0	RIGHT	L70a.EDF	L70	1
114	13050621	13050622	5749	5750	1	RIGHT	L70a.EDF	L70	1
115	13054495	13054495	1899	1899	0	RIGHT	L70a.EDF	L70	1
115	13054535	13054535	1939	1939	0	RIGHT	L70a.EDF	L70	1
115	13054567	13054651	1971	2055	84	RIGHT	L70a.EDF	L70	1
115	13054675	13054680	2079	2084	5	RIGHT	L70a.EDF	L70	1
115	13055012	13055748	2416	3152	736	RIGHT	L70a.EDF	L70	1
115	13056309	13056333	3713	3737	24	RIGHT	L70a.EDF	L70	1
115	13056365	13056435	3769	3839	70	RIGHT	L70a.EDF	L70	1
115	13058082	13058085	5486	5489	3	RIGHT	L70a.EDF	L70	1
115	13058173	13058176	5577	5580	3	RIGHT	L70a.EDF	L70	1
116	13059973	13060403	58	488	430	RIGHT	L70a.EDF	L70	1
116	13060772	13061044	857	1129	272	RIGHT	L70a.EDF	L70	1
116	13061126	13061132	1211	1217	6	RIGHT	L70a.EDF	L70	1
116	13061255	13061256	1340	1341	1	RIGHT	L70a.EDF	L70	1
116	13061318	13061334	1403	1419	16	RIGHT	L70a.EDF	L70	1
116	13061367	13061368	1452	1453	1	RIGHT	L70a.EDF	L70	1
116	13061405	13061441	1490	1526	36	RIGHT	L70a.EDF	L70	1
116	13061475	13061487	1560	1572	12	RIGHT	L70a.EDF	L70	1
116	13061647	13061687	1732	1772	40	RIGHT	L70a.EDF	L70	1
116	13061725	13061725	1810	1810	0	RIGHT	L70a.EDF	L70	1
116	13061773	13061774	1858	1859	1	RIGHT	L70a.EDF	L70	1
116	13061797	13061945	1882	2030	148	RIGHT	L70a.EDF	L70	1
116	13062504	13067008	2589	7093	4504	RIGHT	L70a.EDF	L70	1
117	13070107	13070566	58	517	459	RIGHT	L70a.EDF	L70	1
117	13070588	13070654	539	605	66	RIGHT	L70a.EDF	L70	1
117	13070683	13070987	634	938	304	RIGHT	L70a.EDF	L70	1
117	13071014	13071744	965	1695	730	RIGHT	L70a.EDF	L70	1
117	13071774	13071933	1725	1884	159	RIGHT	L70a.EDF	L70	1
117	13073540	13073540	3491	3491	0	RIGHT	L70a.EDF	L70	1
117	13073586	13073588	3537	3539	2	RIGHT	L70a.EDF	L70	1
117	13073778	13073845	3729	3796	67	RIGHT	L70a.EDF	L70	1
117	13073871	13074026	3822	3977	155	RIGHT	L70a.EDF	L70	1
117	13074059	13074198	4010	4149	139	RIGHT	L70a.EDF	L70	1
117	13074275	13074282	4226	4233	7	RIGHT	L70a.EDF	L70	1
117	13074336	13074461	4287	4412	125	RIGHT	L70a.EDF	L70	1
117	13074482	13074511	4433	4462	29	RIGHT	L70a.EDF	L70	1
117	13074548	13074548	4499	4499	0	RIGHT	L70a.EDF	L70	1
117	13074578	13074589	4529	4540	11	RIGHT	L70a.EDF	L70	1
117	13074650	13075064	4601	5015	414	RIGHT	L70a.EDF	L70	1
117	13075086	13075131	5037	5082	45	RIGHT	L70a.EDF	L70	1
117	13075153	13075217	5104	5168	64	RIGHT	L70a.EDF	L70	1
117	13075257	13075289	5208	5240	32	RIGHT	L70a.EDF	L70	1
117	13075330	13075393	5281	5344	63	RIGHT	L70a.EDF	L70	1
118	13077941	13078040	58	157	99	RIGHT	L70a.EDF	L70	1
118	13078128	13078151	245	268	23	RIGHT	L70a.EDF	L70	1
118	13080703	13081181	2820	3298	478	RIGHT	L70a.EDF	L70	1
118	13081202	13081248	3319	3365	46	RIGHT	L70a.EDF	L70	1
118	13081312	13081338	3429	3455	26	RIGHT	L70a.EDF	L70	1
118	13081363	13081409	3480	3526	46	RIGHT	L70a.EDF	L70	1
118	13081432	13081434	3549	3551	2	RIGHT	L70a.EDF	L70	1
118	13081455	13081465	3572	3582	10	RIGHT	L70a.EDF	L70	1
118	13081526	13081526	3643	3643	0	RIGHT	L70a.EDF	L70	1
118	13081554	13081570	3671	3687	16	RIGHT	L70a.EDF	L70	1
118	13081623	13081623	3740	3740	0	RIGHT	L70a.EDF	L70	1
118	13081653	13081659	3770	3776	6	RIGHT	L70a.EDF	L70	1
118	13081704	13081704	3821	3821	0	RIGHT	L70a.EDF	L70	1
118	13081782	13081783	3899	3900	1	RIGHT	L70a.EDF	L70	1
118	13081846	13081893	3963	4010	47	RIGHT	L70a.EDF	L70	1
118	13081977	13082026	4094	4143	49	RIGHT	L70a.EDF	L70	1
118	13082047	13082047	4164	4164	0	RIGHT	L70a.EDF	L70	1
118	13082158	13082180	4275	4297	22	RIGHT	L70a.EDF	L70	1
118	13082224	13082263	4341	4380	39	RIGHT	L70a.EDF	L70	1
118	13082289	13082289	4406	4406	0	RIGHT	L70a.EDF	L70	1
118	13082312	13082409	4429	4526	97	RIGHT	L70a.EDF	L70	1
118	13082612	13082613	4729	4730	1	RIGHT	L70a.EDF	L70	1
118	13082641	13082641	4758	4758	0	RIGHT	L70a.EDF	L70	1
118	13082944	13083191	5061	5308	247	RIGHT	L70a.EDF	L70	1
119	13086284	13086284	271	271	0	RIGHT	L70a.EDF	L70	1
119	13086321	13086615	308	602	294	RIGHT	L70a.EDF	L70	1
119	13086670	13086670	657	657	0	RIGHT	L70a.EDF	L70	1
119	13089545	13091743	3532	5730	2198	RIGHT	L70a.EDF	L70	1
120	13094129	13094460	76	407	331	RIGHT	L70a.EDF	L70	1
120	13094734	13096539	681	2486	1805	RIGHT	L70a.EDF	L70	1
120	13098801	13098817	4748	4764	16	RIGHT	L70a.EDF	L70	1
120	13098838	13099748	4785	5695	910	RIGHT	L70a.EDF	L70	1
120	13100048	13100050	5995	5997	2	RIGHT	L70a.EDF	L70	1
120	13100079	13101169	6026	7116	1090	RIGHT	L70a.EDF	L70	1
1	14156907	14156915	1135	1143	8	RIGHT	L70b.EDF	L70	2
1	14156940	14157101	1168	1329	161	RIGHT	L70b.EDF	L70	2
1	14160169	14160169	4397	4397	0	RIGHT	L70b.EDF	L70	2
1	14160204	14160225	4432	4453	21	RIGHT	L70b.EDF	L70	2
1	14160264	14161801	4492	6029	1537	RIGHT	L70b.EDF	L70	2
1	14161824	14163094	6052	7322	1270	RIGHT	L70b.EDF	L70	2
2	14165748	14166398	57	707	650	RIGHT	L70b.EDF	L70	2
2	14166554	14166554	863	863	0	RIGHT	L70b.EDF	L70	2
2	14166584	14166594	893	903	10	RIGHT	L70b.EDF	L70	2
2	14166623	14166677	932	986	54	RIGHT	L70b.EDF	L70	2
2	14166707	14167204	1016	1513	497	RIGHT	L70b.EDF	L70	2
2	14167235	14167236	1544	1545	1	RIGHT	L70b.EDF	L70	2
2	14167329	14167329	1638	1638	0	RIGHT	L70b.EDF	L70	2
2	14167352	14167358	1661	1667	6	RIGHT	L70b.EDF	L70	2
2	14167409	14167424	1718	1733	15	RIGHT	L70b.EDF	L70	2
2	14167471	14167563	1780	1872	92	RIGHT	L70b.EDF	L70	2
2	14167964	14168402	2273	2711	438	RIGHT	L70b.EDF	L70	2
2	14168437	14168454	2746	2763	17	RIGHT	L70b.EDF	L70	2
2	14168477	14168477	2786	2786	0	RIGHT	L70b.EDF	L70	2
2	14168515	14168516	2824	2825	1	RIGHT	L70b.EDF	L70	2
2	14168706	14168720	3015	3029	14	RIGHT	L70b.EDF	L70	2
2	14168814	14168816	3123	3125	2	RIGHT	L70b.EDF	L70	2
2	14168860	14168870	3169	3179	10	RIGHT	L70b.EDF	L70	2
2	14168894	14168918	3203	3227	24	RIGHT	L70b.EDF	L70	2
2	14169110	14169110	3419	3419	0	RIGHT	L70b.EDF	L70	2
2	14169339	14169339	3648	3648	0	RIGHT	L70b.EDF	L70	2
3	14175826	14175997	57	228	171	RIGHT	L70b.EDF	L70	2
3	14176090	14176150	321	381	60	RIGHT	L70b.EDF	L70	2
3	14176174	14176321	405	552	147	RIGHT	L70b.EDF	L70	2
3	14176376	14176409	607	640	33	RIGHT	L70b.EDF	L70	2
3	14176443	14176444	674	675	1	RIGHT	L70b.EDF	L70	2
3	14176487	14176493	718	724	6	RIGHT	L70b.EDF	L70	2
3	14176606	14176606	837	837	0	RIGHT	L70b.EDF	L70	2
3	14176710	14176710	941	941	0	RIGHT	L70b.EDF	L70	2
3	14176991	14177246	1222	1477	255	RIGHT	L70b.EDF	L70	2
3	14177386	14177387	1617	1618	1	RIGHT	L70b.EDF	L70	2
3	14179369	14180068	3600	4299	699	RIGHT	L70b.EDF	L70	2
3	14180090	14180174	4321	4405	84	RIGHT	L70b.EDF	L70	2
3	14180200	14180210	4431	4441	10	RIGHT	L70b.EDF	L70	2
3	14180254	14180254	4485	4485	0	RIGHT	L70b.EDF	L70	2
3	14180276	14180284	4507	4515	8	RIGHT	L70b.EDF	L70	2
3	14180308	14180327	4539	4558	19	RIGHT	L70b.EDF	L70	2
3	14180351	14180383	4582	4614	32	RIGHT	L70b.EDF	L70	2
3	14180450	14180656	4681	4887	206	RIGHT	L70b.EDF	L70	2
3	14180677	14181004	4908	5235	327	RIGHT	L70b.EDF	L70	2
3	14181057	14181065	5288	5296	8	RIGHT	L70b.EDF	L70	2
3	14181088	14181199	5319	5430	111	RIGHT	L70b.EDF	L70	2
3	14181270	14181272	5501	5503	2	RIGHT	L70b.EDF	L70	2
3	14181295	14181578	5526	5809	283	RIGHT	L70b.EDF	L70	2
3	14181606	14181610	5837	5841	4	RIGHT	L70b.EDF	L70	2
4	14186011	14186858	57	904	847	RIGHT	L70b.EDF	L70	2
4	14186982	14187010	1028	1056	28	RIGHT	L70b.EDF	L70	2
4	14187183	14187183	1229	1229	0	RIGHT	L70b.EDF	L70	2
4	14187227	14187261	1273	1307	34	RIGHT	L70b.EDF	L70	2
4	14187288	14187308	1334	1354	20	RIGHT	L70b.EDF	L70	2
4	14187340	14187340	1386	1386	0	RIGHT	L70b.EDF	L70	2
4	14187362	14187364	1408	1410	2	RIGHT	L70b.EDF	L70	2
4	14187386	14187388	1432	1434	2	RIGHT	L70b.EDF	L70	2
4	14187415	14187438	1461	1484	23	RIGHT	L70b.EDF	L70	2
4	14187485	14187554	1531	1600	69	RIGHT	L70b.EDF	L70	2
4	14187673	14188036	1719	2082	363	RIGHT	L70b.EDF	L70	2
4	14189406	14189412	3452	3458	6	RIGHT	L70b.EDF	L70	2
4	14189946	14189946	3992	3992	0	RIGHT	L70b.EDF	L70	2
4	14189967	14189969	4013	4015	2	RIGHT	L70b.EDF	L70	2
4	14190093	14190093	4139	4139	0	RIGHT	L70b.EDF	L70	2
4	14190132	14190138	4178	4184	6	RIGHT	L70b.EDF	L70	2
4	14190184	14190184	4230	4230	0	RIGHT	L70b.EDF	L70	2
4	14190305	14190333	4351	4379	28	RIGHT	L70b.EDF	L70	2
4	14190430	14190431	4476	4477	1	RIGHT	L70b.EDF	L70	2
4	14190452	14190485	4498	4531	33	RIGHT	L70b.EDF	L70	2
4	14191586	14191587	5632	5633	1	RIGHT	L70b.EDF	L70	2
4	14191749	14191782	5795	5828	33	RIGHT	L70b.EDF	L70	2
4	14191856	14191917	5902	5963	61	RIGHT	L70b.EDF	L70	2
4	14191947	14191985	5993	6031	38	RIGHT	L70b.EDF	L70	2
4	14192020	14192023	6066	6069	3	RIGHT	L70b.EDF	L70	2
4	14192106	14192107	6152	6153	1	RIGHT	L70b.EDF	L70	2
4	14192321	14192321	6367	6367	0	RIGHT	L70b.EDF	L70	2
4	14192357	14192357	6403	6403	0	RIGHT	L70b.EDF	L70	2
5	14195789	14196052	295	558	263	RIGHT	L70b.EDF	L70	2
5	14199525	14199579	4031	4085	54	RIGHT	L70b.EDF	L70	2
5	14200300	14200351	4806	4857	51	RIGHT	L70b.EDF	L70	2
5	14200375	14200410	4881	4916	35	RIGHT	L70b.EDF	L70	2
5	14200435	14200446	4941	4952	11	RIGHT	L70b.EDF	L70	2
5	14200467	14200507	4973	5013	40	RIGHT	L70b.EDF	L70	2
5	14200546	14200560	5052	5066	14	RIGHT	L70b.EDF	L70	2
5	14200581	14200665	5087	5171	84	RIGHT	L70b.EDF	L70	2
5	14200706	14200738	5212	5244	32	RIGHT	L70b.EDF	L70	2
5	14200770	14201205	5276	5711	435	RIGHT	L70b.EDF	L70	2
6	14204377	14204596	58	277	219	RIGHT	L70b.EDF	L70	2
6	14206161	14206161	1842	1842	0	RIGHT	L70b.EDF	L70	2
6	14207756	14207780	3437	3461	24	RIGHT	L70b.EDF	L70	2
6	14207804	14210423	3485	6104	2619	RIGHT	L70b.EDF	L70	2
7	14213663	14213979	57	373	316	RIGHT	L70b.EDF	L70	2
7	14217633	14217633	4027	4027	0	RIGHT	L70b.EDF	L70	2
7	14217692	14218670	4086	5064	978	RIGHT	L70b.EDF	L70	2
7	14218693	14218992	5087	5386	299	RIGHT	L70b.EDF	L70	2
7	14219022	14219022	5416	5416	0	RIGHT	L70b.EDF	L70	2
7	14219044	14219088	5438	5482	44	RIGHT	L70b.EDF	L70	2
8	14221628	14221770	58	200	142	RIGHT	L70b.EDF	L70	2
8	14221848	14221894	278	324	46	RIGHT	L70b.EDF	L70	2
8	14222316	14222325	746	755	9	RIGHT	L70b.EDF	L70	2
8	14222350	14222619	780	1049	269	RIGHT	L70b.EDF	L70	2
8	14222771	14222772	1201	1202	1	RIGHT	L70b.EDF	L70	2
8	14222998	14223246	1428	1676	248	RIGHT	L70b.EDF	L70	2
8	14223325	14223533	1755	1963	208	RIGHT	L70b.EDF	L70	2
8	14223576	14223848	2006	2278	272	RIGHT	L70b.EDF	L70	2
8	14224152	14227261	2582	5691	3109	RIGHT	L70b.EDF	L70	2
8	14227290	14227353	5720	5783	63	RIGHT	L70b.EDF	L70	2
8	14227383	14227727	5813	6157	344	RIGHT	L70b.EDF	L70	2
8	14227776	14227840	6206	6270	64	RIGHT	L70b.EDF	L70	2
8	14227864	14228033	6294	6463	169	RIGHT	L70b.EDF	L70	2
9	14230433	14231124	58	749	691	RIGHT	L70b.EDF	L70	2
9	14231172	14232226	797	1851	1054	RIGHT	L70b.EDF	L70	2
9	14232288	14235188	1913	4813	2900	RIGHT	L70b.EDF	L70	2
10	14237098	14237192	58	152	94	RIGHT	L70b.EDF	L70	2
10	14240027	14243022	2987	5982	2995	RIGHT	L70b.EDF	L70	2
11	14246455	14246489	58	92	34	RIGHT	L70b.EDF	L70	2
11	14246523	14246558	126	161	35	RIGHT	L70b.EDF	L70	2
11	14246579	14247064	182	667	485	RIGHT	L70b.EDF	L70	2
11	14247098	14247848	701	1451	750	RIGHT	L70b.EDF	L70	2
11	14247870	14247903	1473	1506	33	RIGHT	L70b.EDF	L70	2
11	14247934	14248504	1537	2107	570	RIGHT	L70b.EDF	L70	2
11	14248568	14248614	2171	2217	46	RIGHT	L70b.EDF	L70	2
11	14248638	14248640	2241	2243	2	RIGHT	L70b.EDF	L70	2
11	14248677	14248678	2280	2281	1	RIGHT	L70b.EDF	L70	2
11	14248709	14248781	2312	2384	72	RIGHT	L70b.EDF	L70	2
11	14248827	14252989	2430	6592	4162	RIGHT	L70b.EDF	L70	2
12	14258193	14258204	2981	2992	11	RIGHT	L70b.EDF	L70	2
12	14258227	14258410	3015	3198	183	RIGHT	L70b.EDF	L70	2
12	14258458	14258581	3246	3369	123	RIGHT	L70b.EDF	L70	2
12	14259898	14260143	4686	4931	245	RIGHT	L70b.EDF	L70	2
14	14270026	14270111	58	143	85	RIGHT	L70b.EDF	L70	2
14	14275581	14275683	5613	5715	102	RIGHT	L70b.EDF	L70	2
15	14277961	14278295	57	391	334	RIGHT	L70b.EDF	L70	2
15	14278490	14278862	586	958	372	RIGHT	L70b.EDF	L70	2
15	14278883	14280000	979	2096	1117	RIGHT	L70b.EDF	L70	2
15	14280677	14284160	2773	6256	3483	RIGHT	L70b.EDF	L70	2
16	14287406	14288003	58	655	597	RIGHT	L70b.EDF	L70	2
16	14288058	14288110	710	762	52	RIGHT	L70b.EDF	L70	2
16	14293613	14293626	6265	6278	13	RIGHT	L70b.EDF	L70	2
16	14293687	14293785	6339	6437	98	RIGHT	L70b.EDF	L70	2
16	14293807	14293923	6459	6575	116	RIGHT	L70b.EDF	L70	2
17	14299202	14299458	2969	3225	256	RIGHT	L70b.EDF	L70	2
18	14304471	14305299	57	885	828	RIGHT	L70b.EDF	L70	2
18	14307769	14309153	3355	4739	1384	RIGHT	L70b.EDF	L70	2
19	14311504	14311887	479	862	383	RIGHT	L70b.EDF	L70	2
19	14315081	14315108	4056	4083	27	RIGHT	L70b.EDF	L70	2
19	14315132	14315132	4107	4107	0	RIGHT	L70b.EDF	L70	2
19	14315155	14317538	4130	6513	2383	RIGHT	L70b.EDF	L70	2
20	14320377	14320416	729	768	39	RIGHT	L70b.EDF	L70	2
20	14320450	14320454	802	806	4	RIGHT	L70b.EDF	L70	2
20	14323024	14323265	3376	3617	241	RIGHT	L70b.EDF	L70	2
20	14323300	14323335	3652	3687	35	RIGHT	L70b.EDF	L70	2
20	14325510	14325510	5862	5862	0	RIGHT	L70b.EDF	L70	2
20	14325541	14325593	5893	5945	52	RIGHT	L70b.EDF	L70	2
21	14327643	14328100	177	634	457	RIGHT	L70b.EDF	L70	2
21	14328235	14328728	769	1262	493	RIGHT	L70b.EDF	L70	2
21	14328891	14328945	1425	1479	54	RIGHT	L70b.EDF	L70	2
21	14329246	14329335	1780	1869	89	RIGHT	L70b.EDF	L70	2
21	14330152	14330152	2686	2686	0	RIGHT	L70b.EDF	L70	2
21	14330501	14330502	3035	3036	1	RIGHT	L70b.EDF	L70	2
21	14330615	14332651	3149	5185	2036	RIGHT	L70b.EDF	L70	2
21	14332676	14332880	5210	5414	204	RIGHT	L70b.EDF	L70	2
21	14332909	14332912	5443	5446	3	RIGHT	L70b.EDF	L70	2
21	14333125	14333162	5659	5696	37	RIGHT	L70b.EDF	L70	2
21	14333202	14334309	5736	6843	1107	RIGHT	L70b.EDF	L70	2
22	14336632	14337341	59	768	709	RIGHT	L70b.EDF	L70	2
22	14337861	14338708	1288	2135	847	RIGHT	L70b.EDF	L70	2
22	14339916	14341657	3343	5084	1741	RIGHT	L70b.EDF	L70	2
23	14344642	14345164	58	580	522	RIGHT	L70b.EDF	L70	2
23	14349868	14350163	5284	5579	295	RIGHT	L70b.EDF	L70	2
24	14354950	14355406	1468	1924	456	RIGHT	L70b.EDF	L70	2
24	14357480	14357480	3998	3998	0	RIGHT	L70b.EDF	L70	2
24	14357525	14357552	4043	4070	27	RIGHT	L70b.EDF	L70	2
24	14357581	14357687	4099	4205	106	RIGHT	L70b.EDF	L70	2
24	14357709	14358043	4227	4561	334	RIGHT	L70b.EDF	L70	2
24	14358085	14358095	4603	4613	10	RIGHT	L70b.EDF	L70	2
24	14358217	14358217	4735	4735	0	RIGHT	L70b.EDF	L70	2
24	14358247	14358998	4765	5516	751	RIGHT	L70b.EDF	L70	2
24	14359209	14359209	5727	5727	0	RIGHT	L70b.EDF	L70	2
24	14359262	14359268	5780	5786	6	RIGHT	L70b.EDF	L70	2
24	14359320	14359321	5838	5839	1	RIGHT	L70b.EDF	L70	2
24	14359371	14359741	5889	6259	370	RIGHT	L70b.EDF	L70	2
24	14359764	14359764	6282	6282	0	RIGHT	L70b.EDF	L70	2
24	14359786	14360206	6304	6724	420	RIGHT	L70b.EDF	L70	2
25	14363224	14363773	310	859	549	RIGHT	L70b.EDF	L70	2
25	14363795	14364362	881	1448	567	RIGHT	L70b.EDF	L70	2
25	14364388	14364389	1474	1475	1	RIGHT	L70b.EDF	L70	2
25	14364507	14364509	1593	1595	2	RIGHT	L70b.EDF	L70	2
25	14364534	14364538	1620	1624	4	RIGHT	L70b.EDF	L70	2
25	14364562	14364563	1648	1649	1	RIGHT	L70b.EDF	L70	2
25	14364590	14364590	1676	1676	0	RIGHT	L70b.EDF	L70	2
25	14364617	14364643	1703	1729	26	RIGHT	L70b.EDF	L70	2
25	14364672	14364762	1758	1848	90	RIGHT	L70b.EDF	L70	2
25	14364783	14365077	1869	2163	294	RIGHT	L70b.EDF	L70	2
25	14365776	14368370	2862	5456	2594	RIGHT	L70b.EDF	L70	2
26	14372950	14373235	1220	1505	285	RIGHT	L70b.EDF	L70	2
26	14373257	14373422	1527	1692	165	RIGHT	L70b.EDF	L70	2
26	14374021	14374035	2291	2305	14	RIGHT	L70b.EDF	L70	2
26	14376163	14378496	4433	6766	2333	RIGHT	L70b.EDF	L70	2
27	14381527	14382517	371	1361	990	RIGHT	L70b.EDF	L70	2
27	14382538	14383135	1382	1979	597	RIGHT	L70b.EDF	L70	2
27	14383181	14383188	2025	2032	7	RIGHT	L70b.EDF	L70	2
27	14383219	14383320	2063	2164	101	RIGHT	L70b.EDF	L70	2
27	14383822	14383850	2666	2694	28	RIGHT	L70b.EDF	L70	2
27	14383872	14383875	2716	2719	3	RIGHT	L70b.EDF	L70	2
27	14383942	14383970	2786	2814	28	RIGHT	L70b.EDF	L70	2
27	14383995	14386331	2839	5175	2336	RIGHT	L70b.EDF	L70	2
28	14388908	14388963	372	427	55	RIGHT	L70b.EDF	L70	2
28	14388987	14389041	451	505	54	RIGHT	L70b.EDF	L70	2
28	14389080	14389129	544	593	49	RIGHT	L70b.EDF	L70	2
28	14393215	14393575	4679	5039	360	RIGHT	L70b.EDF	L70	2
28	14393627	14393635	5091	5099	8	RIGHT	L70b.EDF	L70	2
29	14397313	14397340	58	85	27	RIGHT	L70b.EDF	L70	2
29	14397696	14398099	441	844	403	RIGHT	L70b.EDF	L70	2
30	14406800	14407127	1115	1442	327	RIGHT	L70b.EDF	L70	2
30	14410307	14410309	4622	4624	2	RIGHT	L70b.EDF	L70	2
31	14415074	14415319	1075	1320	245	RIGHT	L70b.EDF	L70	2
31	14415375	14415471	1376	1472	96	RIGHT	L70b.EDF	L70	2
31	14416859	14420492	2860	6493	3633	RIGHT	L70b.EDF	L70	2
32	14422555	14423446	57	948	891	RIGHT	L70b.EDF	L70	2
32	14423467	14423960	969	1462	493	RIGHT	L70b.EDF	L70	2
32	14427896	14427972	5398	5474	76	RIGHT	L70b.EDF	L70	2
32	14428012	14428657	5514	6159	645	RIGHT	L70b.EDF	L70	2
33	14431104	14431699	58	653	595	RIGHT	L70b.EDF	L70	2
33	14432533	14432954	1487	1908	421	RIGHT	L70b.EDF	L70	2
33	14434337	14434843	3291	3797	506	RIGHT	L70b.EDF	L70	2
34	14439494	14439878	58	442	384	RIGHT	L70b.EDF	L70	2
34	14444223	14445918	4787	6482	1695	RIGHT	L70b.EDF	L70	2
35	14448237	14448345	58	166	108	RIGHT	L70b.EDF	L70	2
35	14448575	14449031	396	852	456	RIGHT	L70b.EDF	L70	2
35	14449820	14449989	1641	1810	169	RIGHT	L70b.EDF	L70	2
35	14451003	14452902	2824	4723	1899	RIGHT	L70b.EDF	L70	2
36	14458495	14458903	3802	4210	408	RIGHT	L70b.EDF	L70	2
36	14458936	14458937	4243	4244	1	RIGHT	L70b.EDF	L70	2
36	14458962	14458967	4269	4274	5	RIGHT	L70b.EDF	L70	2
36	14459172	14461737	4479	7044	2565	RIGHT	L70b.EDF	L70	2
37	14463696	14463715	58	77	19	RIGHT	L70b.EDF	L70	2
37	14466981	14469702	3343	6064	2721	RIGHT	L70b.EDF	L70	2
38	14471501	14471569	58	126	68	RIGHT	L70b.EDF	L70	2
39	14479714	14479832	58	176	118	RIGHT	L70b.EDF	L70	2
39	14481343	14481655	1687	1999	312	RIGHT	L70b.EDF	L70	2
39	14481890	14482516	2234	2860	626	RIGHT	L70b.EDF	L70	2
39	14483286	14484851	3630	5195	1565	RIGHT	L70b.EDF	L70	2
40	14486921	14487026	57	162	105	RIGHT	L70b.EDF	L70	2
40	14490674	14492174	3810	5310	1500	RIGHT	L70b.EDF	L70	2
40	14492257	14492659	5393	5795	402	RIGHT	L70b.EDF	L70	2
40	14493979	14493988	7115	7124	9	RIGHT	L70b.EDF	L70	2
40	14494012	14494097	7148	7233	85	RIGHT	L70b.EDF	L70	2
41	14496478	14496761	58	341	283	RIGHT	L70b.EDF	L70	2
41	14497004	14497027	584	607	23	RIGHT	L70b.EDF	L70	2
41	14497749	14498386	1329	1966	637	RIGHT	L70b.EDF	L70	2
41	14499338	14499363	2918	2943	25	RIGHT	L70b.EDF	L70	2
41	14499505	14500267	3085	3847	762	RIGHT	L70b.EDF	L70	2
41	14500822	14500822	4402	4402	0	RIGHT	L70b.EDF	L70	2
41	14500856	14503313	4436	6893	2457	RIGHT	L70b.EDF	L70	2
42	14508150	14511568	3100	6518	3418	RIGHT	L70b.EDF	L70	2
43	14514134	14514840	57	763	706	RIGHT	L70b.EDF	L70	2
43	14515134	14515134	1057	1057	0	RIGHT	L70b.EDF	L70	2
43	14515248	14515345	1171	1268	97	RIGHT	L70b.EDF	L70	2
43	14515367	14515408	1290	1331	41	RIGHT	L70b.EDF	L70	2
43	14515438	14515489	1361	1412	51	RIGHT	L70b.EDF	L70	2
43	14515535	14515535	1458	1458	0	RIGHT	L70b.EDF	L70	2
43	14516043	14516051	1966	1974	8	RIGHT	L70b.EDF	L70	2
43	14517084	14520834	3007	6757	3750	RIGHT	L70b.EDF	L70	2
44	14524785	14524823	1481	1519	38	RIGHT	L70b.EDF	L70	2
44	14524850	14524872	1546	1568	22	RIGHT	L70b.EDF	L70	2
44	14524909	14524916	1605	1612	7	RIGHT	L70b.EDF	L70	2
44	14526034	14530319	2730	7015	4285	RIGHT	L70b.EDF	L70	2
45	14532766	14532920	58	212	154	RIGHT	L70b.EDF	L70	2
45	14536322	14536622	3614	3914	300	RIGHT	L70b.EDF	L70	2
45	14536701	14536701	3993	3993	0	RIGHT	L70b.EDF	L70	2
46	14539942	14540053	58	169	111	RIGHT	L70b.EDF	L70	2
46	14543805	14543963	3921	4079	158	RIGHT	L70b.EDF	L70	2
46	14543984	14546760	4100	6876	2776	RIGHT	L70b.EDF	L70	2
48	14558347	14558512	1731	1896	165	RIGHT	L70b.EDF	L70	2
48	14559144	14559518	2528	2902	374	RIGHT	L70b.EDF	L70	2
48	14561077	14561107	4461	4491	30	RIGHT	L70b.EDF	L70	2
48	14561131	14561659	4515	5043	528	RIGHT	L70b.EDF	L70	2
49	14564146	14564476	124	454	330	RIGHT	L70b.EDF	L70	2
49	14565179	14569774	1157	5752	4595	RIGHT	L70b.EDF	L70	2
50	14571844	14571867	58	81	23	RIGHT	L70b.EDF	L70	2
50	14573311	14573311	1525	1525	0	RIGHT	L70b.EDF	L70	2
50	14573342	14573371	1556	1585	29	RIGHT	L70b.EDF	L70	2
50	14573406	14573488	1620	1702	82	RIGHT	L70b.EDF	L70	2
50	14573984	14574014	2198	2228	30	RIGHT	L70b.EDF	L70	2
50	14574251	14574300	2465	2514	49	RIGHT	L70b.EDF	L70	2
50	14575341	14577068	3555	5282	1727	RIGHT	L70b.EDF	L70	2
51	14579578	14580161	76	659	583	RIGHT	L70b.EDF	L70	2
51	14582422	14586164	2920	6662	3742	RIGHT	L70b.EDF	L70	2
52	14588303	14588375	57	129	72	RIGHT	L70b.EDF	L70	2
52	14589953	14590442	1707	2196	489	RIGHT	L70b.EDF	L70	2
52	14591105	14593179	2859	4933	2074	RIGHT	L70b.EDF	L70	2
53	14595762	14596121	792	1151	359	RIGHT	L70b.EDF	L70	2
53	14599108	14599108	4138	4138	0	RIGHT	L70b.EDF	L70	2
53	14599147	14599147	4177	4177	0	RIGHT	L70b.EDF	L70	2
53	14599192	14600553	4222	5583	1361	RIGHT	L70b.EDF	L70	2
54	14607927	14608211	5761	6045	284	RIGHT	L70b.EDF	L70	2
55	14612133	14612379	1013	1259	246	RIGHT	L70b.EDF	L70	2
55	14612410	14612467	1290	1347	57	RIGHT	L70b.EDF	L70	2
55	14616441	14616465	5321	5345	24	RIGHT	L70b.EDF	L70	2
55	14616503	14616514	5383	5394	11	RIGHT	L70b.EDF	L70	2
55	14616567	14617133	5447	6013	566	RIGHT	L70b.EDF	L70	2
56	14618876	14620148	57	1329	1272	RIGHT	L70b.EDF	L70	2
56	14620189	14620217	1370	1398	28	RIGHT	L70b.EDF	L70	2
56	14620247	14620270	1428	1451	23	RIGHT	L70b.EDF	L70	2
56	14620305	14620310	1486	1491	5	RIGHT	L70b.EDF	L70	2
56	14620335	14620360	1516	1541	25	RIGHT	L70b.EDF	L70	2
56	14620395	14620398	1576	1579	3	RIGHT	L70b.EDF	L70	2
56	14620424	14620448	1605	1629	24	RIGHT	L70b.EDF	L70	2
56	14620485	14620591	1666	1772	106	RIGHT	L70b.EDF	L70	2
56	14621904	14622594	3085	3775	690	RIGHT	L70b.EDF	L70	2
56	14623150	14624381	4331	5562	1231	RIGHT	L70b.EDF	L70	2
56	14624891	14625367	6072	6548	476	RIGHT	L70b.EDF	L70	2
57	14627732	14628247	142	657	515	RIGHT	L70b.EDF	L70	2
57	14628304	14628335	714	745	31	RIGHT	L70b.EDF	L70	2
57	14628356	14628703	766	1113	347	RIGHT	L70b.EDF	L70	2
57	14633738	14633831	6148	6241	93	RIGHT	L70b.EDF	L70	2
57	14634182	14634404	6592	6814	222	RIGHT	L70b.EDF	L70	2
58	14637103	14637374	200	471	271	RIGHT	L70b.EDF	L70	2
58	14637685	14638537	782	1634	852	RIGHT	L70b.EDF	L70	2
58	14638618	14638874	1715	1971	256	RIGHT	L70b.EDF	L70	2
58	14639391	14643219	2488	6316	3828	RIGHT	L70b.EDF	L70	2
59	14645448	14645875	58	485	427	RIGHT	L70b.EDF	L70	2
59	14646047	14646048	657	658	1	RIGHT	L70b.EDF	L70	2
59	14646094	14646095	704	705	1	RIGHT	L70b.EDF	L70	2
59	14646143	14647485	753	2095	1342	RIGHT	L70b.EDF	L70	2
59	14647925	14650853	2535	5463	2928	RIGHT	L70b.EDF	L70	2
60	14655014	14655475	1446	1907	461	RIGHT	L70b.EDF	L70	2
60	14656108	14656109	2540	2541	1	RIGHT	L70b.EDF	L70	2
60	14656130	14660109	2562	6541	3979	RIGHT	L70b.EDF	L70	2
61	14662260	14664187	57	1984	1927	RIGHT	L70b.EDF	L70	2
61	14665647	14668244	3444	6041	2597	RIGHT	L70b.EDF	L70	2
62	14669907	14674776	58	4927	4869	RIGHT	L70b.EDF	L70	2
62	14674797	14674886	4948	5037	89	RIGHT	L70b.EDF	L70	2
62	14674910	14674924	5061	5075	14	RIGHT	L70b.EDF	L70	2
62	14674956	14674957	5107	5108	1	RIGHT	L70b.EDF	L70	2
62	14674993	14675076	5144	5227	83	RIGHT	L70b.EDF	L70	2
62	14675343	14675407	5494	5558	64	RIGHT	L70b.EDF	L70	2
62	14675436	14676591	5587	6742	1155	RIGHT	L70b.EDF	L70	2
62	14676631	14676631	6782	6782	0	RIGHT	L70b.EDF	L70	2
63	14678863	14679877	359	1373	1014	RIGHT	L70b.EDF	L70	2
63	14679940	14680145	1436	1641	205	RIGHT	L70b.EDF	L70	2
63	14680279	14684024	1775	5520	3745	RIGHT	L70b.EDF	L70	2
64	14686065	14692168	57	6160	6103	RIGHT	L70b.EDF	L70	2
64	14692191	14692270	6183	6262	79	RIGHT	L70b.EDF	L70	2
65	14694322	14699040	58	4776	4718	RIGHT	L70b.EDF	L70	2
65	14699071	14699165	4807	4901	94	RIGHT	L70b.EDF	L70	2
65	14699751	14699751	5487	5487	0	RIGHT	L70b.EDF	L70	2
65	14699834	14700477	5570	6213	643	RIGHT	L70b.EDF	L70	2
65	14700502	14700601	6238	6337	99	RIGHT	L70b.EDF	L70	2
65	14700633	14700731	6369	6467	98	RIGHT	L70b.EDF	L70	2
65	14700767	14700854	6503	6590	87	RIGHT	L70b.EDF	L70	2
65	14700891	14701054	6627	6790	163	RIGHT	L70b.EDF	L70	2
66	14703135	14703761	72	698	626	RIGHT	L70b.EDF	L70	2
66	14703784	14703784	721	721	0	RIGHT	L70b.EDF	L70	2
66	14703816	14704924	753	1861	1108	RIGHT	L70b.EDF	L70	2
66	14706165	14706683	3102	3620	518	RIGHT	L70b.EDF	L70	2
66	14706711	14706878	3648	3815	167	RIGHT	L70b.EDF	L70	2
66	14706904	14706914	3841	3851	10	RIGHT	L70b.EDF	L70	2
66	14706937	14706938	3874	3875	1	RIGHT	L70b.EDF	L70	2
66	14706967	14706989	3904	3926	22	RIGHT	L70b.EDF	L70	2
66	14707035	14707036	3972	3973	1	RIGHT	L70b.EDF	L70	2
66	14707064	14707064	4001	4001	0	RIGHT	L70b.EDF	L70	2
66	14707193	14707193	4130	4130	0	RIGHT	L70b.EDF	L70	2
66	14707235	14707255	4172	4192	20	RIGHT	L70b.EDF	L70	2
66	14707290	14707290	4227	4227	0	RIGHT	L70b.EDF	L70	2
66	14707312	14707356	4249	4293	44	RIGHT	L70b.EDF	L70	2
66	14707425	14707425	4362	4362	0	RIGHT	L70b.EDF	L70	2
66	14707468	14707470	4405	4407	2	RIGHT	L70b.EDF	L70	2
66	14707946	14707946	4883	4883	0	RIGHT	L70b.EDF	L70	2
66	14707969	14707972	4906	4909	3	RIGHT	L70b.EDF	L70	2
66	14708050	14708179	4987	5116	129	RIGHT	L70b.EDF	L70	2
66	14708202	14708202	5139	5139	0	RIGHT	L70b.EDF	L70	2
66	14708501	14708501	5438	5438	0	RIGHT	L70b.EDF	L70	2
66	14708564	14708580	5501	5517	16	RIGHT	L70b.EDF	L70	2
66	14708605	14708643	5542	5580	38	RIGHT	L70b.EDF	L70	2
66	14708664	14708827	5601	5764	163	RIGHT	L70b.EDF	L70	2
66	14708854	14708953	5791	5890	99	RIGHT	L70b.EDF	L70	2
66	14708979	14709194	5916	6131	215	RIGHT	L70b.EDF	L70	2
66	14709240	14709295	6177	6232	55	RIGHT	L70b.EDF	L70	2
66	14709324	14709340	6261	6277	16	RIGHT	L70b.EDF	L70	2
66	14709363	14709380	6300	6317	17	RIGHT	L70b.EDF	L70	2
66	14709420	14709423	6357	6360	3	RIGHT	L70b.EDF	L70	2
66	14709495	14709496	6432	6433	1	RIGHT	L70b.EDF	L70	2
66	14709525	14709525	6462	6462	0	RIGHT	L70b.EDF	L70	2
66	14709549	14709660	6486	6597	111	RIGHT	L70b.EDF	L70	2
66	14709686	14709710	6623	6647	24	RIGHT	L70b.EDF	L70	2
66	14709734	14709776	6671	6713	42	RIGHT	L70b.EDF	L70	2
66	14709830	14709835	6767	6772	5	RIGHT	L70b.EDF	L70	2
66	14709882	14709900	6819	6837	18	RIGHT	L70b.EDF	L70	2
66	14709977	14709997	6914	6934	20	RIGHT	L70b.EDF	L70	2
66	14710077	14710079	7014	7016	2	RIGHT	L70b.EDF	L70	2
66	14710119	14710136	7056	7073	17	RIGHT	L70b.EDF	L70	2
67	14714503	14714504	2070	2071	1	RIGHT	L70b.EDF	L70	2
68	14722186	14722330	58	202	144	RIGHT	L70b.EDF	L70	2
68	14722478	14722557	350	429	79	RIGHT	L70b.EDF	L70	2
68	14723286	14723286	1158	1158	0	RIGHT	L70b.EDF	L70	2
68	14723314	14723845	1186	1717	531	RIGHT	L70b.EDF	L70	2
68	14723947	14723977	1819	1849	30	RIGHT	L70b.EDF	L70	2
68	14725978	14726075	3850	3947	97	RIGHT	L70b.EDF	L70	2
68	14726118	14726390	3990	4262	272	RIGHT	L70b.EDF	L70	2
68	14726422	14726897	4294	4769	475	RIGHT	L70b.EDF	L70	2
68	14726960	14727058	4832	4930	98	RIGHT	L70b.EDF	L70	2
68	14727091	14727091	4963	4963	0	RIGHT	L70b.EDF	L70	2
68	14727144	14727201	5016	5073	57	RIGHT	L70b.EDF	L70	2
68	14727225	14727313	5097	5185	88	RIGHT	L70b.EDF	L70	2
68	14727334	14727738	5206	5610	404	RIGHT	L70b.EDF	L70	2
68	14727843	14727855	5715	5727	12	RIGHT	L70b.EDF	L70	2
68	14727898	14727898	5770	5770	0	RIGHT	L70b.EDF	L70	2
68	14727924	14727939	5796	5811	15	RIGHT	L70b.EDF	L70	2
68	14727995	14727995	5867	5867	0	RIGHT	L70b.EDF	L70	2
68	14728084	14728094	5956	5966	10	RIGHT	L70b.EDF	L70	2
68	14728158	14728160	6030	6032	2	RIGHT	L70b.EDF	L70	2
68	14728183	14728185	6055	6057	2	RIGHT	L70b.EDF	L70	2
68	14728233	14728280	6105	6152	47	RIGHT	L70b.EDF	L70	2
68	14728306	14728356	6178	6228	50	RIGHT	L70b.EDF	L70	2
68	14728388	14728468	6260	6340	80	RIGHT	L70b.EDF	L70	2
68	14728504	14728528	6376	6400	24	RIGHT	L70b.EDF	L70	2
68	14728560	14728588	6432	6460	28	RIGHT	L70b.EDF	L70	2
68	14728624	14728633	6496	6505	9	RIGHT	L70b.EDF	L70	2
68	14728683	14728684	6555	6556	1	RIGHT	L70b.EDF	L70	2
68	14728730	14728732	6602	6604	2	RIGHT	L70b.EDF	L70	2
69	14730651	14730693	57	99	42	RIGHT	L70b.EDF	L70	2
69	14731645	14731646	1051	1052	1	RIGHT	L70b.EDF	L70	2
69	14731706	14732304	1112	1710	598	RIGHT	L70b.EDF	L70	2
69	14732337	14732627	1743	2033	290	RIGHT	L70b.EDF	L70	2
69	14732692	14732722	2098	2128	30	RIGHT	L70b.EDF	L70	2
69	14733353	14733785	2759	3191	432	RIGHT	L70b.EDF	L70	2
69	14733892	14733895	3298	3301	3	RIGHT	L70b.EDF	L70	2
69	14733952	14733957	3358	3363	5	RIGHT	L70b.EDF	L70	2
69	14733988	14734017	3394	3423	29	RIGHT	L70b.EDF	L70	2
69	14734040	14734059	3446	3465	19	RIGHT	L70b.EDF	L70	2
69	14734083	14734083	3489	3489	0	RIGHT	L70b.EDF	L70	2
69	14734159	14734166	3565	3572	7	RIGHT	L70b.EDF	L70	2
69	14734300	14734300	3706	3706	0	RIGHT	L70b.EDF	L70	2
69	14735040	14735056	4446	4462	16	RIGHT	L70b.EDF	L70	2
69	14735213	14735227	4619	4633	14	RIGHT	L70b.EDF	L70	2
69	14735256	14735260	4662	4666	4	RIGHT	L70b.EDF	L70	2
69	14735286	14735286	4692	4692	0	RIGHT	L70b.EDF	L70	2
69	14735381	14735382	4787	4788	1	RIGHT	L70b.EDF	L70	2
69	14735416	14735434	4822	4840	18	RIGHT	L70b.EDF	L70	2
69	14735456	14735468	4862	4874	12	RIGHT	L70b.EDF	L70	2
70	14738084	14738084	95	95	0	RIGHT	L70b.EDF	L70	2
70	14738120	14738154	131	165	34	RIGHT	L70b.EDF	L70	2
70	14741171	14741199	3182	3210	28	RIGHT	L70b.EDF	L70	2
70	14741224	14741712	3235	3723	488	RIGHT	L70b.EDF	L70	2
70	14741733	14741839	3744	3850	106	RIGHT	L70b.EDF	L70	2
70	14741861	14741873	3872	3884	12	RIGHT	L70b.EDF	L70	2
70	14741897	14741910	3908	3921	13	RIGHT	L70b.EDF	L70	2
70	14741935	14741989	3946	4000	54	RIGHT	L70b.EDF	L70	2
70	14742019	14742020	4030	4031	1	RIGHT	L70b.EDF	L70	2
70	14742058	14742262	4069	4273	204	RIGHT	L70b.EDF	L70	2
70	14742287	14742287	4298	4298	0	RIGHT	L70b.EDF	L70	2
70	14742384	14742425	4395	4436	41	RIGHT	L70b.EDF	L70	2
70	14742446	14742487	4457	4498	41	RIGHT	L70b.EDF	L70	2
70	14742511	14742531	4522	4542	20	RIGHT	L70b.EDF	L70	2
70	14742609	14742644	4620	4655	35	RIGHT	L70b.EDF	L70	2
70	14742685	14742706	4696	4717	21	RIGHT	L70b.EDF	L70	2
70	14742727	14742776	4738	4787	49	RIGHT	L70b.EDF	L70	2
70	14742839	14742917	4850	4928	78	RIGHT	L70b.EDF	L70	2
70	14742950	14742968	4961	4979	18	RIGHT	L70b.EDF	L70	2
70	14743030	14743030	5041	5041	0	RIGHT	L70b.EDF	L70	2
70	14743135	14743136	5146	5147	1	RIGHT	L70b.EDF	L70	2
70	14743192	14743213	5203	5224	21	RIGHT	L70b.EDF	L70	2
70	14743244	14743257	5255	5268	13	RIGHT	L70b.EDF	L70	2
71	14745755	14745987	551	783	232	RIGHT	L70b.EDF	L70	2
71	14749577	14749647	4373	4443	70	RIGHT	L70b.EDF	L70	2
71	14749677	14750086	4473	4882	409	RIGHT	L70b.EDF	L70	2
71	14750118	14750125	4914	4921	7	RIGHT	L70b.EDF	L70	2
71	14750152	14750192	4948	4988	40	RIGHT	L70b.EDF	L70	2
71	14750214	14750219	5010	5015	5	RIGHT	L70b.EDF	L70	2
71	14750266	14750395	5062	5191	129	RIGHT	L70b.EDF	L70	2
72	14754812	14754817	2519	2524	5	RIGHT	L70b.EDF	L70	2
72	14754851	14754858	2558	2565	7	RIGHT	L70b.EDF	L70	2
72	14755762	14755833	3469	3540	71	RIGHT	L70b.EDF	L70	2
72	14755862	14755865	3569	3572	3	RIGHT	L70b.EDF	L70	2
72	14755919	14755946	3626	3653	27	RIGHT	L70b.EDF	L70	2
72	14755981	14755982	3688	3689	1	RIGHT	L70b.EDF	L70	2
72	14756594	14756594	4301	4301	0	RIGHT	L70b.EDF	L70	2
72	14756872	14756872	4579	4579	0	RIGHT	L70b.EDF	L70	2
72	14756958	14756960	4665	4667	2	RIGHT	L70b.EDF	L70	2
72	14757153	14757153	4860	4860	0	RIGHT	L70b.EDF	L70	2
72	14757180	14757180	4887	4887	0	RIGHT	L70b.EDF	L70	2
72	14757231	14757232	4938	4939	1	RIGHT	L70b.EDF	L70	2
72	14757256	14757259	4963	4966	3	RIGHT	L70b.EDF	L70	2
72	14757297	14757300	5004	5007	3	RIGHT	L70b.EDF	L70	2
72	14757482	14757504	5189	5211	22	RIGHT	L70b.EDF	L70	2
72	14757573	14757573	5280	5280	0	RIGHT	L70b.EDF	L70	2
72	14757638	14757684	5345	5391	46	RIGHT	L70b.EDF	L70	2
72	14757716	14757793	5423	5500	77	RIGHT	L70b.EDF	L70	2
72	14757853	14757862	5560	5569	9	RIGHT	L70b.EDF	L70	2
72	14757883	14757943	5590	5650	60	RIGHT	L70b.EDF	L70	2
72	14757971	14757979	5678	5686	8	RIGHT	L70b.EDF	L70	2
72	14758005	14758014	5712	5721	9	RIGHT	L70b.EDF	L70	2
72	14758036	14758036	5743	5743	0	RIGHT	L70b.EDF	L70	2
72	14758215	14758770	5922	6477	555	RIGHT	L70b.EDF	L70	2
73	14762997	14763176	1013	1192	179	RIGHT	L70b.EDF	L70	2
73	14763253	14763306	1269	1322	53	RIGHT	L70b.EDF	L70	2
73	14763507	14763537	1523	1553	30	RIGHT	L70b.EDF	L70	2
74	14769424	14769427	95	98	3	RIGHT	L70b.EDF	L70	2
74	14769889	14770120	560	791	231	RIGHT	L70b.EDF	L70	2
74	14773339	14773341	4010	4012	2	RIGHT	L70b.EDF	L70	2
75	14778956	14781345	3133	5522	2389	RIGHT	L70b.EDF	L70	2
75	14781578	14781578	5755	5755	0	RIGHT	L70b.EDF	L70	2
75	14781603	14781771	5780	5948	168	RIGHT	L70b.EDF	L70	2
75	14781793	14781821	5970	5998	28	RIGHT	L70b.EDF	L70	2
75	14781853	14781854	6030	6031	1	RIGHT	L70b.EDF	L70	2
75	14781876	14781880	6053	6057	4	RIGHT	L70b.EDF	L70	2
75	14781911	14781914	6088	6091	3	RIGHT	L70b.EDF	L70	2
75	14782003	14782022	6180	6199	19	RIGHT	L70b.EDF	L70	2
75	14782075	14782077	6252	6254	2	RIGHT	L70b.EDF	L70	2
75	14782098	14782132	6275	6309	34	RIGHT	L70b.EDF	L70	2
75	14782154	14782182	6331	6359	28	RIGHT	L70b.EDF	L70	2
75	14782205	14782277	6382	6454	72	RIGHT	L70b.EDF	L70	2
75	14782307	14782331	6484	6508	24	RIGHT	L70b.EDF	L70	2
75	14782354	14782377	6531	6554	23	RIGHT	L70b.EDF	L70	2
75	14782419	14782488	6596	6665	69	RIGHT	L70b.EDF	L70	2
75	14782509	14782511	6686	6688	2	RIGHT	L70b.EDF	L70	2
75	14782551	14782552	6728	6729	1	RIGHT	L70b.EDF	L70	2
75	14782603	14782613	6780	6790	10	RIGHT	L70b.EDF	L70	2
75	14782634	14782636	6811	6813	2	RIGHT	L70b.EDF	L70	2
75	14782677	14782716	6854	6893	39	RIGHT	L70b.EDF	L70	2
75	14782747	14782757	6924	6934	10	RIGHT	L70b.EDF	L70	2
75	14782796	14782806	6973	6983	10	RIGHT	L70b.EDF	L70	2
76	14786136	14786182	58	104	46	RIGHT	L70b.EDF	L70	2
76	14786241	14786286	163	208	45	RIGHT	L70b.EDF	L70	2
76	14786319	14786332	241	254	13	RIGHT	L70b.EDF	L70	2
76	14788634	14789910	2556	3832	1276	RIGHT	L70b.EDF	L70	2
76	14790298	14790623	4220	4545	325	RIGHT	L70b.EDF	L70	2
76	14790718	14790718	4640	4640	0	RIGHT	L70b.EDF	L70	2
76	14790876	14790876	4798	4798	0	RIGHT	L70b.EDF	L70	2
76	14790907	14791725	4829	5647	818	RIGHT	L70b.EDF	L70	2
76	14791760	14791908	5682	5830	148	RIGHT	L70b.EDF	L70	2
76	14791964	14791970	5886	5892	6	RIGHT	L70b.EDF	L70	2
76	14791996	14791998	5918	5920	2	RIGHT	L70b.EDF	L70	2
76	14792021	14792078	5943	6000	57	RIGHT	L70b.EDF	L70	2
76	14792104	14792166	6026	6088	62	RIGHT	L70b.EDF	L70	2
76	14792187	14792251	6109	6173	64	RIGHT	L70b.EDF	L70	2
76	14792275	14792277	6197	6199	2	RIGHT	L70b.EDF	L70	2
76	14792299	14792340	6221	6262	41	RIGHT	L70b.EDF	L70	2
76	14792383	14792487	6305	6409	104	RIGHT	L70b.EDF	L70	2
76	14792526	14792631	6448	6553	105	RIGHT	L70b.EDF	L70	2
77	14795619	14796152	58	591	533	RIGHT	L70b.EDF	L70	2
77	14796185	14796264	624	703	79	RIGHT	L70b.EDF	L70	2
77	14796948	14797242	1387	1681	294	RIGHT	L70b.EDF	L70	2
77	14797387	14797389	1826	1828	2	RIGHT	L70b.EDF	L70	2
77	14797615	14797665	2054	2104	50	RIGHT	L70b.EDF	L70	2
77	14798389	14798389	2828	2828	0	RIGHT	L70b.EDF	L70	2
77	14798421	14798909	2860	3348	488	RIGHT	L70b.EDF	L70	2
77	14798930	14799046	3369	3485	116	RIGHT	L70b.EDF	L70	2
77	14799069	14799107	3508	3546	38	RIGHT	L70b.EDF	L70	2
77	14799131	14799183	3570	3622	52	RIGHT	L70b.EDF	L70	2
77	14799320	14799321	3759	3760	1	RIGHT	L70b.EDF	L70	2
77	14799360	14799362	3799	3801	2	RIGHT	L70b.EDF	L70	2
77	14799543	14799543	3982	3982	0	RIGHT	L70b.EDF	L70	2
77	14799592	14799592	4031	4031	0	RIGHT	L70b.EDF	L70	2
77	14799748	14799749	4187	4188	1	RIGHT	L70b.EDF	L70	2
77	14799773	14799790	4212	4229	17	RIGHT	L70b.EDF	L70	2
77	14799824	14799889	4263	4328	65	RIGHT	L70b.EDF	L70	2
77	14799915	14800066	4354	4505	151	RIGHT	L70b.EDF	L70	2
77	14800087	14800745	4526	5184	658	RIGHT	L70b.EDF	L70	2
77	14800773	14800825	5212	5264	52	RIGHT	L70b.EDF	L70	2
77	14801048	14801049	5487	5488	1	RIGHT	L70b.EDF	L70	2
77	14801100	14801131	5539	5570	31	RIGHT	L70b.EDF	L70	2
77	14801166	14801183	5605	5622	17	RIGHT	L70b.EDF	L70	2
77	14801205	14801270	5644	5709	65	RIGHT	L70b.EDF	L70	2
77	14801294	14801297	5733	5736	3	RIGHT	L70b.EDF	L70	2
78	14804937	14805239	1594	1896	302	RIGHT	L70b.EDF	L70	2
78	14805312	14805355	1969	2012	43	RIGHT	L70b.EDF	L70	2
78	14805378	14805399	2035	2056	21	RIGHT	L70b.EDF	L70	2
78	14806234	14806532	2891	3189	298	RIGHT	L70b.EDF	L70	2
78	14806557	14806594	3214	3251	37	RIGHT	L70b.EDF	L70	2
78	14806617	14806851	3274	3508	234	RIGHT	L70b.EDF	L70	2
78	14806908	14806908	3565	3565	0	RIGHT	L70b.EDF	L70	2
78	14806956	14806958	3613	3615	2	RIGHT	L70b.EDF	L70	2
78	14807000	14807010	3657	3667	10	RIGHT	L70b.EDF	L70	2
78	14807224	14807229	3881	3886	5	RIGHT	L70b.EDF	L70	2
78	14807285	14807286	3942	3943	1	RIGHT	L70b.EDF	L70	2
78	14807329	14807957	3986	4614	628	RIGHT	L70b.EDF	L70	2
78	14807979	14808001	4636	4658	22	RIGHT	L70b.EDF	L70	2
78	14808080	14808136	4737	4793	56	RIGHT	L70b.EDF	L70	2
78	14808158	14808160	4815	4817	2	RIGHT	L70b.EDF	L70	2
78	14808202	14808234	4859	4891	32	RIGHT	L70b.EDF	L70	2
78	14808261	14808364	4918	5021	103	RIGHT	L70b.EDF	L70	2
78	14808386	14808567	5043	5224	181	RIGHT	L70b.EDF	L70	2
78	14808607	14808617	5264	5274	10	RIGHT	L70b.EDF	L70	2
78	14808813	14808936	5470	5593	123	RIGHT	L70b.EDF	L70	2
78	14808996	14809042	5653	5699	46	RIGHT	L70b.EDF	L70	2
78	14809328	14809782	5985	6439	454	RIGHT	L70b.EDF	L70	2
79	14812868	14813550	57	739	682	RIGHT	L70b.EDF	L70	2
79	14817281	14817454	4470	4643	173	RIGHT	L70b.EDF	L70	2
80	14821494	14821599	58	163	105	RIGHT	L70b.EDF	L70	2
80	14821627	14821627	191	191	0	RIGHT	L70b.EDF	L70	2
80	14821648	14821648	212	212	0	RIGHT	L70b.EDF	L70	2
80	14821790	14821793	354	357	3	RIGHT	L70b.EDF	L70	2
80	14821891	14821892	455	456	1	RIGHT	L70b.EDF	L70	2
80	14821961	14821962	525	526	1	RIGHT	L70b.EDF	L70	2
80	14822908	14822921	1472	1485	13	RIGHT	L70b.EDF	L70	2
80	14823030	14823311	1594	1875	281	RIGHT	L70b.EDF	L70	2
80	14823448	14823448	2012	2012	0	RIGHT	L70b.EDF	L70	2
80	14823517	14824040	2081	2604	523	RIGHT	L70b.EDF	L70	2
80	14824126	14824127	2690	2691	1	RIGHT	L70b.EDF	L70	2
80	14824179	14824179	2743	2743	0	RIGHT	L70b.EDF	L70	2
80	14824225	14824230	2789	2794	5	RIGHT	L70b.EDF	L70	2
80	14824261	14826073	2825	4637	1812	RIGHT	L70b.EDF	L70	2
81	14828280	14828449	57	226	169	RIGHT	L70b.EDF	L70	2
81	14828477	14829170	254	947	693	RIGHT	L70b.EDF	L70	2
81	14829400	14829727	1177	1504	327	RIGHT	L70b.EDF	L70	2
81	14829752	14829907	1529	1684	155	RIGHT	L70b.EDF	L70	2
81	14829929	14830092	1706	1869	163	RIGHT	L70b.EDF	L70	2
81	14830309	14830309	2086	2086	0	RIGHT	L70b.EDF	L70	2
81	14830393	14830409	2170	2186	16	RIGHT	L70b.EDF	L70	2
81	14830437	14830439	2214	2216	2	RIGHT	L70b.EDF	L70	2
81	14830486	14830506	2263	2283	20	RIGHT	L70b.EDF	L70	2
81	14830680	14830689	2457	2466	9	RIGHT	L70b.EDF	L70	2
81	14830711	14830711	2488	2488	0	RIGHT	L70b.EDF	L70	2
81	14830775	14830775	2552	2552	0	RIGHT	L70b.EDF	L70	2
81	14830846	14830863	2623	2640	17	RIGHT	L70b.EDF	L70	2
81	14830889	14830906	2666	2683	17	RIGHT	L70b.EDF	L70	2
81	14830941	14830941	2718	2718	0	RIGHT	L70b.EDF	L70	2
81	14830973	14831042	2750	2819	69	RIGHT	L70b.EDF	L70	2
81	14831080	14831082	2857	2859	2	RIGHT	L70b.EDF	L70	2
81	14831104	14831134	2881	2911	30	RIGHT	L70b.EDF	L70	2
81	14831159	14831219	2936	2996	60	RIGHT	L70b.EDF	L70	2
81	14831242	14835287	3019	7064	4045	RIGHT	L70b.EDF	L70	2
82	14837248	14837334	57	143	86	RIGHT	L70b.EDF	L70	2
82	14838175	14839531	984	2340	1356	RIGHT	L70b.EDF	L70	2
82	14839733	14839741	2542	2550	8	RIGHT	L70b.EDF	L70	2
82	14839767	14839792	2576	2601	25	RIGHT	L70b.EDF	L70	2
82	14839847	14839859	2656	2668	12	RIGHT	L70b.EDF	L70	2
82	14839929	14839958	2738	2767	29	RIGHT	L70b.EDF	L70	2
82	14840003	14842392	2812	5201	2389	RIGHT	L70b.EDF	L70	2
83	14844799	14850548	57	5806	5749	RIGHT	L70b.EDF	L70	2
84	14852532	14859522	57	7047	6990	RIGHT	L70b.EDF	L70	2
85	14862231	14862751	57	577	520	RIGHT	L70b.EDF	L70	2
85	14862784	14862793	610	619	9	RIGHT	L70b.EDF	L70	2
85	14862833	14862833	659	659	0	RIGHT	L70b.EDF	L70	2
85	14862880	14862920	706	746	40	RIGHT	L70b.EDF	L70	2
85	14862943	14862947	769	773	4	RIGHT	L70b.EDF	L70	2
85	14862980	14862982	806	808	2	RIGHT	L70b.EDF	L70	2
85	14863008	14863049	834	875	41	RIGHT	L70b.EDF	L70	2
85	14863086	14863087	912	913	1	RIGHT	L70b.EDF	L70	2
85	14863109	14863152	935	978	43	RIGHT	L70b.EDF	L70	2
85	14863191	14863813	1017	1639	622	RIGHT	L70b.EDF	L70	2
85	14865168	14865313	2994	3139	145	RIGHT	L70b.EDF	L70	2
85	14865581	14865584	3407	3410	3	RIGHT	L70b.EDF	L70	2
85	14865617	14865619	3443	3445	2	RIGHT	L70b.EDF	L70	2
85	14865640	14865702	3466	3528	62	RIGHT	L70b.EDF	L70	2
85	14865754	14865770	3580	3596	16	RIGHT	L70b.EDF	L70	2
85	14865910	14865942	3736	3768	32	RIGHT	L70b.EDF	L70	2
85	14865979	14866002	3805	3828	23	RIGHT	L70b.EDF	L70	2
85	14866071	14866071	3897	3897	0	RIGHT	L70b.EDF	L70	2
85	14866106	14866108	3932	3934	2	RIGHT	L70b.EDF	L70	2
85	14866129	14866138	3955	3964	9	RIGHT	L70b.EDF	L70	2
85	14866176	14867517	4002	5343	1341	RIGHT	L70b.EDF	L70	2
86	14870308	14870919	58	669	611	RIGHT	L70b.EDF	L70	2
86	14870945	14871086	695	836	141	RIGHT	L70b.EDF	L70	2
86	14871110	14871193	860	943	83	RIGHT	L70b.EDF	L70	2
86	14871252	14871273	1002	1023	21	RIGHT	L70b.EDF	L70	2
86	14871352	14871352	1102	1102	0	RIGHT	L70b.EDF	L70	2
86	14871538	14871539	1288	1289	1	RIGHT	L70b.EDF	L70	2
86	14871560	14876763	1310	6513	5203	RIGHT	L70b.EDF	L70	2
87	14879073	14884938	57	5922	5865	RIGHT	L70b.EDF	L70	2
88	14887035	14889101	58	2124	2066	RIGHT	L70b.EDF	L70	2
88	14889159	14889738	2182	2761	579	RIGHT	L70b.EDF	L70	2
88	14889984	14889984	3007	3007	0	RIGHT	L70b.EDF	L70	2
88	14890025	14890025	3048	3048	0	RIGHT	L70b.EDF	L70	2
88	14890054	14890054	3077	3077	0	RIGHT	L70b.EDF	L70	2
88	14890079	14894324	3102	7347	4245	RIGHT	L70b.EDF	L70	2
89	14896155	14896231	58	134	76	RIGHT	L70b.EDF	L70	2
89	14899410	14902179	3313	6082	2769	RIGHT	L70b.EDF	L70	2
90	14904259	14906588	57	2386	2329	RIGHT	L70b.EDF	L70	2
90	14906826	14907175	2624	2973	349	RIGHT	L70b.EDF	L70	2
90	14907525	14910063	3323	5861	2538	RIGHT	L70b.EDF	L70	2
91	14912066	14912499	57	490	433	RIGHT	L70b.EDF	L70	2
91	14912523	14912535	514	526	12	RIGHT	L70b.EDF	L70	2
91	14912563	14917368	554	5359	4805	RIGHT	L70b.EDF	L70	2
92	14920345	14922247	57	1959	1902	RIGHT	L70b.EDF	L70	2
92	14922520	14922542	2232	2254	22	RIGHT	L70b.EDF	L70	2
93	14928938	14929055	57	174	117	RIGHT	L70b.EDF	L70	2
93	14929155	14929206	274	325	51	RIGHT	L70b.EDF	L70	2
93	14931796	14932074	2915	3193	278	RIGHT	L70b.EDF	L70	2
94	14937872	14937873	85	86	1	RIGHT	L70b.EDF	L70	2
94	14942162	14942163	4375	4376	1	RIGHT	L70b.EDF	L70	2
94	14944724	14944727	6937	6940	3	RIGHT	L70b.EDF	L70	2
94	14944749	14944846	6962	7059	97	RIGHT	L70b.EDF	L70	2
96	14955679	14955769	57	147	90	RIGHT	L70b.EDF	L70	2
96	14955791	14955809	169	187	18	RIGHT	L70b.EDF	L70	2
96	14955830	14955930	208	308	100	RIGHT	L70b.EDF	L70	2
96	14960224	14960312	4602	4690	88	RIGHT	L70b.EDF	L70	2
96	14960334	14960367	4712	4745	33	RIGHT	L70b.EDF	L70	2
97	14964549	14964679	420	550	130	RIGHT	L70b.EDF	L70	2
97	14965918	14966008	1789	1879	90	RIGHT	L70b.EDF	L70	2
98	14972087	14972280	285	478	193	RIGHT	L70b.EDF	L70	2
98	14972340	14972344	538	542	4	RIGHT	L70b.EDF	L70	2
99	14982596	14982747	3578	3729	151	RIGHT	L70b.EDF	L70	2
99	14984419	14984420	5401	5402	1	RIGHT	L70b.EDF	L70	2
99	14984628	14984632	5610	5614	4	RIGHT	L70b.EDF	L70	2
99	14984656	14984658	5638	5640	2	RIGHT	L70b.EDF	L70	2
99	14984685	14984696	5667	5678	11	RIGHT	L70b.EDF	L70	2
99	14984719	14984759	5701	5741	40	RIGHT	L70b.EDF	L70	2
99	14984786	14984839	5768	5821	53	RIGHT	L70b.EDF	L70	2
99	14984873	14984874	5855	5856	1	RIGHT	L70b.EDF	L70	2
99	14984896	14984904	5878	5886	8	RIGHT	L70b.EDF	L70	2
99	14985055	14985089	6037	6071	34	RIGHT	L70b.EDF	L70	2
99	14985149	14985360	6131	6342	211	RIGHT	L70b.EDF	L70	2
99	14985384	14985476	6366	6458	92	RIGHT	L70b.EDF	L70	2
99	14985504	14985603	6486	6585	99	RIGHT	L70b.EDF	L70	2
99	14985630	14985684	6612	6666	54	RIGHT	L70b.EDF	L70	2
99	14985707	14985730	6689	6712	23	RIGHT	L70b.EDF	L70	2
99	14985761	14985877	6743	6859	116	RIGHT	L70b.EDF	L70	2
99	14985900	14985953	6882	6935	53	RIGHT	L70b.EDF	L70	2
99	14985974	14986181	6956	7163	207	RIGHT	L70b.EDF	L70	2
100	14989637	14989682	1788	1833	45	RIGHT	L70b.EDF	L70	2
100	14989717	14989770	1868	1921	53	RIGHT	L70b.EDF	L70	2
100	14993053	14993133	5204	5284	80	RIGHT	L70b.EDF	L70	2
101	14996839	14996997	480	638	158	RIGHT	L70b.EDF	L70	2
101	14997217	14997347	858	988	130	RIGHT	L70b.EDF	L70	2
101	14998012	14998091	1653	1732	79	RIGHT	L70b.EDF	L70	2
101	15000471	15000475	4112	4116	4	RIGHT	L70b.EDF	L70	2
101	15000501	15000585	4142	4226	84	RIGHT	L70b.EDF	L70	2
101	15000617	15000652	4258	4293	35	RIGHT	L70b.EDF	L70	2
103	15014522	15014787	407	672	265	RIGHT	L70b.EDF	L70	2
104	15026440	15026705	2407	2672	265	RIGHT	L70b.EDF	L70	2
104	15027724	15027854	3691	3821	130	RIGHT	L70b.EDF	L70	2
104	15027917	15027919	3884	3886	2	RIGHT	L70b.EDF	L70	2
104	15028118	15028194	4085	4161	76	RIGHT	L70b.EDF	L70	2
104	15028215	15028215	4182	4182	0	RIGHT	L70b.EDF	L70	2
104	15028364	15028364	4331	4331	0	RIGHT	L70b.EDF	L70	2
105	15032702	15032703	109	110	1	RIGHT	L70b.EDF	L70	2
105	15033052	15033195	459	602	143	RIGHT	L70b.EDF	L70	2
105	15034517	15034671	1924	2078	154	RIGHT	L70b.EDF	L70	2
105	15034694	15034698	2101	2105	4	RIGHT	L70b.EDF	L70	2
105	15036014	15036360	3421	3767	346	RIGHT	L70b.EDF	L70	2
105	15036381	15036417	3788	3824	36	RIGHT	L70b.EDF	L70	2
105	15036444	15036452	3851	3859	8	RIGHT	L70b.EDF	L70	2
105	15036520	15036526	3927	3933	6	RIGHT	L70b.EDF	L70	2
105	15036553	15036565	3960	3972	12	RIGHT	L70b.EDF	L70	2
105	15036621	15036621	4028	4028	0	RIGHT	L70b.EDF	L70	2
105	15036643	15036673	4050	4080	30	RIGHT	L70b.EDF	L70	2
105	15036695	15036770	4102	4177	75	RIGHT	L70b.EDF	L70	2
105	15036796	15036834	4203	4241	38	RIGHT	L70b.EDF	L70	2
105	15036862	15036885	4269	4292	23	RIGHT	L70b.EDF	L70	2
105	15036909	15036949	4316	4356	40	RIGHT	L70b.EDF	L70	2
105	15036977	15036996	4384	4403	19	RIGHT	L70b.EDF	L70	2
105	15037035	15037035	4442	4442	0	RIGHT	L70b.EDF	L70	2
105	15037187	15037207	4594	4614	20	RIGHT	L70b.EDF	L70	2
105	15037242	15037262	4649	4669	20	RIGHT	L70b.EDF	L70	2
105	15037293	15037327	4700	4734	34	RIGHT	L70b.EDF	L70	2
105	15037355	15037378	4762	4785	23	RIGHT	L70b.EDF	L70	2
105	15037413	15037464	4820	4871	51	RIGHT	L70b.EDF	L70	2
105	15037514	15037734	4921	5141	220	RIGHT	L70b.EDF	L70	2
105	15037764	15037868	5171	5275	104	RIGHT	L70b.EDF	L70	2
105	15037896	15037909	5303	5316	13	RIGHT	L70b.EDF	L70	2
105	15037958	15037966	5365	5373	8	RIGHT	L70b.EDF	L70	2
105	15037994	15037994	5401	5401	0	RIGHT	L70b.EDF	L70	2
105	15038053	15038063	5460	5470	10	RIGHT	L70b.EDF	L70	2
106	15043096	15043171	3122	3197	75	RIGHT	L70b.EDF	L70	2
106	15043206	15043241	3232	3267	35	RIGHT	L70b.EDF	L70	2
106	15043268	15043268	3294	3294	0	RIGHT	L70b.EDF	L70	2
106	15043297	15043299	3323	3325	2	RIGHT	L70b.EDF	L70	2
106	15043325	15043356	3351	3382	31	RIGHT	L70b.EDF	L70	2
106	15043443	15043446	3469	3472	3	RIGHT	L70b.EDF	L70	2
106	15043601	15043602	3627	3628	1	RIGHT	L70b.EDF	L70	2
106	15043667	15043669	3693	3695	2	RIGHT	L70b.EDF	L70	2
106	15043703	15043722	3729	3748	19	RIGHT	L70b.EDF	L70	2
106	15043865	15043867	3891	3893	2	RIGHT	L70b.EDF	L70	2
106	15044061	15044064	4087	4090	3	RIGHT	L70b.EDF	L70	2
106	15044091	15044092	4117	4118	1	RIGHT	L70b.EDF	L70	2
106	15044140	15044140	4166	4166	0	RIGHT	L70b.EDF	L70	2
106	15045955	15045955	5981	5981	0	RIGHT	L70b.EDF	L70	2
106	15046051	15046052	6077	6078	1	RIGHT	L70b.EDF	L70	2
106	15046243	15046245	6269	6271	2	RIGHT	L70b.EDF	L70	2
106	15046275	15046275	6301	6301	0	RIGHT	L70b.EDF	L70	2
106	15046317	15046336	6343	6362	19	RIGHT	L70b.EDF	L70	2
106	15046374	15046374	6400	6400	0	RIGHT	L70b.EDF	L70	2
106	15046400	15046401	6426	6427	1	RIGHT	L70b.EDF	L70	2
106	15046431	15046451	6457	6477	20	RIGHT	L70b.EDF	L70	2
106	15046482	15046483	6508	6509	1	RIGHT	L70b.EDF	L70	2
106	15046790	15046790	6816	6816	0	RIGHT	L70b.EDF	L70	2
106	15046912	15046918	6938	6944	6	RIGHT	L70b.EDF	L70	2
107	15048511	15048515	99	103	4	RIGHT	L70b.EDF	L70	2
107	15048538	15048700	126	288	162	RIGHT	L70b.EDF	L70	2
107	15050153	15050153	1741	1741	0	RIGHT	L70b.EDF	L70	2
107	15050204	15050233	1792	1821	29	RIGHT	L70b.EDF	L70	2
107	15050460	15050460	2048	2048	0	RIGHT	L70b.EDF	L70	2
107	15050553	15050569	2141	2157	16	RIGHT	L70b.EDF	L70	2
107	15051922	15051922	3510	3510	0	RIGHT	L70b.EDF	L70	2
107	15052782	15052790	4370	4378	8	RIGHT	L70b.EDF	L70	2
107	15052843	15052844	4431	4432	1	RIGHT	L70b.EDF	L70	2
107	15052879	15052880	4467	4468	1	RIGHT	L70b.EDF	L70	2
107	15052912	15052913	4500	4501	1	RIGHT	L70b.EDF	L70	2
107	15052963	15052976	4551	4564	13	RIGHT	L70b.EDF	L70	2
107	15053005	15053006	4593	4594	1	RIGHT	L70b.EDF	L70	2
107	15053036	15053036	4624	4624	0	RIGHT	L70b.EDF	L70	2
107	15053080	15053080	4668	4668	0	RIGHT	L70b.EDF	L70	2
107	15053113	15053155	4701	4743	42	RIGHT	L70b.EDF	L70	2
107	15053179	15053255	4767	4843	76	RIGHT	L70b.EDF	L70	2
107	15053283	15053303	4871	4891	20	RIGHT	L70b.EDF	L70	2
107	15053342	15053422	4930	5010	80	RIGHT	L70b.EDF	L70	2
107	15053462	15053462	5050	5050	0	RIGHT	L70b.EDF	L70	2
107	15053511	15053558	5099	5146	47	RIGHT	L70b.EDF	L70	2
107	15054106	15054106	5694	5694	0	RIGHT	L70b.EDF	L70	2
107	15054134	15054136	5722	5724	2	RIGHT	L70b.EDF	L70	2
107	15054300	15054300	5888	5888	0	RIGHT	L70b.EDF	L70	2
107	15054417	15054419	6005	6007	2	RIGHT	L70b.EDF	L70	2
107	15054457	15054865	6045	6453	408	RIGHT	L70b.EDF	L70	2
107	15054886	15054902	6474	6490	16	RIGHT	L70b.EDF	L70	2
108	15057218	15057240	418	440	22	RIGHT	L70b.EDF	L70	2
108	15057467	15059122	667	2322	1655	RIGHT	L70b.EDF	L70	2
109	15068301	15068302	3921	3922	1	RIGHT	L70b.EDF	L70	2
109	15068347	15068779	3967	4399	432	RIGHT	L70b.EDF	L70	2
109	15068805	15068813	4425	4433	8	RIGHT	L70b.EDF	L70	2
109	15069702	15070360	5322	5980	658	RIGHT	L70b.EDF	L70	2
109	15070389	15070534	6009	6154	145	RIGHT	L70b.EDF	L70	2
109	15071198	15071543	6818	7163	345	RIGHT	L70b.EDF	L70	2
110	15074254	15074330	58	134	76	RIGHT	L70b.EDF	L70	2
110	15076889	15077681	2693	3485	792	RIGHT	L70b.EDF	L70	2
110	15077708	15077879	3512	3683	171	RIGHT	L70b.EDF	L70	2
110	15077900	15077909	3704	3713	9	RIGHT	L70b.EDF	L70	2
110	15077935	15077936	3739	3740	1	RIGHT	L70b.EDF	L70	2
110	15077961	15078034	3765	3838	73	RIGHT	L70b.EDF	L70	2
110	15078055	15078066	3859	3870	11	RIGHT	L70b.EDF	L70	2
110	15078088	15078152	3892	3956	64	RIGHT	L70b.EDF	L70	2
110	15078179	15078190	3983	3994	11	RIGHT	L70b.EDF	L70	2
110	15078211	15078212	4015	4016	1	RIGHT	L70b.EDF	L70	2
110	15078235	15078271	4039	4075	36	RIGHT	L70b.EDF	L70	2
110	15078306	15078383	4110	4187	77	RIGHT	L70b.EDF	L70	2
110	15078422	15078423	4226	4227	1	RIGHT	L70b.EDF	L70	2
110	15078460	15078460	4264	4264	0	RIGHT	L70b.EDF	L70	2
110	15078491	15078515	4295	4319	24	RIGHT	L70b.EDF	L70	2
110	15078583	15078605	4387	4409	22	RIGHT	L70b.EDF	L70	2
110	15078726	15078726	4530	4530	0	RIGHT	L70b.EDF	L70	2
110	15078764	15078765	4568	4569	1	RIGHT	L70b.EDF	L70	2
110	15078799	15078883	4603	4687	84	RIGHT	L70b.EDF	L70	2
110	15078924	15078992	4728	4796	68	RIGHT	L70b.EDF	L70	2
110	15079046	15079067	4850	4871	21	RIGHT	L70b.EDF	L70	2
111	15080769	15080793	57	81	24	RIGHT	L70b.EDF	L70	2
111	15080887	15080893	175	181	6	RIGHT	L70b.EDF	L70	2
111	15081142	15081144	430	432	2	RIGHT	L70b.EDF	L70	2
111	15081166	15081167	454	455	1	RIGHT	L70b.EDF	L70	2
111	15081193	15081271	481	559	78	RIGHT	L70b.EDF	L70	2
111	15085253	15085253	4541	4541	0	RIGHT	L70b.EDF	L70	2
111	15085476	15085477	4764	4765	1	RIGHT	L70b.EDF	L70	2
111	15085531	15085554	4819	4842	23	RIGHT	L70b.EDF	L70	2
111	15085606	15085609	4894	4897	3	RIGHT	L70b.EDF	L70	2
112	15088177	15088186	104	113	9	RIGHT	L70b.EDF	L70	2
112	15091203	15091318	3130	3245	115	RIGHT	L70b.EDF	L70	2
113	15096874	15096894	1545	1565	20	RIGHT	L70b.EDF	L70	2
113	15096933	15096934	1604	1605	1	RIGHT	L70b.EDF	L70	2
113	15096965	15096969	1636	1640	4	RIGHT	L70b.EDF	L70	2
113	15097010	15097017	1681	1688	7	RIGHT	L70b.EDF	L70	2
113	15097048	15097049	1719	1720	1	RIGHT	L70b.EDF	L70	2
113	15097075	15097164	1746	1835	89	RIGHT	L70b.EDF	L70	2
113	15097185	15097194	1856	1865	9	RIGHT	L70b.EDF	L70	2
113	15097223	15097239	1894	1910	16	RIGHT	L70b.EDF	L70	2
113	15099052	15099052	3723	3723	0	RIGHT	L70b.EDF	L70	2
113	15099281	15099297	3952	3968	16	RIGHT	L70b.EDF	L70	2
113	15099341	15099343	4012	4014	2	RIGHT	L70b.EDF	L70	2
113	15099375	15099377	4046	4048	2	RIGHT	L70b.EDF	L70	2
113	15099629	15099630	4300	4301	1	RIGHT	L70b.EDF	L70	2
113	15099745	15099832	4416	4503	87	RIGHT	L70b.EDF	L70	2
113	15099868	15100075	4539	4746	207	RIGHT	L70b.EDF	L70	2
113	15100101	15100125	4772	4796	24	RIGHT	L70b.EDF	L70	2
113	15100155	15100169	4826	4840	14	RIGHT	L70b.EDF	L70	2
113	15100198	15100200	4869	4871	2	RIGHT	L70b.EDF	L70	2
113	15101077	15101078	5748	5749	1	RIGHT	L70b.EDF	L70	2
114	15106667	15106825	3754	3912	158	RIGHT	L70b.EDF	L70	2
114	15106998	15107204	4085	4291	206	RIGHT	L70b.EDF	L70	2
114	15107435	15107766	4522	4853	331	RIGHT	L70b.EDF	L70	2
114	15108012	15108201	5099	5288	189	RIGHT	L70b.EDF	L70	2
115	15112472	15113447	57	1032	975	RIGHT	L70b.EDF	L70	2
115	15113829	15113938	1414	1523	109	RIGHT	L70b.EDF	L70	2
115	15114123	15114405	1708	1990	282	RIGHT	L70b.EDF	L70	2
115	15115150	15115164	2735	2749	14	RIGHT	L70b.EDF	L70	2
115	15115663	15115753	3248	3338	90	RIGHT	L70b.EDF	L70	2
115	15115784	15115796	3369	3381	12	RIGHT	L70b.EDF	L70	2
116	15120600	15121651	716	1767	1051	RIGHT	L70b.EDF	L70	2
117	15129349	15129359	2304	2314	10	RIGHT	L70b.EDF	L70	2
117	15129493	15129508	2448	2463	15	RIGHT	L70b.EDF	L70	2
117	15130792	15131035	3747	3990	243	RIGHT	L70b.EDF	L70	2
117	15131215	15131492	4170	4447	277	RIGHT	L70b.EDF	L70	2
117	15131729	15131948	4684	4903	219	RIGHT	L70b.EDF	L70	2
117	15132938	15133124	5893	6079	186	RIGHT	L70b.EDF	L70	2
117	15133880	15133948	6835	6903	68	RIGHT	L70b.EDF	L70	2
117	15134028	15134100	6983	7055	72	RIGHT	L70b.EDF	L70	2
117	15134127	15134127	7082	7082	0	RIGHT	L70b.EDF	L70	2
117	15134177	15134177	7132	7132	0	RIGHT	L70b.EDF	L70	2
117	15134205	15134249	7160	7204	44	RIGHT	L70b.EDF	L70	2
117	15134274	15134274	7229	7229	0	RIGHT	L70b.EDF	L70	2
117	15134303	15134322	7258	7277	19	RIGHT	L70b.EDF	L70	2
118	15136551	15136569	509	527	18	RIGHT	L70b.EDF	L70	2
118	15137084	15137713	1042	1671	629	RIGHT	L70b.EDF	L70	2
118	15137792	15137799	1750	1757	7	RIGHT	L70b.EDF	L70	2
118	15137824	15138072	1782	2030	248	RIGHT	L70b.EDF	L70	2
118	15138098	15138135	2056	2093	37	RIGHT	L70b.EDF	L70	2
118	15140199	15141467	4157	5425	1268	RIGHT	L70b.EDF	L70	2
118	15141887	15142082	5845	6040	195	RIGHT	L70b.EDF	L70	2
118	15142381	15142396	6339	6354	15	RIGHT	L70b.EDF	L70	2
119	15144598	15144786	157	345	188	RIGHT	L70b.EDF	L70	2
119	15144813	15144861	372	420	48	RIGHT	L70b.EDF	L70	2
119	15144939	15146013	498	1572	1074	RIGHT	L70b.EDF	L70	2
119	15146061	15146062	1620	1621	1	RIGHT	L70b.EDF	L70	2
119	15146100	15146815	1659	2374	715	RIGHT	L70b.EDF	L70	2
120	15153220	15153552	117	449	332	RIGHT	L70b.EDF	L70	2
120	15153586	15155698	483	2595	2112	RIGHT	L70b.EDF	L70	2
120	15155798	15155869	2695	2766	71	RIGHT	L70b.EDF	L70	2
120	15155933	15156083	2830	2980	150	RIGHT	L70b.EDF	L70	2
120	15156448	15156692	3345	3589	244	RIGHT	L70b.EDF	L70	2
120	15156713	15156967	3610	3864	254	RIGHT	L70b.EDF	L70	2
120	15157010	15157502	3907	4399	492	RIGHT	L70b.EDF	L70	2
120	15157841	15158050	4738	4947	209	RIGHT	L70b.EDF	L70	2
120	15158434	15158446	5331	5343	12	RIGHT	L70b.EDF	L70	2
120	15158492	15158494	5389	5391	2	RIGHT	L70b.EDF	L70	2
120	15158519	15158520	5416	5417	1	RIGHT	L70b.EDF	L70	2
120	15158561	15158561	5458	5458	0	RIGHT	L70b.EDF	L70	2
120	15158599	15158602	5496	5499	3	RIGHT	L70b.EDF	L70	2
120	15158631	15158631	5528	5528	0	RIGHT	L70b.EDF	L70	2
120	15159071	15159076	5968	5973	5	RIGHT	L70b.EDF	L70	2
1	15767882	15767917	56	91	35	RIGHT	L70c.EDF	L70	3
1	15770860	15774555	3034	6729	3695	RIGHT	L70c.EDF	L70	3
2	15777211	15777248	75	112	37	RIGHT	L70c.EDF	L70	3
2	15777269	15777313	133	177	44	RIGHT	L70c.EDF	L70	3
2	15777345	15777347	209	211	2	RIGHT	L70c.EDF	L70	3
2	15777585	15777624	449	488	39	RIGHT	L70c.EDF	L70	3
2	15780104	15781123	2968	3987	1019	RIGHT	L70c.EDF	L70	3
2	15781149	15781156	4013	4020	7	RIGHT	L70c.EDF	L70	3
2	15781544	15781544	4408	4408	0	RIGHT	L70c.EDF	L70	3
2	15781567	15782893	4431	5757	1326	RIGHT	L70c.EDF	L70	3
2	15782915	15782916	5779	5780	1	RIGHT	L70c.EDF	L70	3
2	15783457	15783457	6321	6321	0	RIGHT	L70c.EDF	L70	3
2	15783502	15783502	6366	6366	0	RIGHT	L70c.EDF	L70	3
2	15783537	15783550	6401	6414	13	RIGHT	L70c.EDF	L70	3
2	15783576	15783831	6440	6695	255	RIGHT	L70c.EDF	L70	3
3	15785943	15786060	74	191	117	RIGHT	L70c.EDF	L70	3
3	15786354	15786717	485	848	363	RIGHT	L70c.EDF	L70	3
3	15787434	15787819	1565	1950	385	RIGHT	L70c.EDF	L70	3
3	15789040	15792706	3171	6837	3666	RIGHT	L70c.EDF	L70	3
4	15794393	15794495	56	158	102	RIGHT	L70c.EDF	L70	3
4	15795945	15796286	1608	1949	341	RIGHT	L70c.EDF	L70	3
4	15800179	15800805	5842	6468	626	RIGHT	L70c.EDF	L70	3
5	15803482	15804129	58	705	647	RIGHT	L70c.EDF	L70	3
5	15807695	15807947	4271	4523	252	RIGHT	L70c.EDF	L70	3
5	15808431	15808672	5007	5248	241	RIGHT	L70c.EDF	L70	3
6	15813047	15813281	57	291	234	RIGHT	L70c.EDF	L70	3
6	15816445	15818373	3455	5383	1928	RIGHT	L70c.EDF	L70	3
7	15824042	15824044	3818	3820	2	RIGHT	L70c.EDF	L70	3
7	15824069	15824070	3845	3846	1	RIGHT	L70c.EDF	L70	3
7	15824161	15824180	3937	3956	19	RIGHT	L70c.EDF	L70	3
7	15824278	15827228	4054	7004	2950	RIGHT	L70c.EDF	L70	3
8	15829679	15829981	57	359	302	RIGHT	L70c.EDF	L70	3
8	15830265	15830319	643	697	54	RIGHT	L70c.EDF	L70	3
8	15831071	15831405	1449	1783	334	RIGHT	L70c.EDF	L70	3
9	15840368	15840603	1882	2117	235	RIGHT	L70c.EDF	L70	3
9	15843334	15843359	4848	4873	25	RIGHT	L70c.EDF	L70	3
9	15843416	15844396	4930	5910	980	RIGHT	L70c.EDF	L70	3
10	15846466	15846512	58	104	46	RIGHT	L70c.EDF	L70	3
10	15846720	15847302	312	894	582	RIGHT	L70c.EDF	L70	3
10	15847724	15848063	1316	1655	339	RIGHT	L70c.EDF	L70	3
10	15848852	15848852	2444	2444	0	RIGHT	L70c.EDF	L70	3
11	15853601	15853968	468	835	367	RIGHT	L70c.EDF	L70	3
11	15854560	15854866	1427	1733	306	RIGHT	L70c.EDF	L70	3
11	15856331	15857257	3198	4124	926	RIGHT	L70c.EDF	L70	3
11	15857442	15858827	4309	5694	1385	RIGHT	L70c.EDF	L70	3
12	15862628	15863021	492	885	393	RIGHT	L70c.EDF	L70	3
12	15863865	15864303	1729	2167	438	RIGHT	L70c.EDF	L70	3
12	15865624	15868263	3488	6127	2639	RIGHT	L70c.EDF	L70	3
13	15871654	15872119	530	995	465	RIGHT	L70c.EDF	L70	3
13	15874470	15876408	3346	5284	1938	RIGHT	L70c.EDF	L70	3
14	15879519	15879862	327	670	343	RIGHT	L70c.EDF	L70	3
14	15879889	15880111	697	919	222	RIGHT	L70c.EDF	L70	3
14	15884203	15884293	5011	5101	90	RIGHT	L70c.EDF	L70	3
15	15886061	15886332	57	328	271	RIGHT	L70c.EDF	L70	3
15	15889975	15890192	3971	4188	217	RIGHT	L70c.EDF	L70	3
15	15890488	15890816	4484	4812	328	RIGHT	L70c.EDF	L70	3
15	15891335	15891533	5331	5529	198	RIGHT	L70c.EDF	L70	3
15	15891969	15891969	5965	5965	0	RIGHT	L70c.EDF	L70	3
16	15894626	15895104	58	536	478	RIGHT	L70c.EDF	L70	3
16	15897412	15898839	2844	4271	1427	RIGHT	L70c.EDF	L70	3
16	15898864	15899007	4296	4439	143	RIGHT	L70c.EDF	L70	3
16	15899033	15899213	4465	4645	180	RIGHT	L70c.EDF	L70	3
16	15899241	15899589	4673	5021	348	RIGHT	L70c.EDF	L70	3
16	15899611	15900003	5043	5435	392	RIGHT	L70c.EDF	L70	3
16	15900028	15900074	5460	5506	46	RIGHT	L70c.EDF	L70	3
16	15900111	15900162	5543	5594	51	RIGHT	L70c.EDF	L70	3
16	15900185	15900334	5617	5766	149	RIGHT	L70c.EDF	L70	3
16	15900361	15901552	5793	6984	1191	RIGHT	L70c.EDF	L70	3
16	15901579	15901693	7011	7125	114	RIGHT	L70c.EDF	L70	3
17	15904925	15905418	1038	1531	493	RIGHT	L70c.EDF	L70	3
17	15906886	15906889	2999	3002	3	RIGHT	L70c.EDF	L70	3
17	15906913	15908867	3026	4980	1954	RIGHT	L70c.EDF	L70	3
18	15911157	15911283	57	183	126	RIGHT	L70c.EDF	L70	3
18	15914123	15917994	3023	6894	3871	RIGHT	L70c.EDF	L70	3
19	15919953	15920191	57	295	238	RIGHT	L70c.EDF	L70	3
20	15927909	15928793	286	1170	884	RIGHT	L70c.EDF	L70	3
20	15928820	15928820	1197	1197	0	RIGHT	L70c.EDF	L70	3
20	15929488	15929697	1865	2074	209	RIGHT	L70c.EDF	L70	3
21	15937530	15937968	1526	1964	438	RIGHT	L70c.EDF	L70	3
21	15938924	15939020	2920	3016	96	RIGHT	L70c.EDF	L70	3
22	15943173	15943213	483	523	40	RIGHT	L70c.EDF	L70	3
23	15951898	15952179	410	691	281	RIGHT	L70c.EDF	L70	3
23	15954857	15954981	3369	3493	124	RIGHT	L70c.EDF	L70	3
23	15955601	15955603	4113	4115	2	RIGHT	L70c.EDF	L70	3
23	15955645	15955746	4157	4258	101	RIGHT	L70c.EDF	L70	3
24	15961256	15962107	57	908	851	RIGHT	L70c.EDF	L70	3
24	15962139	15962139	940	940	0	RIGHT	L70c.EDF	L70	3
24	15964010	15967194	2811	5995	3184	RIGHT	L70c.EDF	L70	3
25	15969073	15969688	57	672	615	RIGHT	L70c.EDF	L70	3
25	15972723	15974239	3707	5223	1516	RIGHT	L70c.EDF	L70	3
26	15976504	15976589	57	142	85	RIGHT	L70c.EDF	L70	3
26	15976631	15976989	184	542	358	RIGHT	L70c.EDF	L70	3
26	15977018	15977139	571	692	121	RIGHT	L70c.EDF	L70	3
26	15977192	15977368	745	921	176	RIGHT	L70c.EDF	L70	3
26	15977391	15977563	944	1116	172	RIGHT	L70c.EDF	L70	3
26	15977587	15977861	1140	1414	274	RIGHT	L70c.EDF	L70	3
26	15977912	15978030	1465	1583	118	RIGHT	L70c.EDF	L70	3
26	15978079	15978404	1632	1957	325	RIGHT	L70c.EDF	L70	3
26	15978540	15978852	2093	2405	312	RIGHT	L70c.EDF	L70	3
26	15981089	15981115	4642	4668	26	RIGHT	L70c.EDF	L70	3
26	15981144	15981151	4697	4704	7	RIGHT	L70c.EDF	L70	3
26	15982206	15982207	5759	5760	1	RIGHT	L70c.EDF	L70	3
26	15982242	15982244	5795	5797	2	RIGHT	L70c.EDF	L70	3
26	15982347	15982348	5900	5901	1	RIGHT	L70c.EDF	L70	3
26	15982381	15982604	5934	6157	223	RIGHT	L70c.EDF	L70	3
26	15982636	15982637	6189	6190	1	RIGHT	L70c.EDF	L70	3
26	15982731	15982732	6284	6285	1	RIGHT	L70c.EDF	L70	3
26	15982988	15983514	6541	7067	526	RIGHT	L70c.EDF	L70	3
27	15987272	15990828	1456	5012	3556	RIGHT	L70c.EDF	L70	3
28	15992969	15993300	59	390	331	RIGHT	L70c.EDF	L70	3
28	15993328	15993328	418	418	0	RIGHT	L70c.EDF	L70	3
28	15993647	15993647	737	737	0	RIGHT	L70c.EDF	L70	3
28	15993690	15993691	780	781	1	RIGHT	L70c.EDF	L70	3
28	15993744	15993767	834	857	23	RIGHT	L70c.EDF	L70	3
28	15993793	15994222	883	1312	429	RIGHT	L70c.EDF	L70	3
28	15994288	15994336	1378	1426	48	RIGHT	L70c.EDF	L70	3
28	15994359	15998523	1449	5613	4164	RIGHT	L70c.EDF	L70	3
29	16000685	16001376	58	749	691	RIGHT	L70c.EDF	L70	3
29	16001399	16001526	772	899	127	RIGHT	L70c.EDF	L70	3
29	16001548	16001948	921	1321	400	RIGHT	L70c.EDF	L70	3
29	16001977	16002529	1350	1902	552	RIGHT	L70c.EDF	L70	3
29	16002764	16002767	2137	2140	3	RIGHT	L70c.EDF	L70	3
29	16002794	16005527	2167	4900	2733	RIGHT	L70c.EDF	L70	3
30	16007078	16008990	58	1970	1912	RIGHT	L70c.EDF	L70	3
30	16009011	16009074	1991	2054	63	RIGHT	L70c.EDF	L70	3
30	16009131	16013342	2111	6322	4211	RIGHT	L70c.EDF	L70	3
31	16015001	16021337	57	6393	6336	RIGHT	L70c.EDF	L70	3
32	16023205	16029513	56	6364	6308	RIGHT	L70c.EDF	L70	3
33	16031383	16033554	57	2228	2171	RIGHT	L70c.EDF	L70	3
33	16034196	16037887	2870	6561	3691	RIGHT	L70c.EDF	L70	3
34	16040279	16040547	920	1188	268	RIGHT	L70c.EDF	L70	3
34	16040575	16040604	1216	1245	29	RIGHT	L70c.EDF	L70	3
34	16040625	16040707	1266	1348	82	RIGHT	L70c.EDF	L70	3
34	16040729	16040829	1370	1470	100	RIGHT	L70c.EDF	L70	3
34	16040851	16041000	1492	1641	149	RIGHT	L70c.EDF	L70	3
34	16041026	16041151	1667	1792	125	RIGHT	L70c.EDF	L70	3
34	16041184	16041184	1825	1825	0	RIGHT	L70c.EDF	L70	3
34	16041364	16046412	2005	7053	5048	RIGHT	L70c.EDF	L70	3
35	16050295	16052581	58	2344	2286	RIGHT	L70c.EDF	L70	3
35	16052602	16053045	2365	2808	443	RIGHT	L70c.EDF	L70	3
35	16053070	16056450	2833	6213	3380	RIGHT	L70c.EDF	L70	3
36	16059485	16060309	57	881	824	RIGHT	L70c.EDF	L70	3
36	16060417	16060417	989	989	0	RIGHT	L70c.EDF	L70	3
36	16060483	16060500	1055	1072	17	RIGHT	L70c.EDF	L70	3
36	16060545	16061286	1117	1858	741	RIGHT	L70c.EDF	L70	3
36	16061327	16061492	1899	2064	165	RIGHT	L70c.EDF	L70	3
36	16062627	16066595	3199	7167	3968	RIGHT	L70c.EDF	L70	3
37	16069477	16070574	76	1173	1097	RIGHT	L70c.EDF	L70	3
37	16073822	16073822	4421	4421	0	RIGHT	L70c.EDF	L70	3
37	16073884	16074650	4483	5249	766	RIGHT	L70c.EDF	L70	3
38	16076565	16076836	281	552	271	RIGHT	L70c.EDF	L70	3
38	16080179	16082905	3895	6621	2726	RIGHT	L70c.EDF	L70	3
39	16087434	16087436	3206	3208	2	RIGHT	L70c.EDF	L70	3
39	16087457	16091281	3229	7053	3824	RIGHT	L70c.EDF	L70	3
40	16093792	16095544	57	1809	1752	RIGHT	L70c.EDF	L70	3
40	16097120	16099535	3385	5800	2415	RIGHT	L70c.EDF	L70	3
41	16102713	16103065	57	409	352	RIGHT	L70c.EDF	L70	3
41	16105431	16109001	2775	6345	3570	RIGHT	L70c.EDF	L70	3
42	16110953	16111007	240	294	54	RIGHT	L70c.EDF	L70	3
42	16111072	16111142	359	429	70	RIGHT	L70c.EDF	L70	3
42	16111167	16111744	454	1031	577	RIGHT	L70c.EDF	L70	3
42	16113098	16116746	2385	6033	3648	RIGHT	L70c.EDF	L70	3
43	16119035	16120595	57	1617	1560	RIGHT	L70c.EDF	L70	3
43	16120616	16120634	1638	1656	18	RIGHT	L70c.EDF	L70	3
43	16121575	16121687	2597	2709	112	RIGHT	L70c.EDF	L70	3
43	16121935	16124601	2957	5623	2666	RIGHT	L70c.EDF	L70	3
44	16126259	16128746	56	2543	2487	RIGHT	L70c.EDF	L70	3
44	16129384	16131695	3181	5492	2311	RIGHT	L70c.EDF	L70	3
45	16134066	16138869	57	4860	4803	RIGHT	L70c.EDF	L70	3
46	16141456	16143517	57	2118	2061	RIGHT	L70c.EDF	L70	3
46	16143883	16147052	2484	5653	3169	RIGHT	L70c.EDF	L70	3
46	16147079	16147641	5680	6242	562	RIGHT	L70c.EDF	L70	3
46	16147708	16147745	6309	6346	37	RIGHT	L70c.EDF	L70	3
47	16150295	16150438	57	200	143	RIGHT	L70c.EDF	L70	3
47	16150877	16150898	639	660	21	RIGHT	L70c.EDF	L70	3
47	16150974	16150975	736	737	1	RIGHT	L70c.EDF	L70	3
47	16151000	16151000	762	762	0	RIGHT	L70c.EDF	L70	3
47	16151049	16151078	811	840	29	RIGHT	L70c.EDF	L70	3
47	16151197	16151197	959	959	0	RIGHT	L70c.EDF	L70	3
47	16151220	16151220	982	982	0	RIGHT	L70c.EDF	L70	3
47	16151354	16151873	1116	1635	519	RIGHT	L70c.EDF	L70	3
47	16153863	16156690	3625	6452	2827	RIGHT	L70c.EDF	L70	3
48	16158957	16160725	58	1826	1768	RIGHT	L70c.EDF	L70	3
48	16161672	16164725	2773	5826	3053	RIGHT	L70c.EDF	L70	3
49	16166872	16169024	58	2210	2152	RIGHT	L70c.EDF	L70	3
49	16169056	16169057	2242	2243	1	RIGHT	L70c.EDF	L70	3
49	16169292	16169292	2478	2478	0	RIGHT	L70c.EDF	L70	3
49	16169358	16173781	2544	6967	4423	RIGHT	L70c.EDF	L70	3
50	16175783	16181356	58	5631	5573	RIGHT	L70c.EDF	L70	3
51	16183464	16189691	58	6285	6227	RIGHT	L70c.EDF	L70	3
52	16192236	16193259	57	1080	1023	RIGHT	L70c.EDF	L70	3
52	16193943	16194292	1764	2113	349	RIGHT	L70c.EDF	L70	3
52	16195227	16198616	3048	6437	3389	RIGHT	L70c.EDF	L70	3
53	16201173	16202024	57	908	851	RIGHT	L70c.EDF	L70	3
53	16202782	16203024	1666	1908	242	RIGHT	L70c.EDF	L70	3
53	16206483	16206520	5367	5404	37	RIGHT	L70c.EDF	L70	3
53	16207031	16207037	5915	5921	6	RIGHT	L70c.EDF	L70	3
53	16207065	16207813	5949	6697	748	RIGHT	L70c.EDF	L70	3
54	16209779	16210614	153	988	835	RIGHT	L70c.EDF	L70	3
54	16211425	16211426	1799	1800	1	RIGHT	L70c.EDF	L70	3
54	16212930	16216065	3304	6439	3135	RIGHT	L70c.EDF	L70	3
55	16219214	16219689	57	532	475	RIGHT	L70c.EDF	L70	3
55	16222512	16225132	3355	5975	2620	RIGHT	L70c.EDF	L70	3
56	16228054	16228095	58	99	41	RIGHT	L70c.EDF	L70	3
56	16233250	16233338	5254	5342	88	RIGHT	L70c.EDF	L70	3
57	16235548	16235569	57	78	21	RIGHT	L70c.EDF	L70	3
57	16236738	16236994	1247	1503	256	RIGHT	L70c.EDF	L70	3
58	16246646	16248078	3812	5244	1432	RIGHT	L70c.EDF	L70	3
58	16248536	16248783	5702	5949	247	RIGHT	L70c.EDF	L70	3
58	16249548	16249658	6714	6824	110	RIGHT	L70c.EDF	L70	3
59	16253379	16253463	56	140	84	RIGHT	L70c.EDF	L70	3
59	16253848	16254339	525	1016	491	RIGHT	L70c.EDF	L70	3
59	16258763	16258893	5440	5570	130	RIGHT	L70c.EDF	L70	3
59	16258914	16258940	5591	5617	26	RIGHT	L70c.EDF	L70	3
60	16261757	16261855	126	224	98	RIGHT	L70c.EDF	L70	3
60	16265420	16265658	3789	4027	238	RIGHT	L70c.EDF	L70	3
60	16265729	16265781	4098	4150	52	RIGHT	L70c.EDF	L70	3
60	16266180	16268100	4549	6469	1920	RIGHT	L70c.EDF	L70	3
61	16270846	16271057	178	389	211	RIGHT	L70c.EDF	L70	3
61	16271272	16271302	604	634	30	RIGHT	L70c.EDF	L70	3
61	16271358	16271460	690	792	102	RIGHT	L70c.EDF	L70	3
61	16271481	16272975	813	2307	1494	RIGHT	L70c.EDF	L70	3
61	16273596	16274183	2928	3515	587	RIGHT	L70c.EDF	L70	3
61	16274677	16276975	4009	6307	2298	RIGHT	L70c.EDF	L70	3
62	16278615	16280485	57	1927	1870	RIGHT	L70c.EDF	L70	3
62	16281219	16283308	2661	4750	2089	RIGHT	L70c.EDF	L70	3
63	16285149	16285169	58	78	20	RIGHT	L70c.EDF	L70	3
63	16285650	16285783	559	692	133	RIGHT	L70c.EDF	L70	3
63	16287742	16290073	2651	4982	2331	RIGHT	L70c.EDF	L70	3
64	16294842	16298404	57	3619	3562	RIGHT	L70c.EDF	L70	3
64	16298429	16298430	3644	3645	1	RIGHT	L70c.EDF	L70	3
64	16298463	16300939	3678	6154	2476	RIGHT	L70c.EDF	L70	3
65	16302809	16304048	58	1297	1239	RIGHT	L70c.EDF	L70	3
65	16304129	16304129	1378	1378	0	RIGHT	L70c.EDF	L70	3
65	16304221	16304230	1470	1479	9	RIGHT	L70c.EDF	L70	3
65	16304310	16304310	1559	1559	0	RIGHT	L70c.EDF	L70	3
65	16304358	16304378	1607	1627	20	RIGHT	L70c.EDF	L70	3
65	16304406	16304406	1655	1655	0	RIGHT	L70c.EDF	L70	3
65	16304457	16304458	1706	1707	1	RIGHT	L70c.EDF	L70	3
65	16304491	16304516	1740	1765	25	RIGHT	L70c.EDF	L70	3
65	16304564	16307630	1813	4879	3066	RIGHT	L70c.EDF	L70	3
65	16307766	16307767	5015	5016	1	RIGHT	L70c.EDF	L70	3
65	16307825	16307825	5074	5074	0	RIGHT	L70c.EDF	L70	3
65	16307913	16307914	5162	5163	1	RIGHT	L70c.EDF	L70	3
65	16307946	16307946	5195	5195	0	RIGHT	L70c.EDF	L70	3
65	16307976	16308033	5225	5282	57	RIGHT	L70c.EDF	L70	3
66	16309962	16310644	57	739	682	RIGHT	L70c.EDF	L70	3
69	16337741	16337913	4020	4192	172	RIGHT	L70c.EDF	L70	3
70	16343528	16343747	1555	1774	219	RIGHT	L70c.EDF	L70	3
70	16345506	16345747	3533	3774	241	RIGHT	L70c.EDF	L70	3
71	16354616	16354625	5806	5815	9	RIGHT	L70c.EDF	L70	3
71	16354680	16354812	5870	6002	132	RIGHT	L70c.EDF	L70	3
72	16357272	16357348	95	171	76	RIGHT	L70c.EDF	L70	3
72	16357712	16357822	535	645	110	RIGHT	L70c.EDF	L70	3
72	16359002	16359228	1825	2051	226	RIGHT	L70c.EDF	L70	3
72	16360366	16360775	3189	3598	409	RIGHT	L70c.EDF	L70	3
72	16361691	16361693	4514	4516	2	RIGHT	L70c.EDF	L70	3
72	16361716	16361716	4539	4539	0	RIGHT	L70c.EDF	L70	3
72	16361741	16363868	4564	6691	2127	RIGHT	L70c.EDF	L70	3
73	16365958	16366086	57	185	128	RIGHT	L70c.EDF	L70	3
73	16366446	16366453	545	552	7	RIGHT	L70c.EDF	L70	3
73	16367507	16367524	1606	1623	17	RIGHT	L70c.EDF	L70	3
73	16367551	16367652	1650	1751	101	RIGHT	L70c.EDF	L70	3
73	16368819	16372714	2918	6813	3895	RIGHT	L70c.EDF	L70	3
74	16374675	16381219	58	6602	6544	RIGHT	L70c.EDF	L70	3
75	16384216	16386270	57	2111	2054	RIGHT	L70c.EDF	L70	3
75	16386850	16390254	2691	6095	3404	RIGHT	L70c.EDF	L70	3
76	16392724	16393121	57	454	397	RIGHT	L70c.EDF	L70	3
76	16393184	16393426	517	759	242	RIGHT	L70c.EDF	L70	3
76	16393449	16393451	782	784	2	RIGHT	L70c.EDF	L70	3
76	16393536	16394279	869	1612	743	RIGHT	L70c.EDF	L70	3
76	16394300	16394366	1633	1699	66	RIGHT	L70c.EDF	L70	3
76	16394390	16399830	1723	7163	5440	RIGHT	L70c.EDF	L70	3
77	16402599	16409546	58	7005	6947	RIGHT	L70c.EDF	L70	3
78	16411726	16412122	57	453	396	RIGHT	L70c.EDF	L70	3
78	16412157	16412158	488	489	1	RIGHT	L70c.EDF	L70	3
78	16415722	16416695	4053	5026	973	RIGHT	L70c.EDF	L70	3
78	16417380	16417781	5711	6112	401	RIGHT	L70c.EDF	L70	3
79	16420023	16420117	58	152	94	RIGHT	L70c.EDF	L70	3
79	16425358	16425835	5393	5870	477	RIGHT	L70c.EDF	L70	3
80	16433297	16433638	5219	5560	341	RIGHT	L70c.EDF	L70	3
81	16437602	16437623	993	1014	21	RIGHT	L70c.EDF	L70	3
81	16437692	16438549	1083	1940	857	RIGHT	L70c.EDF	L70	3
81	16438575	16438729	1966	2120	154	RIGHT	L70c.EDF	L70	3
81	16438975	16439943	2366	3334	968	RIGHT	L70c.EDF	L70	3
81	16439964	16440186	3355	3577	222	RIGHT	L70c.EDF	L70	3
81	16440228	16440236	3619	3627	8	RIGHT	L70c.EDF	L70	3
81	16440264	16440275	3655	3666	11	RIGHT	L70c.EDF	L70	3
81	16440298	16440318	3689	3709	20	RIGHT	L70c.EDF	L70	3
81	16440341	16440352	3732	3743	11	RIGHT	L70c.EDF	L70	3
81	16440379	16440385	3770	3776	6	RIGHT	L70c.EDF	L70	3
81	16440419	16440485	3810	3876	66	RIGHT	L70c.EDF	L70	3
81	16440510	16440729	3901	4120	219	RIGHT	L70c.EDF	L70	3
81	16440753	16440753	4144	4144	0	RIGHT	L70c.EDF	L70	3
81	16440779	16442937	4170	6328	2158	RIGHT	L70c.EDF	L70	3
82	16444995	16445250	73	328	255	RIGHT	L70c.EDF	L70	3
82	16445271	16445290	349	368	19	RIGHT	L70c.EDF	L70	3
82	16445311	16449831	389	4909	4520	RIGHT	L70c.EDF	L70	3
83	16452299	16453298	56	1055	999	RIGHT	L70c.EDF	L70	3
83	16453795	16453935	1552	1692	140	RIGHT	L70c.EDF	L70	3
83	16455114	16458406	2871	6163	3292	RIGHT	L70c.EDF	L70	3
84	16460624	16467492	59	6927	6868	RIGHT	L70c.EDF	L70	3
85	16469677	16469836	59	218	159	RIGHT	L70c.EDF	L70	3
85	16469876	16471255	258	1637	1379	RIGHT	L70c.EDF	L70	3
86	16480512	16480951	1471	1910	439	RIGHT	L70c.EDF	L70	3
87	16487618	16487868	412	662	250	RIGHT	L70c.EDF	L70	3
88	16494834	16494888	57	111	54	RIGHT	L70c.EDF	L70	3
88	16494921	16495552	144	775	631	RIGHT	L70c.EDF	L70	3
88	16500511	16500765	5734	5988	254	RIGHT	L70c.EDF	L70	3
88	16501477	16501771	6700	6994	294	RIGHT	L70c.EDF	L70	3
89	16507526	16507566	57	97	40	RIGHT	L70c.EDF	L70	3
89	16508006	16508340	537	871	334	RIGHT	L70c.EDF	L70	3
90	16516614	16516981	1419	1786	367	RIGHT	L70c.EDF	L70	3
91	16524437	16524767	580	910	330	RIGHT	L70c.EDF	L70	3
92	16533363	16538175	1210	6022	4812	RIGHT	L70c.EDF	L70	3
93	16539686	16540149	57	520	463	RIGHT	L70c.EDF	L70	3
93	16540593	16541757	964	2128	1164	RIGHT	L70c.EDF	L70	3
93	16541969	16545620	2340	5991	3651	RIGHT	L70c.EDF	L70	3
94	16548912	16548936	1559	1583	24	RIGHT	L70c.EDF	L70	3
94	16549933	16554365	2580	7012	4432	RIGHT	L70c.EDF	L70	3
95	16556749	16556751	455	457	2	RIGHT	L70c.EDF	L70	3
95	16556788	16557053	494	759	265	RIGHT	L70c.EDF	L70	3
96	16565192	16565464	237	509	272	RIGHT	L70c.EDF	L70	3
96	16571003	16571326	6048	6371	323	RIGHT	L70c.EDF	L70	3
97	16574439	16575400	760	1721	961	RIGHT	L70c.EDF	L70	3
97	16578588	16578640	4909	4961	52	RIGHT	L70c.EDF	L70	3
98	16581667	16581730	57	120	63	RIGHT	L70c.EDF	L70	3
98	16582525	16582861	915	1251	336	RIGHT	L70c.EDF	L70	3
98	16583256	16583805	1646	2195	549	RIGHT	L70c.EDF	L70	3
98	16584748	16584748	3138	3138	0	RIGHT	L70c.EDF	L70	3
98	16584769	16584787	3159	3177	18	RIGHT	L70c.EDF	L70	3
98	16584826	16584826	3216	3216	0	RIGHT	L70c.EDF	L70	3
98	16584861	16584870	3251	3260	9	RIGHT	L70c.EDF	L70	3
98	16584906	16584906	3296	3296	0	RIGHT	L70c.EDF	L70	3
98	16584940	16584940	3330	3330	0	RIGHT	L70c.EDF	L70	3
98	16585040	16585040	3430	3430	0	RIGHT	L70c.EDF	L70	3
98	16586703	16586735	5093	5125	32	RIGHT	L70c.EDF	L70	3
98	16586988	16586997	5378	5387	9	RIGHT	L70c.EDF	L70	3
98	16587028	16587032	5418	5422	4	RIGHT	L70c.EDF	L70	3
98	16587058	16587064	5448	5454	6	RIGHT	L70c.EDF	L70	3
98	16587087	16587095	5477	5485	8	RIGHT	L70c.EDF	L70	3
98	16587124	16587136	5514	5526	12	RIGHT	L70c.EDF	L70	3
98	16587223	16587233	5613	5623	10	RIGHT	L70c.EDF	L70	3
98	16587376	16587383	5766	5773	7	RIGHT	L70c.EDF	L70	3
98	16587473	16587595	5863	5985	122	RIGHT	L70c.EDF	L70	3
99	16589796	16589882	57	143	86	RIGHT	L70c.EDF	L70	3
99	16590820	16590821	1081	1082	1	RIGHT	L70c.EDF	L70	3
99	16590864	16590868	1125	1129	4	RIGHT	L70c.EDF	L70	3
99	16591168	16591170	1429	1431	2	RIGHT	L70c.EDF	L70	3
99	16591203	16591228	1464	1489	25	RIGHT	L70c.EDF	L70	3
99	16591251	16591411	1512	1672	160	RIGHT	L70c.EDF	L70	3
99	16591435	16591441	1696	1702	6	RIGHT	L70c.EDF	L70	3
99	16591549	16591554	1810	1815	5	RIGHT	L70c.EDF	L70	3
99	16591593	16591595	1854	1856	2	RIGHT	L70c.EDF	L70	3
101	16606713	16606715	973	975	2	RIGHT	L70c.EDF	L70	3
101	16606758	16606773	1018	1033	15	RIGHT	L70c.EDF	L70	3
101	16606963	16606970	1223	1230	7	RIGHT	L70c.EDF	L70	3
101	16606996	16607008	1256	1268	12	RIGHT	L70c.EDF	L70	3
101	16609014	16609062	3274	3322	48	RIGHT	L70c.EDF	L70	3
101	16610680	16610691	4940	4951	11	RIGHT	L70c.EDF	L70	3
103	16621923	16622063	984	1124	140	RIGHT	L70c.EDF	L70	3
103	16622089	16622091	1150	1152	2	RIGHT	L70c.EDF	L70	3
103	16624123	16624225	3184	3286	102	RIGHT	L70c.EDF	L70	3
104	16628399	16628481	58	140	82	RIGHT	L70c.EDF	L70	3
104	16629009	16629042	668	701	33	RIGHT	L70c.EDF	L70	3
104	16629065	16629071	724	730	6	RIGHT	L70c.EDF	L70	3
104	16629125	16629125	784	784	0	RIGHT	L70c.EDF	L70	3
104	16629211	16630297	870	1956	1086	RIGHT	L70c.EDF	L70	3
105	16636854	16637248	57	451	394	RIGHT	L70c.EDF	L70	3
105	16637384	16637750	587	953	366	RIGHT	L70c.EDF	L70	3
105	16641818	16642329	5021	5532	511	RIGHT	L70c.EDF	L70	3
106	16645902	16646233	437	768	331	RIGHT	L70c.EDF	L70	3
106	16648711	16652676	3246	7211	3965	RIGHT	L70c.EDF	L70	3
108	16662175	16662451	58	334	276	RIGHT	L70c.EDF	L70	3
108	16664662	16665040	2545	2923	378	RIGHT	L70c.EDF	L70	3
109	16671559	16671600	58	99	41	RIGHT	L70c.EDF	L70	3
109	16672403	16673203	902	1702	800	RIGHT	L70c.EDF	L70	3
109	16675291	16675295	3790	3794	4	RIGHT	L70c.EDF	L70	3
109	16675442	16675802	3941	4301	360	RIGHT	L70c.EDF	L70	3
109	16676099	16676113	4598	4612	14	RIGHT	L70c.EDF	L70	3
109	16676134	16676167	4633	4666	33	RIGHT	L70c.EDF	L70	3
109	16676233	16677497	4732	5996	1264	RIGHT	L70c.EDF	L70	3
110	16679972	16680361	58	447	389	RIGHT	L70c.EDF	L70	3
110	16680448	16680523	534	609	75	RIGHT	L70c.EDF	L70	3
110	16683121	16683434	3207	3520	313	RIGHT	L70c.EDF	L70	3
110	16687786	16687798	7872	7884	12	RIGHT	L70c.EDF	L70	3
111	16690051	16690678	57	684	627	RIGHT	L70c.EDF	L70	3
111	16690715	16690774	721	780	59	RIGHT	L70c.EDF	L70	3
111	16690800	16691588	806	1594	788	RIGHT	L70c.EDF	L70	3
111	16695261	16695261	5267	5267	0	RIGHT	L70c.EDF	L70	3
111	16695282	16695282	5288	5288	0	RIGHT	L70c.EDF	L70	3
111	16695312	16697416	5318	7422	2104	RIGHT	L70c.EDF	L70	3
111	16697440	16697574	7446	7580	134	RIGHT	L70c.EDF	L70	3
112	16700658	16708843	58	8243	8185	RIGHT	L70c.EDF	L70	3
113	16710384	16711302	58	976	918	RIGHT	L70c.EDF	L70	3
113	16711324	16711330	998	1004	6	RIGHT	L70c.EDF	L70	3
113	16711358	16712560	1032	2234	1202	RIGHT	L70c.EDF	L70	3
113	16713179	16717226	2853	6900	4047	RIGHT	L70c.EDF	L70	3
114	16719247	16726161	58	6972	6914	RIGHT	L70c.EDF	L70	3
115	16727762	16732655	57	4950	4893	RIGHT	L70c.EDF	L70	3
116	16734786	16736783	57	2054	1997	RIGHT	L70c.EDF	L70	3
116	16737354	16740950	2625	6221	3596	RIGHT	L70c.EDF	L70	3
117	16743000	16744493	56	1549	1493	RIGHT	L70c.EDF	L70	3
117	16745818	16747910	2874	4966	2092	RIGHT	L70c.EDF	L70	3
117	16747934	16747943	4990	4999	9	RIGHT	L70c.EDF	L70	3
117	16748256	16748256	5312	5312	0	RIGHT	L70c.EDF	L70	3
117	16748293	16748298	5349	5354	5	RIGHT	L70c.EDF	L70	3
117	16748320	16748338	5376	5394	18	RIGHT	L70c.EDF	L70	3
117	16748529	16748828	5585	5884	299	RIGHT	L70c.EDF	L70	3
117	16748858	16748975	5914	6031	117	RIGHT	L70c.EDF	L70	3
118	16751466	16752649	797	1980	1183	RIGHT	L70c.EDF	L70	3
118	16753224	16757440	2555	6771	4216	RIGHT	L70c.EDF	L70	3
119	16759430	16759703	57	330	273	RIGHT	L70c.EDF	L70	3
119	16761141	16761152	1768	1779	11	RIGHT	L70c.EDF	L70	3
119	16762336	16762740	2963	3367	404	RIGHT	L70c.EDF	L70	3
119	16762782	16765506	3409	6133	2724	RIGHT	L70c.EDF	L70	3
120	16767616	16768105	57	546	489	RIGHT	L70c.EDF	L70	3
120	16768801	16769444	1242	1885	643	RIGHT	L70c.EDF	L70	3
120	16770097	16772239	2538	4680	2142	RIGHT	L70c.EDF	L70	3
1	490303	490390	757	844	87	RIGHT	lora.EDF	lor	1
2	499790	499911	688	809	121	RIGHT	lora.EDF	lor	1
3	508183	508305	325	447	122	RIGHT	lora.EDF	lor	1
4	516983	517102	688	807	119	RIGHT	lora.EDF	lor	1
4	518288	518378	1993	2083	90	RIGHT	lora.EDF	lor	1
6	534248	534383	429	564	135	RIGHT	lora.EDF	lor	1
7	542737	542897	118	278	160	RIGHT	lora.EDF	lor	1
8	553077	553149	2563	2635	72	RIGHT	lora.EDF	lor	1
10	568760	568884	960	1084	124	RIGHT	lora.EDF	lor	1
12	584648	584783	406	541	135	RIGHT	lora.EDF	lor	1
12	587328	587445	3086	3203	117	RIGHT	lora.EDF	lor	1
12	588548	588659	4306	4417	111	RIGHT	lora.EDF	lor	1
13	592494	592638	57	201	144	RIGHT	lora.EDF	lor	1
13	595352	595477	2915	3040	125	RIGHT	lora.EDF	lor	1
13	597215	597315	4778	4878	100	RIGHT	lora.EDF	lor	1
14	602803	602944	120	261	141	RIGHT	lora.EDF	lor	1
15	612243	612341	1230	1328	98	RIGHT	lora.EDF	lor	1
16	644670	644767	640	737	97	RIGHT	lora.EDF	lor	1
16	647026	647118	2996	3088	92	RIGHT	lora.EDF	lor	1
17	653684	653793	1326	1435	109	RIGHT	lora.EDF	lor	1
18	663777	663867	2574	2664	90	RIGHT	lora.EDF	lor	1
19	671389	671606	433	650	217	RIGHT	lora.EDF	lor	1
19	673236	673343	2280	2387	107	RIGHT	lora.EDF	lor	1
21	712704	712816	1479	1591	112	RIGHT	lora.EDF	lor	1
22	721062	721117	2553	2608	55	RIGHT	lora.EDF	lor	1
23	726511	726650	81	220	139	RIGHT	lora.EDF	lor	1
23	732984	733098	6554	6668	114	RIGHT	lora.EDF	lor	1
24	736342	736474	216	348	132	RIGHT	lora.EDF	lor	1
25	744627	744754	677	804	127	RIGHT	lora.EDF	lor	1
25	746567	746706	2617	2756	139	RIGHT	lora.EDF	lor	1
26	756034	756115	4406	4487	81	RIGHT	lora.EDF	lor	1
28	769634	769755	2274	2395	121	RIGHT	lora.EDF	lor	1
29	777088	777175	58	145	87	RIGHT	lora.EDF	lor	1
30	786596	786704	986	1094	108	RIGHT	lora.EDF	lor	1
30	790653	790747	5043	5137	94	RIGHT	lora.EDF	lor	1
31	795834	795956	1893	2015	122	RIGHT	lora.EDF	lor	1
31	798386	798526	4445	4585	140	RIGHT	lora.EDF	lor	1
32	805379	805498	2405	2524	119	RIGHT	lora.EDF	lor	1
33	812449	812584	654	789	135	RIGHT	lora.EDF	lor	1
33	815389	815489	3594	3694	100	RIGHT	lora.EDF	lor	1
34	820869	820937	58	126	68	RIGHT	lora.EDF	lor	1
35	829882	830168	149	435	286	RIGHT	lora.EDF	lor	1
35	834615	834719	4882	4986	104	RIGHT	lora.EDF	lor	1
36	839999	840119	1810	1930	120	RIGHT	lora.EDF	lor	1
37	849267	849408	2175	2316	141	RIGHT	lora.EDF	lor	1
38	856489	856598	123	232	109	RIGHT	lora.EDF	lor	1
38	858330	858447	1964	2081	117	RIGHT	lora.EDF	lor	1
39	869906	870038	6134	6266	132	RIGHT	lora.EDF	lor	1
40	872927	873062	338	473	135	RIGHT	lora.EDF	lor	1
1	623627	623690	56	119	63	LEFT	lxxa.EDF	lxx	1
1	629084	629188	5513	5617	104	LEFT	lxxa.EDF	lxx	1
2	632814	632897	1065	1148	83	LEFT	lxxa.EDF	lxx	1
2	633887	634396	2138	2647	509	LEFT	lxxa.EDF	lxx	1
1	8701780	8701843	1210	1273	63	RIGHT	M13a.EDF	M13	1
2	8712802	8713813	58	1069	1011	RIGHT	M13a.EDF	M13	1
3	8719699	8719783	381	465	84	RIGHT	M13a.EDF	M13	1
5	8734741	8735669	58	986	928	RIGHT	M13a.EDF	M13	1
5	8735713	8735713	1030	1030	0	RIGHT	M13a.EDF	M13	1
7	8748633	8748740	383	490	107	RIGHT	M13a.EDF	M13	1
9	8761393	8761552	368	527	159	RIGHT	M13a.EDF	M13	1
11	8779253	8779258	339	344	5	RIGHT	M13a.EDF	M13	1
12	8786414	8786421	359	366	7	RIGHT	M13a.EDF	M13	1
12	8786448	8786528	393	473	80	RIGHT	M13a.EDF	M13	1
14	8801528	8801533	184	189	5	RIGHT	M13a.EDF	M13	1
14	8801574	8801603	230	259	29	RIGHT	M13a.EDF	M13	1
14	8801641	8801651	297	307	10	RIGHT	M13a.EDF	M13	1
15	8808172	8808299	58	185	127	RIGHT	M13a.EDF	M13	1
16	8817070	8818007	58	995	937	RIGHT	M13a.EDF	M13	1
16	8820922	8821043	3910	4031	121	RIGHT	M13a.EDF	M13	1
17	8823818	8823820	89	91	2	RIGHT	M13a.EDF	M13	1
17	8826187	8826336	2458	2607	149	RIGHT	M13a.EDF	M13	1
18	8832895	8833003	2854	2962	108	RIGHT	M13a.EDF	M13	1
22	8854548	8854610	58	120	62	RIGHT	M13a.EDF	M13	1
22	8854638	8854643	148	153	5	RIGHT	M13a.EDF	M13	1
22	8856366	8856483	1876	1993	117	RIGHT	M13a.EDF	M13	1
23	8861728	8861866	408	546	138	RIGHT	M13a.EDF	M13	1
24	8869506	8869772	60	326	266	RIGHT	M13a.EDF	M13	1
25	8875984	8876007	58	81	23	RIGHT	M13a.EDF	M13	1
26	8884289	8884387	2362	2460	98	RIGHT	M13a.EDF	M13	1
29	8901287	8901294	88	95	7	RIGHT	M13a.EDF	M13	1
31	8915711	8915818	370	477	107	RIGHT	M13a.EDF	M13	1
33	8927905	8927995	58	148	90	RIGHT	M13a.EDF	M13	1
35	8942333	8942425	59	151	92	RIGHT	M13a.EDF	M13	1
35	8942454	8942455	180	181	1	RIGHT	M13a.EDF	M13	1
38	8961249	8961256	107	114	7	RIGHT	M13a.EDF	M13	1
38	8961293	8961371	151	229	78	RIGHT	M13a.EDF	M13	1
38	8961420	8961420	278	278	0	RIGHT	M13a.EDF	M13	1
40	8975176	8975283	1400	1507	107	RIGHT	M13a.EDF	M13	1
43	8992217	8992365	58	206	148	RIGHT	M13a.EDF	M13	1
43	8994524	8994635	2365	2476	111	RIGHT	M13a.EDF	M13	1
45	9005043	9005192	323	472	149	RIGHT	M13a.EDF	M13	1
47	9017793	9017881	508	596	88	RIGHT	M13a.EDF	M13	1
47	9017905	9017906	620	621	1	RIGHT	M13a.EDF	M13	1
48	9024400	9024500	691	791	100	RIGHT	M13a.EDF	M13	1
52	9049980	9050115	370	505	135	RIGHT	M13a.EDF	M13	1
55	9069885	9070026	456	597	141	RIGHT	M13a.EDF	M13	1
58	9089992	9090073	641	722	81	RIGHT	M13a.EDF	M13	1
58	9090108	9090111	757	760	3	RIGHT	M13a.EDF	M13	1
61	9109460	9109575	364	479	115	RIGHT	M13a.EDF	M13	1
61	9110102	9110239	1006	1143	137	RIGHT	M13a.EDF	M13	1
70	9168010	9168159	646	795	149	RIGHT	M13a.EDF	M13	1
71	9173527	9173608	58	139	81	RIGHT	M13a.EDF	M13	1
71	9173646	9173654	177	185	8	RIGHT	M13a.EDF	M13	1
78	9217256	9217430	59	233	174	RIGHT	M13a.EDF	M13	1
79	9223639	9223641	105	107	2	RIGHT	M13a.EDF	M13	1
83	9248170	9248225	58	113	55	RIGHT	M13a.EDF	M13	1
84	9255025	9255158	577	710	133	RIGHT	M13a.EDF	M13	1
84	9255193	9255195	745	747	2	RIGHT	M13a.EDF	M13	1
88	9280783	9280810	133	160	27	RIGHT	M13a.EDF	M13	1
88	9280856	9280870	206	220	14	RIGHT	M13a.EDF	M13	1
89	9286677	9286688	94	105	11	RIGHT	M13a.EDF	M13	1
90	9293036	9293041	211	216	5	RIGHT	M13a.EDF	M13	1
91	9299727	9299857	356	486	130	RIGHT	M13a.EDF	M13	1
91	9300503	9300587	1132	1216	84	RIGHT	M13a.EDF	M13	1
94	9316922	9316925	768	771	3	RIGHT	M13a.EDF	M13	1
94	9316947	9317016	793	862	69	RIGHT	M13a.EDF	M13	1
94	9317050	9317057	896	903	7	RIGHT	M13a.EDF	M13	1
95	9322521	9322532	195	206	11	RIGHT	M13a.EDF	M13	1
95	9322560	9322572	234	246	12	RIGHT	M13a.EDF	M13	1
95	9322609	9322628	283	302	19	RIGHT	M13a.EDF	M13	1
96	9329293	9329425	583	715	132	RIGHT	M13a.EDF	M13	1
96	9329466	9329475	756	765	9	RIGHT	M13a.EDF	M13	1
98	9339760	9339873	556	669	113	RIGHT	M13a.EDF	M13	1
98	9339903	9339910	699	706	7	RIGHT	M13a.EDF	M13	1
100	9351222	9351269	89	136	47	RIGHT	M13a.EDF	M13	1
100	9351308	9351321	175	188	13	RIGHT	M13a.EDF	M13	1
101	9356720	9356813	57	150	93	RIGHT	M13a.EDF	M13	1
103	9368947	9369058	710	821	111	RIGHT	M13a.EDF	M13	1
103	9369091	9369098	854	861	7	RIGHT	M13a.EDF	M13	1
104	9374483	9374492	91	100	9	RIGHT	M13a.EDF	M13	1
104	9374526	9374587	134	195	61	RIGHT	M13a.EDF	M13	1
104	9374622	9374636	230	244	14	RIGHT	M13a.EDF	M13	1
105	9379761	9379801	59	99	40	RIGHT	M13a.EDF	M13	1
105	9379826	9379844	124	142	18	RIGHT	M13a.EDF	M13	1
105	9380376	9380381	674	679	5	RIGHT	M13a.EDF	M13	1
105	9380403	9380559	701	857	156	RIGHT	M13a.EDF	M13	1
105	9380604	9380609	902	907	5	RIGHT	M13a.EDF	M13	1
107	9393364	9393481	528	645	117	RIGHT	M13a.EDF	M13	1
107	9393508	9393517	672	681	9	RIGHT	M13a.EDF	M13	1
111	9415292	9415418	81	207	126	RIGHT	M13a.EDF	M13	1
113	9430145	9430255	59	169	110	RIGHT	M13a.EDF	M13	1
113	9430290	9430317	204	231	27	RIGHT	M13a.EDF	M13	1
114	9437737	9437858	643	764	121	RIGHT	M13a.EDF	M13	1
114	9437901	9437907	807	813	6	RIGHT	M13a.EDF	M13	1
117	9454483	9454488	270	275	5	RIGHT	M13a.EDF	M13	1
118	9460568	9460593	133	158	25	RIGHT	M13a.EDF	M13	1
1	9943349	9943464	2365	2480	115	RIGHT	M13b.EDF	M13	2
2	9949079	9949141	328	390	62	RIGHT	M13b.EDF	M13	2
6	9972951	9973061	1258	1368	110	RIGHT	M13b.EDF	M13	2
8	9984498	9984663	443	608	165	RIGHT	M13b.EDF	M13	2
8	9984689	9984698	634	643	9	RIGHT	M13b.EDF	M13	2
10	9996054	9996441	328	715	387	RIGHT	M13b.EDF	M13	2
11	10003646	10003786	708	848	140	RIGHT	M13b.EDF	M13	2
15	10028108	10028230	515	637	122	RIGHT	M13b.EDF	M13	2
17	10038283	10038401	446	564	118	RIGHT	M13b.EDF	M13	2
18	10043690	10043695	95	100	5	RIGHT	M13b.EDF	M13	2
23	10072560	10072725	58	223	165	RIGHT	M13b.EDF	M13	2
25	10084836	10084842	426	432	6	RIGHT	M13b.EDF	M13	2
25	10084868	10085141	458	731	273	RIGHT	M13b.EDF	M13	2
26	10089865	10089924	64	123	59	RIGHT	M13b.EDF	M13	2
26	10089958	10089964	157	163	6	RIGHT	M13b.EDF	M13	2
28	10100920	10100921	178	179	1	RIGHT	M13b.EDF	M13	2
28	10100953	10101052	211	310	99	RIGHT	M13b.EDF	M13	2
28	10101082	10101094	340	352	12	RIGHT	M13b.EDF	M13	2
31	10118843	10118968	357	482	125	RIGHT	M13b.EDF	M13	2
32	10123455	10123556	59	160	101	RIGHT	M13b.EDF	M13	2
32	10123584	10123590	188	194	6	RIGHT	M13b.EDF	M13	2
35	10139802	10139958	348	504	156	RIGHT	M13b.EDF	M13	2
38	10156418	10156423	97	102	5	RIGHT	M13b.EDF	M13	2
39	10162383	10162388	211	216	5	RIGHT	M13b.EDF	M13	2
39	10162728	10162850	556	678	122	RIGHT	M13b.EDF	M13	2
41	10173738	10173842	57	161	104	RIGHT	M13b.EDF	M13	2
41	10173864	10173894	183	213	30	RIGHT	M13b.EDF	M13	2
42	10179137	10179153	142	158	16	RIGHT	M13b.EDF	M13	2
42	10179177	10179312	182	317	135	RIGHT	M13b.EDF	M13	2
43	10184924	10185125	380	581	201	RIGHT	M13b.EDF	M13	2
44	10190587	10190751	375	539	164	RIGHT	M13b.EDF	M13	2
45	10196596	10196756	612	772	160	RIGHT	M13b.EDF	M13	2
46	10201401	10201460	83	142	59	RIGHT	M13b.EDF	M13	2
46	10201494	10201499	176	181	5	RIGHT	M13b.EDF	M13	2
49	10217316	10217535	372	591	219	RIGHT	M13b.EDF	M13	2
50	10223480	10223713	377	610	233	RIGHT	M13b.EDF	M13	2
51	10228707	10228781	59	133	74	RIGHT	M13b.EDF	M13	2
51	10228809	10228845	161	197	36	RIGHT	M13b.EDF	M13	2
52	10233694	10233696	78	80	2	RIGHT	M13b.EDF	M13	2
52	10233720	10233728	104	112	8	RIGHT	M13b.EDF	M13	2
53	10239729	10239937	630	838	208	RIGHT	M13b.EDF	M13	2
53	10239961	10239964	862	865	3	RIGHT	M13b.EDF	M13	2
56	10257322	10257518	684	880	196	RIGHT	M13b.EDF	M13	2
58	10267721	10267882	99	260	161	RIGHT	M13b.EDF	M13	2
59	10273153	10273397	275	519	244	RIGHT	M13b.EDF	M13	2
59	10273423	10273424	545	546	1	RIGHT	M13b.EDF	M13	2
60	10279123	10279186	58	121	63	RIGHT	M13b.EDF	M13	2
60	10279228	10279240	163	175	12	RIGHT	M13b.EDF	M13	2
60	10279264	10279280	199	215	16	RIGHT	M13b.EDF	M13	2
61	10286254	10286480	346	572	226	RIGHT	M13b.EDF	M13	2
64	10303199	10303208	105	114	9	RIGHT	M13b.EDF	M13	2
65	10308970	10309011	59	100	41	RIGHT	M13b.EDF	M13	2
65	10309040	10309073	129	162	33	RIGHT	M13b.EDF	M13	2
66	10315780	10315803	124	147	23	RIGHT	M13b.EDF	M13	2
66	10315830	10316009	174	353	179	RIGHT	M13b.EDF	M13	2
66	10316038	10316092	382	436	54	RIGHT	M13b.EDF	M13	2
68	10327563	10327755	577	769	192	RIGHT	M13b.EDF	M13	2
69	10333342	10333499	589	746	157	RIGHT	M13b.EDF	M13	2
69	10333521	10333524	768	771	3	RIGHT	M13b.EDF	M13	2
70	10338953	10339162	579	788	209	RIGHT	M13b.EDF	M13	2
72	10351629	10351732	395	498	103	RIGHT	M13b.EDF	M13	2
73	10357165	10357345	385	565	180	RIGHT	M13b.EDF	M13	2
75	10369175	10369197	83	105	22	RIGHT	M13b.EDF	M13	2
76	10375348	10375511	376	539	163	RIGHT	M13b.EDF	M13	2
76	10375537	10375539	565	567	2	RIGHT	M13b.EDF	M13	2
77	10381981	10381997	369	385	16	RIGHT	M13b.EDF	M13	2
78	10387937	10388010	59	132	73	RIGHT	M13b.EDF	M13	2
78	10388039	10388059	161	181	20	RIGHT	M13b.EDF	M13	2
80	10399917	10399994	59	136	77	RIGHT	M13b.EDF	M13	2
80	10400028	10400044	170	186	16	RIGHT	M13b.EDF	M13	2
82	10411080	10411095	367	382	15	RIGHT	M13b.EDF	M13	2
82	10411151	10411169	438	456	18	RIGHT	M13b.EDF	M13	2
82	10411194	10411195	481	482	1	RIGHT	M13b.EDF	M13	2
83	10416940	10417140	528	728	200	RIGHT	M13b.EDF	M13	2
85	10428219	10428234	149	164	15	RIGHT	M13b.EDF	M13	2
85	10428273	10428274	203	204	1	RIGHT	M13b.EDF	M13	2
85	10428569	10428748	499	678	179	RIGHT	M13b.EDF	M13	2
86	10433851	10434070	340	559	219	RIGHT	M13b.EDF	M13	2
86	10434110	10434112	599	601	2	RIGHT	M13b.EDF	M13	2
89	10452350	10452480	581	711	130	RIGHT	M13b.EDF	M13	2
89	10452510	10452530	741	761	20	RIGHT	M13b.EDF	M13	2
91	10463091	10463262	335	506	171	RIGHT	M13b.EDF	M13	2
91	10463748	10463775	992	1019	27	RIGHT	M13b.EDF	M13	2
91	10463797	10463862	1041	1106	65	RIGHT	M13b.EDF	M13	2
93	10473564	10473696	617	749	132	RIGHT	M13b.EDF	M13	2
93	10473717	10473740	770	793	23	RIGHT	M13b.EDF	M13	2
95	10484562	10484587	571	596	25	RIGHT	M13b.EDF	M13	2
95	10484609	10484778	618	787	169	RIGHT	M13b.EDF	M13	2
96	10489714	10489768	84	138	54	RIGHT	M13b.EDF	M13	2
97	10496554	10496611	128	185	57	RIGHT	M13b.EDF	M13	2
98	10501622	10501670	114	162	48	RIGHT	M13b.EDF	M13	2
99	10507888	10507911	340	363	23	RIGHT	M13b.EDF	M13	2
99	10507935	10508087	387	539	152	RIGHT	M13b.EDF	M13	2
99	10508129	10508157	581	609	28	RIGHT	M13b.EDF	M13	2
100	10513366	10513383	370	387	17	RIGHT	M13b.EDF	M13	2
100	10513404	10513488	408	492	84	RIGHT	M13b.EDF	M13	2
100	10513530	10513585	534	589	55	RIGHT	M13b.EDF	M13	2
101	10519233	10519277	58	102	44	RIGHT	M13b.EDF	M13	2
101	10519328	10519409	153	234	81	RIGHT	M13b.EDF	M13	2
103	10531098	10531473	355	730	375	RIGHT	M13b.EDF	M13	2
103	10531503	10531541	760	798	38	RIGHT	M13b.EDF	M13	2
104	10537181	10537391	395	605	210	RIGHT	M13b.EDF	M13	2
105	10542152	10542257	291	396	105	RIGHT	M13b.EDF	M13	2
105	10542288	10542335	427	474	47	RIGHT	M13b.EDF	M13	2
106	10548896	10549101	335	540	205	RIGHT	M13b.EDF	M13	2
107	10554164	10554193	58	87	29	RIGHT	M13b.EDF	M13	2
107	10554227	10554288	121	182	61	RIGHT	M13b.EDF	M13	2
109	10565219	10565230	74	85	11	RIGHT	M13b.EDF	M13	2
109	10565474	10565489	329	344	15	RIGHT	M13b.EDF	M13	2
109	10565516	10566023	371	878	507	RIGHT	M13b.EDF	M13	2
110	10570624	10570716	66	158	92	RIGHT	M13b.EDF	M13	2
110	10570737	10570861	179	303	124	RIGHT	M13b.EDF	M13	2
111	10577056	10577101	58	103	45	RIGHT	M13b.EDF	M13	2
115	10599314	10599660	374	720	346	RIGHT	M13b.EDF	M13	2
116	10604921	10605141	300	520	220	RIGHT	M13b.EDF	M13	2
117	10610747	10610765	72	90	18	RIGHT	M13b.EDF	M13	2
1	11136372	11136558	1254	1440	186	RIGHT	M13c.EDF	M13	3
1	11136601	11136601	1483	1483	0	RIGHT	M13c.EDF	M13	3
2	11142711	11142721	148	158	10	RIGHT	M13c.EDF	M13	3
2	11142747	11142823	184	260	76	RIGHT	M13c.EDF	M13	3
2	11142852	11142878	289	315	26	RIGHT	M13c.EDF	M13	3
6	11166635	11166815	653	833	180	RIGHT	M13c.EDF	M13	3
8	11176960	11176995	58	93	35	RIGHT	M13c.EDF	M13	3
9	11182488	11182493	118	123	5	RIGHT	M13c.EDF	M13	3
9	11182517	11182674	147	304	157	RIGHT	M13c.EDF	M13	3
11	11193242	11193479	150	387	237	RIGHT	M13c.EDF	M13	3
12	11201996	11202197	3476	3677	201	RIGHT	M13c.EDF	M13	3
13	11205237	11205434	61	258	197	RIGHT	M13c.EDF	M13	3
15	11216432	11216475	58	101	43	RIGHT	M13c.EDF	M13	3
16	11222370	11222373	86	89	3	RIGHT	M13c.EDF	M13	3
16	11222401	11222535	117	251	134	RIGHT	M13c.EDF	M13	3
17	11228985	11229150	927	1092	165	RIGHT	M13c.EDF	M13	3
18	11233496	11233515	58	77	19	RIGHT	M13c.EDF	M13	3
19	11238964	11239107	224	367	143	RIGHT	M13c.EDF	M13	3
21	11251066	11251281	491	706	215	RIGHT	M13c.EDF	M13	3
23	11261592	11261759	363	530	167	RIGHT	M13c.EDF	M13	3
24	11266731	11266817	332	418	86	RIGHT	M13c.EDF	M13	3
26	11278587	11278711	100	224	124	RIGHT	M13c.EDF	M13	3
27	11284639	11284774	58	193	135	RIGHT	M13c.EDF	M13	3
28	11289714	11289811	156	253	97	RIGHT	M13c.EDF	M13	3
29	11295134	11295171	58	95	37	RIGHT	M13c.EDF	M13	3
30	11299912	11299935	65	88	23	RIGHT	M13c.EDF	M13	3
30	11299965	11300129	118	282	164	RIGHT	M13c.EDF	M13	3
31	11305559	11305761	360	562	202	RIGHT	M13c.EDF	M13	3
32	11310371	11310493	58	180	122	RIGHT	M13c.EDF	M13	3
34	11321395	11321409	72	86	14	RIGHT	M13c.EDF	M13	3
35	11327183	11327288	91	196	105	RIGHT	M13c.EDF	M13	3
35	11327608	11327943	516	851	335	RIGHT	M13c.EDF	M13	3
37	11337894	11338060	334	500	166	RIGHT	M13c.EDF	M13	3
41	11360232	11360426	81	275	194	RIGHT	M13c.EDF	M13	3
41	11360737	11360985	586	834	248	RIGHT	M13c.EDF	M13	3
44	11377694	11377937	58	301	243	RIGHT	M13c.EDF	M13	3
44	11378285	11378560	649	924	275	RIGHT	M13c.EDF	M13	3
46	11388824	11389012	59	247	188	RIGHT	M13c.EDF	M13	3
49	11405929	11405998	58	127	69	RIGHT	M13c.EDF	M13	3
50	11411348	11411594	163	409	246	RIGHT	M13c.EDF	M13	3
51	11416585	11416646	58	119	61	RIGHT	M13c.EDF	M13	3
51	11416677	11416771	150	244	94	RIGHT	M13c.EDF	M13	3
52	11421818	11421981	58	221	163	RIGHT	M13c.EDF	M13	3
52	11422004	11422058	244	298	54	RIGHT	M13c.EDF	M13	3
52	11422303	11422324	543	564	21	RIGHT	M13c.EDF	M13	3
52	11422349	11422538	589	778	189	RIGHT	M13c.EDF	M13	3
53	11427799	11427869	68	138	70	RIGHT	M13c.EDF	M13	3
54	11434051	11434265	491	705	214	RIGHT	M13c.EDF	M13	3
55	11439599	11439756	315	472	157	RIGHT	M13c.EDF	M13	3
56	11445273	11445580	58	365	307	RIGHT	M13c.EDF	M13	3
57	11451042	11451065	90	113	23	RIGHT	M13c.EDF	M13	3
57	11451095	11451165	143	213	70	RIGHT	M13c.EDF	M13	3
57	11451194	11451233	242	281	39	RIGHT	M13c.EDF	M13	3
57	11451457	11451778	505	826	321	RIGHT	M13c.EDF	M13	3
58	11456784	11456882	57	155	98	RIGHT	M13c.EDF	M13	3
59	11462378	11462522	58	202	144	RIGHT	M13c.EDF	M13	3
59	11462744	11463101	424	781	357	RIGHT	M13c.EDF	M13	3
60	11468470	11468698	352	580	228	RIGHT	M13c.EDF	M13	3
61	11473823	11473983	357	517	160	RIGHT	M13c.EDF	M13	3
62	11479484	11479635	58	209	151	RIGHT	M13c.EDF	M13	3
62	11479963	11480224	537	798	261	RIGHT	M13c.EDF	M13	3
63	11484760	11484979	58	277	219	RIGHT	M13c.EDF	M13	3
64	11490945	11491135	59	249	190	RIGHT	M13c.EDF	M13	3
65	11497151	11497185	58	92	34	RIGHT	M13c.EDF	M13	3
65	11497217	11497280	124	187	63	RIGHT	M13c.EDF	M13	3
67	11508736	11508907	640	811	171	RIGHT	M13c.EDF	M13	3
69	11519868	11520043	477	652	175	RIGHT	M13c.EDF	M13	3
71	11531892	11532204	308	620	312	RIGHT	M13c.EDF	M13	3
72	11537316	11537409	58	151	93	RIGHT	M13c.EDF	M13	3
72	11537692	11537947	434	689	255	RIGHT	M13c.EDF	M13	3
73	11542868	11542975	58	165	107	RIGHT	M13c.EDF	M13	3
74	11549792	11549813	59	80	21	RIGHT	M13c.EDF	M13	3
74	11549850	11549929	117	196	79	RIGHT	M13c.EDF	M13	3
76	11561650	11561869	57	276	219	RIGHT	M13c.EDF	M13	3
77	11568092	11568318	739	965	226	RIGHT	M13c.EDF	M13	3
78	11572858	11572936	341	419	78	RIGHT	M13c.EDF	M13	3
79	11578822	11578834	71	83	12	RIGHT	M13c.EDF	M13	3
81	11589388	11589420	258	290	32	RIGHT	M13c.EDF	M13	3
81	11589453	11589838	323	708	385	RIGHT	M13c.EDF	M13	3
82	11595411	11595760	58	407	349	RIGHT	M13c.EDF	M13	3
83	11601369	11601438	97	166	69	RIGHT	M13c.EDF	M13	3
83	11605198	11605207	3926	3935	9	RIGHT	M13c.EDF	M13	3
83	11605255	11605391	3983	4119	136	RIGHT	M13c.EDF	M13	3
86	11618370	11618727	257	614	357	RIGHT	M13c.EDF	M13	3
87	11626981	11627052	3528	3599	71	RIGHT	M13c.EDF	M13	3
87	11627087	11627115	3634	3662	28	RIGHT	M13c.EDF	M13	3
88	11629176	11629234	57	115	58	RIGHT	M13c.EDF	M13	3
88	11629256	11629358	137	239	102	RIGHT	M13c.EDF	M13	3
88	11629653	11629675	534	556	22	RIGHT	M13c.EDF	M13	3
88	11629700	11629969	581	850	269	RIGHT	M13c.EDF	M13	3
91	11645867	11646065	326	524	198	RIGHT	M13c.EDF	M13	3
92	11651135	11651323	574	762	188	RIGHT	M13c.EDF	M13	3
93	11656237	11656367	58	188	130	RIGHT	M13c.EDF	M13	3
93	11656557	11656799	378	620	242	RIGHT	M13c.EDF	M13	3
94	11661193	11661234	58	99	41	RIGHT	M13c.EDF	M13	3
96	11673230	11673353	58	181	123	RIGHT	M13c.EDF	M13	3
97	11678992	11679328	305	641	336	RIGHT	M13c.EDF	M13	3
97	11681441	11681461	2754	2774	20	RIGHT	M13c.EDF	M13	3
97	11681513	11681513	2826	2826	0	RIGHT	M13c.EDF	M13	3
99	11690333	11690333	84	84	0	RIGHT	M13c.EDF	M13	3
102	11705925	11706031	58	164	106	RIGHT	M13c.EDF	M13	3
102	11706064	11706188	197	321	124	RIGHT	M13c.EDF	M13	3
104	11716957	11716976	59	78	19	RIGHT	M13c.EDF	M13	3
104	11717245	11717266	347	368	21	RIGHT	M13c.EDF	M13	3
104	11717290	11717488	392	590	198	RIGHT	M13c.EDF	M13	3
104	11717533	11717589	635	691	56	RIGHT	M13c.EDF	M13	3
104	11719647	11719647	2749	2749	0	RIGHT	M13c.EDF	M13	3
104	11719824	11719824	2926	2926	0	RIGHT	M13c.EDF	M13	3
107	11732906	11733113	58	265	207	RIGHT	M13c.EDF	M13	3
107	11733247	11733247	399	399	0	RIGHT	M13c.EDF	M13	3
108	11738314	11738530	58	274	216	RIGHT	M13c.EDF	M13	3
108	11738557	11738664	301	408	107	RIGHT	M13c.EDF	M13	3
111	11756039	11756275	303	539	236	RIGHT	M13c.EDF	M13	3
111	11756298	11756363	562	627	65	RIGHT	M13c.EDF	M13	3
115	11778932	11779122	214	404	190	RIGHT	M13c.EDF	M13	3
115	11779145	11779234	427	516	89	RIGHT	M13c.EDF	M13	3
117	11789855	11789857	84	86	2	RIGHT	M13c.EDF	M13	3
117	11790013	11790292	242	521	279	RIGHT	M13c.EDF	M13	3
120	11807530	11807640	58	168	110	RIGHT	M13c.EDF	M13	3
120	11807667	11807879	195	407	212	RIGHT	M13c.EDF	M13	3
120	11808007	11808034	535	562	27	RIGHT	M13c.EDF	M13	3
120	11808059	11808257	587	785	198	RIGHT	M13c.EDF	M13	3
120	11808283	11808398	811	926	115	RIGHT	M13c.EDF	M13	3
2	5307713	5307833	248	368	120	RIGHT	M22a.EDF	M22	1
4	5328790	5328928	237	375	138	RIGHT	M22a.EDF	M22	1
4	5329401	5331115	848	2562	1714	RIGHT	M22a.EDF	M22	1
5	5337619	5338041	1023	1445	422	RIGHT	M22a.EDF	M22	1
6	5346430	5346475	57	102	45	RIGHT	M22a.EDF	M22	1
6	5347503	5347529	1130	1156	26	RIGHT	M22a.EDF	M22	1
6	5347696	5347777	1323	1404	81	RIGHT	M22a.EDF	M22	1
7	5356339	5356399	1522	1582	60	RIGHT	M22a.EDF	M22	1
7	5356639	5356648	1822	1831	9	RIGHT	M22a.EDF	M22	1
10	5385374	5385398	2121	2145	24	RIGHT	M22a.EDF	M22	1
10	5385443	5385483	2190	2230	40	RIGHT	M22a.EDF	M22	1
11	5392695	5392821	112	238	126	RIGHT	M22a.EDF	M22	1
12	5403194	5403276	57	139	82	RIGHT	M22a.EDF	M22	1
12	5403532	5403547	395	410	15	RIGHT	M22a.EDF	M22	1
12	5403594	5404150	457	1013	556	RIGHT	M22a.EDF	M22	1
14	5422083	5422181	765	863	98	RIGHT	M22a.EDF	M22	1
15	5430102	5430222	801	921	120	RIGHT	M22a.EDF	M22	1
16	5440597	5440718	776	897	121	RIGHT	M22a.EDF	M22	1
19	5466936	5467083	959	1106	147	RIGHT	M22a.EDF	M22	1
20	5475657	5475776	336	455	119	RIGHT	M22a.EDF	M22	1
22	5494318	5494462	1306	1450	144	RIGHT	M22a.EDF	M22	1
23	5503205	5503318	58	171	113	RIGHT	M22a.EDF	M22	1
24	5514274	5514421	1128	1275	147	RIGHT	M22a.EDF	M22	1
25	5524546	5524671	694	819	125	RIGHT	M22a.EDF	M22	1
26	5533267	5533396	180	309	129	RIGHT	M22a.EDF	M22	1
27	5541845	5541969	703	827	124	RIGHT	M22a.EDF	M22	1
28	5551948	5552037	297	386	89	RIGHT	M22a.EDF	M22	1
30	5572000	5572163	699	862	163	RIGHT	M22a.EDF	M22	1
31	5580773	5580892	289	408	119	RIGHT	M22a.EDF	M22	1
32	5590589	5590635	57	103	46	RIGHT	M22a.EDF	M22	1
33	5598896	5599006	168	278	110	RIGHT	M22a.EDF	M22	1
34	5607427	5607560	386	519	133	RIGHT	M22a.EDF	M22	1
35	5617132	5617243	124	235	111	RIGHT	M22a.EDF	M22	1
35	5619030	5619058	2022	2050	28	RIGHT	M22a.EDF	M22	1
36	5626722	5626857	108	243	135	RIGHT	M22a.EDF	M22	1
37	5636119	5636224	169	274	105	RIGHT	M22a.EDF	M22	1
37	5636745	5636876	795	926	131	RIGHT	M22a.EDF	M22	1
37	5637429	5637555	1479	1605	126	RIGHT	M22a.EDF	M22	1
38	5646026	5646918	1240	2132	892	RIGHT	M22a.EDF	M22	1
38	5647271	5647693	2485	2907	422	RIGHT	M22a.EDF	M22	1
38	5647757	5648162	2971	3376	405	RIGHT	M22a.EDF	M22	1
38	5648236	5648244	3450	3458	8	RIGHT	M22a.EDF	M22	1
38	5648303	5648310	3517	3524	7	RIGHT	M22a.EDF	M22	1
38	5648373	5648457	3587	3671	84	RIGHT	M22a.EDF	M22	1
38	5648532	5648594	3746	3808	62	RIGHT	M22a.EDF	M22	1
38	5648724	5648793	3938	4007	69	RIGHT	M22a.EDF	M22	1
38	5648862	5649018	4076	4232	156	RIGHT	M22a.EDF	M22	1
38	5649058	5649232	4272	4446	174	RIGHT	M22a.EDF	M22	1
38	5649308	5649405	4522	4619	97	RIGHT	M22a.EDF	M22	1
38	5649699	5649829	4913	5043	130	RIGHT	M22a.EDF	M22	1
38	5650281	5650328	5495	5542	47	RIGHT	M22a.EDF	M22	1
39	5654114	5654273	1044	1203	159	RIGHT	M22a.EDF	M22	1
39	5654907	5654910	1837	1840	3	RIGHT	M22a.EDF	M22	1
39	5654934	5655028	1864	1958	94	RIGHT	M22a.EDF	M22	1
39	5655076	5655214	2006	2144	138	RIGHT	M22a.EDF	M22	1
39	5655317	5655476	2247	2406	159	RIGHT	M22a.EDF	M22	1
39	5655871	5655878	2801	2808	7	RIGHT	M22a.EDF	M22	1
39	5655965	5657441	2895	4371	1476	RIGHT	M22a.EDF	M22	1
40	5661278	5661423	123	268	145	RIGHT	M22a.EDF	M22	1
40	5662551	5662724	1396	1569	173	RIGHT	M22a.EDF	M22	1
40	5663147	5666879	1992	5724	3732	RIGHT	M22a.EDF	M22	1
41	5670269	5670656	57	444	387	RIGHT	M22a.EDF	M22	1
41	5671928	5672245	1716	2033	317	RIGHT	M22a.EDF	M22	1
41	5672486	5673219	2274	3007	733	RIGHT	M22a.EDF	M22	1
41	5674596	5674924	4384	4712	328	RIGHT	M22a.EDF	M22	1
42	5677909	5678030	93	214	121	RIGHT	M22a.EDF	M22	1
42	5679574	5679590	1758	1774	16	RIGHT	M22a.EDF	M22	1
42	5679648	5680381	1832	2565	733	RIGHT	M22a.EDF	M22	1
42	5680505	5680582	2689	2766	77	RIGHT	M22a.EDF	M22	1
42	5681201	5681622	3385	3806	421	RIGHT	M22a.EDF	M22	1
42	5681808	5681883	3992	4067	75	RIGHT	M22a.EDF	M22	1
42	5681907	5684570	4091	6754	2663	RIGHT	M22a.EDF	M22	1
43	5694393	5697517	1306	4430	3124	RIGHT	M22a.EDF	M22	1
43	5698680	5699530	5593	6443	850	RIGHT	M22a.EDF	M22	1
44	5711639	5711783	1283	1427	144	RIGHT	M22a.EDF	M22	1
44	5712415	5712971	2059	2615	556	RIGHT	M22a.EDF	M22	1
44	5712997	5713382	2641	3026	385	RIGHT	M22a.EDF	M22	1
44	5714494	5714521	4138	4165	27	RIGHT	M22a.EDF	M22	1
44	5714575	5714644	4219	4288	69	RIGHT	M22a.EDF	M22	1
44	5714751	5716200	4395	5844	1449	RIGHT	M22a.EDF	M22	1
45	5720940	5721058	1107	1225	118	RIGHT	M22a.EDF	M22	1
45	5721587	5722263	1754	2430	676	RIGHT	M22a.EDF	M22	1
45	5722290	5723747	2457	3914	1457	RIGHT	M22a.EDF	M22	1
45	5723990	5724514	4157	4681	524	RIGHT	M22a.EDF	M22	1
45	5724611	5724686	4778	4853	75	RIGHT	M22a.EDF	M22	1
45	5724774	5725127	4941	5294	353	RIGHT	M22a.EDF	M22	1
45	5725264	5725313	5431	5480	49	RIGHT	M22a.EDF	M22	1
45	5725454	5725502	5621	5669	48	RIGHT	M22a.EDF	M22	1
45	5725582	5726676	5749	6843	1094	RIGHT	M22a.EDF	M22	1
46	5731431	5736142	862	5573	4711	RIGHT	M22a.EDF	M22	1
47	5739361	5740068	127	834	707	RIGHT	M22a.EDF	M22	1
47	5740139	5740196	905	962	57	RIGHT	M22a.EDF	M22	1
47	5740223	5740402	989	1168	179	RIGHT	M22a.EDF	M22	1
47	5742385	5745068	3151	5834	2683	RIGHT	M22a.EDF	M22	1
48	5748117	5754293	207	6383	6176	RIGHT	M22a.EDF	M22	1
49	5756912	5762738	57	5883	5826	RIGHT	M22a.EDF	M22	1
50	5765086	5766181	57	1152	1095	RIGHT	M22a.EDF	M22	1
50	5766229	5770843	1200	5814	4614	RIGHT	M22a.EDF	M22	1
51	5774034	5780769	119	6854	6735	RIGHT	M22a.EDF	M22	1
52	5783258	5789195	57	5994	5937	RIGHT	M22a.EDF	M22	1
53	5792164	5798691	57	6584	6527	RIGHT	M22a.EDF	M22	1
54	5802360	5808817	58	6515	6457	RIGHT	M22a.EDF	M22	1
55	5812326	5819333	57	7064	7007	RIGHT	M22a.EDF	M22	1
56	5822835	5823297	70	532	462	RIGHT	M22a.EDF	M22	1
56	5823415	5828359	650	5594	4944	RIGHT	M22a.EDF	M22	1
57	5831348	5836894	78	5624	5546	RIGHT	M22a.EDF	M22	1
58	5839761	5844559	57	4855	4798	RIGHT	M22a.EDF	M22	1
59	5848210	5848230	180	200	20	RIGHT	M22a.EDF	M22	1
59	5848488	5849131	458	1101	643	RIGHT	M22a.EDF	M22	1
59	5849176	5852764	1146	4734	3588	RIGHT	M22a.EDF	M22	1
60	5858012	5864261	57	6306	6249	RIGHT	M22a.EDF	M22	1
61	5867269	5873307	57	6095	6038	RIGHT	M22a.EDF	M22	1
62	5876616	5881822	57	5263	5206	RIGHT	M22a.EDF	M22	1
63	5885151	5890147	57	5053	4996	RIGHT	M22a.EDF	M22	1
64	5893575	5899062	96	5583	5487	RIGHT	M22a.EDF	M22	1
65	5902731	5903547	57	873	816	RIGHT	M22a.EDF	M22	1
65	5903619	5909129	945	6455	5510	RIGHT	M22a.EDF	M22	1
66	5912028	5918684	57	6713	6656	RIGHT	M22a.EDF	M22	1
67	5921643	5922812	57	1226	1169	RIGHT	M22a.EDF	M22	1
67	5922877	5928811	1291	7225	5934	RIGHT	M22a.EDF	M22	1
68	5931837	5936676	144	4983	4839	RIGHT	M22a.EDF	M22	1
69	5940795	5940848	57	110	53	RIGHT	M22a.EDF	M22	1
69	5941456	5941584	718	846	128	RIGHT	M22a.EDF	M22	1
69	5942829	5945561	2091	4823	2732	RIGHT	M22a.EDF	M22	1
70	5947963	5947997	151	185	34	RIGHT	M22a.EDF	M22	1
70	5948132	5948301	320	489	169	RIGHT	M22a.EDF	M22	1
70	5948396	5954186	584	6374	5790	RIGHT	M22a.EDF	M22	1
71	5961330	5962125	57	852	795	RIGHT	M22a.EDF	M22	1
71	5962163	5967545	890	6272	5382	RIGHT	M22a.EDF	M22	1
72	5970284	5975720	57	5493	5436	RIGHT	M22a.EDF	M22	1
73	5978812	5983274	169	4631	4462	RIGHT	M22a.EDF	M22	1
74	5986364	5992710	58	6404	6346	RIGHT	M22a.EDF	M22	1
75	5995719	5996386	57	724	667	RIGHT	M22a.EDF	M22	1
75	5996458	6001966	796	6304	5508	RIGHT	M22a.EDF	M22	1
76	6005144	6010461	57	5374	5317	RIGHT	M22a.EDF	M22	1
77	6013509	6018736	57	5284	5227	RIGHT	M22a.EDF	M22	1
78	6021904	6028162	57	6315	6258	RIGHT	M22a.EDF	M22	1
79	6030940	6036337	57	5454	5397	RIGHT	M22a.EDF	M22	1
80	6039796	6046223	57	6484	6427	RIGHT	M22a.EDF	M22	1
81	6048522	6055349	57	6884	6827	RIGHT	M22a.EDF	M22	1
82	6059037	6065105	57	6125	6068	RIGHT	M22a.EDF	M22	1
83	6067744	6074290	57	6603	6546	RIGHT	M22a.EDF	M22	1
84	6077149	6083946	58	6855	6797	RIGHT	M22a.EDF	M22	1
85	6086724	6092602	57	5935	5878	RIGHT	M22a.EDF	M22	1
86	6095880	6103068	58	7246	7188	RIGHT	M22a.EDF	M22	1
87	6105707	6111884	57	6234	6177	RIGHT	M22a.EDF	M22	1
88	6114891	6121720	57	6886	6829	RIGHT	M22a.EDF	M22	1
89	6125078	6130365	57	5344	5287	RIGHT	M22a.EDF	M22	1
90	6133123	6138290	58	5225	5167	RIGHT	M22a.EDF	M22	1
91	6141377	6147946	57	6626	6569	RIGHT	M22a.EDF	M22	1
92	6151135	6156001	57	4923	4866	RIGHT	M22a.EDF	M22	1
93	6158788	6164746	57	6015	5958	RIGHT	M22a.EDF	M22	1
94	6170626	6176273	58	5705	5647	RIGHT	M22a.EDF	M22	1
95	6179042	6184608	57	5623	5566	RIGHT	M22a.EDF	M22	1
96	6188907	6194685	57	5835	5778	RIGHT	M22a.EDF	M22	1
1	6575079	6575246	896	1063	167	RIGHT	M22b.EDF	M22	2
1	6579868	6580082	5685	5899	214	RIGHT	M22b.EDF	M22	2
2	6583767	6583906	257	396	139	RIGHT	M22b.EDF	M22	2
2	6584371	6588847	861	5337	4476	RIGHT	M22b.EDF	M22	2
3	6592555	6598393	57	5895	5838	RIGHT	M22b.EDF	M22	2
4	6601091	6607989	57	6955	6898	RIGHT	M22b.EDF	M22	2
5	6610507	6616794	57	6344	6287	RIGHT	M22b.EDF	M22	2
6	6619514	6624939	56	5481	5425	RIGHT	M22b.EDF	M22	2
7	6627977	6633125	57	5205	5148	RIGHT	M22b.EDF	M22	2
8	6635995	6641089	57	5151	5094	RIGHT	M22b.EDF	M22	2
9	6644059	6649064	57	5062	5005	RIGHT	M22b.EDF	M22	2
10	6651815	6658890	57	7132	7075	RIGHT	M22b.EDF	M22	2
11	6661618	6667105	57	5544	5487	RIGHT	M22b.EDF	M22	2
12	6669694	6676531	57	6894	6837	RIGHT	M22b.EDF	M22	2
13	6681200	6687498	57	6355	6298	RIGHT	M22b.EDF	M22	2
14	6690939	6697524	57	6642	6585	RIGHT	M22b.EDF	M22	2
15	6700704	6707881	57	7234	7177	RIGHT	M22b.EDF	M22	2
16	6710339	6717206	57	6924	6867	RIGHT	M22b.EDF	M22	2
17	6720815	6727513	57	6755	6698	RIGHT	M22b.EDF	M22	2
18	6730361	6735347	57	5043	4986	RIGHT	M22b.EDF	M22	2
19	6738655	6744373	57	5775	5718	RIGHT	M22b.EDF	M22	2
20	6747502	6752628	58	5184	5126	RIGHT	M22b.EDF	M22	2
21	6755236	6761914	57	6735	6678	RIGHT	M22b.EDF	M22	2
22	6764874	6770179	57	5362	5305	RIGHT	M22b.EDF	M22	2
23	6772859	6778624	57	5822	5765	RIGHT	M22b.EDF	M22	2
24	6781664	6788250	57	6643	6586	RIGHT	M22b.EDF	M22	2
25	6790850	6797476	57	6683	6626	RIGHT	M22b.EDF	M22	2
26	6800747	6807782	57	7092	7035	RIGHT	M22b.EDF	M22	2
27	6810830	6817248	57	6475	6418	RIGHT	M22b.EDF	M22	2
28	6820036	6825613	58	5635	5577	RIGHT	M22b.EDF	M22	2
29	6828049	6832978	57	4986	4929	RIGHT	M22b.EDF	M22	2
30	6835787	6841183	57	5453	5396	RIGHT	M22b.EDF	M22	2
31	6844020	6850799	57	6836	6779	RIGHT	M22b.EDF	M22	2
32	6854758	6860465	57	5764	5707	RIGHT	M22b.EDF	M22	2
33	6863813	6868570	57	4814	4757	RIGHT	M22b.EDF	M22	2
34	6871470	6878536	57	7123	7066	RIGHT	M22b.EDF	M22	2
35	6881444	6888131	57	6744	6687	RIGHT	M22b.EDF	M22	2
36	6891380	6896687	57	5364	5307	RIGHT	M22b.EDF	M22	2
37	6900168	6906143	58	6033	5975	RIGHT	M22b.EDF	M22	2
38	6909502	6916209	57	6764	6707	RIGHT	M22b.EDF	M22	2
39	6920149	6925355	58	5264	5206	RIGHT	M22b.EDF	M22	2
40	6927893	6932669	57	4833	4776	RIGHT	M22b.EDF	M22	2
41	6936437	6941264	57	4884	4827	RIGHT	M22b.EDF	M22	2
42	6944284	6950620	58	6394	6336	RIGHT	M22b.EDF	M22	2
43	6954605	6955119	524	1038	514	RIGHT	M22b.EDF	M22	2
43	6955176	6955177	1095	1096	1	RIGHT	M22b.EDF	M22	2
43	6955337	6956370	1256	2289	1033	RIGHT	M22b.EDF	M22	2
43	6956466	6960336	2385	6255	3870	RIGHT	M22b.EDF	M22	2
44	6963435	6963469	57	91	34	RIGHT	M22b.EDF	M22	2
44	6963736	6968801	358	5423	5065	RIGHT	M22b.EDF	M22	2
45	6972651	6972790	769	908	139	RIGHT	M22b.EDF	M22	2
45	6972943	6973481	1061	1599	538	RIGHT	M22b.EDF	M22	2
45	6973516	6979318	1634	7436	5802	RIGHT	M22b.EDF	M22	2
46	6982409	6982520	519	630	111	RIGHT	M22b.EDF	M22	2
46	6982665	6988333	775	6443	5668	RIGHT	M22b.EDF	M22	2
47	6990972	6996008	57	5093	5036	RIGHT	M22b.EDF	M22	2
48	6999628	7005694	58	6124	6066	RIGHT	M22b.EDF	M22	2
49	7009459	7015820	57	6418	6361	RIGHT	M22b.EDF	M22	2
50	7019109	7024626	57	5574	5517	RIGHT	M22b.EDF	M22	2
51	7028064	7033581	57	5574	5517	RIGHT	M22b.EDF	M22	2
52	7036230	7042977	57	6804	6747	RIGHT	M22b.EDF	M22	2
53	7047113	7054274	57	7218	7161	RIGHT	M22b.EDF	M22	2
54	7057072	7062039	57	5024	4967	RIGHT	M22b.EDF	M22	2
55	7064877	7070234	57	5414	5357	RIGHT	M22b.EDF	M22	2
56	7073122	7079440	57	6375	6318	RIGHT	M22b.EDF	M22	2
57	7082448	7087384	57	4993	4936	RIGHT	M22b.EDF	M22	2
58	7090293	7097431	58	7196	7138	RIGHT	M22b.EDF	M22	2
59	7100369	7105506	57	5194	5137	RIGHT	M22b.EDF	M22	2
60	7108234	7113098	58	4922	4864	RIGHT	M22b.EDF	M22	2
60	7113620	7113730	5444	5554	110	RIGHT	M22b.EDF	M22	2
60	7114441	7114583	6265	6407	142	RIGHT	M22b.EDF	M22	2
61	7120814	7120897	321	404	83	RIGHT	M22b.EDF	M22	2
61	7121007	7121568	514	1075	561	RIGHT	M22b.EDF	M22	2
61	7121591	7122234	1098	1741	643	RIGHT	M22b.EDF	M22	2
61	7122267	7125820	1774	5327	3553	RIGHT	M22b.EDF	M22	2
62	7129302	7129567	102	367	265	RIGHT	M22b.EDF	M22	2
62	7130246	7130247	1046	1047	1	RIGHT	M22b.EDF	M22	2
62	7130268	7130269	1068	1069	1	RIGHT	M22b.EDF	M22	2
62	7130301	7130302	1101	1102	1	RIGHT	M22b.EDF	M22	2
62	7130324	7130438	1124	1238	114	RIGHT	M22b.EDF	M22	2
63	7136734	7137443	57	766	709	RIGHT	M22b.EDF	M22	2
63	7137632	7137799	955	1122	167	RIGHT	M22b.EDF	M22	2
63	7138221	7142528	1544	5851	4307	RIGHT	M22b.EDF	M22	2
64	7147423	7147575	693	845	152	RIGHT	M22b.EDF	M22	2
64	7147668	7153155	938	6425	5487	RIGHT	M22b.EDF	M22	2
65	7156024	7161520	58	5554	5496	RIGHT	M22b.EDF	M22	2
66	7165310	7170296	57	5043	4986	RIGHT	M22b.EDF	M22	2
67	7173878	7173898	492	512	20	RIGHT	M22b.EDF	M22	2
67	7173996	7175628	610	2242	1632	RIGHT	M22b.EDF	M22	2
67	7175705	7180032	2319	6646	4327	RIGHT	M22b.EDF	M22	2
68	7182611	7188237	57	5683	5626	RIGHT	M22b.EDF	M22	2
69	7190895	7196081	57	5243	5186	RIGHT	M22b.EDF	M22	2
70	7198679	7205567	57	6945	6888	RIGHT	M22b.EDF	M22	2
71	7208194	7215263	57	7126	7069	RIGHT	M22b.EDF	M22	2
72	7218733	7225790	57	7114	7057	RIGHT	M22b.EDF	M22	2
73	7228709	7235716	58	7065	7007	RIGHT	M22b.EDF	M22	2
74	7239145	7239894	58	807	749	RIGHT	M22b.EDF	M22	2
74	7239924	7244411	837	5324	4487	RIGHT	M22b.EDF	M22	2
75	7247540	7253847	57	6364	6307	RIGHT	M22b.EDF	M22	2
76	7258507	7260297	57	1847	1790	RIGHT	M22b.EDF	M22	2
76	7260335	7263823	1885	5373	3488	RIGHT	M22b.EDF	M22	2
77	7266954	7274120	57	7223	7166	RIGHT	M22b.EDF	M22	2
78	7276979	7282445	57	5523	5466	RIGHT	M22b.EDF	M22	2
79	7285724	7290950	57	5283	5226	RIGHT	M22b.EDF	M22	2
80	7295340	7302027	57	6744	6687	RIGHT	M22b.EDF	M22	2
81	7305238	7311142	58	5962	5904	RIGHT	M22b.EDF	M22	2
82	7314752	7316863	57	2168	2111	RIGHT	M22b.EDF	M22	2
82	7317178	7321489	2483	6794	4311	RIGHT	M22b.EDF	M22	2
83	7325867	7326899	57	1089	1032	RIGHT	M22b.EDF	M22	2
83	7326996	7329739	1186	3929	2743	RIGHT	M22b.EDF	M22	2
83	7330440	7330843	4630	5033	403	RIGHT	M22b.EDF	M22	2
83	7330929	7331375	5119	5565	446	RIGHT	M22b.EDF	M22	2
84	7335556	7335757	58	259	201	RIGHT	M22b.EDF	M22	2
84	7335828	7336447	330	949	619	RIGHT	M22b.EDF	M22	2
84	7336546	7340150	1048	4652	3604	RIGHT	M22b.EDF	M22	2
85	7342808	7349906	57	7155	7098	RIGHT	M22b.EDF	M22	2
86	7353577	7353904	57	384	327	RIGHT	M22b.EDF	M22	2
86	7353989	7358872	469	5352	4883	RIGHT	M22b.EDF	M22	2
87	7361930	7368928	57	7055	6998	RIGHT	M22b.EDF	M22	2
88	7373751	7380705	57	7011	6954	RIGHT	M22b.EDF	M22	2
89	7383174	7384768	57	1651	1594	RIGHT	M22b.EDF	M22	2
89	7384830	7387903	1713	4786	3073	RIGHT	M22b.EDF	M22	2
90	7392783	7392925	1038	1180	142	RIGHT	M22b.EDF	M22	2
90	7392949	7397756	1204	6011	4807	RIGHT	M22b.EDF	M22	2
91	7401510	7403656	1074	3220	2146	RIGHT	M22b.EDF	M22	2
91	7403740	7406711	3304	6275	2971	RIGHT	M22b.EDF	M22	2
91	7406964	7406985	6528	6549	21	RIGHT	M22b.EDF	M22	2
92	7410352	7410458	330	436	106	RIGHT	M22b.EDF	M22	2
92	7410586	7416337	564	6315	5751	RIGHT	M22b.EDF	M22	2
93	7419167	7426293	58	7184	7126	RIGHT	M22b.EDF	M22	2
94	7429609	7429764	635	790	155	RIGHT	M22b.EDF	M22	2
94	7429838	7435659	864	6685	5821	RIGHT	M22b.EDF	M22	2
95	7438726	7445275	57	6606	6549	RIGHT	M22b.EDF	M22	2
96	7448274	7448622	57	405	348	RIGHT	M22b.EDF	M22	2
96	7448661	7449498	444	1281	837	RIGHT	M22b.EDF	M22	2
96	7449542	7454911	1325	6694	5369	RIGHT	M22b.EDF	M22	2
2	7924641	7924764	115	238	123	RIGHT	M22c.EDF	M22	3
2	7925454	7930013	928	5487	4559	RIGHT	M22c.EDF	M22	3
3	7933592	7933918	57	383	326	RIGHT	M22c.EDF	M22	3
3	7933953	7938578	418	5043	4625	RIGHT	M22c.EDF	M22	3
4	7941847	7947174	57	5384	5327	RIGHT	M22c.EDF	M22	3
5	7949843	7954798	57	5012	4955	RIGHT	M22c.EDF	M22	3
6	7958159	7964575	57	6473	6416	RIGHT	M22c.EDF	M22	3
7	7967513	7974451	57	6995	6938	RIGHT	M22c.EDF	M22	3
8	7977242	7982666	57	5481	5424	RIGHT	M22c.EDF	M22	3
9	7985735	7991171	58	5494	5436	RIGHT	M22c.EDF	M22	3
10	7993948	7999186	57	5295	5238	RIGHT	M22c.EDF	M22	3
11	8001793	8007391	57	5655	5598	RIGHT	M22c.EDF	M22	3
12	8010270	8016527	57	6314	6257	RIGHT	M22c.EDF	M22	3
13	8019015	8025973	57	7015	6958	RIGHT	M22c.EDF	M22	3
14	8029760	8035258	57	5555	5498	RIGHT	M22c.EDF	M22	3
15	8037856	8043633	57	5834	5777	RIGHT	M22c.EDF	M22	3
16	8046233	8052159	58	5984	5926	RIGHT	M22c.EDF	M22	3
17	8055177	8060984	57	5864	5807	RIGHT	M22c.EDF	M22	3
18	8064054	8071250	57	7253	7196	RIGHT	M22c.EDF	M22	3
19	8073541	8079535	58	6052	5994	RIGHT	M22c.EDF	M22	3
20	8082014	8087580	58	5624	5566	RIGHT	M22c.EDF	M22	3
21	8090029	8090750	57	778	721	RIGHT	M22c.EDF	M22	3
21	8090771	8095125	799	5153	4354	RIGHT	M22c.EDF	M22	3
22	8100455	8106952	57	6554	6497	RIGHT	M22c.EDF	M22	3
23	8109520	8109631	58	169	111	RIGHT	M22c.EDF	M22	3
23	8109663	8115708	201	6246	6045	RIGHT	M22c.EDF	M22	3
24	8118114	8124403	106	6395	6289	RIGHT	M22c.EDF	M22	3
25	8127033	8132264	58	5289	5231	RIGHT	M22c.EDF	M22	3
26	8135133	8136409	83	1359	1276	RIGHT	M22c.EDF	M22	3
26	8136497	8142354	1447	7304	5857	RIGHT	M22c.EDF	M22	3
27	8145061	8145335	57	331	274	RIGHT	M22c.EDF	M22	3
27	8145369	8150129	365	5125	4760	RIGHT	M22c.EDF	M22	3
28	8153237	8154694	57	1514	1457	RIGHT	M22c.EDF	M22	3
28	8154779	8158175	1599	4995	3396	RIGHT	M22c.EDF	M22	3
29	8163786	8163931	750	895	145	RIGHT	M22c.EDF	M22	3
30	8173768	8173929	275	436	161	RIGHT	M22c.EDF	M22	3
30	8174125	8179607	632	6114	5482	RIGHT	M22c.EDF	M22	3
31	8182894	8183068	176	350	174	RIGHT	M22c.EDF	M22	3
31	8183466	8183596	748	878	130	RIGHT	M22c.EDF	M22	3
31	8184196	8187602	1478	4884	3406	RIGHT	M22c.EDF	M22	3
32	8190521	8192362	57	1898	1841	RIGHT	M22c.EDF	M22	3
32	8192410	8192411	1946	1947	1	RIGHT	M22c.EDF	M22	3
32	8192463	8192486	1999	2022	23	RIGHT	M22c.EDF	M22	3
32	8192557	8192585	2093	2121	28	RIGHT	M22c.EDF	M22	3
32	8192615	8192691	2151	2227	76	RIGHT	M22c.EDF	M22	3
32	8192754	8193029	2290	2565	275	RIGHT	M22c.EDF	M22	3
32	8193097	8193161	2633	2697	64	RIGHT	M22c.EDF	M22	3
32	8193354	8197198	2890	6734	3844	RIGHT	M22c.EDF	M22	3
33	8200670	8207394	212	6936	6724	RIGHT	M22c.EDF	M22	3
34	8210429	8216120	58	5749	5691	RIGHT	M22c.EDF	M22	3
35	8219200	8219837	58	695	637	RIGHT	M22c.EDF	M22	3
35	8219941	8224305	799	5163	4364	RIGHT	M22c.EDF	M22	3
36	8227575	8228409	57	891	834	RIGHT	M22c.EDF	M22	3
36	8228515	8233680	997	6162	5165	RIGHT	M22c.EDF	M22	3
37	8236426	8241746	165	5485	5320	RIGHT	M22c.EDF	M22	3
38	8245134	8251051	58	5975	5917	RIGHT	M22c.EDF	M22	3
39	8254130	8254635	568	1073	505	RIGHT	M22c.EDF	M22	3
39	8254833	8259096	1271	5534	4263	RIGHT	M22c.EDF	M22	3
40	8262506	8263682	57	1233	1176	RIGHT	M22c.EDF	M22	3
40	8263748	8269052	1299	6603	5304	RIGHT	M22c.EDF	M22	3
41	8272219	8272316	225	322	97	RIGHT	M22c.EDF	M22	3
41	8272667	8273068	673	1074	401	RIGHT	M22c.EDF	M22	3
41	8273208	8277838	1214	5844	4630	RIGHT	M22c.EDF	M22	3
42	8280676	8281321	57	702	645	RIGHT	M22c.EDF	M22	3
42	8281453	8281551	834	932	98	RIGHT	M22c.EDF	M22	3
42	8282055	8282212	1436	1593	157	RIGHT	M22c.EDF	M22	3
42	8282324	8286383	1705	5764	4059	RIGHT	M22c.EDF	M22	3
43	8289150	8289180	57	87	30	RIGHT	M22c.EDF	M22	3
43	8289607	8289612	514	519	5	RIGHT	M22c.EDF	M22	3
43	8290273	8290275	1180	1182	2	RIGHT	M22c.EDF	M22	3
43	8290439	8290587	1346	1494	148	RIGHT	M22c.EDF	M22	3
43	8290634	8296119	1541	7026	5485	RIGHT	M22c.EDF	M22	3
44	8299177	8299588	57	468	411	RIGHT	M22c.EDF	M22	3
44	8299674	8304554	554	5434	4880	RIGHT	M22c.EDF	M22	3
45	8308714	8309431	57	774	717	RIGHT	M22c.EDF	M22	3
45	8309548	8313590	891	4933	4042	RIGHT	M22c.EDF	M22	3
46	8316150	8316948	57	855	798	RIGHT	M22c.EDF	M22	3
46	8317006	8322495	913	6402	5489	RIGHT	M22c.EDF	M22	3
47	8325569	8325624	272	327	55	RIGHT	M22c.EDF	M22	3
47	8325774	8325895	477	598	121	RIGHT	M22c.EDF	M22	3
47	8326093	8330740	796	5443	4647	RIGHT	M22c.EDF	M22	3
48	8334239	8334293	57	111	54	RIGHT	M22c.EDF	M22	3
48	8334461	8334520	279	338	59	RIGHT	M22c.EDF	M22	3
48	8334631	8335087	449	905	456	RIGHT	M22c.EDF	M22	3
48	8335176	8339035	994	4853	3859	RIGHT	M22c.EDF	M22	3
49	8341444	8342195	57	808	751	RIGHT	M22c.EDF	M22	3
49	8342296	8346510	909	5123	4214	RIGHT	M22c.EDF	M22	3
50	8350859	8351028	978	1147	169	RIGHT	M22c.EDF	M22	3
51	8359900	8360072	153	325	172	RIGHT	M22c.EDF	M22	3
53	8380428	8380553	1280	1405	125	RIGHT	M22c.EDF	M22	3
54	8389152	8389290	57	195	138	RIGHT	M22c.EDF	M22	3
54	8389950	8390550	855	1455	600	RIGHT	M22c.EDF	M22	3
54	8390617	8390699	1522	1604	82	RIGHT	M22c.EDF	M22	3
55	8399896	8400064	685	853	168	RIGHT	M22c.EDF	M22	3
56	8410134	8410266	1095	1227	132	RIGHT	M22c.EDF	M22	3
57	8419560	8419703	1026	1169	143	RIGHT	M22c.EDF	M22	3
58	8426958	8427132	819	993	174	RIGHT	M22c.EDF	M22	3
59	8435081	8435606	58	583	525	RIGHT	M22c.EDF	M22	3
59	8435826	8435987	803	964	161	RIGHT	M22c.EDF	M22	3
59	8436237	8436624	1214	1601	387	RIGHT	M22c.EDF	M22	3
60	8445744	8445883	384	523	139	RIGHT	M22c.EDF	M22	3
60	8446262	8446434	902	1074	172	RIGHT	M22c.EDF	M22	3
61	8456325	8456436	69	180	111	RIGHT	M22c.EDF	M22	3
61	8456918	8457127	662	871	209	RIGHT	M22c.EDF	M22	3
61	8457519	8457562	1263	1306	43	RIGHT	M22c.EDF	M22	3
61	8457601	8458166	1345	1910	565	RIGHT	M22c.EDF	M22	3
61	8458361	8458474	2105	2218	113	RIGHT	M22c.EDF	M22	3
61	8458846	8458916	2590	2660	70	RIGHT	M22c.EDF	M22	3
61	8458950	8459081	2694	2825	131	RIGHT	M22c.EDF	M22	3
61	8459473	8459515	3217	3259	42	RIGHT	M22c.EDF	M22	3
61	8460775	8460810	4519	4554	35	RIGHT	M22c.EDF	M22	3
61	8461454	8461649	5198	5393	195	RIGHT	M22c.EDF	M22	3
61	8463015	8463160	6759	6904	145	RIGHT	M22c.EDF	M22	3
63	8474303	8474410	196	303	107	RIGHT	M22c.EDF	M22	3
65	8493849	8493962	209	322	113	RIGHT	M22c.EDF	M22	3
65	8494776	8494931	1136	1291	155	RIGHT	M22c.EDF	M22	3
66	8503537	8503641	870	974	104	RIGHT	M22c.EDF	M22	3
67	8512349	8512468	937	1056	119	RIGHT	M22c.EDF	M22	3
68	8520828	8520936	910	1018	108	RIGHT	M22c.EDF	M22	3
70	8540501	8540644	1010	1153	143	RIGHT	M22c.EDF	M22	3
72	8559151	8559274	951	1074	123	RIGHT	M22c.EDF	M22	3
73	8566309	8566442	346	479	133	RIGHT	M22c.EDF	M22	3
74	8576144	8576295	712	863	151	RIGHT	M22c.EDF	M22	3
75	8583617	8583756	79	218	139	RIGHT	M22c.EDF	M22	3
76	8594895	8595022	1424	1551	127	RIGHT	M22c.EDF	M22	3
77	8602142	8602396	916	1170	254	RIGHT	M22c.EDF	M22	3
78	8610619	8610796	1096	1273	177	RIGHT	M22c.EDF	M22	3
80	8626752	8626914	710	872	162	RIGHT	M22c.EDF	M22	3
81	8636640	8637653	862	1875	1013	RIGHT	M22c.EDF	M22	3
81	8637705	8637716	1927	1938	11	RIGHT	M22c.EDF	M22	3
81	8637836	8637856	2058	2078	20	RIGHT	M22c.EDF	M22	3
81	8637944	8638048	2166	2270	104	RIGHT	M22c.EDF	M22	3
82	8644608	8644754	637	783	146	RIGHT	M22c.EDF	M22	3
82	8644856	8644997	885	1026	141	RIGHT	M22c.EDF	M22	3
82	8645607	8645666	1636	1695	59	RIGHT	M22c.EDF	M22	3
82	8645997	8646039	2026	2068	42	RIGHT	M22c.EDF	M22	3
82	8646102	8646132	2131	2161	30	RIGHT	M22c.EDF	M22	3
82	8646153	8646325	2182	2354	172	RIGHT	M22c.EDF	M22	3
82	8646879	8647921	2908	3950	1042	RIGHT	M22c.EDF	M22	3
83	8652755	8657012	967	5224	4257	RIGHT	M22c.EDF	M22	3
84	8660460	8660581	57	178	121	RIGHT	M22c.EDF	M22	3
84	8660706	8661494	303	1091	788	RIGHT	M22c.EDF	M22	3
86	8676914	8677038	70	194	124	RIGHT	M22c.EDF	M22	3
87	8687284	8688857	1034	2607	1573	RIGHT	M22c.EDF	M22	3
87	8688921	8688984	2671	2734	63	RIGHT	M22c.EDF	M22	3
88	8695370	8695511	896	1037	141	RIGHT	M22c.EDF	M22	3
88	8695691	8700778	1217	6304	5087	RIGHT	M22c.EDF	M22	3
89	8703465	8703549	57	141	84	RIGHT	M22c.EDF	M22	3
89	8705362	8705915	1954	2507	553	RIGHT	M22c.EDF	M22	3
90	8714315	8714462	330	477	147	RIGHT	M22c.EDF	M22	3
90	8715266	8715334	1281	1349	68	RIGHT	M22c.EDF	M22	3
90	8715389	8716206	1404	2221	817	RIGHT	M22c.EDF	M22	3
90	8716430	8716682	2445	2697	252	RIGHT	M22c.EDF	M22	3
90	8716780	8716802	2795	2817	22	RIGHT	M22c.EDF	M22	3
90	8717003	8717775	3018	3790	772	RIGHT	M22c.EDF	M22	3
91	8723726	8723867	252	393	141	RIGHT	M22c.EDF	M22	3
91	8724099	8724107	625	633	8	RIGHT	M22c.EDF	M22	3
91	8724132	8729596	658	6122	5464	RIGHT	M22c.EDF	M22	3
92	8733658	8733765	119	226	107	RIGHT	M22c.EDF	M22	3
92	8734428	8740393	889	6854	5965	RIGHT	M22c.EDF	M22	3
93	8743024	8743030	331	337	6	RIGHT	M22c.EDF	M22	3
93	8743498	8748218	805	5525	4720	RIGHT	M22c.EDF	M22	3
94	8752742	8752832	1954	2044	90	RIGHT	M22c.EDF	M22	3
94	8753707	8757413	2919	6625	3706	RIGHT	M22c.EDF	M22	3
95	8760301	8760343	57	99	42	RIGHT	M22c.EDF	M22	3
95	8760704	8766799	460	6555	6095	RIGHT	M22c.EDF	M22	3
96	8770335	8770347	924	936	12	RIGHT	M22c.EDF	M22	3
96	8770368	8770489	957	1078	121	RIGHT	M22c.EDF	M22	3
96	8770682	8776265	1271	6854	5583	RIGHT	M22c.EDF	M22	3
1	7011649	7011813	1046	1210	164	RIGHT	M24.EDF	M24	.
1	7012355	7012524	1752	1921	169	RIGHT	M24.EDF	M24	.
2	7019288	7019531	355	598	243	RIGHT	M24.EDF	M24	.
3	7027856	7028157	131	432	301	RIGHT	M24.EDF	M24	.
3	7028248	7028583	523	858	335	RIGHT	M24.EDF	M24	.
3	7028983	7029211	1258	1486	228	RIGHT	M24.EDF	M24	.
4	7034925	7035075	57	207	150	RIGHT	M24.EDF	M24	.
4	7035109	7035114	241	246	5	RIGHT	M24.EDF	M24	.
4	7035402	7035424	534	556	22	RIGHT	M24.EDF	M24	.
4	7035471	7035765	603	897	294	RIGHT	M24.EDF	M24	.
4	7035797	7035813	929	945	16	RIGHT	M24.EDF	M24	.
5	7042858	7043497	465	1104	639	RIGHT	M24.EDF	M24	.
5	7045131	7045133	2738	2740	2	RIGHT	M24.EDF	M24	.
5	7045454	7045700	3061	3307	246	RIGHT	M24.EDF	M24	.
5	7045726	7049286	3333	6893	3560	RIGHT	M24.EDF	M24	.
6	7051305	7051341	238	274	36	RIGHT	M24.EDF	M24	.
6	7051603	7051603	536	536	0	RIGHT	M24.EDF	M24	.
6	7051839	7052341	772	1274	502	RIGHT	M24.EDF	M24	.
8	7065811	7065813	146	148	2	RIGHT	M24.EDF	M24	.
9	7074710	7075037	579	906	327	RIGHT	M24.EDF	M24	.
9	7078116	7078125	3985	3994	9	RIGHT	M24.EDF	M24	.
9	7080213	7080326	6082	6195	113	RIGHT	M24.EDF	M24	.
9	7080349	7080504	6218	6373	155	RIGHT	M24.EDF	M24	.
10	7083027	7083370	859	1202	343	RIGHT	M24.EDF	M24	.
11	7089925	7090252	975	1302	327	RIGHT	M24.EDF	M24	.
12	7095391	7095683	57	349	292	RIGHT	M24.EDF	M24	.
12	7095860	7096150	526	816	290	RIGHT	M24.EDF	M24	.
13	7104642	7105251	121	730	609	RIGHT	M24.EDF	M24	.
13	7109631	7109692	5110	5171	61	RIGHT	M24.EDF	M24	.
14	7112375	7112776	121	522	401	RIGHT	M24.EDF	M24	.
14	7112879	7112995	625	741	116	RIGHT	M24.EDF	M24	.
14	7113029	7113476	775	1222	447	RIGHT	M24.EDF	M24	.
14	7116851	7116851	4597	4597	0	RIGHT	M24.EDF	M24	.
14	7116921	7116922	4667	4668	1	RIGHT	M24.EDF	M24	.
14	7117022	7117044	4768	4790	22	RIGHT	M24.EDF	M24	.
14	7117091	7117091	4837	4837	0	RIGHT	M24.EDF	M24	.
14	7117438	7117438	5184	5184	0	RIGHT	M24.EDF	M24	.
14	7117951	7117956	5697	5702	5	RIGHT	M24.EDF	M24	.
14	7118157	7118157	5903	5903	0	RIGHT	M24.EDF	M24	.
14	7118185	7118185	5931	5931	0	RIGHT	M24.EDF	M24	.
14	7118208	7118208	5954	5954	0	RIGHT	M24.EDF	M24	.
14	7118252	7118253	5998	5999	1	RIGHT	M24.EDF	M24	.
14	7118286	7118286	6032	6032	0	RIGHT	M24.EDF	M24	.
14	7118363	7118526	6109	6272	163	RIGHT	M24.EDF	M24	.
14	7118548	7118728	6294	6474	180	RIGHT	M24.EDF	M24	.
15	7121708	7122318	58	668	610	RIGHT	M24.EDF	M24	.
16	7130512	7130675	270	433	163	RIGHT	M24.EDF	M24	.
16	7130973	7131391	731	1149	418	RIGHT	M24.EDF	M24	.
17	7139107	7140003	57	953	896	RIGHT	M24.EDF	M24	.
17	7142952	7143050	3902	4000	98	RIGHT	M24.EDF	M24	.
17	7143089	7143094	4039	4044	5	RIGHT	M24.EDF	M24	.
17	7143116	7143128	4066	4078	12	RIGHT	M24.EDF	M24	.
17	7143149	7143166	4099	4116	17	RIGHT	M24.EDF	M24	.
17	7143187	7144717	4137	5667	1530	RIGHT	M24.EDF	M24	.
17	7144752	7144817	5702	5767	65	RIGHT	M24.EDF	M24	.
17	7144842	7144842	5792	5792	0	RIGHT	M24.EDF	M24	.
17	7144878	7144917	5828	5867	39	RIGHT	M24.EDF	M24	.
17	7144943	7145409	5893	6359	466	RIGHT	M24.EDF	M24	.
17	7145443	7145455	6393	6405	12	RIGHT	M24.EDF	M24	.
18	7147182	7147245	57	120	63	RIGHT	M24.EDF	M24	.
18	7147323	7147507	198	382	184	RIGHT	M24.EDF	M24	.
18	7147662	7148656	537	1531	994	RIGHT	M24.EDF	M24	.
19	7154618	7154702	58	142	84	RIGHT	M24.EDF	M24	.
19	7154799	7154988	239	428	189	RIGHT	M24.EDF	M24	.
19	7160975	7161135	6415	6575	160	RIGHT	M24.EDF	M24	.
19	7161408	7161581	6848	7021	173	RIGHT	M24.EDF	M24	.
20	7164234	7164272	57	95	38	RIGHT	M24.EDF	M24	.
20	7164359	7164556	182	379	197	RIGHT	M24.EDF	M24	.
21	7172726	7172726	406	406	0	RIGHT	M24.EDF	M24	.
21	7172763	7172871	443	551	108	RIGHT	M24.EDF	M24	.
21	7172984	7173209	664	889	225	RIGHT	M24.EDF	M24	.
22	7180921	7181380	171	630	459	RIGHT	M24.EDF	M24	.
22	7181442	7181655	692	905	213	RIGHT	M24.EDF	M24	.
22	7181816	7182022	1066	1272	206	RIGHT	M24.EDF	M24	.
23	7188820	7189052	57	289	232	RIGHT	M24.EDF	M24	.
23	7189162	7189507	399	744	345	RIGHT	M24.EDF	M24	.
23	7189553	7189829	790	1066	276	RIGHT	M24.EDF	M24	.
23	7194736	7194914	5973	6151	178	RIGHT	M24.EDF	M24	.
23	7194939	7194944	6176	6181	5	RIGHT	M24.EDF	M24	.
24	7197184	7197647	57	520	463	RIGHT	M24.EDF	M24	.
24	7198226	7198734	1099	1607	508	RIGHT	M24.EDF	M24	.
24	7200019	7202729	2892	5602	2710	RIGHT	M24.EDF	M24	.
25	7204940	7205152	88	300	212	RIGHT	M24.EDF	M24	.
25	7205688	7206076	836	1224	388	RIGHT	M24.EDF	M24	.
26	7212666	7212938	57	329	272	RIGHT	M24.EDF	M24	.
26	7213165	7213393	556	784	228	RIGHT	M24.EDF	M24	.
26	7213497	7213517	888	908	20	RIGHT	M24.EDF	M24	.
27	7221787	7221895	58	166	108	RIGHT	M24.EDF	M24	.
27	7222381	7222854	652	1125	473	RIGHT	M24.EDF	M24	.
27	7222899	7222899	1170	1170	0	RIGHT	M24.EDF	M24	.
27	7222928	7223211	1199	1482	283	RIGHT	M24.EDF	M24	.
27	7223243	7223311	1514	1582	68	RIGHT	M24.EDF	M24	.
27	7223382	7223382	1653	1653	0	RIGHT	M24.EDF	M24	.
27	7223437	7223624	1708	1895	187	RIGHT	M24.EDF	M24	.
27	7223662	7223699	1933	1970	37	RIGHT	M24.EDF	M24	.
28	7231202	7231323	58	179	121	RIGHT	M24.EDF	M24	.
28	7231355	7231376	211	232	21	RIGHT	M24.EDF	M24	.
28	7231594	7231816	450	672	222	RIGHT	M24.EDF	M24	.
28	7231856	7231880	712	736	24	RIGHT	M24.EDF	M24	.
28	7231982	7232218	838	1074	236	RIGHT	M24.EDF	M24	.
28	7232245	7232324	1101	1180	79	RIGHT	M24.EDF	M24	.
28	7233756	7233756	2612	2612	0	RIGHT	M24.EDF	M24	.
28	7233960	7233960	2816	2816	0	RIGHT	M24.EDF	M24	.
28	7234018	7234027	2874	2883	9	RIGHT	M24.EDF	M24	.
28	7234069	7234668	2925	3524	599	RIGHT	M24.EDF	M24	.
28	7234691	7234713	3547	3569	22	RIGHT	M24.EDF	M24	.
28	7234741	7234859	3597	3715	118	RIGHT	M24.EDF	M24	.
28	7234886	7234888	3742	3744	2	RIGHT	M24.EDF	M24	.
28	7234939	7234940	3795	3796	1	RIGHT	M24.EDF	M24	.
28	7235005	7235005	3861	3861	0	RIGHT	M24.EDF	M24	.
28	7235036	7235036	3892	3892	0	RIGHT	M24.EDF	M24	.
28	7235140	7235155	3996	4011	15	RIGHT	M24.EDF	M24	.
28	7235193	7235221	4049	4077	28	RIGHT	M24.EDF	M24	.
28	7235243	7235243	4099	4099	0	RIGHT	M24.EDF	M24	.
28	7235275	7235275	4131	4131	0	RIGHT	M24.EDF	M24	.
28	7235301	7235312	4157	4168	11	RIGHT	M24.EDF	M24	.
28	7235333	7235333	4189	4189	0	RIGHT	M24.EDF	M24	.
28	7235402	7235402	4258	4258	0	RIGHT	M24.EDF	M24	.
28	7235447	7235448	4303	4304	1	RIGHT	M24.EDF	M24	.
28	7235493	7235498	4349	4354	5	RIGHT	M24.EDF	M24	.
28	7235807	7235809	4663	4665	2	RIGHT	M24.EDF	M24	.
28	7235866	7235866	4722	4722	0	RIGHT	M24.EDF	M24	.
28	7235904	7235905	4760	4761	1	RIGHT	M24.EDF	M24	.
28	7236224	7236224	5080	5080	0	RIGHT	M24.EDF	M24	.
28	7236389	7236389	5245	5245	0	RIGHT	M24.EDF	M24	.
28	7236460	7236477	5316	5333	17	RIGHT	M24.EDF	M24	.
28	7236501	7236501	5357	5357	0	RIGHT	M24.EDF	M24	.
28	7236524	7236567	5380	5423	43	RIGHT	M24.EDF	M24	.
28	7236601	7236601	5457	5457	0	RIGHT	M24.EDF	M24	.
29	7238832	7238833	94	95	1	RIGHT	M24.EDF	M24	.
29	7238911	7239140	173	402	229	RIGHT	M24.EDF	M24	.
29	7239164	7239222	426	484	58	RIGHT	M24.EDF	M24	.
29	7239246	7239557	508	819	311	RIGHT	M24.EDF	M24	.
30	7245910	7246370	58	518	460	RIGHT	M24.EDF	M24	.
30	7246603	7246834	751	982	231	RIGHT	M24.EDF	M24	.
31	7253689	7253871	248	430	182	RIGHT	M24.EDF	M24	.
31	7254056	7254286	615	845	230	RIGHT	M24.EDF	M24	.
32	7262207	7262432	540	765	225	RIGHT	M24.EDF	M24	.
33	7270189	7270403	429	643	214	RIGHT	M24.EDF	M24	.
33	7270483	7270694	723	934	211	RIGHT	M24.EDF	M24	.
33	7276353	7276353	6593	6593	0	RIGHT	M24.EDF	M24	.
33	7276395	7276395	6635	6635	0	RIGHT	M24.EDF	M24	.
33	7276712	7276712	6952	6952	0	RIGHT	M24.EDF	M24	.
33	7276738	7276751	6978	6991	13	RIGHT	M24.EDF	M24	.
33	7276810	7276832	7050	7072	22	RIGHT	M24.EDF	M24	.
33	7276864	7276865	7104	7105	1	RIGHT	M24.EDF	M24	.
33	7276954	7276959	7194	7199	5	RIGHT	M24.EDF	M24	.
33	7276984	7276985	7224	7225	1	RIGHT	M24.EDF	M24	.
34	7280399	7280601	1074	1276	202	RIGHT	M24.EDF	M24	.
34	7280689	7280702	1364	1377	13	RIGHT	M24.EDF	M24	.
35	7289276	7289459	1786	1969	183	RIGHT	M24.EDF	M24	.
36	7295551	7295756	845	1050	205	RIGHT	M24.EDF	M24	.
37	7301717	7301753	57	93	36	RIGHT	M24.EDF	M24	.
37	7301786	7301800	126	140	14	RIGHT	M24.EDF	M24	.
37	7301916	7301918	256	258	2	RIGHT	M24.EDF	M24	.
37	7302022	7302067	362	407	45	RIGHT	M24.EDF	M24	.
37	7302285	7302475	625	815	190	RIGHT	M24.EDF	M24	.
37	7302504	7302510	844	850	6	RIGHT	M24.EDF	M24	.
37	7306368	7306369	4708	4709	1	RIGHT	M24.EDF	M24	.
37	7306391	7306562	4731	4902	171	RIGHT	M24.EDF	M24	.
37	7306584	7306586	4924	4926	2	RIGHT	M24.EDF	M24	.
37	7306625	7306944	4965	5284	319	RIGHT	M24.EDF	M24	.
38	7308901	7308911	326	336	10	RIGHT	M24.EDF	M24	.
38	7309471	7309660	896	1085	189	RIGHT	M24.EDF	M24	.
38	7309749	7309978	1174	1403	229	RIGHT	M24.EDF	M24	.
38	7310025	7310174	1450	1599	149	RIGHT	M24.EDF	M24	.
38	7310198	7310200	1623	1625	2	RIGHT	M24.EDF	M24	.
38	7311647	7311648	3072	3073	1	RIGHT	M24.EDF	M24	.
38	7311735	7311735	3160	3160	0	RIGHT	M24.EDF	M24	.
38	7311764	7311764	3189	3189	0	RIGHT	M24.EDF	M24	.
38	7311861	7311875	3286	3300	14	RIGHT	M24.EDF	M24	.
38	7312045	7312057	3470	3482	12	RIGHT	M24.EDF	M24	.
38	7312125	7312155	3550	3580	30	RIGHT	M24.EDF	M24	.
38	7312185	7312229	3610	3654	44	RIGHT	M24.EDF	M24	.
38	7312251	7312262	3676	3687	11	RIGHT	M24.EDF	M24	.
38	7312295	7312295	3720	3720	0	RIGHT	M24.EDF	M24	.
38	7312320	7312374	3745	3799	54	RIGHT	M24.EDF	M24	.
38	7312407	7312407	3832	3832	0	RIGHT	M24.EDF	M24	.
38	7312482	7312482	3907	3907	0	RIGHT	M24.EDF	M24	.
38	7312574	7312574	3999	3999	0	RIGHT	M24.EDF	M24	.
38	7312600	7312606	4025	4031	6	RIGHT	M24.EDF	M24	.
38	7312639	7312640	4064	4065	1	RIGHT	M24.EDF	M24	.
38	7312702	7312702	4127	4127	0	RIGHT	M24.EDF	M24	.
38	7312739	7312745	4164	4170	6	RIGHT	M24.EDF	M24	.
38	7312776	7312792	4201	4217	16	RIGHT	M24.EDF	M24	.
38	7312814	7312830	4239	4255	16	RIGHT	M24.EDF	M24	.
38	7312861	7312877	4286	4302	16	RIGHT	M24.EDF	M24	.
38	7312900	7312912	4325	4337	12	RIGHT	M24.EDF	M24	.
38	7312995	7312995	4420	4420	0	RIGHT	M24.EDF	M24	.
38	7313028	7313079	4453	4504	51	RIGHT	M24.EDF	M24	.
38	7313117	7313130	4542	4555	13	RIGHT	M24.EDF	M24	.
38	7313157	7313176	4582	4601	19	RIGHT	M24.EDF	M24	.
38	7313211	7313216	4636	4641	5	RIGHT	M24.EDF	M24	.
38	7313263	7313263	4688	4688	0	RIGHT	M24.EDF	M24	.
38	7313435	7313435	4860	4860	0	RIGHT	M24.EDF	M24	.
38	7313480	7313489	4905	4914	9	RIGHT	M24.EDF	M24	.
38	7313539	7313539	4964	4964	0	RIGHT	M24.EDF	M24	.
38	7313626	7313649	5051	5074	23	RIGHT	M24.EDF	M24	.
38	7313677	7313677	5102	5102	0	RIGHT	M24.EDF	M24	.
38	7313775	7313782	5200	5207	7	RIGHT	M24.EDF	M24	.
38	7313807	7313968	5232	5393	161	RIGHT	M24.EDF	M24	.
39	7315763	7316192	57	486	429	RIGHT	M24.EDF	M24	.
39	7316222	7316223	516	517	1	RIGHT	M24.EDF	M24	.
39	7316302	7316518	596	812	216	RIGHT	M24.EDF	M24	.
39	7316543	7316572	837	866	29	RIGHT	M24.EDF	M24	.
39	7321493	7321493	5787	5787	0	RIGHT	M24.EDF	M24	.
39	7321983	7321983	6277	6277	0	RIGHT	M24.EDF	M24	.
39	7322299	7322299	6593	6593	0	RIGHT	M24.EDF	M24	.
40	7324603	7324619	101	117	16	RIGHT	M24.EDF	M24	.
40	7324736	7324875	234	373	139	RIGHT	M24.EDF	M24	.
40	7324924	7324924	422	422	0	RIGHT	M24.EDF	M24	.
40	7324960	7325143	458	641	183	RIGHT	M24.EDF	M24	.
40	7325186	7325186	684	684	0	RIGHT	M24.EDF	M24	.
40	7327926	7327926	3424	3424	0	RIGHT	M24.EDF	M24	.
40	7328034	7328034	3532	3532	0	RIGHT	M24.EDF	M24	.
40	7328198	7328226	3696	3724	28	RIGHT	M24.EDF	M24	.
40	7328315	7328315	3813	3813	0	RIGHT	M24.EDF	M24	.
40	7328410	7328429	3908	3927	19	RIGHT	M24.EDF	M24	.
40	7328464	7328481	3962	3979	17	RIGHT	M24.EDF	M24	.
40	7328623	7328634	4121	4132	11	RIGHT	M24.EDF	M24	.
40	7328664	7328665	4162	4163	1	RIGHT	M24.EDF	M24	.
40	7328687	7328694	4185	4192	7	RIGHT	M24.EDF	M24	.
40	7328719	7328746	4217	4244	27	RIGHT	M24.EDF	M24	.
40	7328791	7328791	4289	4289	0	RIGHT	M24.EDF	M24	.
40	7328821	7328847	4319	4345	26	RIGHT	M24.EDF	M24	.
40	7328871	7328887	4369	4385	16	RIGHT	M24.EDF	M24	.
40	7328909	7328909	4407	4407	0	RIGHT	M24.EDF	M24	.
40	7328938	7328938	4436	4436	0	RIGHT	M24.EDF	M24	.
40	7329006	7329024	4504	4522	18	RIGHT	M24.EDF	M24	.
40	7329053	7329055	4551	4553	2	RIGHT	M24.EDF	M24	.
40	7329084	7329110	4582	4608	26	RIGHT	M24.EDF	M24	.
40	7329139	7329187	4637	4685	48	RIGHT	M24.EDF	M24	.
40	7329208	7329208	4706	4706	0	RIGHT	M24.EDF	M24	.
40	7329231	7329247	4729	4745	16	RIGHT	M24.EDF	M24	.
41	7331685	7333309	58	1682	1624	RIGHT	M24.EDF	M24	.
41	7335203	7335323	3576	3696	120	RIGHT	M24.EDF	M24	.
42	7341960	7342112	150	302	152	RIGHT	M24.EDF	M24	.
42	7342174	7342175	364	365	1	RIGHT	M24.EDF	M24	.
42	7342215	7342360	405	550	145	RIGHT	M24.EDF	M24	.
42	7342474	7342486	664	676	12	RIGHT	M24.EDF	M24	.
42	7345529	7345552	3719	3742	23	RIGHT	M24.EDF	M24	.
42	7345624	7345639	3814	3829	15	RIGHT	M24.EDF	M24	.
42	7345669	7347719	3859	5909	2050	RIGHT	M24.EDF	M24	.
43	7350017	7352100	58	2141	2083	RIGHT	M24.EDF	M24	.
43	7352837	7352840	2878	2881	3	RIGHT	M24.EDF	M24	.
43	7352886	7352922	2927	2963	36	RIGHT	M24.EDF	M24	.
43	7352949	7356153	2990	6194	3204	RIGHT	M24.EDF	M24	.
43	7356174	7356655	6215	6696	481	RIGHT	M24.EDF	M24	.
44	7359453	7359802	57	406	349	RIGHT	M24.EDF	M24	.
44	7359845	7360566	449	1170	721	RIGHT	M24.EDF	M24	.
44	7361964	7361965	2568	2569	1	RIGHT	M24.EDF	M24	.
44	7361989	7364449	2593	5053	2460	RIGHT	M24.EDF	M24	.
45	7366799	7367175	57	433	376	RIGHT	M24.EDF	M24	.
45	7367326	7367341	584	599	15	RIGHT	M24.EDF	M24	.
45	7367363	7367365	621	623	2	RIGHT	M24.EDF	M24	.
45	7368038	7368958	1296	2216	920	RIGHT	M24.EDF	M24	.
45	7369384	7374115	2642	7373	4731	RIGHT	M24.EDF	M24	.
46	7376808	7377920	701	1813	1112	RIGHT	M24.EDF	M24	.
46	7377947	7377956	1840	1849	9	RIGHT	M24.EDF	M24	.
46	7379064	7382210	2957	6103	3146	RIGHT	M24.EDF	M24	.
47	7384362	7385730	58	1426	1368	RIGHT	M24.EDF	M24	.
47	7385806	7385807	1502	1503	1	RIGHT	M24.EDF	M24	.
47	7385829	7385829	1525	1525	0	RIGHT	M24.EDF	M24	.
47	7385887	7386211	1583	1907	324	RIGHT	M24.EDF	M24	.
47	7386980	7389015	2676	4711	2035	RIGHT	M24.EDF	M24	.
48	7390932	7396469	58	5595	5537	RIGHT	M24.EDF	M24	.
49	7398327	7398999	58	730	672	RIGHT	M24.EDF	M24	.
49	7399282	7399283	1013	1014	1	RIGHT	M24.EDF	M24	.
49	7399316	7399317	1047	1048	1	RIGHT	M24.EDF	M24	.
49	7399350	7399586	1081	1317	236	RIGHT	M24.EDF	M24	.
49	7399626	7399638	1357	1369	12	RIGHT	M24.EDF	M24	.
49	7399671	7399692	1402	1423	21	RIGHT	M24.EDF	M24	.
49	7399715	7399835	1446	1566	120	RIGHT	M24.EDF	M24	.
49	7399873	7400032	1604	1763	159	RIGHT	M24.EDF	M24	.
49	7400054	7400095	1785	1826	41	RIGHT	M24.EDF	M24	.
49	7400134	7400173	1865	1904	39	RIGHT	M24.EDF	M24	.
49	7400197	7400204	1928	1935	7	RIGHT	M24.EDF	M24	.
49	7400324	7400324	2055	2055	0	RIGHT	M24.EDF	M24	.
49	7400367	7400367	2098	2098	0	RIGHT	M24.EDF	M24	.
49	7400625	7400625	2356	2356	0	RIGHT	M24.EDF	M24	.
49	7400919	7400919	2650	2650	0	RIGHT	M24.EDF	M24	.
49	7400951	7400951	2682	2682	0	RIGHT	M24.EDF	M24	.
49	7401012	7401012	2743	2743	0	RIGHT	M24.EDF	M24	.
49	7401035	7401036	2766	2767	1	RIGHT	M24.EDF	M24	.
49	7401071	7401073	2802	2804	2	RIGHT	M24.EDF	M24	.
49	7401110	7401243	2841	2974	133	RIGHT	M24.EDF	M24	.
49	7401265	7404214	2996	5945	2949	RIGHT	M24.EDF	M24	.
50	7406615	7406955	229	569	340	RIGHT	M24.EDF	M24	.
50	7406995	7406995	609	609	0	RIGHT	M24.EDF	M24	.
50	7407156	7407295	770	909	139	RIGHT	M24.EDF	M24	.
50	7408197	7408486	1811	2100	289	RIGHT	M24.EDF	M24	.
50	7409300	7409430	2914	3044	130	RIGHT	M24.EDF	M24	.
50	7409451	7409575	3065	3189	124	RIGHT	M24.EDF	M24	.
50	7409596	7412519	3210	6133	2923	RIGHT	M24.EDF	M24	.
51	7414416	7414790	105	479	374	RIGHT	M24.EDF	M24	.
51	7415089	7415432	778	1121	343	RIGHT	M24.EDF	M24	.
51	7416646	7416646	2335	2335	0	RIGHT	M24.EDF	M24	.
51	7416790	7416825	2479	2514	35	RIGHT	M24.EDF	M24	.
51	7416858	7416899	2547	2588	41	RIGHT	M24.EDF	M24	.
51	7416965	7416975	2654	2664	10	RIGHT	M24.EDF	M24	.
51	7417008	7417017	2697	2706	9	RIGHT	M24.EDF	M24	.
51	7417046	7417059	2735	2748	13	RIGHT	M24.EDF	M24	.
51	7417096	7417202	2785	2891	106	RIGHT	M24.EDF	M24	.
51	7417235	7418249	2924	3938	1014	RIGHT	M24.EDF	M24	.
51	7418272	7421305	3961	6994	3033	RIGHT	M24.EDF	M24	.
52	7423434	7424289	461	1316	855	RIGHT	M24.EDF	M24	.
52	7424325	7424807	1352	1834	482	RIGHT	M24.EDF	M24	.
52	7424857	7424868	1884	1895	11	RIGHT	M24.EDF	M24	.
52	7424915	7428569	1942	5596	3654	RIGHT	M24.EDF	M24	.
53	7431015	7431299	57	341	284	RIGHT	M24.EDF	M24	.
53	7431388	7431388	430	430	0	RIGHT	M24.EDF	M24	.
53	7431456	7431848	498	890	392	RIGHT	M24.EDF	M24	.
53	7432133	7432228	1175	1270	95	RIGHT	M24.EDF	M24	.
53	7432250	7432269	1292	1311	19	RIGHT	M24.EDF	M24	.
53	7432296	7432296	1338	1338	0	RIGHT	M24.EDF	M24	.
53	7432328	7435553	1370	4595	3225	RIGHT	M24.EDF	M24	.
54	7437873	7438190	60	377	317	RIGHT	M24.EDF	M24	.
54	7438276	7438276	463	463	0	RIGHT	M24.EDF	M24	.
54	7438834	7438892	1021	1079	58	RIGHT	M24.EDF	M24	.
54	7438915	7438915	1102	1102	0	RIGHT	M24.EDF	M24	.
54	7439511	7439511	1698	1698	0	RIGHT	M24.EDF	M24	.
54	7439572	7439588	1759	1775	16	RIGHT	M24.EDF	M24	.
54	7439661	7439695	1848	1882	34	RIGHT	M24.EDF	M24	.
54	7439853	7439864	2040	2051	11	RIGHT	M24.EDF	M24	.
54	7439892	7439905	2079	2092	13	RIGHT	M24.EDF	M24	.
54	7439931	7439933	2118	2120	2	RIGHT	M24.EDF	M24	.
54	7440012	7440020	2199	2207	8	RIGHT	M24.EDF	M24	.
54	7440320	7440320	2507	2507	0	RIGHT	M24.EDF	M24	.
54	7440480	7440480	2667	2667	0	RIGHT	M24.EDF	M24	.
54	7440505	7443348	2692	5535	2843	RIGHT	M24.EDF	M24	.
55	7445666	7451012	58	5404	5346	RIGHT	M24.EDF	M24	.
56	7453102	7454077	57	1032	975	RIGHT	M24.EDF	M24	.
56	7454175	7454223	1130	1178	48	RIGHT	M24.EDF	M24	.
56	7454264	7454264	1219	1219	0	RIGHT	M24.EDF	M24	.
56	7459038	7459047	5993	6002	9	RIGHT	M24.EDF	M24	.
57	7461084	7462167	57	1140	1083	RIGHT	M24.EDF	M24	.
57	7462218	7462495	1191	1468	277	RIGHT	M24.EDF	M24	.
57	7463866	7463874	2839	2847	8	RIGHT	M24.EDF	M24	.
57	7463911	7467593	2884	6566	3682	RIGHT	M24.EDF	M24	.
58	7469542	7470576	58	1092	1034	RIGHT	M24.EDF	M24	.
58	7472358	7472358	2874	2874	0	RIGHT	M24.EDF	M24	.
58	7472385	7472385	2901	2901	0	RIGHT	M24.EDF	M24	.
58	7472429	7472429	2945	2945	0	RIGHT	M24.EDF	M24	.
58	7472451	7472579	2967	3095	128	RIGHT	M24.EDF	M24	.
58	7472608	7474408	3124	4924	1800	RIGHT	M24.EDF	M24	.
59	7476293	7476341	58	106	48	RIGHT	M24.EDF	M24	.
59	7476536	7477500	301	1265	964	RIGHT	M24.EDF	M24	.
59	7480734	7480750	4499	4515	16	RIGHT	M24.EDF	M24	.
59	7480809	7480992	4574	4757	183	RIGHT	M24.EDF	M24	.
60	7483746	7484371	552	1177	625	RIGHT	M24.EDF	M24	.
60	7487393	7487432	4199	4238	39	RIGHT	M24.EDF	M24	.
60	7487453	7487489	4259	4295	36	RIGHT	M24.EDF	M24	.
60	7487513	7489196	4319	6002	1683	RIGHT	M24.EDF	M24	.
61	7491134	7491261	57	184	127	RIGHT	M24.EDF	M24	.
61	7491335	7491426	258	349	91	RIGHT	M24.EDF	M24	.
61	7491712	7492194	635	1117	482	RIGHT	M24.EDF	M24	.
61	7492333	7492431	1256	1354	98	RIGHT	M24.EDF	M24	.
61	7492572	7492661	1495	1584	89	RIGHT	M24.EDF	M24	.
61	7494594	7494594	3517	3517	0	RIGHT	M24.EDF	M24	.
61	7494785	7494785	3708	3708	0	RIGHT	M24.EDF	M24	.
61	7494809	7498091	3732	7014	3282	RIGHT	M24.EDF	M24	.
62	7500199	7500303	58	162	104	RIGHT	M24.EDF	M24	.
62	7500419	7500704	278	563	285	RIGHT	M24.EDF	M24	.
62	7500947	7501199	806	1058	252	RIGHT	M24.EDF	M24	.
62	7502856	7503071	2715	2930	215	RIGHT	M24.EDF	M24	.
62	7503841	7503842	3700	3701	1	RIGHT	M24.EDF	M24	.
62	7503870	7503889	3729	3748	19	RIGHT	M24.EDF	M24	.
63	7507591	7507671	57	137	80	RIGHT	M24.EDF	M24	.
63	7507828	7507901	294	367	73	RIGHT	M24.EDF	M24	.
63	7507999	7508617	465	1083	618	RIGHT	M24.EDF	M24	.
63	7511243	7513911	3709	6377	2668	RIGHT	M24.EDF	M24	.
64	7515527	7515527	308	308	0	RIGHT	M24.EDF	M24	.
64	7515550	7515599	331	380	49	RIGHT	M24.EDF	M24	.
64	7515720	7515948	501	729	228	RIGHT	M24.EDF	M24	.
64	7519415	7519554	4196	4335	139	RIGHT	M24.EDF	M24	.
65	7523460	7525023	483	2046	1563	RIGHT	M24.EDF	M24	.
65	7525061	7525063	2084	2086	2	RIGHT	M24.EDF	M24	.
65	7525151	7525151	2174	2174	0	RIGHT	M24.EDF	M24	.
65	7525192	7525192	2215	2215	0	RIGHT	M24.EDF	M24	.
65	7525246	7525246	2269	2269	0	RIGHT	M24.EDF	M24	.
65	7525282	7525282	2305	2305	0	RIGHT	M24.EDF	M24	.
65	7525326	7525326	2349	2349	0	RIGHT	M24.EDF	M24	.
65	7525347	7528380	2370	5403	3033	RIGHT	M24.EDF	M24	.
66	7530686	7531325	609	1248	639	RIGHT	M24.EDF	M24	.
66	7535033	7535111	4956	5034	78	RIGHT	M24.EDF	M24	.
66	7535134	7535135	5057	5058	1	RIGHT	M24.EDF	M24	.
66	7535915	7535915	5838	5838	0	RIGHT	M24.EDF	M24	.
67	7539072	7540138	454	1520	1066	RIGHT	M24.EDF	M24	.
67	7540184	7540210	1566	1592	26	RIGHT	M24.EDF	M24	.
67	7540268	7540268	1650	1650	0	RIGHT	M24.EDF	M24	.
67	7540307	7540307	1689	1689	0	RIGHT	M24.EDF	M24	.
67	7540334	7540357	1716	1739	23	RIGHT	M24.EDF	M24	.
67	7540803	7540823	2185	2205	20	RIGHT	M24.EDF	M24	.
67	7541566	7541588	2948	2970	22	RIGHT	M24.EDF	M24	.
67	7541652	7544380	3034	5762	2728	RIGHT	M24.EDF	M24	.
68	7546108	7553226	57	7175	7118	RIGHT	M24.EDF	M24	.
69	7555125	7556032	58	965	907	RIGHT	M24.EDF	M24	.
69	7556079	7556091	1012	1024	12	RIGHT	M24.EDF	M24	.
69	7556124	7556124	1057	1057	0	RIGHT	M24.EDF	M24	.
69	7556166	7556428	1099	1361	262	RIGHT	M24.EDF	M24	.
69	7557015	7557017	1948	1950	2	RIGHT	M24.EDF	M24	.
69	7558260	7558260	3193	3193	0	RIGHT	M24.EDF	M24	.
69	7558317	7558788	3250	3721	471	RIGHT	M24.EDF	M24	.
69	7558819	7559607	3752	4540	788	RIGHT	M24.EDF	M24	.
69	7559628	7560961	4561	5894	1333	RIGHT	M24.EDF	M24	.
70	7563001	7567919	58	4976	4918	RIGHT	M24.EDF	M24	.
71	7570434	7570769	120	455	335	RIGHT	M24.EDF	M24	.
71	7575576	7575860	5262	5546	284	RIGHT	M24.EDF	M24	.
71	7575882	7575900	5568	5586	18	RIGHT	M24.EDF	M24	.
71	7576043	7576710	5729	6396	667	RIGHT	M24.EDF	M24	.
72	7579070	7579370	58	358	300	RIGHT	M24.EDF	M24	.
72	7579625	7579816	613	804	191	RIGHT	M24.EDF	M24	.
72	7583701	7583721	4689	4709	20	RIGHT	M24.EDF	M24	.
72	7583879	7583889	4867	4877	10	RIGHT	M24.EDF	M24	.
72	7583921	7583933	4909	4921	12	RIGHT	M24.EDF	M24	.
72	7584034	7584382	5022	5370	348	RIGHT	M24.EDF	M24	.
72	7584469	7585020	5457	6008	551	RIGHT	M24.EDF	M24	.
72	7585053	7585956	6041	6944	903	RIGHT	M24.EDF	M24	.
73	7588436	7589767	58	1389	1331	RIGHT	M24.EDF	M24	.
73	7593460	7595472	5082	7094	2012	RIGHT	M24.EDF	M24	.
74	7597581	7598912	58	1389	1331	RIGHT	M24.EDF	M24	.
74	7601011	7601256	3488	3733	245	RIGHT	M24.EDF	M24	.
74	7601280	7602446	3757	4923	1166	RIGHT	M24.EDF	M24	.
75	7604913	7605822	57	966	909	RIGHT	M24.EDF	M24	.
75	7605893	7605901	1037	1045	8	RIGHT	M24.EDF	M24	.
75	7606131	7606255	1275	1399	124	RIGHT	M24.EDF	M24	.
75	7606310	7606344	1454	1488	34	RIGHT	M24.EDF	M24	.
75	7607539	7608463	2683	3607	924	RIGHT	M24.EDF	M24	.
75	7608496	7608661	3640	3805	165	RIGHT	M24.EDF	M24	.
75	7608698	7608707	3842	3851	9	RIGHT	M24.EDF	M24	.
75	7608732	7611204	3876	6348	2472	RIGHT	M24.EDF	M24	.
75	7611254	7611286	6398	6430	32	RIGHT	M24.EDF	M24	.
75	7611307	7611352	6451	6496	45	RIGHT	M24.EDF	M24	.
76	7612971	7619967	58	7054	6996	RIGHT	M24.EDF	M24	.
77	7623167	7628912	58	5803	5745	RIGHT	M24.EDF	M24	.
78	7630761	7631431	58	728	670	RIGHT	M24.EDF	M24	.
78	7633699	7633717	2996	3014	18	RIGHT	M24.EDF	M24	.
78	7633886	7633889	3183	3186	3	RIGHT	M24.EDF	M24	.
78	7633970	7633995	3267	3292	25	RIGHT	M24.EDF	M24	.
78	7634022	7634053	3319	3350	31	RIGHT	M24.EDF	M24	.
78	7634111	7634123	3408	3420	12	RIGHT	M24.EDF	M24	.
78	7634156	7635677	3453	4974	1521	RIGHT	M24.EDF	M24	.
79	7637473	7638554	58	1139	1081	RIGHT	M24.EDF	M24	.
79	7639482	7639619	2067	2204	137	RIGHT	M24.EDF	M24	.
79	7640212	7643741	2797	6326	3529	RIGHT	M24.EDF	M24	.
80	7645519	7645636	58	175	117	RIGHT	M24.EDF	M24	.
80	7645774	7645923	313	462	149	RIGHT	M24.EDF	M24	.
80	7650540	7650580	5079	5119	40	RIGHT	M24.EDF	M24	.
80	7650610	7650640	5149	5179	30	RIGHT	M24.EDF	M24	.
80	7650672	7650672	5211	5211	0	RIGHT	M24.EDF	M24	.
80	7650709	7650738	5248	5277	29	RIGHT	M24.EDF	M24	.
80	7650767	7650767	5306	5306	0	RIGHT	M24.EDF	M24	.
80	7650828	7650828	5367	5367	0	RIGHT	M24.EDF	M24	.
80	7650849	7650849	5388	5388	0	RIGHT	M24.EDF	M24	.
80	7650889	7650926	5428	5465	37	RIGHT	M24.EDF	M24	.
80	7650961	7650961	5500	5500	0	RIGHT	M24.EDF	M24	.
80	7651000	7651043	5539	5582	43	RIGHT	M24.EDF	M24	.
80	7651069	7651090	5608	5629	21	RIGHT	M24.EDF	M24	.
80	7651121	7651121	5660	5660	0	RIGHT	M24.EDF	M24	.
80	7651156	7651156	5695	5695	0	RIGHT	M24.EDF	M24	.
80	7651177	7651177	5716	5716	0	RIGHT	M24.EDF	M24	.
80	7651217	7651228	5756	5767	11	RIGHT	M24.EDF	M24	.
80	7651323	7651323	5862	5862	0	RIGHT	M24.EDF	M24	.
80	7651353	7651357	5892	5896	4	RIGHT	M24.EDF	M24	.
80	7651471	7651472	6010	6011	1	RIGHT	M24.EDF	M24	.
80	7651513	7651513	6052	6052	0	RIGHT	M24.EDF	M24	.
80	7651543	7651578	6082	6117	35	RIGHT	M24.EDF	M24	.
80	7651611	7651732	6150	6271	121	RIGHT	M24.EDF	M24	.
80	7651755	7651824	6294	6363	69	RIGHT	M24.EDF	M24	.
80	7651846	7651912	6385	6451	66	RIGHT	M24.EDF	M24	.
80	7651939	7651986	6478	6525	47	RIGHT	M24.EDF	M24	.
81	7654136	7655374	57	1295	1238	RIGHT	M24.EDF	M24	.
81	7655914	7656232	1835	2153	318	RIGHT	M24.EDF	M24	.
81	7657343	7660803	3264	6724	3460	RIGHT	M24.EDF	M24	.
82	7662787	7663095	58	366	308	RIGHT	M24.EDF	M24	.
82	7663119	7663883	390	1154	764	RIGHT	M24.EDF	M24	.
82	7665717	7668646	2988	5917	2929	RIGHT	M24.EDF	M24	.
83	7670461	7670606	57	202	145	RIGHT	M24.EDF	M24	.
83	7673603	7676411	3199	6007	2808	RIGHT	M24.EDF	M24	.
84	7678691	7679330	58	697	639	RIGHT	M24.EDF	M24	.
84	7679802	7679862	1169	1229	60	RIGHT	M24.EDF	M24	.
84	7681536	7681881	2903	3248	345	RIGHT	M24.EDF	M24	.
84	7681924	7684536	3291	5903	2612	RIGHT	M24.EDF	M24	.
85	7686964	7687650	57	743	686	RIGHT	M24.EDF	M24	.
85	7692590	7692624	5683	5717	34	RIGHT	M24.EDF	M24	.
85	7692668	7692668	5761	5761	0	RIGHT	M24.EDF	M24	.
85	7692763	7694013	5856	7106	1250	RIGHT	M24.EDF	M24	.
86	7697330	7698251	57	978	921	RIGHT	M24.EDF	M24	.
86	7700301	7704179	3028	6906	3878	RIGHT	M24.EDF	M24	.
87	7706057	7706087	57	87	30	RIGHT	M24.EDF	M24	.
87	7706194	7707015	194	1015	821	RIGHT	M24.EDF	M24	.
87	7708661	7708691	2661	2691	30	RIGHT	M24.EDF	M24	.
87	7708739	7708742	2739	2742	3	RIGHT	M24.EDF	M24	.
87	7708779	7713125	2779	7125	4346	RIGHT	M24.EDF	M24	.
88	7714880	7715095	58	273	215	RIGHT	M24.EDF	M24	.
88	7718022	7718269	3200	3447	247	RIGHT	M24.EDF	M24	.
88	7718437	7720619	3615	5797	2182	RIGHT	M24.EDF	M24	.
89	7722428	7722647	57	276	219	RIGHT	M24.EDF	M24	.
89	7723503	7723531	1132	1160	28	RIGHT	M24.EDF	M24	.
89	7723681	7723885	1310	1514	204	RIGHT	M24.EDF	M24	.
89	7725155	7725245	2784	2874	90	RIGHT	M24.EDF	M24	.
89	7725326	7725344	2955	2973	18	RIGHT	M24.EDF	M24	.
89	7725415	7728634	3044	6263	3219	RIGHT	M24.EDF	M24	.
90	7730116	7737019	57	6960	6903	RIGHT	M24.EDF	M24	.
91	7738856	7744974	58	6176	6118	RIGHT	M24.EDF	M24	.
92	7747061	7748208	57	1204	1147	RIGHT	M24.EDF	M24	.
92	7750028	7750660	3024	3656	632	RIGHT	M24.EDF	M24	.
92	7750682	7750682	3678	3678	0	RIGHT	M24.EDF	M24	.
92	7750714	7751027	3710	4023	313	RIGHT	M24.EDF	M24	.
92	7751968	7751994	4964	4990	26	RIGHT	M24.EDF	M24	.
92	7752022	7753179	5018	6175	1157	RIGHT	M24.EDF	M24	.
93	7755827	7757030	57	1260	1203	RIGHT	M24.EDF	M24	.
93	7758540	7758540	2770	2770	0	RIGHT	M24.EDF	M24	.
93	7758566	7758586	2796	2816	20	RIGHT	M24.EDF	M24	.
93	7758637	7762224	2867	6454	3587	RIGHT	M24.EDF	M24	.
94	7764562	7771700	57	7195	7138	RIGHT	M24.EDF	M24	.
95	7774007	7774350	57	400	343	RIGHT	M24.EDF	M24	.
95	7774484	7774484	534	534	0	RIGHT	M24.EDF	M24	.
95	7774766	7775078	816	1128	312	RIGHT	M24.EDF	M24	.
95	7775525	7779455	1575	5505	3930	RIGHT	M24.EDF	M24	.
96	7781440	7781788	57	405	348	RIGHT	M24.EDF	M24	.
96	7781948	7782275	565	892	327	RIGHT	M24.EDF	M24	.
96	7782380	7782454	997	1071	74	RIGHT	M24.EDF	M24	.
96	7782680	7782728	1297	1345	48	RIGHT	M24.EDF	M24	.
96	7782798	7782799	1415	1416	1	RIGHT	M24.EDF	M24	.
96	7782863	7782981	1480	1598	118	RIGHT	M24.EDF	M24	.
96	7783018	7783018	1635	1635	0	RIGHT	M24.EDF	M24	.
96	7783048	7783099	1665	1716	51	RIGHT	M24.EDF	M24	.
96	7783136	7788200	1753	6817	5064	RIGHT	M24.EDF	M24	.
97	7790321	7790956	58	693	635	RIGHT	M24.EDF	M24	.
97	7791652	7791707	1389	1444	55	RIGHT	M24.EDF	M24	.
97	7791912	7797096	1649	6833	5184	RIGHT	M24.EDF	M24	.
98	7799003	7799616	57	670	613	RIGHT	M24.EDF	M24	.
98	7799700	7799702	754	756	2	RIGHT	M24.EDF	M24	.
98	7800339	7800345	1393	1399	6	RIGHT	M24.EDF	M24	.
98	7800376	7800507	1430	1561	131	RIGHT	M24.EDF	M24	.
98	7800542	7804090	1596	5144	3548	RIGHT	M24.EDF	M24	.
99	7806120	7812615	58	6553	6495	RIGHT	M24.EDF	M24	.
100	7814262	7814446	58	242	184	RIGHT	M24.EDF	M24	.
100	7814745	7815064	541	860	319	RIGHT	M24.EDF	M24	.
100	7815091	7815104	887	900	13	RIGHT	M24.EDF	M24	.
100	7815518	7815540	1314	1336	22	RIGHT	M24.EDF	M24	.
100	7815573	7815587	1369	1383	14	RIGHT	M24.EDF	M24	.
100	7815626	7815646	1422	1442	20	RIGHT	M24.EDF	M24	.
100	7815685	7815686	1481	1482	1	RIGHT	M24.EDF	M24	.
100	7815713	7815721	1509	1517	8	RIGHT	M24.EDF	M24	.
100	7815743	7815767	1539	1563	24	RIGHT	M24.EDF	M24	.
100	7815810	7815919	1606	1715	109	RIGHT	M24.EDF	M24	.
100	7815943	7820870	1739	6666	4927	RIGHT	M24.EDF	M24	.
101	7823110	7828025	57	4972	4915	RIGHT	M24.EDF	M24	.
102	7829939	7835800	58	5919	5861	RIGHT	M24.EDF	M24	.
103	7837643	7843244	57	5658	5601	RIGHT	M24.EDF	M24	.
104	7845382	7852360	57	7035	6978	RIGHT	M24.EDF	M24	.
105	7854139	7860205	58	6124	6066	RIGHT	M24.EDF	M24	.
106	7862229	7869030	57	6858	6801	RIGHT	M24.EDF	M24	.
107	7871035	7871158	57	180	123	RIGHT	M24.EDF	M24	.
107	7873496	7877756	2518	6778	4260	RIGHT	M24.EDF	M24	.
108	7879754	7881402	57	1705	1648	RIGHT	M24.EDF	M24	.
108	7881488	7881580	1791	1883	92	RIGHT	M24.EDF	M24	.
108	7882086	7885970	2389	6273	3884	RIGHT	M24.EDF	M24	.
109	7888379	7889463	57	1141	1084	RIGHT	M24.EDF	M24	.
109	7889488	7889489	1166	1167	1	RIGHT	M24.EDF	M24	.
109	7890718	7894436	2396	6114	3718	RIGHT	M24.EDF	M24	.
110	7897065	7898054	57	1046	989	RIGHT	M24.EDF	M24	.
110	7898999	7898999	1991	1991	0	RIGHT	M24.EDF	M24	.
110	7899736	7903231	2728	6223	3495	RIGHT	M24.EDF	M24	.
111	7905560	7906577	58	1075	1017	RIGHT	M24.EDF	M24	.
111	7908066	7911046	2564	5544	2980	RIGHT	M24.EDF	M24	.
112	7913342	7914106	57	821	764	RIGHT	M24.EDF	M24	.
112	7916943	7916943	3658	3658	0	RIGHT	M24.EDF	M24	.
112	7916968	7919981	3683	6696	3013	RIGHT	M24.EDF	M24	.
113	7922017	7922939	58	980	922	RIGHT	M24.EDF	M24	.
113	7923001	7923464	1042	1505	463	RIGHT	M24.EDF	M24	.
113	7923735	7923901	1776	1942	166	RIGHT	M24.EDF	M24	.
113	7924606	7927567	2647	5608	2961	RIGHT	M24.EDF	M24	.
114	7929932	7931202	58	1328	1270	RIGHT	M24.EDF	M24	.
114	7931237	7931263	1363	1389	26	RIGHT	M24.EDF	M24	.
114	7932486	7935931	2612	6057	3445	RIGHT	M24.EDF	M24	.
115	7937967	7939144	57	1234	1177	RIGHT	M24.EDF	M24	.
115	7940850	7945017	2940	7107	4167	RIGHT	M24.EDF	M24	.
116	7948299	7948321	771	793	22	RIGHT	M24.EDF	M24	.
116	7948355	7949296	827	1768	941	RIGHT	M24.EDF	M24	.
116	7949569	7949603	2041	2075	34	RIGHT	M24.EDF	M24	.
116	7950291	7952632	2763	5104	2341	RIGHT	M24.EDF	M24	.
117	7954599	7954823	58	282	224	RIGHT	M24.EDF	M24	.
117	7956818	7961927	2277	7386	5109	RIGHT	M24.EDF	M24	.
118	7964354	7966256	57	1959	1902	RIGHT	M24.EDF	M24	.
118	7966321	7966321	2024	2024	0	RIGHT	M24.EDF	M24	.
118	7966630	7970653	2333	6356	4023	RIGHT	M24.EDF	M24	.
119	7973160	7973372	57	269	212	RIGHT	M24.EDF	M24	.
119	7973541	7973614	438	511	73	RIGHT	M24.EDF	M24	.
119	7973648	7973658	545	555	10	RIGHT	M24.EDF	M24	.
119	7973934	7973950	831	847	16	RIGHT	M24.EDF	M24	.
119	7973977	7979038	874	5935	5061	RIGHT	M24.EDF	M24	.
120	7981547	7981901	57	411	354	RIGHT	M24.EDF	M24	.
120	7981942	7982059	452	569	117	RIGHT	M24.EDF	M24	.
120	7982184	7982232	694	742	48	RIGHT	M24.EDF	M24	.
120	7982260	7983774	770	2284	1514	RIGHT	M24.EDF	M24	.
120	7983795	7983795	2305	2305	0	RIGHT	M24.EDF	M24	.
120	7983823	7983841	2333	2351	18	RIGHT	M24.EDF	M24	.
120	7983869	7983956	2379	2466	87	RIGHT	M24.EDF	M24	.
120	7983983	7987873	2493	6383	3890	RIGHT	M24.EDF	M24	.
2	18261380	18261535	188	343	155	RIGHT	M321.EDF	M32	1
2	18261556	18261556	364	364	0	RIGHT	M321.EDF	M32	1
2	18262530	18262662	1338	1470	132	RIGHT	M321.EDF	M32	1
3	18270041	18270203	393	555	162	RIGHT	M321.EDF	M32	1
4	18276708	18276765	58	115	57	RIGHT	M321.EDF	M32	1
4	18276786	18276794	136	144	8	RIGHT	M321.EDF	M32	1
4	18277963	18278168	1313	1518	205	RIGHT	M321.EDF	M32	1
4	18281397	18281507	4747	4857	110	RIGHT	M321.EDF	M32	1
5	18288315	18288487	232	404	172	RIGHT	M321.EDF	M32	1
5	18294295	18294472	6212	6389	177	RIGHT	M321.EDF	M32	1
6	18297108	18297215	520	627	107	RIGHT	M321.EDF	M32	1
6	18297244	18297249	656	661	5	RIGHT	M321.EDF	M32	1
6	18298269	18298386	1681	1798	117	RIGHT	M321.EDF	M32	1
6	18298415	18298417	1827	1829	2	RIGHT	M321.EDF	M32	1
7	18304435	18304614	662	841	179	RIGHT	M321.EDF	M32	1
7	18304635	18304638	862	865	3	RIGHT	M321.EDF	M32	1
8	18312073	18312237	255	419	164	RIGHT	M321.EDF	M32	1
8	18312262	18312282	444	464	20	RIGHT	M321.EDF	M32	1
8	18313422	18313616	1604	1798	194	RIGHT	M321.EDF	M32	1
9	18321069	18321176	627	734	107	RIGHT	M321.EDF	M32	1
9	18325480	18325610	5038	5168	130	RIGHT	M321.EDF	M32	1
10	18328920	18329034	1422	1536	114	RIGHT	M321.EDF	M32	1
10	18332052	18332239	4554	4741	187	RIGHT	M321.EDF	M32	1
10	18332261	18332262	4763	4764	1	RIGHT	M321.EDF	M32	1
10	18332288	18332290	4790	4792	2	RIGHT	M321.EDF	M32	1
11	18335954	18336082	457	585	128	RIGHT	M321.EDF	M32	1
11	18337343	18337459	1846	1962	116	RIGHT	M321.EDF	M32	1
11	18337486	18337487	1989	1990	1	RIGHT	M321.EDF	M32	1
11	18340136	18340286	4639	4789	150	RIGHT	M321.EDF	M32	1
12	18343083	18343254	747	918	171	RIGHT	M321.EDF	M32	1
12	18343275	18343275	939	939	0	RIGHT	M321.EDF	M32	1
13	18350139	18350247	497	605	108	RIGHT	M321.EDF	M32	1
13	18351304	18351431	1662	1789	127	RIGHT	M321.EDF	M32	1
14	18357946	18358059	791	904	113	RIGHT	M321.EDF	M32	1
14	18358092	18358095	937	940	3	RIGHT	M321.EDF	M32	1
14	18361633	18361761	4478	4606	128	RIGHT	M321.EDF	M32	1
15	18364556	18364557	487	488	1	RIGHT	M321.EDF	M32	1
15	18364584	18364709	515	640	125	RIGHT	M321.EDF	M32	1
15	18364734	18364735	665	666	1	RIGHT	M321.EDF	M32	1
16	18372139	18372324	909	1094	185	RIGHT	M321.EDF	M32	1
17	18379888	18380014	491	617	126	RIGHT	M321.EDF	M32	1
17	18381425	18381549	2028	2152	124	RIGHT	M321.EDF	M32	1
18	18387704	18387872	581	749	168	RIGHT	M321.EDF	M32	1
18	18389256	18389369	2133	2246	113	RIGHT	M321.EDF	M32	1
18	18389402	18389417	2279	2294	15	RIGHT	M321.EDF	M32	1
18	18393371	18393507	6248	6384	136	RIGHT	M321.EDF	M32	1
19	18397245	18397411	1650	1816	166	RIGHT	M321.EDF	M32	1
19	18401622	18401813	6027	6218	191	RIGHT	M321.EDF	M32	1
19	18401851	18401854	6256	6259	3	RIGHT	M321.EDF	M32	1
20	18404067	18404306	418	657	239	RIGHT	M321.EDF	M32	1
20	18410165	18410312	6516	6663	147	RIGHT	M321.EDF	M32	1
21	18413414	18413594	494	674	180	RIGHT	M321.EDF	M32	1
22	18424910	18425096	4988	5174	186	RIGHT	M321.EDF	M32	1
22	18425138	18425151	5216	5229	13	RIGHT	M321.EDF	M32	1
23	18428947	18429095	459	607	148	RIGHT	M321.EDF	M32	1
23	18429128	18429129	640	641	1	RIGHT	M321.EDF	M32	1
23	18430041	18430180	1553	1692	139	RIGHT	M321.EDF	M32	1
24	18436728	18436918	1676	1866	190	RIGHT	M321.EDF	M32	1
24	18441008	18441135	5956	6083	127	RIGHT	M321.EDF	M32	1
25	18444016	18444215	589	788	199	RIGHT	M321.EDF	M32	1
25	18447034	18447185	3607	3758	151	RIGHT	M321.EDF	M32	1
25	18449573	18449759	6146	6332	186	RIGHT	M321.EDF	M32	1
26	18453130	18453322	907	1099	192	RIGHT	M321.EDF	M32	1
26	18455259	18455435	3036	3212	176	RIGHT	M321.EDF	M32	1
26	18455479	18455482	3256	3259	3	RIGHT	M321.EDF	M32	1
27	18459264	18459389	57	182	125	RIGHT	M321.EDF	M32	1
28	18467874	18468018	753	897	144	RIGHT	M321.EDF	M32	1
28	18468044	18468051	923	930	7	RIGHT	M321.EDF	M32	1
28	18470727	18470888	3606	3767	161	RIGHT	M321.EDF	M32	1
28	18470914	18470919	3793	3798	5	RIGHT	M321.EDF	M32	1
29	18475735	18475898	488	651	163	RIGHT	M321.EDF	M32	1
29	18478940	18479096	3693	3849	156	RIGHT	M321.EDF	M32	1
29	18479119	18479130	3872	3883	11	RIGHT	M321.EDF	M32	1
30	18489172	18489323	6311	6462	151	RIGHT	M321.EDF	M32	1
30	18489361	18489362	6500	6501	1	RIGHT	M321.EDF	M32	1
31	18492532	18492687	504	659	155	RIGHT	M321.EDF	M32	1
31	18494086	18494207	2058	2179	121	RIGHT	M321.EDF	M32	1
31	18497058	18497296	5030	5268	238	RIGHT	M321.EDF	M32	1
32	18499745	18499854	116	225	109	RIGHT	M321.EDF	M32	1
32	18499876	18499884	247	255	8	RIGHT	M321.EDF	M32	1
32	18500108	18500233	479	604	125	RIGHT	M321.EDF	M32	1
32	18500837	18501006	1208	1377	169	RIGHT	M321.EDF	M32	1
32	18504691	18504885	5062	5256	194	RIGHT	M321.EDF	M32	1
33	18508896	18509030	467	601	134	RIGHT	M321.EDF	M32	1
33	18509615	18509758	1186	1329	143	RIGHT	M321.EDF	M32	1
33	18513016	18513201	4587	4772	185	RIGHT	M321.EDF	M32	1
33	18513226	18513233	4797	4804	7	RIGHT	M321.EDF	M32	1
34	18518208	18518324	519	635	116	RIGHT	M321.EDF	M32	1
34	18518346	18518357	657	668	11	RIGHT	M321.EDF	M32	1
34	18519183	18519367	1494	1678	184	RIGHT	M321.EDF	M32	1
35	18525629	18525793	932	1096	164	RIGHT	M321.EDF	M32	1
35	18529413	18529566	4716	4869	153	RIGHT	M321.EDF	M32	1
35	18529590	18529595	4893	4898	5	RIGHT	M321.EDF	M32	1
36	18533889	18534074	506	691	185	RIGHT	M321.EDF	M32	1
36	18539157	18539291	5774	5908	134	RIGHT	M321.EDF	M32	1
37	18545333	18545370	66	103	37	RIGHT	M321.EDF	M32	1
37	18545729	18545877	462	610	148	RIGHT	M321.EDF	M32	1
37	18547020	18547147	1753	1880	127	RIGHT	M321.EDF	M32	1
38	18553177	18553342	460	625	165	RIGHT	M321.EDF	M32	1
38	18553385	18553392	668	675	7	RIGHT	M321.EDF	M32	1
38	18554193	18554350	1476	1633	157	RIGHT	M321.EDF	M32	1
38	18558182	18558319	5465	5602	137	RIGHT	M321.EDF	M32	1
39	18560956	18561130	540	714	174	RIGHT	M321.EDF	M32	1
39	18561664	18561864	1248	1448	200	RIGHT	M321.EDF	M32	1
40	18567365	18567567	552	754	202	RIGHT	M321.EDF	M32	1
40	18572836	18572998	6023	6185	162	RIGHT	M321.EDF	M32	1
41	18575985	18576097	459	571	112	RIGHT	M321.EDF	M32	1
41	18576138	18576157	612	631	19	RIGHT	M321.EDF	M32	1
41	18576763	18576929	1237	1403	166	RIGHT	M321.EDF	M32	1
41	18579723	18579891	4197	4365	168	RIGHT	M321.EDF	M32	1
42	18583639	18583830	434	625	191	RIGHT	M321.EDF	M32	1
42	18585096	18585239	1891	2034	143	RIGHT	M321.EDF	M32	1
42	18585260	18585262	2055	2057	2	RIGHT	M321.EDF	M32	1
42	18589644	18589753	6439	6548	109	RIGHT	M321.EDF	M32	1
43	18593014	18593214	524	724	200	RIGHT	M321.EDF	M32	1
43	18594881	18595034	2391	2544	153	RIGHT	M321.EDF	M32	1
44	18600625	18600816	1101	1292	191	RIGHT	M321.EDF	M32	1
44	18604574	18604790	5050	5266	216	RIGHT	M321.EDF	M32	1
44	18604876	18604898	5352	5374	22	RIGHT	M321.EDF	M32	1
45	18609583	18609762	552	731	179	RIGHT	M321.EDF	M32	1
45	18610359	18610505	1328	1474	146	RIGHT	M321.EDF	M32	1
45	18615327	18615512	6296	6481	185	RIGHT	M321.EDF	M32	1
46	18618042	18618134	57	149	92	RIGHT	M321.EDF	M32	1
46	18618536	18618671	551	686	135	RIGHT	M321.EDF	M32	1
46	18619643	18619823	1658	1838	180	RIGHT	M321.EDF	M32	1
46	18622386	18622578	4401	4593	192	RIGHT	M321.EDF	M32	1
46	18624119	18624119	6134	6134	0	RIGHT	M321.EDF	M32	1
46	18624140	18624150	6155	6165	10	RIGHT	M321.EDF	M32	1
47	18626049	18626238	511	700	189	RIGHT	M321.EDF	M32	1
47	18631131	18631214	5593	5676	83	RIGHT	M321.EDF	M32	1
48	18633510	18633710	496	696	200	RIGHT	M321.EDF	M32	1
48	18636800	18636962	3786	3948	162	RIGHT	M321.EDF	M32	1
49	18641927	18642101	487	661	174	RIGHT	M321.EDF	M32	1
49	18642692	18642858	1252	1418	166	RIGHT	M321.EDF	M32	1
49	18648074	18648249	6634	6809	175	RIGHT	M321.EDF	M32	1
50	18650704	18650889	478	663	185	RIGHT	M321.EDF	M32	1
50	18650914	18650923	688	697	9	RIGHT	M321.EDF	M32	1
50	18652032	18652182	1806	1956	150	RIGHT	M321.EDF	M32	1
50	18655825	18655978	5599	5752	153	RIGHT	M321.EDF	M32	1
50	18656006	18656009	5780	5783	3	RIGHT	M321.EDF	M32	1
51	18659290	18659476	584	770	186	RIGHT	M321.EDF	M32	1
51	18659539	18659542	833	836	3	RIGHT	M321.EDF	M32	1
51	18663274	18663469	4568	4763	195	RIGHT	M321.EDF	M32	1
51	18663496	18663497	4790	4791	1	RIGHT	M321.EDF	M32	1
52	18666974	18667077	57	160	103	RIGHT	M321.EDF	M32	1
52	18667111	18667114	194	197	3	RIGHT	M321.EDF	M32	1
52	18668322	18668467	1405	1550	145	RIGHT	M321.EDF	M32	1
52	18673282	18673464	6365	6547	182	RIGHT	M321.EDF	M32	1
53	18675918	18676091	117	290	173	RIGHT	M321.EDF	M32	1
53	18679716	18679937	3915	4136	221	RIGHT	M321.EDF	M32	1
54	18684904	18685051	607	754	147	RIGHT	M321.EDF	M32	1
54	18686277	18686472	1980	2175	195	RIGHT	M321.EDF	M32	1
54	18689395	18689548	5098	5251	153	RIGHT	M321.EDF	M32	1
55	18691474	18691515	57	98	41	RIGHT	M321.EDF	M32	1
55	18695601	18695762	4184	4345	161	RIGHT	M321.EDF	M32	1
55	18695806	18695806	4389	4389	0	RIGHT	M321.EDF	M32	1
56	18699655	18699830	538	713	175	RIGHT	M321.EDF	M32	1
56	18700895	18701057	1778	1940	162	RIGHT	M321.EDF	M32	1
56	18701078	18701085	1961	1968	7	RIGHT	M321.EDF	M32	1
57	18707689	18707885	459	655	196	RIGHT	M321.EDF	M32	1
57	18710557	18710729	3327	3499	172	RIGHT	M321.EDF	M32	1
58	18716260	18716483	458	681	223	RIGHT	M321.EDF	M32	1
58	18716538	18716539	736	737	1	RIGHT	M321.EDF	M32	1
58	18717712	18717862	1910	2060	150	RIGHT	M321.EDF	M32	1
59	18723405	18723541	525	661	136	RIGHT	M321.EDF	M32	1
59	18727203	18727371	4323	4491	168	RIGHT	M321.EDF	M32	1
59	18727403	18727427	4523	4547	24	RIGHT	M321.EDF	M32	1
60	18731215	18731221	441	447	6	RIGHT	M321.EDF	M32	1
60	18731259	18731410	485	636	151	RIGHT	M321.EDF	M32	1
60	18732480	18732652	1706	1878	172	RIGHT	M321.EDF	M32	1
61	18741050	18741207	440	597	157	RIGHT	M321.EDF	M32	1
61	18741399	18741403	789	793	4	RIGHT	M321.EDF	M32	1
61	18741429	18741533	819	923	104	RIGHT	M321.EDF	M32	1
61	18741816	18741943	1206	1333	127	RIGHT	M321.EDF	M32	1
61	18742261	18742414	1651	1804	153	RIGHT	M321.EDF	M32	1
61	18742684	18742752	2074	2142	68	RIGHT	M321.EDF	M32	1
61	18744551	18744733	3941	4123	182	RIGHT	M321.EDF	M32	1
62	18749410	18749630	638	858	220	RIGHT	M321.EDF	M32	1
62	18752518	18752749	3746	3977	231	RIGHT	M321.EDF	M32	1
62	18752806	18752815	4034	4043	9	RIGHT	M321.EDF	M32	1
63	18757377	18757565	156	344	188	RIGHT	M321.EDF	M32	1
63	18758483	18758627	1262	1406	144	RIGHT	M321.EDF	M32	1
63	18760542	18760715	3321	3494	173	RIGHT	M321.EDF	M32	1
63	18762981	18763160	5760	5939	179	RIGHT	M321.EDF	M32	1
64	18768177	18768337	447	607	160	RIGHT	M321.EDF	M32	1
64	18768359	18768362	629	632	3	RIGHT	M321.EDF	M32	1
64	18772522	18772711	4792	4981	189	RIGHT	M321.EDF	M32	1
64	18772761	18772761	5031	5031	0	RIGHT	M321.EDF	M32	1
65	18777683	18777874	943	1134	191	RIGHT	M321.EDF	M32	1
65	18777923	18777932	1183	1192	9	RIGHT	M321.EDF	M32	1
65	18782385	18782558	5645	5818	173	RIGHT	M321.EDF	M32	1
65	18782609	18782609	5869	5869	0	RIGHT	M321.EDF	M32	1
66	18785780	18785980	762	962	200	RIGHT	M321.EDF	M32	1
66	18790564	18790612	5546	5594	48	RIGHT	M321.EDF	M32	1
67	18794028	18794237	1455	1664	209	RIGHT	M321.EDF	M32	1
67	18797525	18797725	4952	5152	200	RIGHT	M321.EDF	M32	1
68	18802734	18802888	1445	1599	154	RIGHT	M321.EDF	M32	1
68	18807524	18807653	6235	6364	129	RIGHT	M321.EDF	M32	1
71	18826117	18826294	542	719	177	RIGHT	M321.EDF	M32	1
72	18834670	18834792	470	592	122	RIGHT	M321.EDF	M32	1
72	18835169	18835308	969	1108	139	RIGHT	M321.EDF	M32	1
72	18836061	18836197	1861	1997	136	RIGHT	M321.EDF	M32	1
73	18842074	18842235	538	699	161	RIGHT	M321.EDF	M32	1
73	18845244	18845402	3708	3866	158	RIGHT	M321.EDF	M32	1
74	18849154	18849342	781	969	188	RIGHT	M321.EDF	M32	1
74	18851718	18851892	3345	3519	174	RIGHT	M321.EDF	M32	1
75	18857098	18857262	484	648	164	RIGHT	M321.EDF	M32	1
75	18858527	18858701	1913	2087	174	RIGHT	M321.EDF	M32	1
75	18862915	18863061	6301	6447	146	RIGHT	M321.EDF	M32	1
76	18866436	18866588	477	629	152	RIGHT	M321.EDF	M32	1
76	18871683	18871888	5724	5929	205	RIGHT	M321.EDF	M32	1
77	18877835	18878038	2762	2965	203	RIGHT	M321.EDF	M32	1
78	18885722	18885919	2764	2961	197	RIGHT	M321.EDF	M32	1
78	18885941	18885945	2983	2987	4	RIGHT	M321.EDF	M32	1
78	18889691	18889693	6733	6735	2	RIGHT	M321.EDF	M32	1
79	18892717	18892884	723	890	167	RIGHT	M321.EDF	M32	1
79	18894323	18894504	2329	2510	181	RIGHT	M321.EDF	M32	1
79	18896692	18896921	4698	4927	229	RIGHT	M321.EDF	M32	1
80	18900169	18900343	492	666	174	RIGHT	M321.EDF	M32	1
80	18902444	18902670	2767	2993	226	RIGHT	M321.EDF	M32	1
81	18908636	18908811	755	930	175	RIGHT	M321.EDF	M32	1
81	18910611	18910820	2730	2939	209	RIGHT	M321.EDF	M32	1
81	18912881	18913089	5000	5208	208	RIGHT	M321.EDF	M32	1
82	18918435	18918627	1887	2079	192	RIGHT	M321.EDF	M32	1
82	18918652	18918657	2104	2109	5	RIGHT	M321.EDF	M32	1
82	18921243	18921444	4695	4896	201	RIGHT	M321.EDF	M32	1
83	18926161	18926330	544	713	169	RIGHT	M321.EDF	M32	1
83	18929074	18929264	3457	3647	190	RIGHT	M321.EDF	M32	1
84	18934212	18934420	442	650	208	RIGHT	M321.EDF	M32	1
84	18934443	18934454	673	684	11	RIGHT	M321.EDF	M32	1
84	18935744	18935937	1974	2167	193	RIGHT	M321.EDF	M32	1
84	18939796	18940009	6026	6239	213	RIGHT	M321.EDF	M32	1
85	18942687	18942893	452	658	206	RIGHT	M321.EDF	M32	1
85	18945056	18945279	2821	3044	223	RIGHT	M321.EDF	M32	1
86	18951967	18952137	488	658	170	RIGHT	M321.EDF	M32	1
86	18952765	18952943	1286	1464	178	RIGHT	M321.EDF	M32	1
86	18955907	18956132	4428	4653	225	RIGHT	M321.EDF	M32	1
87	18961007	18961194	687	874	187	RIGHT	M321.EDF	M32	1
87	18962089	18962227	1769	1907	138	RIGHT	M321.EDF	M32	1
87	18962249	18962262	1929	1942	13	RIGHT	M321.EDF	M32	1
88	18970274	18970474	2726	2926	200	RIGHT	M321.EDF	M32	1
88	18974591	18974795	7043	7247	204	RIGHT	M321.EDF	M32	1
89	18977690	18977852	453	615	162	RIGHT	M321.EDF	M32	1
90	18986876	18987062	287	473	186	RIGHT	M321.EDF	M32	1
90	18991395	18991569	4806	4980	174	RIGHT	M321.EDF	M32	1
91	18996163	18996352	464	653	189	RIGHT	M321.EDF	M32	1
91	18998793	18998965	3094	3266	172	RIGHT	M321.EDF	M32	1
91	18998991	18999010	3292	3311	19	RIGHT	M321.EDF	M32	1
92	19005021	19005214	512	705	193	RIGHT	M321.EDF	M32	1
92	19008929	19009080	4420	4571	151	RIGHT	M321.EDF	M32	1
92	19009104	19009128	4595	4619	24	RIGHT	M321.EDF	M32	1
93	19013008	19013121	521	634	113	RIGHT	M321.EDF	M32	1
93	19013148	19013167	661	680	19	RIGHT	M321.EDF	M32	1
93	19014085	19014311	1598	1824	226	RIGHT	M321.EDF	M32	1
93	19016487	19016694	4000	4207	207	RIGHT	M321.EDF	M32	1
94	19022207	19022359	1644	1796	152	RIGHT	M321.EDF	M32	1
94	19022383	19022414	1820	1851	31	RIGHT	M321.EDF	M32	1
95	19030432	19030668	450	686	236	RIGHT	M321.EDF	M32	1
95	19033071	19033220	3089	3238	149	RIGHT	M321.EDF	M32	1
96	19039600	19039765	756	921	165	RIGHT	M321.EDF	M32	1
96	19039794	19039801	950	957	7	RIGHT	M321.EDF	M32	1
96	19041959	19042093	3115	3249	134	RIGHT	M321.EDF	M32	1
96	19042116	19042123	3272	3279	7	RIGHT	M321.EDF	M32	1
97	19046849	19047085	560	796	236	RIGHT	M321.EDF	M32	1
97	19052007	19052189	5718	5900	182	RIGHT	M321.EDF	M32	1
98	19054967	19055165	422	620	198	RIGHT	M321.EDF	M32	1
98	19056980	19057191	2435	2646	211	RIGHT	M321.EDF	M32	1
98	19060735	19060928	6190	6383	193	RIGHT	M321.EDF	M32	1
99	19064586	19064732	509	655	146	RIGHT	M321.EDF	M32	1
99	19065937	19066089	1860	2012	152	RIGHT	M321.EDF	M32	1
99	19067688	19067836	3611	3759	148	RIGHT	M321.EDF	M32	1
100	19071961	19072099	495	633	138	RIGHT	M321.EDF	M32	1
100	19073083	19073236	1617	1770	153	RIGHT	M321.EDF	M32	1
100	19076444	19076655	4978	5189	211	RIGHT	M321.EDF	M32	1
101	19080919	19081091	538	710	172	RIGHT	M321.EDF	M32	1
102	19090063	19090271	1056	1264	208	RIGHT	M321.EDF	M32	1
102	19095100	19095274	6093	6267	174	RIGHT	M321.EDF	M32	1
103	19098254	19098420	532	698	166	RIGHT	M321.EDF	M32	1
103	19100948	19101186	3226	3464	238	RIGHT	M321.EDF	M32	1
103	19101208	19101208	3486	3486	0	RIGHT	M321.EDF	M32	1
104	19106141	19106231	93	183	90	RIGHT	M321.EDF	M32	1
104	19106521	19106700	473	652	179	RIGHT	M321.EDF	M32	1
104	19108416	19108591	2368	2543	175	RIGHT	M321.EDF	M32	1
105	19113681	19113858	521	698	177	RIGHT	M321.EDF	M32	1
105	19115613	19115802	2453	2642	189	RIGHT	M321.EDF	M32	1
105	19117192	19117412	4032	4252	220	RIGHT	M321.EDF	M32	1
106	19120679	19120859	129	309	180	RIGHT	M321.EDF	M32	1
106	19122406	19122601	1856	2051	195	RIGHT	M321.EDF	M32	1
107	19128747	19128979	447	679	232	RIGHT	M321.EDF	M32	1
107	19130128	19130280	1828	1980	152	RIGHT	M321.EDF	M32	1
107	19132694	19132883	4394	4583	189	RIGHT	M321.EDF	M32	1
108	19136726	19136899	445	618	173	RIGHT	M321.EDF	M32	1
108	19137590	19137731	1309	1450	141	RIGHT	M321.EDF	M32	1
108	19138066	19138199	1785	1918	133	RIGHT	M321.EDF	M32	1
108	19142140	19142298	5859	6017	158	RIGHT	M321.EDF	M32	1
108	19142419	19142608	6138	6327	189	RIGHT	M321.EDF	M32	1
109	19146241	19146439	1274	1472	198	RIGHT	M321.EDF	M32	1
110	19152976	19153179	494	697	203	RIGHT	M321.EDF	M32	1
111	19165095	19165299	3554	3758	204	RIGHT	M321.EDF	M32	1
112	19170346	19170616	544	814	270	RIGHT	M321.EDF	M32	1
112	19173667	19173856	3865	4054	189	RIGHT	M321.EDF	M32	1
113	19179921	19180077	1870	2026	156	RIGHT	M321.EDF	M32	1
113	19180098	19180098	2047	2047	0	RIGHT	M321.EDF	M32	1
114	19185152	19185396	537	781	244	RIGHT	M321.EDF	M32	1
114	19185431	19185437	816	822	6	RIGHT	M321.EDF	M32	1
114	19186428	19186583	1813	1968	155	RIGHT	M321.EDF	M32	1
114	19188661	19188880	4046	4265	219	RIGHT	M321.EDF	M32	1
115	19194644	19194873	587	816	229	RIGHT	M321.EDF	M32	1
115	19198386	19198539	4329	4482	153	RIGHT	M321.EDF	M32	1
116	19203182	19203359	447	624	177	RIGHT	M321.EDF	M32	1
116	19204678	19204814	1943	2079	136	RIGHT	M321.EDF	M32	1
116	19205543	19205755	2808	3020	212	RIGHT	M321.EDF	M32	1
117	19214770	19214965	3949	4144	195	RIGHT	M321.EDF	M32	1
117	19214992	19215024	4171	4203	32	RIGHT	M321.EDF	M32	1
118	19220338	19220502	1492	1656	164	RIGHT	M321.EDF	M32	1
118	19222241	19222470	3395	3624	229	RIGHT	M321.EDF	M32	1
119	19225944	19226073	497	626	129	RIGHT	M321.EDF	M32	1
119	19226095	19226106	648	659	11	RIGHT	M321.EDF	M32	1
119	19227990	19228121	2543	2674	131	RIGHT	M321.EDF	M32	1
119	19228142	19228165	2695	2718	23	RIGHT	M321.EDF	M32	1
120	19232965	19233172	535	742	207	RIGHT	M321.EDF	M32	1
120	19234308	19234342	1878	1912	34	RIGHT	M321.EDF	M32	1
120	19234413	19234558	1983	2128	145	RIGHT	M321.EDF	M32	1
120	19234594	19234597	2164	2167	3	RIGHT	M321.EDF	M32	1
120	19237720	19237853	5290	5423	133	RIGHT	M321.EDF	M32	1
120	19237880	19237904	5450	5474	24	RIGHT	M321.EDF	M32	1
1	19386119	19386331	1139	1351	212	RIGHT	M322.EDF	M32	2
2	19393771	19393870	481	580	99	RIGHT	M322.EDF	M32	2
2	19395087	19395248	1797	1958	161	RIGHT	M322.EDF	M32	2
3	19403675	19403843	496	664	168	RIGHT	M322.EDF	M32	2
3	19406739	19406931	3560	3752	192	RIGHT	M322.EDF	M32	2
4	19412344	19412518	610	784	174	RIGHT	M322.EDF	M32	2
4	19416659	19416865	4925	5131	206	RIGHT	M322.EDF	M32	2
5	19421215	19421363	1645	1793	148	RIGHT	M322.EDF	M32	2
6	19431880	19432086	4194	4400	206	RIGHT	M322.EDF	M32	2
7	19438438	19438658	1987	2207	220	RIGHT	M322.EDF	M32	2
7	19442584	19442709	6133	6258	125	RIGHT	M322.EDF	M32	2
7	19442794	19443020	6343	6569	226	RIGHT	M322.EDF	M32	2
8	19445853	19446048	310	505	195	RIGHT	M322.EDF	M32	2
8	19450431	19450606	4888	5063	175	RIGHT	M322.EDF	M32	2
9	19456680	19456895	2298	2513	215	RIGHT	M322.EDF	M32	2
9	19458813	19458984	4431	4602	171	RIGHT	M322.EDF	M32	2
10	19461888	19462026	553	691	138	RIGHT	M322.EDF	M32	2
10	19465335	19465507	4000	4172	172	RIGHT	M322.EDF	M32	2
13	19483626	19483853	669	896	227	RIGHT	M322.EDF	M32	2
14	19492416	19492600	445	629	184	RIGHT	M322.EDF	M32	2
14	19492630	19492634	659	663	4	RIGHT	M322.EDF	M32	2
14	19492658	19492659	687	688	1	RIGHT	M322.EDF	M32	2
15	19500434	19500564	1495	1625	130	RIGHT	M322.EDF	M32	2
15	19500596	19500597	1657	1658	1	RIGHT	M322.EDF	M32	2
15	19500618	19500618	1679	1679	0	RIGHT	M322.EDF	M32	2
15	19504910	19505049	5971	6110	139	RIGHT	M322.EDF	M32	2
15	19505072	19505089	6133	6150	17	RIGHT	M322.EDF	M32	2
16	19507987	19508137	485	635	150	RIGHT	M322.EDF	M32	2
16	19508162	19508186	660	684	24	RIGHT	M322.EDF	M32	2
16	19512458	19512628	4956	5126	170	RIGHT	M322.EDF	M32	2
16	19512655	19512656	5153	5154	1	RIGHT	M322.EDF	M32	2
17	19518826	19519079	2938	3191	253	RIGHT	M322.EDF	M32	2
18	19524051	19524168	58	175	117	RIGHT	M322.EDF	M32	2
18	19527252	19527506	3259	3513	254	RIGHT	M322.EDF	M32	2
19	19532922	19533118	1514	1710	196	RIGHT	M322.EDF	M32	2
20	19538851	19538917	58	124	66	RIGHT	M322.EDF	M32	2
20	19539244	19539464	451	671	220	RIGHT	M322.EDF	M32	2
21	19546804	19547012	517	725	208	RIGHT	M322.EDF	M32	2
21	19549105	19549364	2818	3077	259	RIGHT	M322.EDF	M32	2
22	19555168	19555298	649	779	130	RIGHT	M322.EDF	M32	2
22	19555320	19555340	801	821	20	RIGHT	M322.EDF	M32	2
22	19556259	19556446	1740	1927	187	RIGHT	M322.EDF	M32	2
22	19559513	19559724	4994	5205	211	RIGHT	M322.EDF	M32	2
24	19570823	19571099	471	747	276	RIGHT	M322.EDF	M32	2
24	19575028	19575228	4676	4876	200	RIGHT	M322.EDF	M32	2
25	19580398	19580644	2524	2770	246	RIGHT	M322.EDF	M32	2
26	19585907	19586077	1420	1590	170	RIGHT	M322.EDF	M32	2
26	19587150	19587279	2663	2792	129	RIGHT	M322.EDF	M32	2
26	19588579	19588733	4092	4246	154	RIGHT	M322.EDF	M32	2
27	19593193	19593273	57	137	80	RIGHT	M322.EDF	M32	2
27	19595505	19595688	2369	2552	183	RIGHT	M322.EDF	M32	2
27	19597304	19597519	4168	4383	215	RIGHT	M322.EDF	M32	2
28	19601618	19601786	521	689	168	RIGHT	M322.EDF	M32	2
28	19602567	19602755	1470	1658	188	RIGHT	M322.EDF	M32	2
28	19603390	19603580	2293	2483	190	RIGHT	M322.EDF	M32	2
28	19604401	19604571	3304	3474	170	RIGHT	M322.EDF	M32	2
28	19606906	19607128	5809	6031	222	RIGHT	M322.EDF	M32	2
29	19611168	19611351	634	817	183	RIGHT	M322.EDF	M32	2
29	19616586	19616827	6052	6293	241	RIGHT	M322.EDF	M32	2
30	19619997	19620169	904	1076	172	RIGHT	M322.EDF	M32	2
30	19620911	19621053	1818	1960	142	RIGHT	M322.EDF	M32	2
30	19625826	19625954	6733	6861	128	RIGHT	M322.EDF	M32	2
31	19628751	19628928	582	759	177	RIGHT	M322.EDF	M32	2
31	19630100	19630275	1931	2106	175	RIGHT	M322.EDF	M32	2
32	19635634	19635834	582	782	200	RIGHT	M322.EDF	M32	2
32	19641817	19641978	6765	6926	161	RIGHT	M322.EDF	M32	2
33	19646243	19646482	1626	1865	239	RIGHT	M322.EDF	M32	2
33	19649054	19649209	4437	4592	155	RIGHT	M322.EDF	M32	2
33	19649742	19649761	5125	5144	19	RIGHT	M322.EDF	M32	2
34	19651776	19651892	57	173	116	RIGHT	M322.EDF	M32	2
34	19653077	19653263	1358	1544	186	RIGHT	M322.EDF	M32	2
34	19654741	19654880	3022	3161	139	RIGHT	M322.EDF	M32	2
34	19656511	19656670	4792	4951	159	RIGHT	M322.EDF	M32	2
35	19658716	19658870	112	266	154	RIGHT	M322.EDF	M32	2
35	19661238	19661398	2634	2794	160	RIGHT	M322.EDF	M32	2
36	19666793	19666957	532	696	164	RIGHT	M322.EDF	M32	2
36	19668179	19668332	1918	2071	153	RIGHT	M322.EDF	M32	2
36	19668915	19669136	2654	2875	221	RIGHT	M322.EDF	M32	2
36	19670296	19670477	4035	4216	181	RIGHT	M322.EDF	M32	2
36	19673126	19673166	6865	6905	40	RIGHT	M322.EDF	M32	2
37	19675885	19676082	762	959	197	RIGHT	M322.EDF	M32	2
38	19685098	19685319	654	875	221	RIGHT	M322.EDF	M32	2
38	19687060	19687288	2616	2844	228	RIGHT	M322.EDF	M32	2
38	19688080	19688255	3636	3811	175	RIGHT	M322.EDF	M32	2
38	19690010	19690197	5566	5753	187	RIGHT	M322.EDF	M32	2
39	19693726	19693888	812	974	162	RIGHT	M322.EDF	M32	2
39	19694966	19695112	2052	2198	146	RIGHT	M322.EDF	M32	2
39	19696917	19697111	4003	4197	194	RIGHT	M322.EDF	M32	2
40	19703018	19703211	1421	1614	193	RIGHT	M322.EDF	M32	2
40	19706998	19707139	5401	5542	141	RIGHT	M322.EDF	M32	2
41	19712034	19712186	1509	1661	152	RIGHT	M322.EDF	M32	2
41	19714666	19714888	4141	4363	222	RIGHT	M322.EDF	M32	2
43	19726234	19726388	1095	1249	154	RIGHT	M322.EDF	M32	2
43	19728921	19729170	3782	4031	249	RIGHT	M322.EDF	M32	2
43	19731941	19732072	6802	6933	131	RIGHT	M322.EDF	M32	2
44	19734696	19734853	562	719	157	RIGHT	M322.EDF	M32	2
44	19739205	19739360	5071	5226	155	RIGHT	M322.EDF	M32	2
45	19741826	19741991	509	674	165	RIGHT	M322.EDF	M32	2
45	19742456	19742633	1139	1316	177	RIGHT	M322.EDF	M32	2
45	19742914	19743074	1597	1757	160	RIGHT	M322.EDF	M32	2
45	19745304	19745453	3987	4136	149	RIGHT	M322.EDF	M32	2
46	19750226	19750321	1615	1710	95	RIGHT	M322.EDF	M32	2
46	19750348	19750355	1737	1744	7	RIGHT	M322.EDF	M32	2
46	19751170	19751327	2559	2716	157	RIGHT	M322.EDF	M32	2
46	19752899	19753028	4288	4417	129	RIGHT	M322.EDF	M32	2
46	19753049	19753061	4438	4450	12	RIGHT	M322.EDF	M32	2
47	19758300	19758392	531	623	92	RIGHT	M322.EDF	M32	2
47	19758419	19758426	650	657	7	RIGHT	M322.EDF	M32	2
47	19759361	19759538	1592	1769	177	RIGHT	M322.EDF	M32	2
47	19763340	19763513	5571	5744	173	RIGHT	M322.EDF	M32	2
48	19768854	19769027	440	613	173	RIGHT	M322.EDF	M32	2
48	19769397	19769468	983	1054	71	RIGHT	M322.EDF	M32	2
48	19770199	19770346	1785	1932	147	RIGHT	M322.EDF	M32	2
48	19773553	19773588	5139	5174	35	RIGHT	M322.EDF	M32	2
49	19776320	19776488	925	1093	168	RIGHT	M322.EDF	M32	2
49	19778080	19778304	2685	2909	224	RIGHT	M322.EDF	M32	2
50	19784207	19784377	468	638	170	RIGHT	M322.EDF	M32	2
50	19786424	19786630	2685	2891	206	RIGHT	M322.EDF	M32	2
50	19787817	19788002	4078	4263	185	RIGHT	M322.EDF	M32	2
51	19796782	19797010	4284	4512	228	RIGHT	M322.EDF	M32	2
52	19803056	19803231	2145	2320	175	RIGHT	M322.EDF	M32	2
52	19803264	19803265	2353	2354	1	RIGHT	M322.EDF	M32	2
52	19806485	19806668	5574	5757	183	RIGHT	M322.EDF	M32	2
53	19812031	19812257	2072	2298	226	RIGHT	M322.EDF	M32	2
53	19814081	19814285	4122	4326	204	RIGHT	M322.EDF	M32	2
54	19819584	19819779	2909	3104	195	RIGHT	M322.EDF	M32	2
55	19826139	19826344	593	798	205	RIGHT	M322.EDF	M32	2
55	19829339	19829521	3793	3975	182	RIGHT	M322.EDF	M32	2
55	19832518	19832684	6972	7138	166	RIGHT	M322.EDF	M32	2
56	19835087	19835300	613	826	213	RIGHT	M322.EDF	M32	2
56	19836751	19836960	2277	2486	209	RIGHT	M322.EDF	M32	2
56	19840889	19841107	6415	6633	218	RIGHT	M322.EDF	M32	2
57	19844189	19844408	419	638	219	RIGHT	M322.EDF	M32	2
57	19846129	19846353	2359	2583	224	RIGHT	M322.EDF	M32	2
57	19849462	19849678	5692	5908	216	RIGHT	M322.EDF	M32	2
58	19855154	19855356	2451	2653	202	RIGHT	M322.EDF	M32	2
59	19863559	19863774	2131	2346	215	RIGHT	M322.EDF	M32	2
59	19865769	19865988	4341	4560	219	RIGHT	M322.EDF	M32	2
60	19870748	19870965	2206	2423	217	RIGHT	M322.EDF	M32	2
60	19872294	19872506	3752	3964	212	RIGHT	M322.EDF	M32	2
61	19876275	19876458	507	690	183	RIGHT	M322.EDF	M32	2
61	19878497	19878703	2729	2935	206	RIGHT	M322.EDF	M32	2
62	19886070	19886257	1754	1941	187	RIGHT	M322.EDF	M32	2
62	19887448	19887645	3132	3329	197	RIGHT	M322.EDF	M32	2
62	19889151	19889337	4835	5021	186	RIGHT	M322.EDF	M32	2
63	19892544	19892752	474	682	208	RIGHT	M322.EDF	M32	2
63	19894781	19895014	2711	2944	233	RIGHT	M322.EDF	M32	2
64	19901740	19901938	1345	1543	198	RIGHT	M322.EDF	M32	2
65	19908819	19909016	653	850	197	RIGHT	M322.EDF	M32	2
65	19910690	19910954	2524	2788	264	RIGHT	M322.EDF	M32	2
65	19912857	19913070	4691	4904	213	RIGHT	M322.EDF	M32	2
67	19926062	19926293	560	791	231	RIGHT	M322.EDF	M32	2
67	19929253	19929476	3751	3974	223	RIGHT	M322.EDF	M32	2
68	19934796	19934960	1954	2118	164	RIGHT	M322.EDF	M32	2
68	19935511	19935725	2669	2883	214	RIGHT	M322.EDF	M32	2
69	19940165	19940369	606	810	204	RIGHT	M322.EDF	M32	2
69	19942666	19942862	3107	3303	196	RIGHT	M322.EDF	M32	2
70	19947075	19947299	460	684	224	RIGHT	M322.EDF	M32	2
70	19948246	19948466	1631	1851	220	RIGHT	M322.EDF	M32	2
71	19958232	19958280	5236	5284	48	RIGHT	M322.EDF	M32	2
72	19962353	19962548	709	904	195	RIGHT	M322.EDF	M32	2
72	19963618	19963818	1974	2174	200	RIGHT	M322.EDF	M32	2
72	19968186	19968268	6542	6624	82	RIGHT	M322.EDF	M32	2
73	19973042	19973263	3118	3339	221	RIGHT	M322.EDF	M32	2
74	19980189	19980343	2386	2540	154	RIGHT	M322.EDF	M32	2
75	19986767	19987026	615	874	259	RIGHT	M322.EDF	M32	2
75	19988849	19989133	2697	2981	284	RIGHT	M322.EDF	M32	2
75	19991872	19992107	5720	5955	235	RIGHT	M322.EDF	M32	2
77	20003897	20004134	2310	2547	237	RIGHT	M322.EDF	M32	2
77	20006654	20006891	5067	5304	237	RIGHT	M322.EDF	M32	2
78	20014662	20014817	4329	4484	155	RIGHT	M322.EDF	M32	2
79	20021718	20021955	2210	2447	237	RIGHT	M322.EDF	M32	2
80	20027268	20027484	453	669	216	RIGHT	M322.EDF	M32	2
80	20028784	20028971	1969	2156	187	RIGHT	M322.EDF	M32	2
81	20036159	20036364	2072	2277	205	RIGHT	M322.EDF	M32	2
82	20044356	20044610	2294	2548	254	RIGHT	M322.EDF	M32	2
83	20051198	20051425	2723	2950	227	RIGHT	M322.EDF	M32	2
84	20058074	20058313	1493	1732	239	RIGHT	M322.EDF	M32	2
85	20065013	20065154	1417	1558	141	RIGHT	M322.EDF	M32	2
85	20066781	20066974	3185	3378	193	RIGHT	M322.EDF	M32	2
86	20072618	20072818	499	699	200	RIGHT	M322.EDF	M32	2
86	20074164	20074346	2045	2227	182	RIGHT	M322.EDF	M32	2
86	20074376	20074376	2257	2257	0	RIGHT	M322.EDF	M32	2
86	20075408	20075591	3289	3472	183	RIGHT	M322.EDF	M32	2
86	20076342	20076526	4223	4407	184	RIGHT	M322.EDF	M32	2
87	20081248	20081470	892	1114	222	RIGHT	M322.EDF	M32	2
87	20081505	20081509	1149	1153	4	RIGHT	M322.EDF	M32	2
88	20087678	20087882	481	685	204	RIGHT	M322.EDF	M32	2
88	20088803	20088930	1606	1733	127	RIGHT	M322.EDF	M32	2
88	20091441	20091636	4244	4439	195	RIGHT	M322.EDF	M32	2
89	20097104	20097288	1952	2136	184	RIGHT	M322.EDF	M32	2
89	20099948	20100139	4796	4987	191	RIGHT	M322.EDF	M32	2
91	20116490	20116670	1792	1972	180	RIGHT	M322.EDF	M32	2
91	20116714	20116724	2016	2026	10	RIGHT	M322.EDF	M32	2
91	20117729	20117899	3031	3201	170	RIGHT	M322.EDF	M32	2
91	20117942	20117952	3244	3254	10	RIGHT	M322.EDF	M32	2
92	20125142	20125318	2360	2536	176	RIGHT	M322.EDF	M32	2
93	20132695	20132858	2662	2825	163	RIGHT	M322.EDF	M32	2
93	20132900	20132904	2867	2871	4	RIGHT	M322.EDF	M32	2
93	20134916	20135066	4883	5033	150	RIGHT	M322.EDF	M32	2
94	20139132	20139335	538	741	203	RIGHT	M322.EDF	M32	2
94	20143172	20143410	4578	4816	238	RIGHT	M322.EDF	M32	2
95	20148564	20148778	1536	1750	214	RIGHT	M322.EDF	M32	2
95	20150207	20150421	3179	3393	214	RIGHT	M322.EDF	M32	2
95	20153440	20153617	6412	6589	177	RIGHT	M322.EDF	M32	2
96	20159436	20159598	3665	3827	162	RIGHT	M322.EDF	M32	2
97	20164636	20164821	509	694	185	RIGHT	M322.EDF	M32	2
97	20166333	20166519	2206	2392	186	RIGHT	M322.EDF	M32	2
98	20171957	20172153	302	498	196	RIGHT	M322.EDF	M32	2
98	20172855	20173007	1200	1352	152	RIGHT	M322.EDF	M32	2
98	20175825	20175983	4170	4328	158	RIGHT	M322.EDF	M32	2
99	20180308	20180503	2102	2297	195	RIGHT	M322.EDF	M32	2
100	20186964	20187113	1410	1559	149	RIGHT	M322.EDF	M32	2
101	20196532	20196656	3887	4011	124	RIGHT	M322.EDF	M32	2
101	20196684	20196697	4039	4052	13	RIGHT	M322.EDF	M32	2
102	20200469	20200692	470	693	223	RIGHT	M322.EDF	M32	2
103	20210172	20210332	1905	2065	160	RIGHT	M322.EDF	M32	2
104	20216130	20216295	629	794	165	RIGHT	M322.EDF	M32	2
104	20216365	20216365	864	864	0	RIGHT	M322.EDF	M32	2
104	20217829	20217980	2328	2479	151	RIGHT	M322.EDF	M32	2
104	20221126	20221292	5625	5791	166	RIGHT	M322.EDF	M32	2
105	20225974	20226119	2252	2397	145	RIGHT	M322.EDF	M32	2
105	20226157	20226158	2435	2436	1	RIGHT	M322.EDF	M32	2
106	20231082	20231302	514	734	220	RIGHT	M322.EDF	M32	2
106	20234075	20234298	3507	3730	223	RIGHT	M322.EDF	M32	2
107	20239300	20239490	2179	2369	190	RIGHT	M322.EDF	M32	2
108	20246754	20246971	475	692	217	RIGHT	M322.EDF	M32	2
108	20248700	20248920	2421	2641	220	RIGHT	M322.EDF	M32	2
110	20263282	20263556	783	1057	274	RIGHT	M322.EDF	M32	2
110	20265937	20266201	3438	3702	264	RIGHT	M322.EDF	M32	2
110	20268957	20269181	6458	6682	224	RIGHT	M322.EDF	M32	2
111	20272215	20272425	641	851	210	RIGHT	M322.EDF	M32	2
111	20274163	20274329	2589	2755	166	RIGHT	M322.EDF	M32	2
111	20274351	20274370	2777	2796	19	RIGHT	M322.EDF	M32	2
111	20277329	20277545	5755	5971	216	RIGHT	M322.EDF	M32	2
112	20282880	20283098	2329	2547	218	RIGHT	M322.EDF	M32	2
113	20290887	20291129	2022	2264	242	RIGHT	M322.EDF	M32	2
113	20291164	20291170	2299	2305	6	RIGHT	M322.EDF	M32	2
113	20294003	20294228	5138	5363	225	RIGHT	M322.EDF	M32	2
114	20297691	20297887	251	447	196	RIGHT	M322.EDF	M32	2
114	20299700	20299858	2260	2418	158	RIGHT	M322.EDF	M32	2
114	20301043	20301288	3603	3848	245	RIGHT	M322.EDF	M32	2
115	20307310	20307522	858	1070	212	RIGHT	M322.EDF	M32	2
116	20316157	20316383	826	1052	226	RIGHT	M322.EDF	M32	2
116	20318057	20318280	2726	2949	223	RIGHT	M322.EDF	M32	2
116	20320328	20320535	4997	5204	207	RIGHT	M322.EDF	M32	2
118	20336266	20336478	5276	5488	212	RIGHT	M322.EDF	M32	2
119	20341353	20341565	1999	2211	212	RIGHT	M322.EDF	M32	2
120	20349541	20349812	1933	2204	271	RIGHT	M322.EDF	M32	2
1	733653	733758	872	977	105	RIGHT	M431.EDF	M43	1
2	742111	742189	377	455	78	RIGHT	M431.EDF	M43	1
2	743609	743685	1875	1951	76	RIGHT	M431.EDF	M43	1
4	759201	759217	1387	1403	16	RIGHT	M431.EDF	M43	1
5	769625	769640	4861	4876	15	RIGHT	M431.EDF	M43	1
5	769673	769708	4909	4944	35	RIGHT	M431.EDF	M43	1
5	769754	769774	4990	5010	20	RIGHT	M431.EDF	M43	1
5	769804	769805	5040	5041	1	RIGHT	M431.EDF	M43	1
5	769829	769829	5065	5065	0	RIGHT	M431.EDF	M43	1
5	770564	770597	5800	5833	33	RIGHT	M431.EDF	M43	1
6	775400	775470	1030	1100	70	RIGHT	M431.EDF	M43	1
6	779586	779587	5216	5217	1	RIGHT	M431.EDF	M43	1
6	779626	779627	5256	5257	1	RIGHT	M431.EDF	M43	1
6	779675	779675	5305	5305	0	RIGHT	M431.EDF	M43	1
7	785504	785504	3209	3209	0	RIGHT	M431.EDF	M43	1
7	786324	786324	4029	4029	0	RIGHT	M431.EDF	M43	1
7	787057	787076	4762	4781	19	RIGHT	M431.EDF	M43	1
8	791173	791230	1124	1181	57	RIGHT	M431.EDF	M43	1
8	791834	791836	1785	1787	2	RIGHT	M431.EDF	M43	1
8	792746	792747	2697	2698	1	RIGHT	M431.EDF	M43	1
8	793413	793422	3364	3373	9	RIGHT	M431.EDF	M43	1
8	793462	793470	3413	3421	8	RIGHT	M431.EDF	M43	1
8	793496	793681	3447	3632	185	RIGHT	M431.EDF	M43	1
8	793709	793709	3660	3660	0	RIGHT	M431.EDF	M43	1
8	793757	793764	3708	3715	7	RIGHT	M431.EDF	M43	1
8	793794	793795	3745	3746	1	RIGHT	M431.EDF	M43	1
8	793845	793845	3796	3796	0	RIGHT	M431.EDF	M43	1
8	793891	793905	3842	3856	14	RIGHT	M431.EDF	M43	1
8	793933	793933	3884	3884	0	RIGHT	M431.EDF	M43	1
8	794030	794039	3981	3990	9	RIGHT	M431.EDF	M43	1
8	794094	794095	4045	4046	1	RIGHT	M431.EDF	M43	1
8	794165	794165	4116	4116	0	RIGHT	M431.EDF	M43	1
8	794203	794203	4154	4154	0	RIGHT	M431.EDF	M43	1
8	794242	794739	4193	4690	497	RIGHT	M431.EDF	M43	1
8	794781	794822	4732	4773	41	RIGHT	M431.EDF	M43	1
8	794863	794869	4814	4820	6	RIGHT	M431.EDF	M43	1
8	794890	795104	4841	5055	214	RIGHT	M431.EDF	M43	1
8	795131	795569	5082	5520	438	RIGHT	M431.EDF	M43	1
8	795612	795701	5563	5652	89	RIGHT	M431.EDF	M43	1
9	804585	804596	6702	6713	11	RIGHT	M431.EDF	M43	1
9	804626	804626	6743	6743	0	RIGHT	M431.EDF	M43	1
10	808001	808001	1492	1492	0	RIGHT	M431.EDF	M43	1
10	808069	808070	1560	1561	1	RIGHT	M431.EDF	M43	1
10	808105	808120	1596	1611	15	RIGHT	M431.EDF	M43	1
10	808155	808155	1646	1646	0	RIGHT	M431.EDF	M43	1
10	808231	808231	1722	1722	0	RIGHT	M431.EDF	M43	1
10	808276	808276	1767	1767	0	RIGHT	M431.EDF	M43	1
10	810681	810869	4172	4360	188	RIGHT	M431.EDF	M43	1
10	810893	810955	4384	4446	62	RIGHT	M431.EDF	M43	1
10	811078	811079	4569	4570	1	RIGHT	M431.EDF	M43	1
10	811138	811139	4629	4630	1	RIGHT	M431.EDF	M43	1
10	811337	811376	4828	4867	39	RIGHT	M431.EDF	M43	1
10	811397	811753	4888	5244	356	RIGHT	M431.EDF	M43	1
10	811774	812571	5265	6062	797	RIGHT	M431.EDF	M43	1
10	812592	812594	6083	6085	2	RIGHT	M431.EDF	M43	1
10	812698	812699	6189	6190	1	RIGHT	M431.EDF	M43	1
10	813005	813006	6496	6497	1	RIGHT	M431.EDF	M43	1
10	813064	813098	6555	6589	34	RIGHT	M431.EDF	M43	1
10	813148	813149	6639	6640	1	RIGHT	M431.EDF	M43	1
10	813304	813306	6795	6797	2	RIGHT	M431.EDF	M43	1
10	813339	813377	6830	6868	38	RIGHT	M431.EDF	M43	1
12	827831	827881	3393	3443	50	RIGHT	M431.EDF	M43	1
12	828201	828201	3763	3763	0	RIGHT	M431.EDF	M43	1
12	828238	828238	3800	3800	0	RIGHT	M431.EDF	M43	1
12	828271	828293	3833	3855	22	RIGHT	M431.EDF	M43	1
12	828326	828405	3888	3967	79	RIGHT	M431.EDF	M43	1
12	828451	828763	4013	4325	312	RIGHT	M431.EDF	M43	1
12	828789	828798	4351	4360	9	RIGHT	M431.EDF	M43	1
12	828838	828847	4400	4409	9	RIGHT	M431.EDF	M43	1
12	828880	828905	4442	4467	25	RIGHT	M431.EDF	M43	1
12	828931	828999	4493	4561	68	RIGHT	M431.EDF	M43	1
12	829071	829143	4633	4705	72	RIGHT	M431.EDF	M43	1
12	829184	829197	4746	4759	13	RIGHT	M431.EDF	M43	1
12	829218	829223	4780	4785	5	RIGHT	M431.EDF	M43	1
12	829250	829697	4812	5259	447	RIGHT	M431.EDF	M43	1
12	829718	829765	5280	5327	47	RIGHT	M431.EDF	M43	1
12	829796	829812	5358	5374	16	RIGHT	M431.EDF	M43	1
12	829836	830474	5398	6036	638	RIGHT	M431.EDF	M43	1
12	830528	830532	6090	6094	4	RIGHT	M431.EDF	M43	1
12	830553	830553	6115	6115	0	RIGHT	M431.EDF	M43	1
12	830575	830599	6137	6161	24	RIGHT	M431.EDF	M43	1
12	830621	830633	6183	6195	12	RIGHT	M431.EDF	M43	1
12	830787	830789	6349	6351	2	RIGHT	M431.EDF	M43	1
12	830811	830926	6373	6488	115	RIGHT	M431.EDF	M43	1
12	830947	831203	6509	6765	256	RIGHT	M431.EDF	M43	1
13	833304	833377	138	211	73	RIGHT	M431.EDF	M43	1
13	837173	837200	4007	4034	27	RIGHT	M431.EDF	M43	1
13	837250	837261	4084	4095	11	RIGHT	M431.EDF	M43	1
13	837666	837666	4500	4500	0	RIGHT	M431.EDF	M43	1
13	837791	837791	4625	4625	0	RIGHT	M431.EDF	M43	1
13	837821	837927	4655	4761	106	RIGHT	M431.EDF	M43	1
14	841407	841407	1438	1438	0	RIGHT	M431.EDF	M43	1
14	843773	843794	3804	3825	21	RIGHT	M431.EDF	M43	1
14	843815	843859	3846	3890	44	RIGHT	M431.EDF	M43	1
14	843886	843928	3917	3959	42	RIGHT	M431.EDF	M43	1
14	843960	843960	3991	3991	0	RIGHT	M431.EDF	M43	1
14	844007	844007	4038	4038	0	RIGHT	M431.EDF	M43	1
14	844278	844278	4309	4309	0	RIGHT	M431.EDF	M43	1
14	844309	844309	4340	4340	0	RIGHT	M431.EDF	M43	1
14	844429	844472	4460	4503	43	RIGHT	M431.EDF	M43	1
14	844503	844534	4534	4565	31	RIGHT	M431.EDF	M43	1
14	844568	844773	4599	4804	205	RIGHT	M431.EDF	M43	1
14	844794	844891	4825	4922	97	RIGHT	M431.EDF	M43	1
14	844941	844974	4972	5005	33	RIGHT	M431.EDF	M43	1
14	845002	845030	5033	5061	28	RIGHT	M431.EDF	M43	1
14	845063	845064	5094	5095	1	RIGHT	M431.EDF	M43	1
14	845130	845136	5161	5167	6	RIGHT	M431.EDF	M43	1
14	845173	845187	5204	5218	14	RIGHT	M431.EDF	M43	1
14	845208	845363	5239	5394	155	RIGHT	M431.EDF	M43	1
14	845385	845396	5416	5427	11	RIGHT	M431.EDF	M43	1
14	845418	845676	5449	5707	258	RIGHT	M431.EDF	M43	1
14	845716	845739	5747	5770	23	RIGHT	M431.EDF	M43	1
14	845767	845802	5798	5833	35	RIGHT	M431.EDF	M43	1
15	848275	848325	685	735	50	RIGHT	M431.EDF	M43	1
15	850335	850387	2745	2797	52	RIGHT	M431.EDF	M43	1
15	850416	850416	2826	2826	0	RIGHT	M431.EDF	M43	1
15	850444	850444	2854	2854	0	RIGHT	M431.EDF	M43	1
15	850546	850554	2956	2964	8	RIGHT	M431.EDF	M43	1
15	850613	850613	3023	3023	0	RIGHT	M431.EDF	M43	1
15	850665	850667	3075	3077	2	RIGHT	M431.EDF	M43	1
15	850806	850807	3216	3217	1	RIGHT	M431.EDF	M43	1
15	850918	850934	3328	3344	16	RIGHT	M431.EDF	M43	1
15	850974	850974	3384	3384	0	RIGHT	M431.EDF	M43	1
15	851068	851293	3478	3703	225	RIGHT	M431.EDF	M43	1
15	851318	851383	3728	3793	65	RIGHT	M431.EDF	M43	1
15	851439	851566	3849	3976	127	RIGHT	M431.EDF	M43	1
15	851593	853576	4003	5986	1983	RIGHT	M431.EDF	M43	1
16	855333	855864	57	588	531	RIGHT	M431.EDF	M43	1
16	855893	856619	617	1343	726	RIGHT	M431.EDF	M43	1
16	857080	857080	1804	1804	0	RIGHT	M431.EDF	M43	1
16	857137	857211	1861	1935	74	RIGHT	M431.EDF	M43	1
16	857235	857346	1959	2070	111	RIGHT	M431.EDF	M43	1
16	857388	857390	2112	2114	2	RIGHT	M431.EDF	M43	1
16	858158	858158	2882	2882	0	RIGHT	M431.EDF	M43	1
16	858211	858316	2935	3040	105	RIGHT	M431.EDF	M43	1
16	858337	858341	3061	3065	4	RIGHT	M431.EDF	M43	1
16	858407	858408	3131	3132	1	RIGHT	M431.EDF	M43	1
16	858663	858664	3387	3388	1	RIGHT	M431.EDF	M43	1
16	858691	858691	3415	3415	0	RIGHT	M431.EDF	M43	1
16	858779	858779	3503	3503	0	RIGHT	M431.EDF	M43	1
16	858841	858893	3565	3617	52	RIGHT	M431.EDF	M43	1
16	858927	858933	3651	3657	6	RIGHT	M431.EDF	M43	1
16	858961	858961	3685	3685	0	RIGHT	M431.EDF	M43	1
16	859005	859037	3729	3761	32	RIGHT	M431.EDF	M43	1
16	859079	859198	3803	3922	119	RIGHT	M431.EDF	M43	1
16	859283	859283	4007	4007	0	RIGHT	M431.EDF	M43	1
16	859397	859420	4121	4144	23	RIGHT	M431.EDF	M43	1
16	859524	859526	4248	4250	2	RIGHT	M431.EDF	M43	1
16	859550	859550	4274	4274	0	RIGHT	M431.EDF	M43	1
16	859619	859621	4343	4345	2	RIGHT	M431.EDF	M43	1
16	859662	859766	4386	4490	104	RIGHT	M431.EDF	M43	1
16	859790	859825	4514	4549	35	RIGHT	M431.EDF	M43	1
16	859850	859852	4574	4576	2	RIGHT	M431.EDF	M43	1
16	859895	860078	4619	4802	183	RIGHT	M431.EDF	M43	1
16	860107	860185	4831	4909	78	RIGHT	M431.EDF	M43	1
16	860269	860270	4993	4994	1	RIGHT	M431.EDF	M43	1
16	860502	860607	5226	5331	105	RIGHT	M431.EDF	M43	1
16	860633	860711	5357	5435	78	RIGHT	M431.EDF	M43	1
16	860733	860751	5457	5475	18	RIGHT	M431.EDF	M43	1
17	863449	863579	57	187	130	RIGHT	M431.EDF	M43	1
17	865041	865054	1649	1662	13	RIGHT	M431.EDF	M43	1
17	865076	865084	1684	1692	8	RIGHT	M431.EDF	M43	1
17	865169	865169	1777	1777	0	RIGHT	M431.EDF	M43	1
17	866003	866305	2611	2913	302	RIGHT	M431.EDF	M43	1
17	866361	866361	2969	2969	0	RIGHT	M431.EDF	M43	1
17	866390	866420	2998	3028	30	RIGHT	M431.EDF	M43	1
17	866444	866445	3052	3053	1	RIGHT	M431.EDF	M43	1
17	866561	866565	3169	3173	4	RIGHT	M431.EDF	M43	1
17	866586	866588	3194	3196	2	RIGHT	M431.EDF	M43	1
17	866613	866638	3221	3246	25	RIGHT	M431.EDF	M43	1
17	866661	867149	3269	3757	488	RIGHT	M431.EDF	M43	1
17	867212	867218	3820	3826	6	RIGHT	M431.EDF	M43	1
17	867346	867346	3954	3954	0	RIGHT	M431.EDF	M43	1
17	867396	867396	4004	4004	0	RIGHT	M431.EDF	M43	1
17	867439	867475	4047	4083	36	RIGHT	M431.EDF	M43	1
17	867502	867508	4110	4116	6	RIGHT	M431.EDF	M43	1
17	867531	867534	4139	4142	3	RIGHT	M431.EDF	M43	1
17	867558	868416	4166	5024	858	RIGHT	M431.EDF	M43	1
18	870275	870354	58	137	79	RIGHT	M431.EDF	M43	1
18	870384	871602	167	1385	1218	RIGHT	M431.EDF	M43	1
18	871624	871635	1407	1418	11	RIGHT	M431.EDF	M43	1
18	871676	871682	1459	1465	6	RIGHT	M431.EDF	M43	1
18	871704	871776	1487	1559	72	RIGHT	M431.EDF	M43	1
18	871807	871830	1590	1613	23	RIGHT	M431.EDF	M43	1
18	871864	872347	1647	2130	483	RIGHT	M431.EDF	M43	1
18	872370	872408	2153	2191	38	RIGHT	M431.EDF	M43	1
18	872434	872471	2217	2254	37	RIGHT	M431.EDF	M43	1
18	872503	872504	2286	2287	1	RIGHT	M431.EDF	M43	1
18	872639	872640	2422	2423	1	RIGHT	M431.EDF	M43	1
18	872664	872693	2447	2476	29	RIGHT	M431.EDF	M43	1
18	872776	873405	2559	3188	629	RIGHT	M431.EDF	M43	1
18	873430	874053	3213	3836	623	RIGHT	M431.EDF	M43	1
18	874076	874125	3859	3908	49	RIGHT	M431.EDF	M43	1
18	874167	874167	3950	3950	0	RIGHT	M431.EDF	M43	1
18	874229	874256	4012	4039	27	RIGHT	M431.EDF	M43	1
18	874320	874320	4103	4103	0	RIGHT	M431.EDF	M43	1
18	874480	874480	4263	4263	0	RIGHT	M431.EDF	M43	1
18	874507	874566	4290	4349	59	RIGHT	M431.EDF	M43	1
18	874619	874735	4402	4518	116	RIGHT	M431.EDF	M43	1
18	874758	875022	4541	4805	264	RIGHT	M431.EDF	M43	1
18	875064	875082	4847	4865	18	RIGHT	M431.EDF	M43	1
18	875206	875226	4989	5009	20	RIGHT	M431.EDF	M43	1
18	875281	875281	5064	5064	0	RIGHT	M431.EDF	M43	1
18	875373	875401	5156	5184	28	RIGHT	M431.EDF	M43	1
18	875438	875438	5221	5221	0	RIGHT	M431.EDF	M43	1
18	875479	875479	5262	5262	0	RIGHT	M431.EDF	M43	1
18	875503	875519	5286	5302	16	RIGHT	M431.EDF	M43	1
18	875550	875590	5333	5373	40	RIGHT	M431.EDF	M43	1
19	879905	879905	1733	1733	0	RIGHT	M431.EDF	M43	1
19	880020	880020	1848	1848	0	RIGHT	M431.EDF	M43	1
19	880057	880110	1885	1938	53	RIGHT	M431.EDF	M43	1
19	880154	880154	1982	1982	0	RIGHT	M431.EDF	M43	1
19	880189	880189	2017	2017	0	RIGHT	M431.EDF	M43	1
19	880901	880902	2729	2730	1	RIGHT	M431.EDF	M43	1
19	880923	881244	2751	3072	321	RIGHT	M431.EDF	M43	1
19	881650	881650	3478	3478	0	RIGHT	M431.EDF	M43	1
19	881673	881673	3501	3501	0	RIGHT	M431.EDF	M43	1
19	881751	881756	3579	3584	5	RIGHT	M431.EDF	M43	1
19	881804	881804	3632	3632	0	RIGHT	M431.EDF	M43	1
19	881926	881975	3754	3803	49	RIGHT	M431.EDF	M43	1
19	881998	882091	3826	3919	93	RIGHT	M431.EDF	M43	1
19	882144	882144	3972	3972	0	RIGHT	M431.EDF	M43	1
19	882207	882210	4035	4038	3	RIGHT	M431.EDF	M43	1
19	882637	882651	4465	4479	14	RIGHT	M431.EDF	M43	1
19	882676	883074	4504	4902	398	RIGHT	M431.EDF	M43	1
19	883102	883113	4930	4941	11	RIGHT	M431.EDF	M43	1
19	883315	883316	5143	5144	1	RIGHT	M431.EDF	M43	1
19	883494	883532	5322	5360	38	RIGHT	M431.EDF	M43	1
19	883560	883560	5388	5388	0	RIGHT	M431.EDF	M43	1
19	883602	883850	5430	5678	248	RIGHT	M431.EDF	M43	1
19	884055	884055	5883	5883	0	RIGHT	M431.EDF	M43	1
19	884089	884098	5917	5926	9	RIGHT	M431.EDF	M43	1
19	884125	884223	5953	6051	98	RIGHT	M431.EDF	M43	1
19	884246	884312	6074	6140	66	RIGHT	M431.EDF	M43	1
19	884356	884366	6184	6194	10	RIGHT	M431.EDF	M43	1
19	884405	884509	6233	6337	104	RIGHT	M431.EDF	M43	1
19	884536	884548	6364	6376	12	RIGHT	M431.EDF	M43	1
19	884576	885376	6404	7204	800	RIGHT	M431.EDF	M43	1
20	889820	889912	162	254	92	RIGHT	M431.EDF	M43	1
20	893596	893596	3938	3938	0	RIGHT	M431.EDF	M43	1
20	893754	893912	4096	4254	158	RIGHT	M431.EDF	M43	1
20	893954	893954	4296	4296	0	RIGHT	M431.EDF	M43	1
20	893995	893995	4337	4337	0	RIGHT	M431.EDF	M43	1
20	894023	894023	4365	4365	0	RIGHT	M431.EDF	M43	1
20	894163	894163	4505	4505	0	RIGHT	M431.EDF	M43	1
20	894238	894240	4580	4582	2	RIGHT	M431.EDF	M43	1
20	894262	894263	4604	4605	1	RIGHT	M431.EDF	M43	1
20	894343	894346	4685	4688	3	RIGHT	M431.EDF	M43	1
20	894421	894540	4763	4882	119	RIGHT	M431.EDF	M43	1
20	894566	894677	4908	5019	111	RIGHT	M431.EDF	M43	1
20	894711	894746	5053	5088	35	RIGHT	M431.EDF	M43	1
20	894802	894803	5144	5145	1	RIGHT	M431.EDF	M43	1
20	894873	894880	5215	5222	7	RIGHT	M431.EDF	M43	1
20	894924	894970	5266	5312	46	RIGHT	M431.EDF	M43	1
20	895011	895023	5353	5365	12	RIGHT	M431.EDF	M43	1
20	895045	895046	5387	5388	1	RIGHT	M431.EDF	M43	1
20	895068	895071	5410	5413	3	RIGHT	M431.EDF	M43	1
20	895111	895340	5453	5682	229	RIGHT	M431.EDF	M43	1
20	895378	895459	5720	5801	81	RIGHT	M431.EDF	M43	1
20	895485	895510	5827	5852	25	RIGHT	M431.EDF	M43	1
20	895535	895535	5877	5877	0	RIGHT	M431.EDF	M43	1
20	895613	895658	5955	6000	45	RIGHT	M431.EDF	M43	1
20	895755	895983	6097	6325	228	RIGHT	M431.EDF	M43	1
21	897497	897558	123	184	61	RIGHT	M431.EDF	M43	1
21	898287	898287	913	913	0	RIGHT	M431.EDF	M43	1
21	898485	898485	1111	1111	0	RIGHT	M431.EDF	M43	1
21	898507	898518	1133	1144	11	RIGHT	M431.EDF	M43	1
21	898751	898771	1377	1397	20	RIGHT	M431.EDF	M43	1
21	898798	898798	1424	1424	0	RIGHT	M431.EDF	M43	1
21	898851	898868	1477	1494	17	RIGHT	M431.EDF	M43	1
21	899010	899545	1636	2171	535	RIGHT	M431.EDF	M43	1
21	899604	899605	2230	2231	1	RIGHT	M431.EDF	M43	1
21	900016	900282	2642	2908	266	RIGHT	M431.EDF	M43	1
21	900330	900333	2956	2959	3	RIGHT	M431.EDF	M43	1
21	900520	900520	3146	3146	0	RIGHT	M431.EDF	M43	1
21	900751	900751	3377	3377	0	RIGHT	M431.EDF	M43	1
21	900790	900859	3416	3485	69	RIGHT	M431.EDF	M43	1
21	900881	900896	3507	3522	15	RIGHT	M431.EDF	M43	1
21	900947	903207	3573	5833	2260	RIGHT	M431.EDF	M43	1
22	906680	906825	1650	1795	145	RIGHT	M431.EDF	M43	1
22	908843	908844	3813	3814	1	RIGHT	M431.EDF	M43	1
22	909329	909330	4299	4300	1	RIGHT	M431.EDF	M43	1
22	909467	909467	4437	4437	0	RIGHT	M431.EDF	M43	1
22	909491	909491	4461	4461	0	RIGHT	M431.EDF	M43	1
22	909569	909570	4539	4540	1	RIGHT	M431.EDF	M43	1
22	909612	909627	4582	4597	15	RIGHT	M431.EDF	M43	1
22	909648	909749	4618	4719	101	RIGHT	M431.EDF	M43	1
22	909770	909786	4740	4756	16	RIGHT	M431.EDF	M43	1
22	909874	909901	4844	4871	27	RIGHT	M431.EDF	M43	1
22	910227	910227	5197	5197	0	RIGHT	M431.EDF	M43	1
22	910284	910284	5254	5254	0	RIGHT	M431.EDF	M43	1
22	910313	910313	5283	5283	0	RIGHT	M431.EDF	M43	1
22	910340	910341	5310	5311	1	RIGHT	M431.EDF	M43	1
22	910380	910387	5350	5357	7	RIGHT	M431.EDF	M43	1
22	910447	910588	5417	5558	141	RIGHT	M431.EDF	M43	1
22	910614	910694	5584	5664	80	RIGHT	M431.EDF	M43	1
22	910716	910751	5686	5721	35	RIGHT	M431.EDF	M43	1
22	910773	910773	5743	5743	0	RIGHT	M431.EDF	M43	1
22	910805	910819	5775	5789	14	RIGHT	M431.EDF	M43	1
22	910855	910856	5825	5826	1	RIGHT	M431.EDF	M43	1
22	910897	910906	5867	5876	9	RIGHT	M431.EDF	M43	1
22	910941	911192	5911	6162	251	RIGHT	M431.EDF	M43	1
23	914882	915005	960	1083	123	RIGHT	M431.EDF	M43	1
23	915187	915302	1265	1380	115	RIGHT	M431.EDF	M43	1
23	915432	915529	1510	1607	97	RIGHT	M431.EDF	M43	1
23	915654	915718	1732	1796	64	RIGHT	M431.EDF	M43	1
23	916545	916545	2623	2623	0	RIGHT	M431.EDF	M43	1
23	916679	916679	2757	2757	0	RIGHT	M431.EDF	M43	1
23	918233	918233	4311	4311	0	RIGHT	M431.EDF	M43	1
23	918781	918781	4859	4859	0	RIGHT	M431.EDF	M43	1
23	918819	918820	4897	4898	1	RIGHT	M431.EDF	M43	1
23	918864	918869	4942	4947	5	RIGHT	M431.EDF	M43	1
23	918905	918905	4983	4983	0	RIGHT	M431.EDF	M43	1
23	918926	918926	5004	5004	0	RIGHT	M431.EDF	M43	1
23	918958	918959	5036	5037	1	RIGHT	M431.EDF	M43	1
23	918988	918988	5066	5066	0	RIGHT	M431.EDF	M43	1
23	919033	919041	5111	5119	8	RIGHT	M431.EDF	M43	1
23	919065	919247	5143	5325	182	RIGHT	M431.EDF	M43	1
23	919272	919292	5350	5370	20	RIGHT	M431.EDF	M43	1
23	919313	919338	5391	5416	25	RIGHT	M431.EDF	M43	1
23	919367	919376	5445	5454	9	RIGHT	M431.EDF	M43	1
23	919417	919435	5495	5513	18	RIGHT	M431.EDF	M43	1
23	919607	919612	5685	5690	5	RIGHT	M431.EDF	M43	1
23	919678	919678	5756	5756	0	RIGHT	M431.EDF	M43	1
23	919700	919725	5778	5803	25	RIGHT	M431.EDF	M43	1
23	919746	919817	5824	5895	71	RIGHT	M431.EDF	M43	1
24	922518	922595	100	177	77	RIGHT	M431.EDF	M43	1
24	927879	927879	5461	5461	0	RIGHT	M431.EDF	M43	1
25	929981	930087	138	244	106	RIGHT	M431.EDF	M43	1
25	931051	931115	1208	1272	64	RIGHT	M431.EDF	M43	1
26	938046	938108	57	119	62	RIGHT	M431.EDF	M43	1
26	943628	943628	5639	5639	0	RIGHT	M431.EDF	M43	1
26	943664	943664	5675	5675	0	RIGHT	M431.EDF	M43	1
26	944231	944231	6242	6242	0	RIGHT	M431.EDF	M43	1
26	944478	944478	6489	6489	0	RIGHT	M431.EDF	M43	1
26	944517	944579	6528	6590	62	RIGHT	M431.EDF	M43	1
26	944964	945013	6975	7024	49	RIGHT	M431.EDF	M43	1
27	948501	948612	1596	1707	111	RIGHT	M431.EDF	M43	1
27	952995	952995	6090	6090	0	RIGHT	M431.EDF	M43	1
28	957496	957521	1256	1281	25	RIGHT	M431.EDF	M43	1
28	961434	961455	5194	5215	21	RIGHT	M431.EDF	M43	1
28	961480	961486	5240	5246	6	RIGHT	M431.EDF	M43	1
28	961512	961533	5272	5293	21	RIGHT	M431.EDF	M43	1
29	965435	965557	229	351	122	RIGHT	M431.EDF	M43	1
29	970358	970358	5152	5152	0	RIGHT	M431.EDF	M43	1
29	971156	971156	5950	5950	0	RIGHT	M431.EDF	M43	1
29	971293	971294	6087	6088	1	RIGHT	M431.EDF	M43	1
29	971974	971975	6768	6769	1	RIGHT	M431.EDF	M43	1
29	972017	972080	6811	6874	63	RIGHT	M431.EDF	M43	1
29	972108	972108	6902	6902	0	RIGHT	M431.EDF	M43	1
30	974253	974388	264	399	135	RIGHT	M431.EDF	M43	1
30	979521	979521	5532	5532	0	RIGHT	M431.EDF	M43	1
30	980384	980384	6395	6395	0	RIGHT	M431.EDF	M43	1
32	992610	992610	3029	3029	0	RIGHT	M431.EDF	M43	1
32	993281	993281	3700	3700	0	RIGHT	M431.EDF	M43	1
32	993415	993415	3834	3834	0	RIGHT	M431.EDF	M43	1
32	994067	994068	4486	4487	1	RIGHT	M431.EDF	M43	1
32	994133	994146	4552	4565	13	RIGHT	M431.EDF	M43	1
32	994876	994876	5295	5295	0	RIGHT	M431.EDF	M43	1
32	994945	994945	5364	5364	0	RIGHT	M431.EDF	M43	1
32	994972	994972	5391	5391	0	RIGHT	M431.EDF	M43	1
32	995018	995019	5437	5438	1	RIGHT	M431.EDF	M43	1
32	995608	995608	6027	6027	0	RIGHT	M431.EDF	M43	1
32	995682	995690	6101	6109	8	RIGHT	M431.EDF	M43	1
32	995714	995737	6133	6156	23	RIGHT	M431.EDF	M43	1
32	995762	995856	6181	6275	94	RIGHT	M431.EDF	M43	1
32	995979	995984	6398	6403	5	RIGHT	M431.EDF	M43	1
33	998303	998444	249	390	141	RIGHT	M431.EDF	M43	1
34	1005760	1005760	747	747	0	RIGHT	M431.EDF	M43	1
34	1006551	1006591	1538	1578	40	RIGHT	M431.EDF	M43	1
34	1006618	1006618	1605	1605	0	RIGHT	M431.EDF	M43	1
34	1006657	1006665	1644	1652	8	RIGHT	M431.EDF	M43	1
34	1006750	1006858	1737	1845	108	RIGHT	M431.EDF	M43	1
34	1009815	1009816	4802	4803	1	RIGHT	M431.EDF	M43	1
34	1009869	1009869	4856	4856	0	RIGHT	M431.EDF	M43	1
34	1009896	1009900	4883	4887	4	RIGHT	M431.EDF	M43	1
34	1009940	1009952	4927	4939	12	RIGHT	M431.EDF	M43	1
34	1010034	1010161	5021	5148	127	RIGHT	M431.EDF	M43	1
34	1010207	1010267	5194	5254	60	RIGHT	M431.EDF	M43	1
34	1010289	1010290	5276	5277	1	RIGHT	M431.EDF	M43	1
34	1010342	1010361	5329	5348	19	RIGHT	M431.EDF	M43	1
34	1010462	1010462	5449	5449	0	RIGHT	M431.EDF	M43	1
34	1010483	1010491	5470	5478	8	RIGHT	M431.EDF	M43	1
34	1010515	1010531	5502	5518	16	RIGHT	M431.EDF	M43	1
34	1010560	1010561	5547	5548	1	RIGHT	M431.EDF	M43	1
34	1010610	1011534	5597	6521	924	RIGHT	M431.EDF	M43	1
35	1013440	1013480	58	98	40	RIGHT	M431.EDF	M43	1
35	1015166	1015266	1784	1884	100	RIGHT	M431.EDF	M43	1
36	1024138	1024267	1804	1933	129	RIGHT	M431.EDF	M43	1
36	1028378	1028378	6044	6044	0	RIGHT	M431.EDF	M43	1
36	1028553	1028568	6219	6234	15	RIGHT	M431.EDF	M43	1
37	1032173	1032258	788	873	85	RIGHT	M431.EDF	M43	1
37	1037026	1037026	5641	5641	0	RIGHT	M431.EDF	M43	1
37	1037180	1037180	5795	5795	0	RIGHT	M431.EDF	M43	1
37	1037918	1037985	6533	6600	67	RIGHT	M431.EDF	M43	1
38	1042848	1042849	2788	2789	1	RIGHT	M431.EDF	M43	1
38	1042894	1042894	2834	2834	0	RIGHT	M431.EDF	M43	1
38	1042934	1042934	2874	2874	0	RIGHT	M431.EDF	M43	1
38	1043736	1043736	3676	3676	0	RIGHT	M431.EDF	M43	1
38	1043763	1043771	3703	3711	8	RIGHT	M431.EDF	M43	1
38	1043803	1043863	3743	3803	60	RIGHT	M431.EDF	M43	1
38	1043966	1043968	3906	3908	2	RIGHT	M431.EDF	M43	1
38	1044207	1044207	4147	4147	0	RIGHT	M431.EDF	M43	1
38	1044351	1044369	4291	4309	18	RIGHT	M431.EDF	M43	1
38	1044406	1044546	4346	4486	140	RIGHT	M431.EDF	M43	1
38	1044567	1044712	4507	4652	145	RIGHT	M431.EDF	M43	1
38	1044737	1044813	4677	4753	76	RIGHT	M431.EDF	M43	1
38	1044937	1044974	4877	4914	37	RIGHT	M431.EDF	M43	1
38	1045115	1045174	5055	5114	59	RIGHT	M431.EDF	M43	1
38	1045218	1045218	5158	5158	0	RIGHT	M431.EDF	M43	1
38	1045246	1045271	5186	5211	25	RIGHT	M431.EDF	M43	1
38	1045307	1046645	5247	6585	1338	RIGHT	M431.EDF	M43	1
39	1048745	1048745	238	238	0	RIGHT	M431.EDF	M43	1
39	1048811	1048812	304	305	1	RIGHT	M431.EDF	M43	1
39	1049864	1049864	1357	1357	0	RIGHT	M431.EDF	M43	1
39	1049885	1049889	1378	1382	4	RIGHT	M431.EDF	M43	1
39	1049949	1049949	1442	1442	0	RIGHT	M431.EDF	M43	1
39	1052670	1052670	4163	4163	0	RIGHT	M431.EDF	M43	1
39	1053179	1053179	4672	4672	0	RIGHT	M431.EDF	M43	1
39	1053203	1053206	4696	4699	3	RIGHT	M431.EDF	M43	1
39	1053240	1053559	4733	5052	319	RIGHT	M431.EDF	M43	1
39	1053591	1053601	5084	5094	10	RIGHT	M431.EDF	M43	1
39	1053632	1053662	5125	5155	30	RIGHT	M431.EDF	M43	1
39	1053689	1053853	5182	5346	164	RIGHT	M431.EDF	M43	1
39	1053874	1053880	5367	5373	6	RIGHT	M431.EDF	M43	1
39	1053907	1053909	5400	5402	2	RIGHT	M431.EDF	M43	1
39	1053940	1054427	5433	5920	487	RIGHT	M431.EDF	M43	1
39	1054449	1054569	5942	6062	120	RIGHT	M431.EDF	M43	1
39	1054594	1054618	6087	6111	24	RIGHT	M431.EDF	M43	1
39	1054643	1054682	6136	6175	39	RIGHT	M431.EDF	M43	1
39	1054727	1054759	6220	6252	32	RIGHT	M431.EDF	M43	1
39	1054797	1054906	6290	6399	109	RIGHT	M431.EDF	M43	1
39	1054928	1055141	6421	6634	213	RIGHT	M431.EDF	M43	1
40	1057239	1057331	170	262	92	RIGHT	M431.EDF	M43	1
40	1060144	1060144	3075	3075	0	RIGHT	M431.EDF	M43	1
40	1060273	1060317	3204	3248	44	RIGHT	M431.EDF	M43	1
40	1060411	1060411	3342	3342	0	RIGHT	M431.EDF	M43	1
40	1060453	1060454	3384	3385	1	RIGHT	M431.EDF	M43	1
40	1061095	1061095	4026	4026	0	RIGHT	M431.EDF	M43	1
40	1061502	1061502	4433	4433	0	RIGHT	M431.EDF	M43	1
40	1061675	1061679	4606	4610	4	RIGHT	M431.EDF	M43	1
40	1061700	1061702	4631	4633	2	RIGHT	M431.EDF	M43	1
40	1061844	1061844	4775	4775	0	RIGHT	M431.EDF	M43	1
40	1061865	1061866	4796	4797	1	RIGHT	M431.EDF	M43	1
40	1061905	1061921	4836	4852	16	RIGHT	M431.EDF	M43	1
40	1061946	1061954	4877	4885	8	RIGHT	M431.EDF	M43	1
40	1062003	1062685	4934	5616	682	RIGHT	M431.EDF	M43	1
41	1064680	1064764	254	338	84	RIGHT	M431.EDF	M43	1
41	1065643	1065643	1217	1217	0	RIGHT	M431.EDF	M43	1
41	1065669	1065816	1243	1390	147	RIGHT	M431.EDF	M43	1
41	1065860	1065903	1434	1477	43	RIGHT	M431.EDF	M43	1
41	1065932	1065932	1506	1506	0	RIGHT	M431.EDF	M43	1
41	1068231	1068243	3805	3817	12	RIGHT	M431.EDF	M43	1
41	1068732	1068748	4306	4322	16	RIGHT	M431.EDF	M43	1
41	1068942	1069242	4516	4816	300	RIGHT	M431.EDF	M43	1
41	1069264	1069295	4838	4869	31	RIGHT	M431.EDF	M43	1
41	1069339	1069356	4913	4930	17	RIGHT	M431.EDF	M43	1
41	1069384	1069900	4958	5474	516	RIGHT	M431.EDF	M43	1
42	1072672	1072786	299	413	114	RIGHT	M431.EDF	M43	1
42	1074174	1074326	1801	1953	152	RIGHT	M431.EDF	M43	1
43	1081478	1081564	1752	1838	86	RIGHT	M431.EDF	M43	1
43	1084989	1084990	5263	5264	1	RIGHT	M431.EDF	M43	1
43	1085113	1085121	5387	5395	8	RIGHT	M431.EDF	M43	1
43	1085830	1085830	6104	6104	0	RIGHT	M431.EDF	M43	1
43	1085868	1085910	6142	6184	42	RIGHT	M431.EDF	M43	1
43	1085966	1086076	6240	6350	110	RIGHT	M431.EDF	M43	1
43	1086343	1086343	6617	6617	0	RIGHT	M431.EDF	M43	1
43	1086455	1086475	6729	6749	20	RIGHT	M431.EDF	M43	1
43	1086500	1086524	6774	6798	24	RIGHT	M431.EDF	M43	1
43	1086558	1086560	6832	6834	2	RIGHT	M431.EDF	M43	1
44	1093721	1093781	5119	5179	60	RIGHT	M431.EDF	M43	1
44	1094508	1094565	5906	5963	57	RIGHT	M431.EDF	M43	1
45	1096689	1096800	644	755	111	RIGHT	M431.EDF	M43	1
45	1101125	1101125	5080	5080	0	RIGHT	M431.EDF	M43	1
45	1101295	1101308	5250	5263	13	RIGHT	M431.EDF	M43	1
45	1101343	1101411	5298	5366	68	RIGHT	M431.EDF	M43	1
45	1101631	1101631	5586	5586	0	RIGHT	M431.EDF	M43	1
45	1102001	1102011	5956	5966	10	RIGHT	M431.EDF	M43	1
45	1102044	1102063	5999	6018	19	RIGHT	M431.EDF	M43	1
45	1102093	1102118	6048	6073	25	RIGHT	M431.EDF	M43	1
45	1102201	1102209	6156	6164	8	RIGHT	M431.EDF	M43	1
45	1102232	1102245	6187	6200	13	RIGHT	M431.EDF	M43	1
45	1102282	1102292	6237	6247	10	RIGHT	M431.EDF	M43	1
46	1104638	1104671	57	90	33	RIGHT	M431.EDF	M43	1
46	1105256	1105346	675	765	90	RIGHT	M431.EDF	M43	1
46	1106954	1106987	2373	2406	33	RIGHT	M431.EDF	M43	1
49	1127313	1127495	58	240	182	RIGHT	M431.EDF	M43	1
49	1128911	1129038	1656	1783	127	RIGHT	M431.EDF	M43	1
49	1132606	1132606	5351	5351	0	RIGHT	M431.EDF	M43	1
50	1135720	1135869	570	719	149	RIGHT	M431.EDF	M43	1
50	1136261	1136397	1111	1247	136	RIGHT	M431.EDF	M43	1
51	1146653	1146780	1207	1334	127	RIGHT	M431.EDF	M43	1
52	1153849	1153965	772	888	116	RIGHT	M431.EDF	M43	1
53	1165587	1165663	4000	4076	76	RIGHT	M431.EDF	M43	1
54	1170197	1170375	205	383	178	RIGHT	M431.EDF	M43	1
54	1170631	1170779	639	787	148	RIGHT	M431.EDF	M43	1
54	1171034	1171175	1042	1183	141	RIGHT	M431.EDF	M43	1
55	1177087	1177166	57	136	79	RIGHT	M431.EDF	M43	1
55	1178063	1178134	1033	1104	71	RIGHT	M431.EDF	M43	1
55	1181677	1181770	4647	4740	93	RIGHT	M431.EDF	M43	1
55	1181946	1182049	4916	5019	103	RIGHT	M431.EDF	M43	1
57	1198265	1198370	3987	4092	105	RIGHT	M431.EDF	M43	1
58	1201264	1201264	170	170	0	RIGHT	M431.EDF	M43	1
58	1201370	1201370	276	276	0	RIGHT	M431.EDF	M43	1
58	1201449	1201474	355	380	25	RIGHT	M431.EDF	M43	1
58	1201522	1201535	428	441	13	RIGHT	M431.EDF	M43	1
59	1209951	1210078	1810	1937	127	RIGHT	M431.EDF	M43	1
60	1215950	1216079	342	471	129	RIGHT	M431.EDF	M43	1
61	1225182	1225294	2436	2548	112	RIGHT	M431.EDF	M43	1
62	1231657	1231722	697	762	65	RIGHT	M431.EDF	M43	1
62	1232903	1233007	1943	2047	104	RIGHT	M431.EDF	M43	1
62	1233787	1233922	2827	2962	135	RIGHT	M431.EDF	M43	1
63	1239023	1239157	1100	1234	134	RIGHT	M431.EDF	M43	1
64	1249594	1249710	2169	2285	116	RIGHT	M431.EDF	M43	1
64	1252893	1253002	5468	5577	109	RIGHT	M431.EDF	M43	1
65	1256303	1256394	68	159	91	RIGHT	M431.EDF	M43	1
65	1257672	1257819	1437	1584	147	RIGHT	M431.EDF	M43	1
66	1266793	1266850	3762	3819	57	RIGHT	M431.EDF	M43	1
67	1271515	1271535	351	371	20	RIGHT	M431.EDF	M43	1
67	1273510	1273646	2346	2482	136	RIGHT	M431.EDF	M43	1
67	1275502	1275600	4338	4436	98	RIGHT	M431.EDF	M43	1
68	1282252	1282348	3654	3750	96	RIGHT	M431.EDF	M43	1
69	1287555	1287694	2193	2332	139	RIGHT	M431.EDF	M43	1
70	1294465	1294631	2341	2507	166	RIGHT	M431.EDF	M43	1
71	1299726	1299867	145	286	141	RIGHT	M431.EDF	M43	1
71	1303123	1303253	3542	3672	130	RIGHT	M431.EDF	M43	1
74	1326589	1326726	1052	1189	137	RIGHT	M431.EDF	M43	1
74	1326910	1327054	1373	1517	144	RIGHT	M431.EDF	M43	1
75	1335359	1335477	1556	1674	118	RIGHT	M431.EDF	M43	1
75	1337472	1337573	3669	3770	101	RIGHT	M431.EDF	M43	1
76	1347250	1347250	4806	4806	0	RIGHT	M431.EDF	M43	1
76	1347306	1347335	4862	4891	29	RIGHT	M431.EDF	M43	1
76	1347361	1347362	4917	4918	1	RIGHT	M431.EDF	M43	1
76	1347383	1347383	4939	4939	0	RIGHT	M431.EDF	M43	1
76	1347826	1347826	5382	5382	0	RIGHT	M431.EDF	M43	1
76	1347876	1347932	5432	5488	56	RIGHT	M431.EDF	M43	1
76	1347962	1348490	5518	6046	528	RIGHT	M431.EDF	M43	1
76	1348524	1348524	6080	6080	0	RIGHT	M431.EDF	M43	1
76	1348558	1348586	6114	6142	28	RIGHT	M431.EDF	M43	1
76	1348618	1348621	6174	6177	3	RIGHT	M431.EDF	M43	1
77	1350811	1350902	57	148	91	RIGHT	M431.EDF	M43	1
77	1352938	1353078	2184	2324	140	RIGHT	M431.EDF	M43	1
78	1358919	1359083	1423	1587	164	RIGHT	M431.EDF	M43	1
79	1371347	1371446	5096	5195	99	RIGHT	M431.EDF	M43	1
80	1378856	1378857	4886	4887	1	RIGHT	M431.EDF	M43	1
80	1379696	1379696	5726	5726	0	RIGHT	M431.EDF	M43	1
80	1379724	1379724	5754	5754	0	RIGHT	M431.EDF	M43	1
80	1379753	1379772	5783	5802	19	RIGHT	M431.EDF	M43	1
80	1379843	1379844	5873	5874	1	RIGHT	M431.EDF	M43	1
80	1379906	1379906	5936	5936	0	RIGHT	M431.EDF	M43	1
80	1380393	1380393	6423	6423	0	RIGHT	M431.EDF	M43	1
80	1380516	1380516	6546	6546	0	RIGHT	M431.EDF	M43	1
80	1380598	1380598	6628	6628	0	RIGHT	M431.EDF	M43	1
80	1380627	1380653	6657	6683	26	RIGHT	M431.EDF	M43	1
80	1380697	1380702	6727	6732	5	RIGHT	M431.EDF	M43	1
81	1383562	1383717	979	1134	155	RIGHT	M431.EDF	M43	1
81	1383904	1384052	1321	1469	148	RIGHT	M431.EDF	M43	1
82	1391413	1391484	607	678	71	RIGHT	M431.EDF	M43	1
82	1393473	1393617	2667	2811	144	RIGHT	M431.EDF	M43	1
83	1398046	1398139	57	150	93	RIGHT	M431.EDF	M43	1
83	1398302	1398440	313	451	138	RIGHT	M431.EDF	M43	1
83	1399700	1399847	1711	1858	147	RIGHT	M431.EDF	M43	1
84	1406486	1406601	58	173	115	RIGHT	M431.EDF	M43	1
84	1408543	1408704	2115	2276	161	RIGHT	M431.EDF	M43	1
85	1415224	1415424	256	456	200	RIGHT	M431.EDF	M43	1
85	1415890	1416021	922	1053	131	RIGHT	M431.EDF	M43	1
86	1423573	1423742	1236	1405	169	RIGHT	M431.EDF	M43	1
86	1424086	1424235	1749	1898	149	RIGHT	M431.EDF	M43	1
87	1432230	1432399	986	1155	169	RIGHT	M431.EDF	M43	1
87	1432619	1432770	1375	1526	151	RIGHT	M431.EDF	M43	1
89	1447001	1447125	1890	2014	124	RIGHT	M431.EDF	M43	1
90	1454990	1455192	1094	1296	202	RIGHT	M431.EDF	M43	1
91	1463584	1463642	294	352	58	RIGHT	M431.EDF	M43	1
91	1465401	1465560	2111	2270	159	RIGHT	M431.EDF	M43	1
91	1468174	1468174	4884	4884	0	RIGHT	M431.EDF	M43	1
91	1468271	1468272	4981	4982	1	RIGHT	M431.EDF	M43	1
91	1469028	1469036	5738	5746	8	RIGHT	M431.EDF	M43	1
91	1469069	1469165	5779	5875	96	RIGHT	M431.EDF	M43	1
91	1469189	1469259	5899	5969	70	RIGHT	M431.EDF	M43	1
91	1469331	1469331	6041	6041	0	RIGHT	M431.EDF	M43	1
91	1469962	1469962	6672	6672	0	RIGHT	M431.EDF	M43	1
91	1469994	1469994	6704	6704	0	RIGHT	M431.EDF	M43	1
91	1470028	1470028	6738	6738	0	RIGHT	M431.EDF	M43	1
91	1470064	1470064	6774	6774	0	RIGHT	M431.EDF	M43	1
91	1470091	1470098	6801	6808	7	RIGHT	M431.EDF	M43	1
91	1470121	1470151	6831	6861	30	RIGHT	M431.EDF	M43	1
92	1472703	1472808	86	191	105	RIGHT	M431.EDF	M43	1
92	1473537	1473694	920	1077	157	RIGHT	M431.EDF	M43	1
92	1477115	1477115	4498	4498	0	RIGHT	M431.EDF	M43	1
93	1480048	1480187	536	675	139	RIGHT	M431.EDF	M43	1
93	1485277	1485277	5765	5765	0	RIGHT	M431.EDF	M43	1
93	1485317	1485318	5805	5806	1	RIGHT	M431.EDF	M43	1
93	1485340	1485571	5828	6059	231	RIGHT	M431.EDF	M43	1
93	1485598	1485609	6086	6097	11	RIGHT	M431.EDF	M43	1
93	1485637	1485658	6125	6146	21	RIGHT	M431.EDF	M43	1
93	1485793	1485793	6281	6281	0	RIGHT	M431.EDF	M43	1
93	1485826	1485826	6314	6314	0	RIGHT	M431.EDF	M43	1
93	1485988	1486066	6476	6554	78	RIGHT	M431.EDF	M43	1
93	1486098	1486156	6586	6644	58	RIGHT	M431.EDF	M43	1
94	1488071	1488071	134	134	0	RIGHT	M431.EDF	M43	1
94	1488098	1488099	161	162	1	RIGHT	M431.EDF	M43	1
94	1488124	1488140	187	203	16	RIGHT	M431.EDF	M43	1
94	1488189	1488196	252	259	7	RIGHT	M431.EDF	M43	1
94	1489046	1489201	1109	1264	155	RIGHT	M431.EDF	M43	1
94	1491644	1491644	3707	3707	0	RIGHT	M431.EDF	M43	1
94	1492637	1492637	4700	4700	0	RIGHT	M431.EDF	M43	1
94	1492892	1492892	4955	4955	0	RIGHT	M431.EDF	M43	1
94	1493082	1493082	5145	5145	0	RIGHT	M431.EDF	M43	1
94	1493248	1493254	5311	5317	6	RIGHT	M431.EDF	M43	1
94	1493281	1493305	5344	5368	24	RIGHT	M431.EDF	M43	1
94	1493326	1493328	5389	5391	2	RIGHT	M431.EDF	M43	1
94	1493349	1493744	5412	5807	395	RIGHT	M431.EDF	M43	1
94	1493822	1493848	5885	5911	26	RIGHT	M431.EDF	M43	1
94	1493931	1493970	5994	6033	39	RIGHT	M431.EDF	M43	1
94	1493993	1494011	6056	6074	18	RIGHT	M431.EDF	M43	1
95	1496598	1496753	938	1093	155	RIGHT	M431.EDF	M43	1
95	1499540	1499540	3880	3880	0	RIGHT	M431.EDF	M43	1
95	1500445	1500446	4785	4786	1	RIGHT	M431.EDF	M43	1
95	1501071	1501072	5411	5412	1	RIGHT	M431.EDF	M43	1
95	1501239	1501239	5579	5579	0	RIGHT	M431.EDF	M43	1
96	1504401	1504545	1184	1328	144	RIGHT	M431.EDF	M43	1
96	1506485	1506502	3268	3285	17	RIGHT	M431.EDF	M43	1
96	1507323	1507362	4106	4145	39	RIGHT	M431.EDF	M43	1
96	1507479	1507479	4262	4262	0	RIGHT	M431.EDF	M43	1
96	1507828	1507828	4611	4611	0	RIGHT	M431.EDF	M43	1
96	1508081	1508081	4864	4864	0	RIGHT	M431.EDF	M43	1
96	1508132	1508211	4915	4994	79	RIGHT	M431.EDF	M43	1
96	1508236	1508375	5019	5158	139	RIGHT	M431.EDF	M43	1
96	1508402	1508434	5185	5217	32	RIGHT	M431.EDF	M43	1
96	1508704	1508704	5487	5487	0	RIGHT	M431.EDF	M43	1
96	1508850	1508850	5633	5633	0	RIGHT	M431.EDF	M43	1
97	1511712	1511713	759	760	1	RIGHT	M431.EDF	M43	1
97	1511738	1511750	785	797	12	RIGHT	M431.EDF	M43	1
97	1511777	1511793	824	840	16	RIGHT	M431.EDF	M43	1
97	1511842	1511842	889	889	0	RIGHT	M431.EDF	M43	1
97	1511869	1511869	916	916	0	RIGHT	M431.EDF	M43	1
97	1512942	1513042	1989	2089	100	RIGHT	M431.EDF	M43	1
97	1515196	1515196	4243	4243	0	RIGHT	M431.EDF	M43	1
97	1515250	1515278	4297	4325	28	RIGHT	M431.EDF	M43	1
97	1516053	1516054	5100	5101	1	RIGHT	M431.EDF	M43	1
97	1516172	1516174	5219	5221	2	RIGHT	M431.EDF	M43	1
97	1516426	1516427	5473	5474	1	RIGHT	M431.EDF	M43	1
97	1516578	1516580	5625	5627	2	RIGHT	M431.EDF	M43	1
97	1516602	1518266	5649	7313	1664	RIGHT	M431.EDF	M43	1
98	1520524	1520678	57	211	154	RIGHT	M431.EDF	M43	1
98	1520736	1520785	269	318	49	RIGHT	M431.EDF	M43	1
98	1521470	1521593	1003	1126	123	RIGHT	M431.EDF	M43	1
98	1521616	1521636	1149	1169	20	RIGHT	M431.EDF	M43	1
98	1522418	1522511	1951	2044	93	RIGHT	M431.EDF	M43	1
99	1532273	1532405	4121	4253	132	RIGHT	M431.EDF	M43	1
100	1538314	1538467	2239	2392	153	RIGHT	M431.EDF	M43	1
101	1544341	1544488	150	297	147	RIGHT	M431.EDF	M43	1
101	1546387	1546561	2196	2370	174	RIGHT	M431.EDF	M43	1
102	1554244	1554359	2379	2494	115	RIGHT	M431.EDF	M43	1
103	1562166	1562291	1833	1958	125	RIGHT	M431.EDF	M43	1
104	1568297	1568454	911	1068	157	RIGHT	M431.EDF	M43	1
105	1577628	1577756	3166	3294	128	RIGHT	M431.EDF	M43	1
106	1583347	1583466	1690	1809	119	RIGHT	M431.EDF	M43	1
106	1586123	1586123	4466	4466	0	RIGHT	M431.EDF	M43	1
107	1593943	1593962	4972	4991	19	RIGHT	M431.EDF	M43	1
108	1600082	1600082	4318	4318	0	RIGHT	M431.EDF	M43	1
108	1600199	1600200	4435	4436	1	RIGHT	M431.EDF	M43	1
108	1600227	1600227	4463	4463	0	RIGHT	M431.EDF	M43	1
108	1600269	1600269	4505	4505	0	RIGHT	M431.EDF	M43	1
108	1600417	1600417	4653	4653	0	RIGHT	M431.EDF	M43	1
108	1600508	1600509	4744	4745	1	RIGHT	M431.EDF	M43	1
108	1600545	1600545	4781	4781	0	RIGHT	M431.EDF	M43	1
108	1600646	1600647	4882	4883	1	RIGHT	M431.EDF	M43	1
108	1600715	1600715	4951	4951	0	RIGHT	M431.EDF	M43	1
108	1600741	1600754	4977	4990	13	RIGHT	M431.EDF	M43	1
108	1600791	1600794	5027	5030	3	RIGHT	M431.EDF	M43	1
108	1600836	1600853	5072	5089	17	RIGHT	M431.EDF	M43	1
108	1600895	1600898	5131	5134	3	RIGHT	M431.EDF	M43	1
108	1600942	1600946	5178	5182	4	RIGHT	M431.EDF	M43	1
108	1600974	1600974	5210	5210	0	RIGHT	M431.EDF	M43	1
108	1601017	1601056	5253	5292	39	RIGHT	M431.EDF	M43	1
109	1603488	1603639	719	870	151	RIGHT	M431.EDF	M43	1
109	1608356	1608356	5587	5587	0	RIGHT	M431.EDF	M43	1
109	1608381	1608381	5612	5612	0	RIGHT	M431.EDF	M43	1
109	1608624	1608680	5855	5911	56	RIGHT	M431.EDF	M43	1
109	1608705	1608707	5936	5938	2	RIGHT	M431.EDF	M43	1
109	1608730	1608731	5961	5962	1	RIGHT	M431.EDF	M43	1
109	1608777	1608777	6008	6008	0	RIGHT	M431.EDF	M43	1
109	1608802	1608883	6033	6114	81	RIGHT	M431.EDF	M43	1
109	1608942	1608944	6173	6175	2	RIGHT	M431.EDF	M43	1
109	1609119	1609119	6350	6350	0	RIGHT	M431.EDF	M43	1
109	1609171	1609213	6402	6444	42	RIGHT	M431.EDF	M43	1
109	1609261	1609279	6492	6510	18	RIGHT	M431.EDF	M43	1
109	1609310	1609315	6541	6546	5	RIGHT	M431.EDF	M43	1
109	1609339	1609518	6570	6749	179	RIGHT	M431.EDF	M43	1
109	1609543	1609592	6774	6823	49	RIGHT	M431.EDF	M43	1
110	1613722	1613856	2129	2263	134	RIGHT	M431.EDF	M43	1
111	1619723	1619892	946	1115	169	RIGHT	M431.EDF	M43	1
111	1620223	1620384	1446	1607	161	RIGHT	M431.EDF	M43	1
112	1626696	1626802	97	203	106	RIGHT	M431.EDF	M43	1
112	1627969	1628108	1370	1509	139	RIGHT	M431.EDF	M43	1
113	1634007	1634145	661	799	138	RIGHT	M431.EDF	M43	1
114	1641299	1641395	649	745	96	RIGHT	M431.EDF	M43	1
114	1642611	1642746	1961	2096	135	RIGHT	M431.EDF	M43	1
115	1649116	1649276	360	520	160	RIGHT	M431.EDF	M43	1
115	1651901	1652039	3145	3283	138	RIGHT	M431.EDF	M43	1
116	1657305	1657470	955	1120	165	RIGHT	M431.EDF	M43	1
117	1663990	1664113	865	988	123	RIGHT	M431.EDF	M43	1
118	1671263	1671411	1004	1152	148	RIGHT	M431.EDF	M43	1
118	1672295	1672405	2036	2146	110	RIGHT	M431.EDF	M43	1
118	1675784	1675784	5525	5525	0	RIGHT	M431.EDF	M43	1
119	1680732	1680848	317	433	116	RIGHT	M431.EDF	M43	1
120	1688715	1688868	904	1057	153	RIGHT	M431.EDF	M43	1
120	1690520	1690648	2709	2837	128	RIGHT	M431.EDF	M43	1
1	2453340	2453453	879	992	113	RIGHT	M432.EDF	M43	2
2	2462155	2462701	73	619	546	RIGHT	M432.EDF	M43	2
2	2463625	2463737	1543	1655	112	RIGHT	M432.EDF	M43	2
3	2471352	2471498	1228	1374	146	RIGHT	M432.EDF	M43	2
4	2477437	2477640	755	958	203	RIGHT	M432.EDF	M43	2
5	2484913	2484914	341	342	1	RIGHT	M432.EDF	M43	2
5	2486694	2486848	2122	2276	154	RIGHT	M432.EDF	M43	2
6	2493195	2493352	1011	1168	157	RIGHT	M432.EDF	M43	2
6	2494626	2494777	2442	2593	151	RIGHT	M432.EDF	M43	2
7	2502630	2502758	2073	2201	128	RIGHT	M432.EDF	M43	2
8	2508686	2508779	300	393	93	RIGHT	M432.EDF	M43	2
8	2509679	2509793	1293	1407	114	RIGHT	M432.EDF	M43	2
8	2510517	2510687	2131	2301	170	RIGHT	M432.EDF	M43	2
9	2516123	2516278	835	990	155	RIGHT	M432.EDF	M43	2
10	2523365	2523387	572	594	22	RIGHT	M432.EDF	M43	2
10	2524804	2524958	2011	2165	154	RIGHT	M432.EDF	M43	2
11	2531433	2531708	57	332	275	RIGHT	M432.EDF	M43	2
11	2531928	2532048	552	672	120	RIGHT	M432.EDF	M43	2
11	2532357	2532437	981	1061	80	RIGHT	M432.EDF	M43	2
11	2532603	2532717	1227	1341	114	RIGHT	M432.EDF	M43	2
11	2536727	2536727	5351	5351	0	RIGHT	M432.EDF	M43	2
11	2536809	2536809	5433	5433	0	RIGHT	M432.EDF	M43	2
11	2537406	2537469	6030	6093	63	RIGHT	M432.EDF	M43	2
11	2537527	2537574	6151	6198	47	RIGHT	M432.EDF	M43	2
11	2537635	2537635	6259	6259	0	RIGHT	M432.EDF	M43	2
11	2538175	2538191	6799	6815	16	RIGHT	M432.EDF	M43	2
12	2540274	2540422	203	351	148	RIGHT	M432.EDF	M43	2
12	2541123	2541279	1052	1208	156	RIGHT	M432.EDF	M43	2
12	2545159	2545159	5088	5088	0	RIGHT	M432.EDF	M43	2
13	2548684	2548843	476	635	159	RIGHT	M432.EDF	M43	2
13	2549581	2549735	1373	1527	154	RIGHT	M432.EDF	M43	2
14	2555970	2556021	58	109	51	RIGHT	M432.EDF	M43	2
14	2560936	2560936	5024	5024	0	RIGHT	M432.EDF	M43	2
14	2561701	2561701	5789	5789	0	RIGHT	M432.EDF	M43	2
14	2561739	2561741	5827	5829	2	RIGHT	M432.EDF	M43	2
14	2561763	2561798	5851	5886	35	RIGHT	M432.EDF	M43	2
14	2561832	2561923	5920	6011	91	RIGHT	M432.EDF	M43	2
14	2561944	2561961	6032	6049	17	RIGHT	M432.EDF	M43	2
14	2562024	2562148	6112	6236	124	RIGHT	M432.EDF	M43	2
15	2564586	2564680	368	462	94	RIGHT	M432.EDF	M43	2
15	2566331	2566461	2113	2243	130	RIGHT	M432.EDF	M43	2
16	2573601	2573756	721	876	155	RIGHT	M432.EDF	M43	2
16	2575256	2575395	2376	2515	139	RIGHT	M432.EDF	M43	2
17	2582014	2582163	567	716	149	RIGHT	M432.EDF	M43	2
18	2589373	2589469	72	168	96	RIGHT	M432.EDF	M43	2
18	2590916	2591009	1615	1708	93	RIGHT	M432.EDF	M43	2
19	2598779	2598900	351	472	121	RIGHT	M432.EDF	M43	2
19	2599294	2599392	866	964	98	RIGHT	M432.EDF	M43	2
19	2599700	2599736	1272	1308	36	RIGHT	M432.EDF	M43	2
19	2599760	2599760	1332	1332	0	RIGHT	M432.EDF	M43	2
19	2600378	2600511	1950	2083	133	RIGHT	M432.EDF	M43	2
20	2607937	2608044	1324	1431	107	RIGHT	M432.EDF	M43	2
20	2608766	2608876	2153	2263	110	RIGHT	M432.EDF	M43	2
21	2616553	2616682	1395	1524	129	RIGHT	M432.EDF	M43	2
22	2622772	2622902	868	998	130	RIGHT	M432.EDF	M43	2
24	2638196	2638308	58	170	112	RIGHT	M432.EDF	M43	2
24	2642244	2642328	4106	4190	84	RIGHT	M432.EDF	M43	2
24	2644357	2644482	6219	6344	125	RIGHT	M432.EDF	M43	2
25	2649164	2649288	1916	2040	124	RIGHT	M432.EDF	M43	2
26	2656904	2657043	1071	1210	139	RIGHT	M432.EDF	M43	2
27	2665591	2665742	1813	1964	151	RIGHT	M432.EDF	M43	2
27	2668126	2668235	4348	4457	109	RIGHT	M432.EDF	M43	2
28	2673456	2673571	1243	1358	115	RIGHT	M432.EDF	M43	2
29	2681793	2681877	425	509	84	RIGHT	M432.EDF	M43	2
30	2691641	2691762	1855	1976	121	RIGHT	M432.EDF	M43	2
31	2699067	2699186	1296	1415	119	RIGHT	M432.EDF	M43	2
32	2705002	2705577	57	632	575	RIGHT	M432.EDF	M43	2
32	2705697	2705792	752	847	95	RIGHT	M432.EDF	M43	2
33	2712894	2713066	836	1008	172	RIGHT	M432.EDF	M43	2
34	2721793	2721970	788	965	177	RIGHT	M432.EDF	M43	2
35	2729897	2730013	491	607	116	RIGHT	M432.EDF	M43	2
35	2731614	2731746	2208	2340	132	RIGHT	M432.EDF	M43	2
36	2737686	2737822	1053	1189	136	RIGHT	M432.EDF	M43	2
37	2744915	2745018	727	830	103	RIGHT	M432.EDF	M43	2
37	2745186	2745329	998	1141	143	RIGHT	M432.EDF	M43	2
38	2754126	2754251	1293	1418	125	RIGHT	M432.EDF	M43	2
38	2755238	2755352	2405	2519	114	RIGHT	M432.EDF	M43	2
39	2761617	2761777	1020	1180	160	RIGHT	M432.EDF	M43	2
40	2769100	2769227	1321	1448	127	RIGHT	M432.EDF	M43	2
41	2777388	2777517	2041	2170	129	RIGHT	M432.EDF	M43	2
42	2785925	2786071	1083	1229	146	RIGHT	M432.EDF	M43	2
43	2792466	2792591	829	954	125	RIGHT	M432.EDF	M43	2
44	2801737	2801865	1182	1310	128	RIGHT	M432.EDF	M43	2
45	2809516	2809696	1140	1320	180	RIGHT	M432.EDF	M43	2
46	2818088	2818133	563	608	45	RIGHT	M432.EDF	M43	2
46	2818812	2818981	1287	1456	169	RIGHT	M432.EDF	M43	2
47	2827118	2827238	1022	1142	120	RIGHT	M432.EDF	M43	2
48	2835372	2835539	656	823	167	RIGHT	M432.EDF	M43	2
49	2842539	2843290	58	809	751	RIGHT	M432.EDF	M43	2
49	2844671	2844755	2190	2274	84	RIGHT	M432.EDF	M43	2
50	2852211	2852349	880	1018	138	RIGHT	M432.EDF	M43	2
50	2853708	2853823	2377	2492	115	RIGHT	M432.EDF	M43	2
51	2861876	2862025	2378	2527	149	RIGHT	M432.EDF	M43	2
52	2869319	2869401	57	139	82	RIGHT	M432.EDF	M43	2
52	2870987	2871131	1725	1869	144	RIGHT	M432.EDF	M43	2
53	2877354	2877509	826	981	155	RIGHT	M432.EDF	M43	2
54	2883740	2883888	976	1124	148	RIGHT	M432.EDF	M43	2
56	2899010	2899087	58	135	77	RIGHT	M432.EDF	M43	2
56	2899341	2899444	389	492	103	RIGHT	M432.EDF	M43	2
56	2899955	2900049	1003	1097	94	RIGHT	M432.EDF	M43	2
56	2900888	2901000	1936	2048	112	RIGHT	M432.EDF	M43	2
57	2908079	2908096	74	91	17	RIGHT	M432.EDF	M43	2
57	2909943	2910050	1938	2045	107	RIGHT	M432.EDF	M43	2
59	2925234	2925376	768	910	142	RIGHT	M432.EDF	M43	2
60	2933755	2933928	720	893	173	RIGHT	M432.EDF	M43	2
61	2942667	2942795	2689	2817	128	RIGHT	M432.EDF	M43	2
62	2949242	2949397	980	1135	155	RIGHT	M432.EDF	M43	2
63	2956486	2956572	147	233	86	RIGHT	M432.EDF	M43	2
65	2973957	2974099	1047	1189	142	RIGHT	M432.EDF	M43	2
66	2980766	2980934	114	282	168	RIGHT	M432.EDF	M43	2
66	2982061	2982179	1409	1527	118	RIGHT	M432.EDF	M43	2
67	2989434	2989574	1094	1234	140	RIGHT	M432.EDF	M43	2
68	2997446	2997558	1210	1322	112	RIGHT	M432.EDF	M43	2
68	3000696	3000819	4460	4583	123	RIGHT	M432.EDF	M43	2
69	3003473	3003590	85	202	117	RIGHT	M432.EDF	M43	2
69	3005153	3005249	1765	1861	96	RIGHT	M432.EDF	M43	2
70	3011963	3011964	77	78	1	RIGHT	M432.EDF	M43	2
70	3012122	3012226	236	340	104	RIGHT	M432.EDF	M43	2
70	3012458	3012505	572	619	47	RIGHT	M432.EDF	M43	2
70	3012940	3013087	1054	1201	147	RIGHT	M432.EDF	M43	2
70	3014152	3014251	2266	2365	99	RIGHT	M432.EDF	M43	2
71	3021154	3021304	685	835	150	RIGHT	M432.EDF	M43	2
72	3030607	3030712	1827	1932	105	RIGHT	M432.EDF	M43	2
73	3037526	3037629	638	741	103	RIGHT	M432.EDF	M43	2
73	3039736	3039818	2848	2930	82	RIGHT	M432.EDF	M43	2
74	3045944	3046062	1283	1401	118	RIGHT	M432.EDF	M43	2
74	3048687	3048687	4026	4026	0	RIGHT	M432.EDF	M43	2
74	3051120	3051124	6459	6463	4	RIGHT	M432.EDF	M43	2
74	3051148	3051148	6487	6487	0	RIGHT	M432.EDF	M43	2
74	3051184	3051184	6523	6523	0	RIGHT	M432.EDF	M43	2
74	3051214	3051214	6553	6553	0	RIGHT	M432.EDF	M43	2
74	3051286	3051308	6625	6647	22	RIGHT	M432.EDF	M43	2
74	3051488	3051488	6827	6827	0	RIGHT	M432.EDF	M43	2
75	3055144	3055269	1512	1637	125	RIGHT	M432.EDF	M43	2
76	3063103	3063194	340	431	91	RIGHT	M432.EDF	M43	2
77	3069472	3069587	324	439	115	RIGHT	M432.EDF	M43	2
77	3073522	3073523	4374	4375	1	RIGHT	M432.EDF	M43	2
77	3073556	3073566	4408	4418	10	RIGHT	M432.EDF	M43	2
77	3073600	3073600	4452	4452	0	RIGHT	M432.EDF	M43	2
77	3073638	3073638	4490	4490	0	RIGHT	M432.EDF	M43	2
77	3074245	3074245	5097	5097	0	RIGHT	M432.EDF	M43	2
78	3077587	3077587	1049	1049	0	RIGHT	M432.EDF	M43	2
78	3078949	3078958	2411	2420	9	RIGHT	M432.EDF	M43	2
78	3078984	3079003	2446	2465	19	RIGHT	M432.EDF	M43	2
78	3079026	3079059	2488	2521	33	RIGHT	M432.EDF	M43	2
78	3079081	3079086	2543	2548	5	RIGHT	M432.EDF	M43	2
78	3079109	3079129	2571	2591	20	RIGHT	M432.EDF	M43	2
78	3079150	3079150	2612	2612	0	RIGHT	M432.EDF	M43	2
79	3085876	3085956	2489	2569	80	RIGHT	M432.EDF	M43	2
79	3087423	3087542	4036	4155	119	RIGHT	M432.EDF	M43	2
80	3090975	3091124	84	233	149	RIGHT	M432.EDF	M43	2
80	3093868	3093911	2977	3020	43	RIGHT	M432.EDF	M43	2
80	3094661	3094661	3770	3770	0	RIGHT	M432.EDF	M43	2
80	3094705	3094715	3814	3824	10	RIGHT	M432.EDF	M43	2
81	3099053	3099154	1808	1909	101	RIGHT	M432.EDF	M43	2
83	3112475	3112632	943	1100	157	RIGHT	M432.EDF	M43	2
84	3119901	3120036	1005	1140	135	RIGHT	M432.EDF	M43	2
85	3127881	3128006	2410	2535	125	RIGHT	M432.EDF	M43	2
86	3135774	3135904	2185	2315	130	RIGHT	M432.EDF	M43	2
87	3143847	3144012	1995	2160	165	RIGHT	M432.EDF	M43	2
88	3152332	3152442	2277	2387	110	RIGHT	M432.EDF	M43	2
89	3159385	3159507	619	741	122	RIGHT	M432.EDF	M43	2
89	3161127	3161265	2361	2499	138	RIGHT	M432.EDF	M43	2
90	3168583	3168726	885	1028	143	RIGHT	M432.EDF	M43	2
91	3176747	3176832	2063	2148	85	RIGHT	M432.EDF	M43	2
92	3181745	3181875	68	198	130	RIGHT	M432.EDF	M43	2
92	3182115	3182206	438	529	91	RIGHT	M432.EDF	M43	2
92	3182919	3183044	1242	1367	125	RIGHT	M432.EDF	M43	2
93	3189404	3189515	133	244	111	RIGHT	M432.EDF	M43	2
93	3190147	3190288	876	1017	141	RIGHT	M432.EDF	M43	2
94	3198960	3199108	130	278	148	RIGHT	M432.EDF	M43	2
94	3200888	3200946	2058	2116	58	RIGHT	M432.EDF	M43	2
95	3206383	3206501	93	211	118	RIGHT	M432.EDF	M43	2
95	3207145	3207307	855	1017	162	RIGHT	M432.EDF	M43	2
96	3213685	3213704	58	77	19	RIGHT	M432.EDF	M43	2
96	3213742	3213847	115	220	105	RIGHT	M432.EDF	M43	2
97	3224912	3225030	2539	2657	118	RIGHT	M432.EDF	M43	2
98	3231696	3231811	1818	1933	115	RIGHT	M432.EDF	M43	2
99	3239985	3240132	1383	1530	147	RIGHT	M432.EDF	M43	2
100	3246837	3246969	922	1054	132	RIGHT	M432.EDF	M43	2
101	3255214	3255326	541	653	112	RIGHT	M432.EDF	M43	2
101	3256814	3256933	2141	2260	119	RIGHT	M432.EDF	M43	2
102	3264196	3264334	769	907	138	RIGHT	M432.EDF	M43	2
104	3282560	3282663	780	883	103	RIGHT	M432.EDF	M43	2
105	3289957	3290114	642	799	157	RIGHT	M432.EDF	M43	2
108	3316243	3316270	574	601	27	RIGHT	M432.EDF	M43	2
110	3338120	3338157	6210	6247	37	RIGHT	M432.EDF	M43	2
111	3341177	3341302	372	497	125	RIGHT	M432.EDF	M43	2
111	3341959	3342084	1154	1279	125	RIGHT	M432.EDF	M43	2
112	3351181	3351282	1603	1704	101	RIGHT	M432.EDF	M43	2
113	3359029	3359180	912	1063	151	RIGHT	M432.EDF	M43	2
114	3368364	3368512	981	1129	148	RIGHT	M432.EDF	M43	2
115	3376361	3376470	935	1044	109	RIGHT	M432.EDF	M43	2
116	3383604	3383756	902	1054	152	RIGHT	M432.EDF	M43	2
117	3392380	3392508	193	321	128	RIGHT	M432.EDF	M43	2
118	3400952	3401088	893	1029	136	RIGHT	M432.EDF	M43	2
119	3410018	3410111	1453	1546	93	RIGHT	M432.EDF	M43	2
120	3419071	3419200	1796	1925	129	RIGHT	M432.EDF	M43	2
1	3870291	3870399	712	820	108	RIGHT	M433.EDF	M43	3
1	3871484	3871567	1905	1988	83	RIGHT	M433.EDF	M43	3
3	3890553	3890638	5983	6068	85	RIGHT	M433.EDF	M43	3
4	3893961	3894113	1185	1337	152	RIGHT	M433.EDF	M43	3
5	3901352	3901509	698	855	157	RIGHT	M433.EDF	M43	3
6	3912346	3912416	4900	4970	70	RIGHT	M433.EDF	M43	3
7	3917549	3917670	869	990	121	RIGHT	M433.EDF	M43	3
8	3927680	3927777	4045	4142	97	RIGHT	M433.EDF	M43	3
9	3932251	3932362	742	853	111	RIGHT	M433.EDF	M43	3
10	3941582	3941706	2435	2559	124	RIGHT	M433.EDF	M43	3
11	3946722	3946807	58	143	85	RIGHT	M433.EDF	M43	3
11	3947038	3947139	374	475	101	RIGHT	M433.EDF	M43	3
11	3948664	3948752	2000	2088	88	RIGHT	M433.EDF	M43	3
13	3964196	3964303	1897	2004	107	RIGHT	M433.EDF	M43	3
14	3970594	3970710	1253	1369	116	RIGHT	M433.EDF	M43	3
15	3978144	3978213	566	635	69	RIGHT	M433.EDF	M43	3
16	3984476	3984605	58	187	129	RIGHT	M433.EDF	M43	3
17	3992811	3992935	995	1119	124	RIGHT	M433.EDF	M43	3
18	4000248	4000602	57	411	354	RIGHT	M433.EDF	M43	3
18	4000796	4000889	605	698	93	RIGHT	M433.EDF	M43	3
18	4005609	4005609	5418	5418	0	RIGHT	M433.EDF	M43	3
18	4006186	4006266	5995	6075	80	RIGHT	M433.EDF	M43	3
19	4008632	4008783	157	308	151	RIGHT	M433.EDF	M43	3
20	4022328	4022330	6011	6013	2	RIGHT	M433.EDF	M43	3
20	4022395	4022396	6078	6079	1	RIGHT	M433.EDF	M43	3
20	4022421	4022455	6104	6138	34	RIGHT	M433.EDF	M43	3
20	4022476	4022514	6159	6197	38	RIGHT	M433.EDF	M43	3
20	4023123	4023137	6806	6820	14	RIGHT	M433.EDF	M43	3
20	4023172	4023173	6855	6856	1	RIGHT	M433.EDF	M43	3
22	4034531	4034618	500	587	87	RIGHT	M433.EDF	M43	3
24	4050755	4050905	993	1143	150	RIGHT	M433.EDF	M43	3
24	4056085	4056085	6323	6323	0	RIGHT	M433.EDF	M43	3
24	4056132	4056134	6370	6372	2	RIGHT	M433.EDF	M43	3
24	4056161	4056178	6399	6416	17	RIGHT	M433.EDF	M43	3
24	4056240	4056240	6478	6478	0	RIGHT	M433.EDF	M43	3
24	4056291	4056293	6529	6531	2	RIGHT	M433.EDF	M43	3
24	4056809	4056809	7047	7047	0	RIGHT	M433.EDF	M43	3
25	4062274	4062274	3529	3529	0	RIGHT	M433.EDF	M43	3
25	4062473	4062478	3728	3733	5	RIGHT	M433.EDF	M43	3
25	4062528	4062528	3783	3783	0	RIGHT	M433.EDF	M43	3
25	4063233	4063233	4488	4488	0	RIGHT	M433.EDF	M43	3
25	4063266	4063323	4521	4578	57	RIGHT	M433.EDF	M43	3
25	4063347	4063353	4602	4608	6	RIGHT	M433.EDF	M43	3
26	4069497	4069498	3745	3746	1	RIGHT	M433.EDF	M43	3
26	4069583	4069583	3831	3831	0	RIGHT	M433.EDF	M43	3
26	4069605	4069605	3853	3853	0	RIGHT	M433.EDF	M43	3
26	4069668	4069668	3916	3916	0	RIGHT	M433.EDF	M43	3
28	4088592	4088685	6159	6252	93	RIGHT	M433.EDF	M43	3
29	4093533	4093539	1915	1921	6	RIGHT	M433.EDF	M43	3
29	4093565	4093566	1947	1948	1	RIGHT	M433.EDF	M43	3
29	4093628	4093629	2010	2011	1	RIGHT	M433.EDF	M43	3
29	4093658	4093675	2040	2057	17	RIGHT	M433.EDF	M43	3
29	4093701	4093707	2083	2089	6	RIGHT	M433.EDF	M43	3
29	4093770	4094047	2152	2429	277	RIGHT	M433.EDF	M43	3
29	4094102	4094478	2484	2860	376	RIGHT	M433.EDF	M43	3
29	4094504	4094576	2886	2958	72	RIGHT	M433.EDF	M43	3
29	4094599	4094649	2981	3031	50	RIGHT	M433.EDF	M43	3
29	4094670	4096900	3052	5282	2230	RIGHT	M433.EDF	M43	3
30	4099380	4099510	517	647	130	RIGHT	M433.EDF	M43	3
30	4102003	4102003	3140	3140	0	RIGHT	M433.EDF	M43	3
30	4102030	4102031	3167	3168	1	RIGHT	M433.EDF	M43	3
30	4102081	4102082	3218	3219	1	RIGHT	M433.EDF	M43	3
30	4102106	4102110	3243	3247	4	RIGHT	M433.EDF	M43	3
30	4102132	4102141	3269	3278	9	RIGHT	M433.EDF	M43	3
30	4102167	4102215	3304	3352	48	RIGHT	M433.EDF	M43	3
30	4102275	4102300	3412	3437	25	RIGHT	M433.EDF	M43	3
30	4102353	4102353	3490	3490	0	RIGHT	M433.EDF	M43	3
30	4102655	4102656	3792	3793	1	RIGHT	M433.EDF	M43	3
30	4102736	4102761	3873	3898	25	RIGHT	M433.EDF	M43	3
30	4102794	4103127	3931	4264	333	RIGHT	M433.EDF	M43	3
30	4103149	4103275	4286	4412	126	RIGHT	M433.EDF	M43	3
30	4103296	4103298	4433	4435	2	RIGHT	M433.EDF	M43	3
30	4103383	4103384	4520	4521	1	RIGHT	M433.EDF	M43	3
30	4103430	4103648	4567	4785	218	RIGHT	M433.EDF	M43	3
30	4103674	4103848	4811	4985	174	RIGHT	M433.EDF	M43	3
30	4103922	4103962	5059	5099	40	RIGHT	M433.EDF	M43	3
30	4104735	4104735	5872	5872	0	RIGHT	M433.EDF	M43	3
31	4108139	4108140	1103	1104	1	RIGHT	M433.EDF	M43	3
31	4108176	4108184	1140	1148	8	RIGHT	M433.EDF	M43	3
31	4108213	4108306	1177	1270	93	RIGHT	M433.EDF	M43	3
31	4109114	4109115	2078	2079	1	RIGHT	M433.EDF	M43	3
31	4109136	4109151	2100	2115	15	RIGHT	M433.EDF	M43	3
31	4109175	4109202	2139	2166	27	RIGHT	M433.EDF	M43	3
31	4109434	4109454	2398	2418	20	RIGHT	M433.EDF	M43	3
31	4109504	4109548	2468	2512	44	RIGHT	M433.EDF	M43	3
31	4109582	4109582	2546	2546	0	RIGHT	M433.EDF	M43	3
31	4109604	4109610	2568	2574	6	RIGHT	M433.EDF	M43	3
31	4109635	4110240	2599	3204	605	RIGHT	M433.EDF	M43	3
31	4110262	4111192	3226	4156	930	RIGHT	M433.EDF	M43	3
31	4111214	4113347	4178	6311	2133	RIGHT	M433.EDF	M43	3
31	4113410	4113417	6374	6381	7	RIGHT	M433.EDF	M43	3
31	4113440	4113661	6404	6625	221	RIGHT	M433.EDF	M43	3
32	4116615	4116615	1143	1143	0	RIGHT	M433.EDF	M43	3
32	4117396	4117431	1924	1959	35	RIGHT	M433.EDF	M43	3
32	4117486	4117612	2014	2140	126	RIGHT	M433.EDF	M43	3
32	4117649	4117668	2177	2196	19	RIGHT	M433.EDF	M43	3
32	4117698	4117706	2226	2234	8	RIGHT	M433.EDF	M43	3
32	4117741	4117755	2269	2283	14	RIGHT	M433.EDF	M43	3
32	4117786	4117852	2314	2380	66	RIGHT	M433.EDF	M43	3
32	4117880	4117880	2408	2408	0	RIGHT	M433.EDF	M43	3
32	4117915	4120225	2443	4753	2310	RIGHT	M433.EDF	M43	3
33	4123692	4123790	1666	1764	98	RIGHT	M433.EDF	M43	3
33	4124818	4124818	2792	2792	0	RIGHT	M433.EDF	M43	3
33	4124839	4124839	2813	2813	0	RIGHT	M433.EDF	M43	3
33	4124919	4124919	2893	2893	0	RIGHT	M433.EDF	M43	3
33	4125007	4125017	2981	2991	10	RIGHT	M433.EDF	M43	3
33	4125789	4125797	3763	3771	8	RIGHT	M433.EDF	M43	3
33	4125825	4125825	3799	3799	0	RIGHT	M433.EDF	M43	3
33	4125898	4125898	3872	3872	0	RIGHT	M433.EDF	M43	3
34	4132723	4132723	2510	2510	0	RIGHT	M433.EDF	M43	3
34	4132785	4133066	2572	2853	281	RIGHT	M433.EDF	M43	3
34	4133115	4133115	2902	2902	0	RIGHT	M433.EDF	M43	3
34	4133161	4133182	2948	2969	21	RIGHT	M433.EDF	M43	3
34	4133219	4133236	3006	3023	17	RIGHT	M433.EDF	M43	3
34	4133318	4133319	3105	3106	1	RIGHT	M433.EDF	M43	3
34	4133701	4133705	3488	3492	4	RIGHT	M433.EDF	M43	3
34	4133756	4133777	3543	3564	21	RIGHT	M433.EDF	M43	3
34	4133808	4134071	3595	3858	263	RIGHT	M433.EDF	M43	3
34	4134117	4134181	3904	3968	64	RIGHT	M433.EDF	M43	3
34	4134257	4134284	4044	4071	27	RIGHT	M433.EDF	M43	3
34	4134318	4134322	4105	4109	4	RIGHT	M433.EDF	M43	3
34	4134403	4134540	4190	4327	137	RIGHT	M433.EDF	M43	3
34	4134563	4134564	4350	4351	1	RIGHT	M433.EDF	M43	3
34	4134600	4134616	4387	4403	16	RIGHT	M433.EDF	M43	3
34	4134640	4135015	4427	4802	375	RIGHT	M433.EDF	M43	3
34	4135044	4135054	4831	4841	10	RIGHT	M433.EDF	M43	3
34	4135075	4135076	4862	4863	1	RIGHT	M433.EDF	M43	3
34	4135100	4135118	4887	4905	18	RIGHT	M433.EDF	M43	3
34	4135140	4135154	4927	4941	14	RIGHT	M433.EDF	M43	3
34	4135198	4135199	4985	4986	1	RIGHT	M433.EDF	M43	3
34	4135467	4135468	5254	5255	1	RIGHT	M433.EDF	M43	3
34	4135492	4135915	5279	5702	423	RIGHT	M433.EDF	M43	3
35	4145141	4145141	6668	6668	0	RIGHT	M433.EDF	M43	3
35	4145247	4145247	6774	6774	0	RIGHT	M433.EDF	M43	3
35	4145276	4145292	6803	6819	16	RIGHT	M433.EDF	M43	3
35	4145314	4145871	6841	7398	557	RIGHT	M433.EDF	M43	3
36	4152546	4152546	4854	4854	0	RIGHT	M433.EDF	M43	3
36	4153486	4153486	5794	5794	0	RIGHT	M433.EDF	M43	3
37	4158856	4158856	3079	3079	0	RIGHT	M433.EDF	M43	3
37	4159657	4159657	3880	3880	0	RIGHT	M433.EDF	M43	3
37	4159680	4159817	3903	4040	137	RIGHT	M433.EDF	M43	3
37	4159843	4159859	4066	4082	16	RIGHT	M433.EDF	M43	3
37	4160145	4160145	4368	4368	0	RIGHT	M433.EDF	M43	3
37	4160175	4160175	4398	4398	0	RIGHT	M433.EDF	M43	3
37	4160436	4160436	4659	4659	0	RIGHT	M433.EDF	M43	3
37	4160481	4160491	4704	4714	10	RIGHT	M433.EDF	M43	3
37	4160545	4160592	4768	4815	47	RIGHT	M433.EDF	M43	3
37	4160621	4160641	4844	4864	20	RIGHT	M433.EDF	M43	3
37	4160672	4160683	4895	4906	11	RIGHT	M433.EDF	M43	3
37	4161520	4161522	5743	5745	2	RIGHT	M433.EDF	M43	3
37	4161554	4161586	5777	5809	32	RIGHT	M433.EDF	M43	3
37	4161617	4161649	5840	5872	32	RIGHT	M433.EDF	M43	3
37	4161673	4161717	5896	5940	44	RIGHT	M433.EDF	M43	3
37	4161740	4161768	5963	5991	28	RIGHT	M433.EDF	M43	3
37	4161856	4161934	6079	6157	78	RIGHT	M433.EDF	M43	3
37	4161989	4161989	6212	6212	0	RIGHT	M433.EDF	M43	3
37	4162037	4162161	6260	6384	124	RIGHT	M433.EDF	M43	3
38	4165313	4165335	1111	1133	22	RIGHT	M433.EDF	M43	3
38	4165400	4165500	1198	1298	100	RIGHT	M433.EDF	M43	3
38	4165524	4165531	1322	1329	7	RIGHT	M433.EDF	M43	3
38	4165563	4165596	1361	1394	33	RIGHT	M433.EDF	M43	3
38	4165617	4165893	1415	1691	276	RIGHT	M433.EDF	M43	3
38	4165960	4166015	1758	1813	55	RIGHT	M433.EDF	M43	3
38	4166396	4166506	2194	2304	110	RIGHT	M433.EDF	M43	3
38	4169294	4169295	5092	5093	1	RIGHT	M433.EDF	M43	3
38	4169399	4169458	5197	5256	59	RIGHT	M433.EDF	M43	3
38	4169746	4169746	5544	5544	0	RIGHT	M433.EDF	M43	3
38	4169951	4169951	5749	5749	0	RIGHT	M433.EDF	M43	3
38	4170143	4170165	5941	5963	22	RIGHT	M433.EDF	M43	3
38	4170195	4170314	5993	6112	119	RIGHT	M433.EDF	M43	3
38	4170371	4170371	6169	6169	0	RIGHT	M433.EDF	M43	3
38	4170837	4171166	6635	6964	329	RIGHT	M433.EDF	M43	3
39	4175624	4175624	2156	2156	0	RIGHT	M433.EDF	M43	3
39	4175655	4175655	2187	2187	0	RIGHT	M433.EDF	M43	3
39	4175677	4175678	2209	2210	1	RIGHT	M433.EDF	M43	3
39	4175710	4175711	2242	2243	1	RIGHT	M433.EDF	M43	3
39	4175755	4175773	2287	2305	18	RIGHT	M433.EDF	M43	3
39	4175893	4175894	2425	2426	1	RIGHT	M433.EDF	M43	3
39	4175959	4175959	2491	2491	0	RIGHT	M433.EDF	M43	3
39	4176013	4176022	2545	2554	9	RIGHT	M433.EDF	M43	3
39	4176113	4176191	2645	2723	78	RIGHT	M433.EDF	M43	3
39	4176221	4176774	2753	3306	553	RIGHT	M433.EDF	M43	3
39	4176798	4176845	3330	3377	47	RIGHT	M433.EDF	M43	3
39	4176883	4176924	3415	3456	41	RIGHT	M433.EDF	M43	3
39	4176955	4180312	3487	6844	3357	RIGHT	M433.EDF	M43	3
40	4183650	4183753	918	1021	103	RIGHT	M433.EDF	M43	3
40	4184626	4187987	1894	5255	3361	RIGHT	M433.EDF	M43	3
41	4191153	4191153	925	925	0	RIGHT	M433.EDF	M43	3
41	4191178	4191195	950	967	17	RIGHT	M433.EDF	M43	3
41	4191299	4191320	1071	1092	21	RIGHT	M433.EDF	M43	3
41	4192024	4192027	1796	1799	3	RIGHT	M433.EDF	M43	3
41	4192609	4192626	2381	2398	17	RIGHT	M433.EDF	M43	3
41	4192678	4192774	2450	2546	96	RIGHT	M433.EDF	M43	3
41	4192796	4193051	2568	2823	255	RIGHT	M433.EDF	M43	3
41	4193080	4193080	2852	2852	0	RIGHT	M433.EDF	M43	3
41	4193121	4193139	2893	2911	18	RIGHT	M433.EDF	M43	3
41	4193268	4193268	3040	3040	0	RIGHT	M433.EDF	M43	3
41	4193429	4193903	3201	3675	474	RIGHT	M433.EDF	M43	3
41	4194109	4194109	3881	3881	0	RIGHT	M433.EDF	M43	3
41	4194230	4194230	4002	4002	0	RIGHT	M433.EDF	M43	3
41	4194301	4194309	4073	4081	8	RIGHT	M433.EDF	M43	3
41	4194336	4197182	4108	6954	2846	RIGHT	M433.EDF	M43	3
42	4199889	4200011	765	887	122	RIGHT	M433.EDF	M43	3
43	4208005	4208123	2027	2145	118	RIGHT	M433.EDF	M43	3
43	4209951	4209965	3973	3987	14	RIGHT	M433.EDF	M43	3
43	4210039	4210336	4061	4358	297	RIGHT	M433.EDF	M43	3
43	4210656	4210656	4678	4678	0	RIGHT	M433.EDF	M43	3
43	4210987	4210987	5009	5009	0	RIGHT	M433.EDF	M43	3
43	4211010	4211021	5032	5043	11	RIGHT	M433.EDF	M43	3
44	4215130	4215204	2187	2261	74	RIGHT	M433.EDF	M43	3
45	4222982	4223040	2310	2368	58	RIGHT	M433.EDF	M43	3
45	4224488	4224504	3816	3832	16	RIGHT	M433.EDF	M43	3
45	4225076	4225103	4404	4431	27	RIGHT	M433.EDF	M43	3
45	4225136	4225136	4464	4464	0	RIGHT	M433.EDF	M43	3
45	4225159	4225192	4487	4520	33	RIGHT	M433.EDF	M43	3
45	4225225	4225574	4553	4902	349	RIGHT	M433.EDF	M43	3
45	4225650	4225666	4978	4994	16	RIGHT	M433.EDF	M43	3
45	4225742	4225746	5070	5074	4	RIGHT	M433.EDF	M43	3
45	4225831	4225831	5159	5159	0	RIGHT	M433.EDF	M43	3
45	4225954	4226514	5282	5842	560	RIGHT	M433.EDF	M43	3
46	4229909	4229909	1361	1361	0	RIGHT	M433.EDF	M43	3
46	4230658	4230698	2110	2150	40	RIGHT	M433.EDF	M43	3
46	4230736	4230738	2188	2190	2	RIGHT	M433.EDF	M43	3
46	4230798	4230798	2250	2250	0	RIGHT	M433.EDF	M43	3
46	4230841	4230841	2293	2293	0	RIGHT	M433.EDF	M43	3
46	4230891	4230925	2343	2377	34	RIGHT	M433.EDF	M43	3
46	4230973	4230973	2425	2425	0	RIGHT	M433.EDF	M43	3
46	4230994	4231035	2446	2487	41	RIGHT	M433.EDF	M43	3
46	4231062	4231062	2514	2514	0	RIGHT	M433.EDF	M43	3
46	4231088	4231212	2540	2664	124	RIGHT	M433.EDF	M43	3
46	4231233	4233594	2685	5046	2361	RIGHT	M433.EDF	M43	3
47	4235754	4235818	362	426	64	RIGHT	M433.EDF	M43	3
47	4236871	4236871	1479	1479	0	RIGHT	M433.EDF	M43	3
47	4237431	4237432	2039	2040	1	RIGHT	M433.EDF	M43	3
47	4237455	4241150	2063	5758	3695	RIGHT	M433.EDF	M43	3
47	4241235	4241248	5843	5856	13	RIGHT	M433.EDF	M43	3
47	4241338	4241344	5946	5952	6	RIGHT	M433.EDF	M43	3
47	4241446	4241454	6054	6062	8	RIGHT	M433.EDF	M43	3
47	4241499	4241499	6107	6107	0	RIGHT	M433.EDF	M43	3
47	4241530	4241530	6138	6138	0	RIGHT	M433.EDF	M43	3
47	4241565	4242640	6173	7248	1075	RIGHT	M433.EDF	M43	3
48	4244996	4245018	253	275	22	RIGHT	M433.EDF	M43	3
48	4245050	4245128	307	385	78	RIGHT	M433.EDF	M43	3
48	4246598	4246664	1855	1921	66	RIGHT	M433.EDF	M43	3
48	4246688	4247029	1945	2286	341	RIGHT	M433.EDF	M43	3
48	4247070	4247070	2327	2327	0	RIGHT	M433.EDF	M43	3
48	4247127	4247143	2384	2400	16	RIGHT	M433.EDF	M43	3
48	4247232	4247232	2489	2489	0	RIGHT	M433.EDF	M43	3
48	4247295	4247305	2552	2562	10	RIGHT	M433.EDF	M43	3
48	4247328	4247328	2585	2585	0	RIGHT	M433.EDF	M43	3
48	4247352	4247389	2609	2646	37	RIGHT	M433.EDF	M43	3
48	4247415	4247421	2672	2678	6	RIGHT	M433.EDF	M43	3
48	4247442	4247903	2699	3160	461	RIGHT	M433.EDF	M43	3
48	4247925	4248749	3182	4006	824	RIGHT	M433.EDF	M43	3
48	4248782	4248875	4039	4132	93	RIGHT	M433.EDF	M43	3
48	4248948	4249175	4205	4432	227	RIGHT	M433.EDF	M43	3
48	4249198	4249584	4455	4841	386	RIGHT	M433.EDF	M43	3
48	4249606	4249655	4863	4912	49	RIGHT	M433.EDF	M43	3
48	4249691	4249697	4948	4954	6	RIGHT	M433.EDF	M43	3
48	4249744	4249842	5001	5099	98	RIGHT	M433.EDF	M43	3
48	4249864	4250105	5121	5362	241	RIGHT	M433.EDF	M43	3
49	4253307	4253421	1171	1285	114	RIGHT	M433.EDF	M43	3
49	4254164	4254165	2028	2029	1	RIGHT	M433.EDF	M43	3
49	4254187	4254189	2051	2053	2	RIGHT	M433.EDF	M43	3
49	4254278	4254279	2142	2143	1	RIGHT	M433.EDF	M43	3
49	4254307	4254545	2171	2409	238	RIGHT	M433.EDF	M43	3
49	4254662	4254662	2526	2526	0	RIGHT	M433.EDF	M43	3
49	4254698	4254698	2562	2562	0	RIGHT	M433.EDF	M43	3
49	4254758	4254758	2622	2622	0	RIGHT	M433.EDF	M43	3
49	4254813	4254813	2677	2677	0	RIGHT	M433.EDF	M43	3
49	4254854	4258440	2718	6304	3586	RIGHT	M433.EDF	M43	3
50	4260179	4260732	58	611	553	RIGHT	M433.EDF	M43	3
50	4260757	4260902	636	781	145	RIGHT	M433.EDF	M43	3
50	4262214	4262365	2093	2244	151	RIGHT	M433.EDF	M43	3
50	4262389	4262513	2268	2392	124	RIGHT	M433.EDF	M43	3
50	4262537	4262538	2416	2417	1	RIGHT	M433.EDF	M43	3
50	4262559	4262559	2438	2438	0	RIGHT	M433.EDF	M43	3
50	4262591	4262607	2470	2486	16	RIGHT	M433.EDF	M43	3
50	4262683	4262703	2562	2582	20	RIGHT	M433.EDF	M43	3
50	4262776	4262792	2655	2671	16	RIGHT	M433.EDF	M43	3
50	4262823	4263523	2702	3402	700	RIGHT	M433.EDF	M43	3
50	4263561	4263562	3440	3441	1	RIGHT	M433.EDF	M43	3
50	4264065	4264453	3944	4332	388	RIGHT	M433.EDF	M43	3
50	4264493	4264580	4372	4459	87	RIGHT	M433.EDF	M43	3
50	4264757	4265297	4636	5176	540	RIGHT	M433.EDF	M43	3
50	4265323	4266915	5202	6794	1592	RIGHT	M433.EDF	M43	3
51	4269939	4269939	580	580	0	RIGHT	M433.EDF	M43	3
51	4270338	4270339	979	980	1	RIGHT	M433.EDF	M43	3
51	4270413	4270887	1054	1528	474	RIGHT	M433.EDF	M43	3
51	4270911	4270929	1552	1570	18	RIGHT	M433.EDF	M43	3
51	4270952	4270966	1593	1607	14	RIGHT	M433.EDF	M43	3
51	4271028	4271036	1669	1677	8	RIGHT	M433.EDF	M43	3
51	4271135	4271179	1776	1820	44	RIGHT	M433.EDF	M43	3
51	4271213	4271329	1854	1970	116	RIGHT	M433.EDF	M43	3
51	4271462	4271968	2103	2609	506	RIGHT	M433.EDF	M43	3
51	4272032	4272113	2673	2754	81	RIGHT	M433.EDF	M43	3
51	4272448	4272469	3089	3110	21	RIGHT	M433.EDF	M43	3
51	4272498	4272553	3139	3194	55	RIGHT	M433.EDF	M43	3
51	4272579	4272579	3220	3220	0	RIGHT	M433.EDF	M43	3
51	4272626	4272626	3267	3267	0	RIGHT	M433.EDF	M43	3
51	4272681	4272684	3322	3325	3	RIGHT	M433.EDF	M43	3
51	4272768	4272879	3409	3520	111	RIGHT	M433.EDF	M43	3
51	4272923	4276441	3564	7082	3518	RIGHT	M433.EDF	M43	3
52	4280723	4280740	2102	2119	17	RIGHT	M433.EDF	M43	3
52	4280774	4280774	2153	2153	0	RIGHT	M433.EDF	M43	3
52	4281228	4281228	2607	2607	0	RIGHT	M433.EDF	M43	3
52	4281257	4281257	2636	2636	0	RIGHT	M433.EDF	M43	3
52	4281287	4284586	2666	5965	3299	RIGHT	M433.EDF	M43	3
53	4286826	4287212	57	443	386	RIGHT	M433.EDF	M43	3
53	4288974	4288974	2205	2205	0	RIGHT	M433.EDF	M43	3
53	4289522	4289533	2753	2764	11	RIGHT	M433.EDF	M43	3
53	4289555	4289558	2786	2789	3	RIGHT	M433.EDF	M43	3
53	4289593	4289980	2824	3211	387	RIGHT	M433.EDF	M43	3
53	4290001	4290033	3232	3264	32	RIGHT	M433.EDF	M43	3
53	4290072	4290082	3303	3313	10	RIGHT	M433.EDF	M43	3
53	4290103	4290122	3334	3353	19	RIGHT	M433.EDF	M43	3
53	4290147	4290172	3378	3403	25	RIGHT	M433.EDF	M43	3
53	4290241	4290273	3472	3504	32	RIGHT	M433.EDF	M43	3
53	4290341	4290357	3572	3588	16	RIGHT	M433.EDF	M43	3
53	4290422	4290439	3653	3670	17	RIGHT	M433.EDF	M43	3
53	4290467	4290489	3698	3720	22	RIGHT	M433.EDF	M43	3
53	4290528	4290548	3759	3779	20	RIGHT	M433.EDF	M43	3
53	4290571	4290627	3802	3858	56	RIGHT	M433.EDF	M43	3
53	4290659	4290902	3890	4133	243	RIGHT	M433.EDF	M43	3
53	4290988	4290988	4219	4219	0	RIGHT	M433.EDF	M43	3
53	4291059	4291059	4290	4290	0	RIGHT	M433.EDF	M43	3
53	4291318	4291318	4549	4549	0	RIGHT	M433.EDF	M43	3
53	4291385	4291394	4616	4625	9	RIGHT	M433.EDF	M43	3
53	4291422	4291455	4653	4686	33	RIGHT	M433.EDF	M43	3
53	4291480	4291480	4711	4711	0	RIGHT	M433.EDF	M43	3
53	4291505	4291764	4736	4995	259	RIGHT	M433.EDF	M43	3
53	4291788	4291791	5019	5022	3	RIGHT	M433.EDF	M43	3
53	4291821	4291822	5052	5053	1	RIGHT	M433.EDF	M43	3
53	4292303	4292319	5534	5550	16	RIGHT	M433.EDF	M43	3
53	4292403	4292403	5634	5634	0	RIGHT	M433.EDF	M43	3
53	4292436	4292444	5667	5675	8	RIGHT	M433.EDF	M43	3
53	4292486	4292505	5717	5736	19	RIGHT	M433.EDF	M43	3
53	4292536	4292733	5767	5964	197	RIGHT	M433.EDF	M43	3
53	4292758	4292771	5989	6002	13	RIGHT	M433.EDF	M43	3
53	4292795	4292796	6026	6027	1	RIGHT	M433.EDF	M43	3
53	4293001	4293002	6232	6233	1	RIGHT	M433.EDF	M43	3
53	4293081	4293081	6312	6312	0	RIGHT	M433.EDF	M43	3
53	4293153	4293193	6384	6424	40	RIGHT	M433.EDF	M43	3
53	4293216	4293217	6447	6448	1	RIGHT	M433.EDF	M43	3
53	4293241	4293261	6472	6492	20	RIGHT	M433.EDF	M43	3
54	4298732	4298732	3640	3640	0	RIGHT	M433.EDF	M43	3
54	4298794	4298795	3702	3703	1	RIGHT	M433.EDF	M43	3
54	4298844	4299051	3752	3959	207	RIGHT	M433.EDF	M43	3
54	4299076	4299095	3984	4003	19	RIGHT	M433.EDF	M43	3
54	4299130	4299131	4038	4039	1	RIGHT	M433.EDF	M43	3
54	4299629	4299629	4537	4537	0	RIGHT	M433.EDF	M43	3
54	4299669	4299686	4577	4594	17	RIGHT	M433.EDF	M43	3
54	4299799	4299980	4707	4888	181	RIGHT	M433.EDF	M43	3
54	4300006	4300036	4914	4944	30	RIGHT	M433.EDF	M43	3
54	4300065	4300085	4973	4993	20	RIGHT	M433.EDF	M43	3
54	4300139	4300139	5047	5047	0	RIGHT	M433.EDF	M43	3
54	4300172	4300172	5080	5080	0	RIGHT	M433.EDF	M43	3
54	4300414	4300414	5322	5322	0	RIGHT	M433.EDF	M43	3
54	4300574	4300590	5482	5498	16	RIGHT	M433.EDF	M43	3
54	4300615	4300615	5523	5523	0	RIGHT	M433.EDF	M43	3
54	4300648	4300706	5556	5614	58	RIGHT	M433.EDF	M43	3
54	4300737	4300893	5645	5801	156	RIGHT	M433.EDF	M43	3
54	4300919	4301001	5827	5909	82	RIGHT	M433.EDF	M43	3
54	4301048	4301139	5956	6047	91	RIGHT	M433.EDF	M43	3
54	4301188	4301188	6096	6096	0	RIGHT	M433.EDF	M43	3
54	4301210	4301227	6118	6135	17	RIGHT	M433.EDF	M43	3
54	4301252	4301285	6160	6193	33	RIGHT	M433.EDF	M43	3
54	4301317	4301317	6225	6225	0	RIGHT	M433.EDF	M43	3
54	4301340	4301365	6248	6273	25	RIGHT	M433.EDF	M43	3
54	4301389	4301389	6297	6297	0	RIGHT	M433.EDF	M43	3
54	4301452	4301499	6360	6407	47	RIGHT	M433.EDF	M43	3
54	4301523	4301576	6431	6484	53	RIGHT	M433.EDF	M43	3
55	4306512	4306512	2645	2645	0	RIGHT	M433.EDF	M43	3
55	4306558	4306793	2691	2926	235	RIGHT	M433.EDF	M43	3
55	4306814	4311117	2947	7250	4303	RIGHT	M433.EDF	M43	3
55	4311179	4311203	7312	7336	24	RIGHT	M433.EDF	M43	3
56	4313100	4313272	58	230	172	RIGHT	M433.EDF	M43	3
56	4314687	4314688	1645	1646	1	RIGHT	M433.EDF	M43	3
56	4314765	4314765	1723	1723	0	RIGHT	M433.EDF	M43	3
56	4314792	4314792	1750	1750	0	RIGHT	M433.EDF	M43	3
56	4314837	4314996	1795	1954	159	RIGHT	M433.EDF	M43	3
56	4315178	4315179	2136	2137	1	RIGHT	M433.EDF	M43	3
56	4315217	4315222	2175	2180	5	RIGHT	M433.EDF	M43	3
56	4315251	4315252	2209	2210	1	RIGHT	M433.EDF	M43	3
56	4315283	4316941	2241	3899	1658	RIGHT	M433.EDF	M43	3
56	4316968	4317052	3926	4010	84	RIGHT	M433.EDF	M43	3
56	4317077	4317233	4035	4191	156	RIGHT	M433.EDF	M43	3
56	4317281	4317282	4239	4240	1	RIGHT	M433.EDF	M43	3
56	4317308	4318577	4266	5535	1269	RIGHT	M433.EDF	M43	3
57	4324436	4324437	3768	3769	1	RIGHT	M433.EDF	M43	3
57	4324487	4324504	3819	3836	17	RIGHT	M433.EDF	M43	3
57	4324538	4324559	3870	3891	21	RIGHT	M433.EDF	M43	3
57	4324599	4324599	3931	3931	0	RIGHT	M433.EDF	M43	3
57	4325224	4325224	4556	4556	0	RIGHT	M433.EDF	M43	3
57	4325325	4325325	4657	4657	0	RIGHT	M433.EDF	M43	3
57	4325348	4325348	4680	4680	0	RIGHT	M433.EDF	M43	3
57	4325373	4325376	4705	4708	3	RIGHT	M433.EDF	M43	3
57	4325398	4325398	4730	4730	0	RIGHT	M433.EDF	M43	3
58	4328758	4329361	95	698	603	RIGHT	M433.EDF	M43	3
59	4336723	4336834	1099	1210	111	RIGHT	M433.EDF	M43	3
60	4349721	4349728	5968	5975	7	RIGHT	M433.EDF	M43	3
60	4349781	4349781	6028	6028	0	RIGHT	M433.EDF	M43	3
60	4350593	4350598	6840	6845	5	RIGHT	M433.EDF	M43	3
61	4353148	4353280	202	334	132	RIGHT	M433.EDF	M43	3
61	4355478	4355479	2532	2533	1	RIGHT	M433.EDF	M43	3
61	4355500	4355524	2554	2578	24	RIGHT	M433.EDF	M43	3
61	4355549	4355569	2603	2623	20	RIGHT	M433.EDF	M43	3
61	4355602	4355635	2656	2689	33	RIGHT	M433.EDF	M43	3
61	4355664	4355691	2718	2745	27	RIGHT	M433.EDF	M43	3
61	4355723	4355723	2777	2777	0	RIGHT	M433.EDF	M43	3
61	4355747	4355802	2801	2856	55	RIGHT	M433.EDF	M43	3
61	4355831	4355842	2885	2896	11	RIGHT	M433.EDF	M43	3
61	4355865	4356037	2919	3091	172	RIGHT	M433.EDF	M43	3
61	4356064	4356117	3118	3171	53	RIGHT	M433.EDF	M43	3
61	4356139	4356146	3193	3200	7	RIGHT	M433.EDF	M43	3
61	4356210	4356309	3264	3363	99	RIGHT	M433.EDF	M43	3
61	4356345	4356365	3399	3419	20	RIGHT	M433.EDF	M43	3
62	4361259	4361289	406	436	30	RIGHT	M433.EDF	M43	3
62	4362754	4362856	1901	2003	102	RIGHT	M433.EDF	M43	3
62	4363927	4363940	3074	3087	13	RIGHT	M433.EDF	M43	3
62	4364241	4364241	3388	3388	0	RIGHT	M433.EDF	M43	3
62	4364275	4364289	3422	3436	14	RIGHT	M433.EDF	M43	3
62	4364312	4364334	3459	3481	22	RIGHT	M433.EDF	M43	3
62	4364444	4364460	3591	3607	16	RIGHT	M433.EDF	M43	3
62	4364489	4365146	3636	4293	657	RIGHT	M433.EDF	M43	3
62	4365208	4365295	4355	4442	87	RIGHT	M433.EDF	M43	3
63	4370976	4370996	2599	2619	20	RIGHT	M433.EDF	M43	3
63	4371032	4371060	2655	2683	28	RIGHT	M433.EDF	M43	3
63	4371090	4371091	2713	2714	1	RIGHT	M433.EDF	M43	3
63	4371759	4371767	3382	3390	8	RIGHT	M433.EDF	M43	3
63	4371788	4371792	3411	3415	4	RIGHT	M433.EDF	M43	3
63	4371815	4371847	3438	3470	32	RIGHT	M433.EDF	M43	3
63	4371883	4371883	3506	3506	0	RIGHT	M433.EDF	M43	3
63	4371973	4372048	3596	3671	75	RIGHT	M433.EDF	M43	3
63	4372604	4372623	4227	4246	19	RIGHT	M433.EDF	M43	3
63	4372680	4372680	4303	4303	0	RIGHT	M433.EDF	M43	3
63	4372880	4372880	4503	4503	0	RIGHT	M433.EDF	M43	3
64	4378873	4378981	3264	3372	108	RIGHT	M433.EDF	M43	3
64	4379024	4379033	3415	3424	9	RIGHT	M433.EDF	M43	3
64	4379230	4379252	3621	3643	22	RIGHT	M433.EDF	M43	3
64	4379297	4379318	3688	3709	21	RIGHT	M433.EDF	M43	3
64	4379351	4379387	3742	3778	36	RIGHT	M433.EDF	M43	3
64	4379423	4379891	3814	4282	468	RIGHT	M433.EDF	M43	3
64	4379916	4379935	4307	4326	19	RIGHT	M433.EDF	M43	3
64	4380619	4380636	5010	5027	17	RIGHT	M433.EDF	M43	3
67	4400048	4400138	2153	2243	90	RIGHT	M433.EDF	M43	3
68	4410476	4410476	3454	3454	0	RIGHT	M433.EDF	M43	3
68	4410521	4410531	3499	3509	10	RIGHT	M433.EDF	M43	3
68	4411003	4413845	3981	6823	2842	RIGHT	M433.EDF	M43	3
69	4415874	4420550	277	4953	4676	RIGHT	M433.EDF	M43	3
70	4423578	4423578	645	645	0	RIGHT	M433.EDF	M43	3
70	4423604	4423861	671	928	257	RIGHT	M433.EDF	M43	3
70	4423927	4424057	994	1124	130	RIGHT	M433.EDF	M43	3
70	4424542	4424542	1609	1609	0	RIGHT	M433.EDF	M43	3
70	4424596	4424597	1663	1664	1	RIGHT	M433.EDF	M43	3
70	4424636	4424637	1703	1704	1	RIGHT	M433.EDF	M43	3
70	4424663	4426560	1730	3627	1897	RIGHT	M433.EDF	M43	3
70	4426611	4426668	3678	3735	57	RIGHT	M433.EDF	M43	3
70	4426845	4426847	3912	3914	2	RIGHT	M433.EDF	M43	3
70	4426872	4427073	3939	4140	201	RIGHT	M433.EDF	M43	3
70	4427095	4427134	4162	4201	39	RIGHT	M433.EDF	M43	3
70	4427184	4430356	4251	7423	3172	RIGHT	M433.EDF	M43	3
71	4433361	4433518	993	1150	157	RIGHT	M433.EDF	M43	3
71	4434852	4434852	2484	2484	0	RIGHT	M433.EDF	M43	3
71	4434887	4434896	2519	2528	9	RIGHT	M433.EDF	M43	3
71	4434940	4435127	2572	2759	187	RIGHT	M433.EDF	M43	3
71	4435599	4436102	3231	3734	503	RIGHT	M433.EDF	M43	3
71	4436151	4436157	3783	3789	6	RIGHT	M433.EDF	M43	3
71	4436183	4436183	3815	3815	0	RIGHT	M433.EDF	M43	3
71	4436263	4436263	3895	3895	0	RIGHT	M433.EDF	M43	3
71	4436292	4436292	3924	3924	0	RIGHT	M433.EDF	M43	3
71	4436413	4436430	4045	4062	17	RIGHT	M433.EDF	M43	3
71	4436455	4436455	4087	4087	0	RIGHT	M433.EDF	M43	3
71	4436488	4437080	4120	4712	592	RIGHT	M433.EDF	M43	3
71	4437152	4437213	4784	4845	61	RIGHT	M433.EDF	M43	3
71	4437704	4437708	5336	5340	4	RIGHT	M433.EDF	M43	3
71	4437743	4439285	5375	6917	1542	RIGHT	M433.EDF	M43	3
71	4439308	4439481	6940	7113	173	RIGHT	M433.EDF	M43	3
72	4442627	4442730	353	456	103	RIGHT	M433.EDF	M43	3
72	4443579	4443687	1305	1413	108	RIGHT	M433.EDF	M43	3
72	4444866	4444996	2592	2722	130	RIGHT	M433.EDF	M43	3
72	4445181	4445181	2907	2907	0	RIGHT	M433.EDF	M43	3
72	4445384	4445395	3110	3121	11	RIGHT	M433.EDF	M43	3
72	4445469	4445537	3195	3263	68	RIGHT	M433.EDF	M43	3
72	4445558	4447508	3284	5234	1950	RIGHT	M433.EDF	M43	3
72	4447546	4447640	5272	5366	94	RIGHT	M433.EDF	M43	3
72	4447661	4447726	5387	5452	65	RIGHT	M433.EDF	M43	3
73	4449375	4450069	58	752	694	RIGHT	M433.EDF	M43	3
73	4450093	4450093	776	776	0	RIGHT	M433.EDF	M43	3
73	4450124	4450124	807	807	0	RIGHT	M433.EDF	M43	3
73	4450167	4450181	850	864	14	RIGHT	M433.EDF	M43	3
73	4450234	4450287	917	970	53	RIGHT	M433.EDF	M43	3
73	4450308	4450797	991	1480	489	RIGHT	M433.EDF	M43	3
73	4450821	4450841	1504	1524	20	RIGHT	M433.EDF	M43	3
73	4451193	4451290	1876	1973	97	RIGHT	M433.EDF	M43	3
73	4451335	4451379	2018	2062	44	RIGHT	M433.EDF	M43	3
73	4451441	4451559	2124	2242	118	RIGHT	M433.EDF	M43	3
73	4452098	4453733	2781	4416	1635	RIGHT	M433.EDF	M43	3
73	4453759	4453845	4442	4528	86	RIGHT	M433.EDF	M43	3
73	4453872	4454411	4555	5094	539	RIGHT	M433.EDF	M43	3
74	4456739	4457044	647	952	305	RIGHT	M433.EDF	M43	3
74	4457067	4457577	975	1485	510	RIGHT	M433.EDF	M43	3
74	4457623	4457685	1531	1593	62	RIGHT	M433.EDF	M43	3
74	4458054	4458119	1962	2027	65	RIGHT	M433.EDF	M43	3
74	4458145	4460349	2053	4257	2204	RIGHT	M433.EDF	M43	3
74	4460458	4460458	4366	4366	0	RIGHT	M433.EDF	M43	3
74	4460754	4460755	4662	4663	1	RIGHT	M433.EDF	M43	3
74	4460795	4460834	4703	4742	39	RIGHT	M433.EDF	M43	3
74	4460857	4461070	4765	4978	213	RIGHT	M433.EDF	M43	3
74	4461100	4461100	5008	5008	0	RIGHT	M433.EDF	M43	3
74	4461121	4461161	5029	5069	40	RIGHT	M433.EDF	M43	3
74	4461216	4461216	5124	5124	0	RIGHT	M433.EDF	M43	3
74	4461491	4461506	5399	5414	15	RIGHT	M433.EDF	M43	3
74	4461536	4461536	5444	5444	0	RIGHT	M433.EDF	M43	3
74	4461596	4461665	5504	5573	69	RIGHT	M433.EDF	M43	3
74	4461729	4461750	5637	5658	21	RIGHT	M433.EDF	M43	3
74	4461811	4461833	5719	5741	22	RIGHT	M433.EDF	M43	3
74	4461862	4461923	5770	5831	61	RIGHT	M433.EDF	M43	3
74	4462305	4462305	6213	6213	0	RIGHT	M433.EDF	M43	3
74	4462427	4462427	6335	6335	0	RIGHT	M433.EDF	M43	3
74	4462468	4462522	6376	6430	54	RIGHT	M433.EDF	M43	3
74	4462597	4462613	6505	6521	16	RIGHT	M433.EDF	M43	3
74	4462636	4462945	6544	6853	309	RIGHT	M433.EDF	M43	3
74	4462967	4462976	6875	6884	9	RIGHT	M433.EDF	M43	3
75	4466990	4469920	2163	5093	2930	RIGHT	M433.EDF	M43	3
76	4472257	4472270	555	568	13	RIGHT	M433.EDF	M43	3
76	4472306	4472306	604	604	0	RIGHT	M433.EDF	M43	3
76	4472387	4472494	685	792	107	RIGHT	M433.EDF	M43	3
76	4472537	4472725	835	1023	188	RIGHT	M433.EDF	M43	3
76	4472752	4473378	1050	1676	626	RIGHT	M433.EDF	M43	3
76	4473406	4473408	1704	1706	2	RIGHT	M433.EDF	M43	3
76	4473482	4473482	1780	1780	0	RIGHT	M433.EDF	M43	3
76	4473522	4473522	1820	1820	0	RIGHT	M433.EDF	M43	3
76	4473583	4473583	1881	1881	0	RIGHT	M433.EDF	M43	3
76	4473863	4473892	2161	2190	29	RIGHT	M433.EDF	M43	3
76	4473917	4473964	2215	2262	47	RIGHT	M433.EDF	M43	3
76	4473986	4473986	2284	2284	0	RIGHT	M433.EDF	M43	3
76	4474009	4474069	2307	2367	60	RIGHT	M433.EDF	M43	3
76	4474104	4474105	2402	2403	1	RIGHT	M433.EDF	M43	3
76	4474148	4474148	2446	2446	0	RIGHT	M433.EDF	M43	3
76	4474480	4478015	2778	6313	3535	RIGHT	M433.EDF	M43	3
77	4481286	4481306	929	949	20	RIGHT	M433.EDF	M43	3
77	4481536	4481899	1179	1542	363	RIGHT	M433.EDF	M43	3
77	4481923	4482689	1566	2332	766	RIGHT	M433.EDF	M43	3
77	4482746	4482853	2389	2496	107	RIGHT	M433.EDF	M43	3
77	4483176	4483176	2819	2819	0	RIGHT	M433.EDF	M43	3
77	4483227	4483253	2870	2896	26	RIGHT	M433.EDF	M43	3
77	4483279	4483280	2922	2923	1	RIGHT	M433.EDF	M43	3
77	4483304	4485420	2947	5063	2116	RIGHT	M433.EDF	M43	3
78	4487247	4487250	77	80	3	RIGHT	M433.EDF	M43	3
78	4487364	4487391	194	221	27	RIGHT	M433.EDF	M43	3
78	4487415	4487415	245	245	0	RIGHT	M433.EDF	M43	3
78	4487443	4487443	273	273	0	RIGHT	M433.EDF	M43	3
78	4487497	4487497	327	327	0	RIGHT	M433.EDF	M43	3
78	4487535	4487536	365	366	1	RIGHT	M433.EDF	M43	3
78	4487561	4487639	391	469	78	RIGHT	M433.EDF	M43	3
78	4487663	4488092	493	922	429	RIGHT	M433.EDF	M43	3
78	4488135	4488141	965	971	6	RIGHT	M433.EDF	M43	3
78	4488165	4488165	995	995	0	RIGHT	M433.EDF	M43	3
78	4488203	4488318	1033	1148	115	RIGHT	M433.EDF	M43	3
78	4488350	4488433	1180	1263	83	RIGHT	M433.EDF	M43	3
78	4488468	4488836	1298	1666	368	RIGHT	M433.EDF	M43	3
78	4488883	4488883	1713	1713	0	RIGHT	M433.EDF	M43	3
78	4488936	4488969	1766	1799	33	RIGHT	M433.EDF	M43	3
78	4489043	4489063	1873	1893	20	RIGHT	M433.EDF	M43	3
78	4489101	4494055	1931	6885	4954	RIGHT	M433.EDF	M43	3
79	4495745	4496855	57	1167	1110	RIGHT	M433.EDF	M43	3
79	4496880	4496880	1192	1192	0	RIGHT	M433.EDF	M43	3
79	4497007	4497007	1319	1319	0	RIGHT	M433.EDF	M43	3
79	4497109	4497109	1421	1421	0	RIGHT	M433.EDF	M43	3
79	4497136	4497136	1448	1448	0	RIGHT	M433.EDF	M43	3
79	4497262	4497533	1574	1845	271	RIGHT	M433.EDF	M43	3
79	4497594	4497594	1906	1906	0	RIGHT	M433.EDF	M43	3
79	4497874	4503150	2186	7462	5276	RIGHT	M433.EDF	M43	3
80	4508184	4508213	2778	2807	29	RIGHT	M433.EDF	M43	3
80	4508245	4508292	2839	2886	47	RIGHT	M433.EDF	M43	3
80	4508319	4508361	2913	2955	42	RIGHT	M433.EDF	M43	3
80	4508388	4508390	2982	2984	2	RIGHT	M433.EDF	M43	3
80	4508429	4508433	3023	3027	4	RIGHT	M433.EDF	M43	3
80	4508480	4511642	3074	6236	3162	RIGHT	M433.EDF	M43	3
80	4511710	4511821	6304	6415	111	RIGHT	M433.EDF	M43	3
81	4515313	4515313	896	896	0	RIGHT	M433.EDF	M43	3
81	4515349	4515581	932	1164	232	RIGHT	M433.EDF	M43	3
81	4515626	4515659	1209	1242	33	RIGHT	M433.EDF	M43	3
81	4515683	4515713	1266	1296	30	RIGHT	M433.EDF	M43	3
81	4515821	4515821	1404	1404	0	RIGHT	M433.EDF	M43	3
81	4515939	4515939	1522	1522	0	RIGHT	M433.EDF	M43	3
81	4515974	4515975	1557	1558	1	RIGHT	M433.EDF	M43	3
81	4516003	4521482	1586	7065	5479	RIGHT	M433.EDF	M43	3
82	4523431	4523537	58	164	106	RIGHT	M433.EDF	M43	3
82	4524508	4524607	1135	1234	99	RIGHT	M433.EDF	M43	3
82	4524836	4524854	1463	1481	18	RIGHT	M433.EDF	M43	3
82	4524897	4524897	1524	1524	0	RIGHT	M433.EDF	M43	3
82	4524925	4524925	1552	1552	0	RIGHT	M433.EDF	M43	3
82	4524967	4528386	1594	5013	3419	RIGHT	M433.EDF	M43	3
83	4530311	4530368	215	272	57	RIGHT	M433.EDF	M43	3
83	4530803	4530917	707	821	114	RIGHT	M433.EDF	M43	3
83	4531020	4531253	924	1157	233	RIGHT	M433.EDF	M43	3
83	4531385	4531386	1289	1290	1	RIGHT	M433.EDF	M43	3
83	4531421	4531421	1325	1325	0	RIGHT	M433.EDF	M43	3
83	4531479	4531480	1383	1384	1	RIGHT	M433.EDF	M43	3
83	4531591	4531631	1495	1535	40	RIGHT	M433.EDF	M43	3
83	4531702	4531746	1606	1650	44	RIGHT	M433.EDF	M43	3
83	4531826	4531826	1730	1730	0	RIGHT	M433.EDF	M43	3
83	4531887	4531887	1791	1791	0	RIGHT	M433.EDF	M43	3
83	4531911	4531954	1815	1858	43	RIGHT	M433.EDF	M43	3
83	4531997	4531997	1901	1901	0	RIGHT	M433.EDF	M43	3
83	4532049	4532049	1953	1953	0	RIGHT	M433.EDF	M43	3
83	4532114	4532150	2018	2054	36	RIGHT	M433.EDF	M43	3
83	4532183	4536091	2087	5995	3908	RIGHT	M433.EDF	M43	3
84	4537831	4545046	60	7275	7215	RIGHT	M433.EDF	M43	3
85	4547296	4547374	138	216	78	RIGHT	M433.EDF	M43	3
85	4548151	4548152	993	994	1	RIGHT	M433.EDF	M43	3
85	4548199	4548199	1041	1041	0	RIGHT	M433.EDF	M43	3
85	4548247	4548394	1089	1236	147	RIGHT	M433.EDF	M43	3
85	4548432	4548439	1274	1281	7	RIGHT	M433.EDF	M43	3
85	4548470	4548481	1312	1323	11	RIGHT	M433.EDF	M43	3
85	4548942	4548942	1784	1784	0	RIGHT	M433.EDF	M43	3
85	4549008	4549033	1850	1875	25	RIGHT	M433.EDF	M43	3
85	4549140	4549140	1982	1982	0	RIGHT	M433.EDF	M43	3
85	4549286	4549286	2128	2128	0	RIGHT	M433.EDF	M43	3
85	4549307	4549307	2149	2149	0	RIGHT	M433.EDF	M43	3
85	4549333	4549402	2175	2244	69	RIGHT	M433.EDF	M43	3
85	4549435	4552291	2277	5133	2856	RIGHT	M433.EDF	M43	3
86	4554645	4554771	111	237	126	RIGHT	M433.EDF	M43	3
86	4555781	4555795	1247	1261	14	RIGHT	M433.EDF	M43	3
86	4556310	4556834	1776	2300	524	RIGHT	M433.EDF	M43	3
86	4556884	4556886	2350	2352	2	RIGHT	M433.EDF	M43	3
86	4556917	4557161	2383	2627	244	RIGHT	M433.EDF	M43	3
86	4557182	4557184	2648	2650	2	RIGHT	M433.EDF	M43	3
86	4557206	4557494	2672	2960	288	RIGHT	M433.EDF	M43	3
86	4557519	4560106	2985	5572	2587	RIGHT	M433.EDF	M43	3
87	4562643	4562783	565	705	140	RIGHT	M433.EDF	M43	3
87	4562929	4563090	851	1012	161	RIGHT	M433.EDF	M43	3
87	4563133	4563164	1055	1086	31	RIGHT	M433.EDF	M43	3
87	4563321	4563321	1243	1243	0	RIGHT	M433.EDF	M43	3
87	4563407	4563407	1329	1329	0	RIGHT	M433.EDF	M43	3
87	4563568	4563652	1490	1574	84	RIGHT	M433.EDF	M43	3
87	4563751	4563751	1673	1673	0	RIGHT	M433.EDF	M43	3
87	4563781	4563959	1703	1881	178	RIGHT	M433.EDF	M43	3
87	4564292	4564293	2214	2215	1	RIGHT	M433.EDF	M43	3
87	4564315	4564315	2237	2237	0	RIGHT	M433.EDF	M43	3
87	4564352	4564797	2274	2719	445	RIGHT	M433.EDF	M43	3
87	4564877	4564877	2799	2799	0	RIGHT	M433.EDF	M43	3
87	4564989	4564989	2911	2911	0	RIGHT	M433.EDF	M43	3
87	4565042	4565140	2964	3062	98	RIGHT	M433.EDF	M43	3
87	4565235	4565235	3157	3157	0	RIGHT	M433.EDF	M43	3
87	4565362	4565362	3284	3284	0	RIGHT	M433.EDF	M43	3
87	4565401	4565524	3323	3446	123	RIGHT	M433.EDF	M43	3
87	4565554	4565554	3476	3476	0	RIGHT	M433.EDF	M43	3
87	4565594	4565594	3516	3516	0	RIGHT	M433.EDF	M43	3
87	4565680	4565680	3602	3602	0	RIGHT	M433.EDF	M43	3
87	4565792	4565792	3714	3714	0	RIGHT	M433.EDF	M43	3
87	4565818	4565818	3740	3740	0	RIGHT	M433.EDF	M43	3
87	4565859	4565859	3781	3781	0	RIGHT	M433.EDF	M43	3
87	4565886	4565904	3808	3826	18	RIGHT	M433.EDF	M43	3
87	4565944	4566340	3866	4262	396	RIGHT	M433.EDF	M43	3
87	4566423	4566423	4345	4345	0	RIGHT	M433.EDF	M43	3
87	4566448	4566451	4370	4373	3	RIGHT	M433.EDF	M43	3
87	4566683	4566690	4605	4612	7	RIGHT	M433.EDF	M43	3
87	4566713	4566832	4635	4754	119	RIGHT	M433.EDF	M43	3
87	4566858	4567281	4780	5203	423	RIGHT	M433.EDF	M43	3
87	4567304	4567330	5226	5252	26	RIGHT	M433.EDF	M43	3
88	4574121	4574121	5283	5283	0	RIGHT	M433.EDF	M43	3
90	4585912	4586061	132	281	149	RIGHT	M433.EDF	M43	3
91	4593574	4593715	130	271	141	RIGHT	M433.EDF	M43	3
91	4594640	4594815	1196	1371	175	RIGHT	M433.EDF	M43	3
93	4611993	4612109	1307	1423	116	RIGHT	M433.EDF	M43	3
93	4614506	4614506	3820	3820	0	RIGHT	M433.EDF	M43	3
94	4618953	4619076	674	797	123	RIGHT	M433.EDF	M43	3
94	4622312	4622393	4033	4114	81	RIGHT	M433.EDF	M43	3
94	4622414	4622421	4135	4142	7	RIGHT	M433.EDF	M43	3
96	4639133	4639133	5311	5311	0	RIGHT	M433.EDF	M43	3
96	4639862	4639862	6040	6040	0	RIGHT	M433.EDF	M43	3
96	4640322	4640332	6500	6510	10	RIGHT	M433.EDF	M43	3
96	4640653	4640654	6831	6832	1	RIGHT	M433.EDF	M43	3
96	4640689	4640753	6867	6931	64	RIGHT	M433.EDF	M43	3
96	4640805	4640806	6983	6984	1	RIGHT	M433.EDF	M43	3
98	4651421	4651579	418	576	158	RIGHT	M433.EDF	M43	3
99	4661815	4661816	3509	3510	1	RIGHT	M433.EDF	M43	3
99	4661847	4661848	3541	3542	1	RIGHT	M433.EDF	M43	3
100	4666954	4667082	782	910	128	RIGHT	M433.EDF	M43	3
101	4676347	4676464	1640	1757	117	RIGHT	M433.EDF	M43	3
102	4683558	4683628	57	127	70	RIGHT	M433.EDF	M43	3
103	4692442	4692556	1085	1199	114	RIGHT	M433.EDF	M43	3
104	4699364	4699388	392	416	24	RIGHT	M433.EDF	M43	3
106	4715263	4715383	443	563	120	RIGHT	M433.EDF	M43	3
107	4724961	4725080	2327	2446	119	RIGHT	M433.EDF	M43	3
107	4727123	4727200	4489	4566	77	RIGHT	M433.EDF	M43	3
108	4731541	4731687	922	1068	146	RIGHT	M433.EDF	M43	3
108	4733030	4733128	2411	2509	98	RIGHT	M433.EDF	M43	3
110	4746011	4746029	718	736	18	RIGHT	M433.EDF	M43	3
112	4759771	4759924	524	677	153	RIGHT	M433.EDF	M43	3
113	4769482	4769625	1252	1395	143	RIGHT	M433.EDF	M43	3
115	4784741	4784853	918	1030	112	RIGHT	M433.EDF	M43	3
118	4810400	4810490	1691	1781	90	RIGHT	M433.EDF	M43	3
119	4817294	4817388	1820	1914	94	RIGHT	M433.EDF	M43	3
3	2788868	2789025	632	789	157	RIGHT	M471.EDF	M47	1
5	2808788	2808882	626	720	94	RIGHT	M471.EDF	M47	1
5	2808918	2808934	756	772	16	RIGHT	M471.EDF	M47	1
6	2818248	2818376	563	691	128	RIGHT	M471.EDF	M47	1
8	2833790	2833799	537	546	9	RIGHT	M471.EDF	M47	1
8	2833835	2833925	582	672	90	RIGHT	M471.EDF	M47	1
10	2850245	2850285	153	193	40	RIGHT	M471.EDF	M47	1
11	2859865	2859993	200	328	128	RIGHT	M471.EDF	M47	1
14	2883346	2883503	224	381	157	RIGHT	M471.EDF	M47	1
17	2909377	2909491	58	172	114	RIGHT	M471.EDF	M47	1
18	2917914	2917980	58	124	66	RIGHT	M471.EDF	M47	1
18	2918453	2918654	597	798	201	RIGHT	M471.EDF	M47	1
19	2925716	2925747	58	89	31	RIGHT	M471.EDF	M47	1
20	2935837	2936002	1334	1499	165	RIGHT	M471.EDF	M47	1
21	2942042	2942112	57	127	70	RIGHT	M471.EDF	M47	1
21	2942821	2943020	836	1035	199	RIGHT	M471.EDF	M47	1
23	2958688	2958897	970	1179	209	RIGHT	M471.EDF	M47	1
24	2966144	2966169	57	82	25	RIGHT	M471.EDF	M47	1
26	2986073	2986250	3321	3498	177	RIGHT	M471.EDF	M47	1
28	2999027	2999154	57	184	127	RIGHT	M471.EDF	M47	1
29	3008661	3008783	311	433	122	RIGHT	M471.EDF	M47	1
30	3017107	3017117	510	520	10	RIGHT	M471.EDF	M47	1
30	3017146	3017235	549	638	89	RIGHT	M471.EDF	M47	1
31	3025108	3025267	57	216	159	RIGHT	M471.EDF	M47	1
33	3040228	3040230	227	229	2	RIGHT	M471.EDF	M47	1
33	3040254	3040375	253	374	121	RIGHT	M471.EDF	M47	1
34	3049425	3049500	532	607	75	RIGHT	M471.EDF	M47	1
35	3058205	3058398	1249	1442	193	RIGHT	M471.EDF	M47	1
36	3065904	3066107	1277	1480	203	RIGHT	M471.EDF	M47	1
38	3079356	3079513	121	278	157	RIGHT	M471.EDF	M47	1
39	3086818	3086988	209	379	170	RIGHT	M471.EDF	M47	1
41	3106162	3106310	109	257	148	RIGHT	M471.EDF	M47	1
42	3114695	3114734	58	97	39	RIGHT	M471.EDF	M47	1
44	3131212	3131246	57	91	34	RIGHT	M471.EDF	M47	1
44	3131284	3131347	129	192	63	RIGHT	M471.EDF	M47	1
44	3131688	3131864	533	709	176	RIGHT	M471.EDF	M47	1
45	3138708	3138719	417	428	11	RIGHT	M471.EDF	M47	1
45	3138743	3138862	452	571	119	RIGHT	M471.EDF	M47	1
46	3149162	3149345	2963	3146	183	RIGHT	M471.EDF	M47	1
49	3169343	3169406	541	604	63	RIGHT	M471.EDF	M47	1
49	3169673	3169832	871	1030	159	RIGHT	M471.EDF	M47	1
51	3186725	3186818	234	327	93	RIGHT	M471.EDF	M47	1
51	3187042	3187201	551	710	159	RIGHT	M471.EDF	M47	1
53	3202433	3202572	341	480	139	RIGHT	M471.EDF	M47	1
53	3202646	3202838	554	746	192	RIGHT	M471.EDF	M47	1
55	3218368	3218497	58	187	129	RIGHT	M471.EDF	M47	1
55	3222737	3222789	4427	4479	52	RIGHT	M471.EDF	M47	1
55	3222812	3222888	4502	4578	76	RIGHT	M471.EDF	M47	1
60	3257284	3257479	92	287	195	RIGHT	M471.EDF	M47	1
61	3265927	3266066	57	196	139	RIGHT	M471.EDF	M47	1
62	3275784	3275930	3168	3314	146	RIGHT	M471.EDF	M47	1
65	3295751	3295947	110	306	196	RIGHT	M471.EDF	M47	1
66	3304399	3304526	57	184	127	RIGHT	M471.EDF	M47	1
66	3306834	3306988	2492	2646	154	RIGHT	M471.EDF	M47	1
68	3319441	3319526	57	142	85	RIGHT	M471.EDF	M47	1
71	3341784	3341926	255	397	142	RIGHT	M471.EDF	M47	1
72	3351139	3351246	57	164	107	RIGHT	M471.EDF	M47	1
72	3354336	3354339	3254	3257	3	RIGHT	M471.EDF	M47	1
72	3354368	3354510	3286	3428	142	RIGHT	M471.EDF	M47	1
75	3376746	3376937	549	740	191	RIGHT	M471.EDF	M47	1
76	3383254	3383518	103	367	264	RIGHT	M471.EDF	M47	1
77	3391787	3391973	2449	2635	186	RIGHT	M471.EDF	M47	1
78	3396802	3397022	332	552	220	RIGHT	M471.EDF	M47	1
78	3398303	3398522	1833	2052	219	RIGHT	M471.EDF	M47	1
79	3405515	3405722	630	837	207	RIGHT	M471.EDF	M47	1
80	3412987	3413079	57	149	92	RIGHT	M471.EDF	M47	1
80	3416162	3416292	3232	3362	130	RIGHT	M471.EDF	M47	1
80	3417355	3418344	4425	5414	989	RIGHT	M471.EDF	M47	1
81	3420591	3421759	598	1766	1168	RIGHT	M471.EDF	M47	1
81	3421990	3422363	1997	2370	373	RIGHT	M471.EDF	M47	1
81	3422811	3422983	2818	2990	172	RIGHT	M471.EDF	M47	1
82	3429351	3429542	480	671	191	RIGHT	M471.EDF	M47	1
83	3437030	3437236	57	263	206	RIGHT	M471.EDF	M47	1
84	3445829	3445866	58	95	37	RIGHT	M471.EDF	M47	1
84	3446280	3446493	509	722	213	RIGHT	M471.EDF	M47	1
87	3470150	3470329	453	632	179	RIGHT	M471.EDF	M47	1
87	3470815	3470961	1118	1264	146	RIGHT	M471.EDF	M47	1
88	3476969	3477129	169	329	160	RIGHT	M471.EDF	M47	1
89	3484124	3484319	59	254	195	RIGHT	M471.EDF	M47	1
90	3493356	3493578	473	695	222	RIGHT	M471.EDF	M47	1
96	3540353	3540533	64	244	180	RIGHT	M471.EDF	M47	1
99	3564195	3564430	1980	2215	235	RIGHT	M471.EDF	M47	1
103	3597771	3597907	4029	4165	136	RIGHT	M471.EDF	M47	1
104	3601748	3601901	570	723	153	RIGHT	M471.EDF	M47	1
105	3609604	3609635	130	161	31	RIGHT	M471.EDF	M47	1
105	3609656	3609831	182	357	175	RIGHT	M471.EDF	M47	1
106	3620220	3620381	100	261	161	RIGHT	M471.EDF	M47	1
106	3620654	3620838	534	718	184	RIGHT	M471.EDF	M47	1
112	3664419	3664626	465	672	207	RIGHT	M471.EDF	M47	1
112	3664766	3664987	812	1033	221	RIGHT	M471.EDF	M47	1
112	3666183	3666916	2229	2962	733	RIGHT	M471.EDF	M47	1
112	3667265	3667285	3311	3331	20	RIGHT	M471.EDF	M47	1
117	3701948	3702144	207	403	196	RIGHT	M471.EDF	M47	1
119	3719779	3719961	3624	3806	182	RIGHT	M471.EDF	M47	1
120	3725328	3725529	285	486	201	RIGHT	M471.EDF	M47	1
2	4570800	4570944	57	201	144	RIGHT	M472.EDF	M47	2
3	4580795	4580931	65	201	136	RIGHT	M472.EDF	M47	2
6	4604940	4605153	622	835	213	RIGHT	M472.EDF	M47	2
8	4620118	4620291	173	346	173	RIGHT	M472.EDF	M47	2
10	4634873	4634956	58	141	83	RIGHT	M472.EDF	M47	2
13	4657453	4657598	269	414	145	RIGHT	M472.EDF	M47	2
16	4683402	4683448	1331	1377	46	RIGHT	M472.EDF	M47	2
19	4707320	4707450	186	316	130	RIGHT	M472.EDF	M47	2
22	4733562	4733733	58	229	171	RIGHT	M472.EDF	M47	2
23	4741234	4741442	57	265	208	RIGHT	M472.EDF	M47	2
24	4750033	4750170	176	313	137	RIGHT	M472.EDF	M47	2
26	4765870	4765931	58	119	61	RIGHT	M472.EDF	M47	2
30	4797587	4797772	274	459	185	RIGHT	M472.EDF	M47	2
39	4866692	4866878	57	243	186	RIGHT	M472.EDF	M47	2
40	4875150	4875299	621	770	149	RIGHT	M472.EDF	M47	2
41	4881272	4881437	76	241	165	RIGHT	M472.EDF	M47	2
42	4888084	4888259	188	363	175	RIGHT	M472.EDF	M47	2
44	4904369	4904578	2702	2911	209	RIGHT	M472.EDF	M47	2
46	4920448	4920635	519	706	187	RIGHT	M472.EDF	M47	2
47	4928164	4928217	57	110	53	RIGHT	M472.EDF	M47	2
49	4941731	4941736	409	414	5	RIGHT	M472.EDF	M47	2
49	4941772	4941962	450	640	190	RIGHT	M472.EDF	M47	2
51	4956480	4956568	58	146	88	RIGHT	M472.EDF	M47	2
57	5004475	5004735	564	824	260	RIGHT	M472.EDF	M47	2
60	5029043	5029215	514	686	172	RIGHT	M472.EDF	M47	2
63	5049820	5049950	57	187	130	RIGHT	M472.EDF	M47	2
64	5057023	5057187	102	266	164	RIGHT	M472.EDF	M47	2
67	5077934	5077959	57	82	25	RIGHT	M472.EDF	M47	2
67	5078475	5078653	598	776	178	RIGHT	M472.EDF	M47	2
68	5086978	5086987	512	521	9	RIGHT	M472.EDF	M47	2
68	5087009	5087021	543	555	12	RIGHT	M472.EDF	M47	2
68	5087070	5087103	604	637	33	RIGHT	M472.EDF	M47	2
70	5101071	5101123	483	535	52	RIGHT	M472.EDF	M47	2
70	5101151	5101225	563	637	74	RIGHT	M472.EDF	M47	2
71	5107694	5107862	61	229	168	RIGHT	M472.EDF	M47	2
72	5115725	5115821	58	154	96	RIGHT	M472.EDF	M47	2
76	5147118	5147199	278	359	81	RIGHT	M472.EDF	M47	2
77	5157974	5158144	2861	3031	170	RIGHT	M472.EDF	M47	2
78	5162013	5162171	59	217	158	RIGHT	M472.EDF	M47	2
82	5196181	5196377	434	630	196	RIGHT	M472.EDF	M47	2
83	5202602	5202682	58	138	80	RIGHT	M472.EDF	M47	2
86	5228038	5228204	2561	2727	166	RIGHT	M472.EDF	M47	2
87	5234100	5234241	58	199	141	RIGHT	M472.EDF	M47	2
90	5255620	5255781	58	219	161	RIGHT	M472.EDF	M47	2
92	5270342	5270405	57	120	63	RIGHT	M472.EDF	M47	2
96	5298829	5298879	566	616	50	RIGHT	M472.EDF	M47	2
96	5298901	5299048	638	785	147	RIGHT	M472.EDF	M47	2
97	5307516	5307566	58	108	50	RIGHT	M472.EDF	M47	2
98	5317075	5317293	262	480	218	RIGHT	M472.EDF	M47	2
102	5346839	5346861	58	80	22	RIGHT	M472.EDF	M47	2
102	5347113	5347322	332	541	209	RIGHT	M472.EDF	M47	2
103	5357333	5357542	2745	2954	209	RIGHT	M472.EDF	M47	2
104	5363545	5363642	633	730	97	RIGHT	M472.EDF	M47	2
106	5378400	5378581	59	240	181	RIGHT	M472.EDF	M47	2
111	5418318	5418343	321	346	25	RIGHT	M472.EDF	M47	2
111	5418365	5418528	368	531	163	RIGHT	M472.EDF	M47	2
115	5448847	5448979	57	189	132	RIGHT	M472.EDF	M47	2
118	5470144	5470340	234	430	196	RIGHT	M472.EDF	M47	2
119	5479391	5479604	57	270	213	RIGHT	M472.EDF	M47	2
120	5487718	5487846	229	357	128	RIGHT	M472.EDF	M47	2
6	6086894	6087010	57	173	116	RIGHT	M473.EDF	M47	3
7	6094695	6094855	431	591	160	RIGHT	M473.EDF	M47	3
7	6094880	6094909	616	645	29	RIGHT	M473.EDF	M47	3
10	6118910	6119045	58	193	135	RIGHT	M473.EDF	M47	3
10	6119394	6119622	542	770	228	RIGHT	M473.EDF	M47	3
11	6127315	6127516	164	365	201	RIGHT	M473.EDF	M47	3
11	6129450	6129603	2299	2452	153	RIGHT	M473.EDF	M47	3
13	6144981	6145098	720	837	117	RIGHT	M473.EDF	M47	3
14	6152061	6152281	504	724	220	RIGHT	M473.EDF	M47	3
15	6158247	6158391	57	201	144	RIGHT	M473.EDF	M47	3
16	6167298	6167354	57	113	56	RIGHT	M473.EDF	M47	3
17	6176440	6176653	57	270	213	RIGHT	M473.EDF	M47	3
18	6183827	6184030	471	674	203	RIGHT	M473.EDF	M47	3
19	6192900	6192968	58	126	68	RIGHT	M473.EDF	M47	3
23	6224499	6224543	57	101	44	RIGHT	M473.EDF	M47	3
26	6249436	6249636	100	300	200	RIGHT	M473.EDF	M47	3
27	6257608	6257803	536	731	195	RIGHT	M473.EDF	M47	3
33	6300579	6300754	550	725	175	RIGHT	M473.EDF	M47	3
34	6308901	6309050	219	368	149	RIGHT	M473.EDF	M47	3
34	6311114	6311279	2432	2597	165	RIGHT	M473.EDF	M47	3
35	6316151	6316392	232	473	241	RIGHT	M473.EDF	M47	3
36	6323854	6324093	231	470	239	RIGHT	M473.EDF	M47	3
37	6331928	6332025	121	218	97	RIGHT	M473.EDF	M47	3
37	6332318	6332526	511	719	208	RIGHT	M473.EDF	M47	3
42	6370268	6370277	648	657	9	RIGHT	M473.EDF	M47	3
42	6370299	6370464	679	844	165	RIGHT	M473.EDF	M47	3
43	6377505	6377548	58	101	43	RIGHT	M473.EDF	M47	3
43	6377939	6378201	492	754	262	RIGHT	M473.EDF	M47	3
45	6394092	6394251	2599	2758	159	RIGHT	M473.EDF	M47	3
47	6408134	6408310	2175	2351	176	RIGHT	M473.EDF	M47	3
49	6423823	6424066	120	363	243	RIGHT	M473.EDF	M47	3
50	6431787	6432001	700	914	214	RIGHT	M473.EDF	M47	3
52	6444819	6444893	75	149	74	RIGHT	M473.EDF	M47	3
52	6445361	6445619	617	875	258	RIGHT	M473.EDF	M47	3
54	6460907	6461066	58	217	159	RIGHT	M473.EDF	M47	3
56	6476338	6476521	214	397	183	RIGHT	M473.EDF	M47	3
58	6491788	6492042	263	517	254	RIGHT	M473.EDF	M47	3
59	6499991	6500261	233	503	270	RIGHT	M473.EDF	M47	3
61	6517530	6517791	57	318	261	RIGHT	M473.EDF	M47	3
62	6524465	6524558	58	151	93	RIGHT	M473.EDF	M47	3
65	6548226	6548358	516	648	132	RIGHT	M473.EDF	M47	3
65	6548383	6548477	673	767	94	RIGHT	M473.EDF	M47	3
68	6573024	6573205	507	688	181	RIGHT	M473.EDF	M47	3
70	6586711	6586978	140	407	267	RIGHT	M473.EDF	M47	3
72	6600821	6601025	188	392	204	RIGHT	M473.EDF	M47	3
73	6609100	6609277	211	388	177	RIGHT	M473.EDF	M47	3
74	6616277	6616577	486	786	300	RIGHT	M473.EDF	M47	3
75	6622960	6623202	108	350	242	RIGHT	M473.EDF	M47	3
76	6631526	6631549	58	81	23	RIGHT	M473.EDF	M47	3
77	6640744	6640815	57	128	71	RIGHT	M473.EDF	M47	3
77	6641244	6641459	557	772	215	RIGHT	M473.EDF	M47	3
78	6649196	6649266	523	593	70	RIGHT	M473.EDF	M47	3
78	6649531	6649752	858	1079	221	RIGHT	M473.EDF	M47	3
79	6656696	6656833	57	194	137	RIGHT	M473.EDF	M47	3
80	6665390	6665432	57	99	42	RIGHT	M473.EDF	M47	3
83	6690143	6690217	57	131	74	RIGHT	M473.EDF	M47	3
86	6714214	6714387	581	754	173	RIGHT	M473.EDF	M47	3
87	6721574	6721846	58	330	272	RIGHT	M473.EDF	M47	3
88	6730448	6730533	57	142	85	RIGHT	M473.EDF	M47	3
90	6747183	6747349	79	245	166	RIGHT	M473.EDF	M47	3
90	6747696	6747852	592	748	156	RIGHT	M473.EDF	M47	3
92	6762180	6762387	91	298	207	RIGHT	M473.EDF	M47	3
95	6786310	6786374	57	121	64	RIGHT	M473.EDF	M47	3
96	6794459	6794483	57	81	24	RIGHT	M473.EDF	M47	3
97	6800643	6800853	58	268	210	RIGHT	M473.EDF	M47	3
98	6807969	6808108	57	196	139	RIGHT	M473.EDF	M47	3
101	6829868	6830100	554	786	232	RIGHT	M473.EDF	M47	3
102	6836423	6836704	125	406	281	RIGHT	M473.EDF	M47	3
104	6853158	6853401	563	806	243	RIGHT	M473.EDF	M47	3
106	6871438	6871460	57	79	22	RIGHT	M473.EDF	M47	3
106	6871903	6872096	522	715	193	RIGHT	M473.EDF	M47	3
107	6880125	6880377	273	525	252	RIGHT	M473.EDF	M47	3
107	6882241	6882424	2389	2572	183	RIGHT	M473.EDF	M47	3
108	6888757	6889140	58	441	383	RIGHT	M473.EDF	M47	3
108	6889418	6889676	719	977	258	RIGHT	M473.EDF	M47	3
109	6897704	6897959	199	454	255	RIGHT	M473.EDF	M47	3
111	6912341	6912380	57	96	39	RIGHT	M473.EDF	M47	3
112	6919284	6919469	57	242	185	RIGHT	M473.EDF	M47	3
113	6925640	6925767	58	185	127	RIGHT	M473.EDF	M47	3
118	6965866	6966022	497	653	156	RIGHT	M473.EDF	M47	3
119	6973042	6973267	598	823	225	RIGHT	M473.EDF	M47	3
120	6981926	6982174	3219	3467	248	RIGHT	M473.EDF	M47	3
1	2010729	2010785	948	1004	56	LEFT	M60a.EDF	M60	1
1	2011039	2011063	1258	1282	24	LEFT	M60a.EDF	M60	1
2	2020009	2020098	69	158	89	LEFT	M60a.EDF	M60	1
3	2029986	2030060	238	312	74	LEFT	M60a.EDF	M60	1
3	2030730	2030806	982	1058	76	LEFT	M60a.EDF	M60	1
4	2043819	2043849	6195	6225	30	LEFT	M60a.EDF	M60	1
5	2048640	2048664	57	81	24	LEFT	M60a.EDF	M60	1
5	2049296	2049355	713	772	59	LEFT	M60a.EDF	M60	1
5	2049972	2050039	1389	1456	67	LEFT	M60a.EDF	M60	1
7	2072644	2072666	58	80	22	LEFT	M60a.EDF	M60	1
7	2073418	2073487	832	901	69	LEFT	M60a.EDF	M60	1
7	2073985	2074058	1399	1472	73	LEFT	M60a.EDF	M60	1
8	2081189	2081217	58	86	28	LEFT	M60a.EDF	M60	1
8	2081500	2081537	369	406	37	LEFT	M60a.EDF	M60	1
9	2091457	2091511	139	193	54	LEFT	M60a.EDF	M60	1
9	2092326	2092414	1008	1096	88	LEFT	M60a.EDF	M60	1
10	2100783	2100862	1460	1539	79	LEFT	M60a.EDF	M60	1
11	2108134	2108222	299	387	88	LEFT	M60a.EDF	M60	1
12	2116818	2116921	215	318	103	LEFT	M60a.EDF	M60	1
12	2117534	2117626	931	1023	92	LEFT	M60a.EDF	M60	1
13	2125737	2125811	59	133	74	LEFT	M60a.EDF	M60	1
13	2126507	2126598	829	920	91	LEFT	M60a.EDF	M60	1
14	2134421	2134522	108	209	101	LEFT	M60a.EDF	M60	1
14	2134829	2134896	516	583	67	LEFT	M60a.EDF	M60	1
14	2135385	2135453	1072	1140	68	LEFT	M60a.EDF	M60	1
14	2135919	2135999	1606	1686	80	LEFT	M60a.EDF	M60	1
15	2143837	2143934	58	155	97	LEFT	M60a.EDF	M60	1
15	2144199	2144263	420	484	64	LEFT	M60a.EDF	M60	1
15	2145049	2145129	1270	1350	80	LEFT	M60a.EDF	M60	1
16	2156088	2156179	311	402	91	LEFT	M60a.EDF	M60	1
16	2156979	2157046	1202	1269	67	LEFT	M60a.EDF	M60	1
16	2157240	2157314	1463	1537	74	LEFT	M60a.EDF	M60	1
17	2166812	2166899	59	146	87	LEFT	M60a.EDF	M60	1
17	2167749	2167845	996	1092	96	LEFT	M60a.EDF	M60	1
17	2168200	2168290	1447	1537	90	LEFT	M60a.EDF	M60	1
18	2174774	2174860	126	212	86	LEFT	M60a.EDF	M60	1
18	2175427	2175515	779	867	88	LEFT	M60a.EDF	M60	1
19	2185180	2185252	396	468	72	LEFT	M60a.EDF	M60	1
19	2185950	2186000	1166	1216	50	LEFT	M60a.EDF	M60	1
19	2186250	2186351	1466	1567	101	LEFT	M60a.EDF	M60	1
19	2186568	2186638	1784	1854	70	LEFT	M60a.EDF	M60	1
20	2192907	2192992	221	306	85	LEFT	M60a.EDF	M60	1
20	2193492	2193569	806	883	77	LEFT	M60a.EDF	M60	1
20	2194309	2194371	1623	1685	62	LEFT	M60a.EDF	M60	1
21	2203227	2203321	916	1010	94	LEFT	M60a.EDF	M60	1
22	2211730	2211834	243	347	104	LEFT	M60a.EDF	M60	1
22	2212489	2212591	1002	1104	102	LEFT	M60a.EDF	M60	1
23	2220201	2220324	218	341	123	LEFT	M60a.EDF	M60	1
23	2221144	2221235	1161	1252	91	LEFT	M60a.EDF	M60	1
23	2223017	2223040	3034	3057	23	LEFT	M60a.EDF	M60	1
23	2223635	2223685	3652	3702	50	LEFT	M60a.EDF	M60	1
24	2229264	2229353	186	275	89	LEFT	M60a.EDF	M60	1
24	2229966	2230066	888	988	100	LEFT	M60a.EDF	M60	1
24	2230724	2230799	1646	1721	75	LEFT	M60a.EDF	M60	1
25	2238901	2239023	213	335	122	LEFT	M60a.EDF	M60	1
25	2239605	2239678	917	990	73	LEFT	M60a.EDF	M60	1
25	2240284	2240370	1596	1682	86	LEFT	M60a.EDF	M60	1
26	2248691	2248763	57	129	72	LEFT	M60a.EDF	M60	1
26	2249004	2249064	370	430	60	LEFT	M60a.EDF	M60	1
26	2249868	2249928	1234	1294	60	LEFT	M60a.EDF	M60	1
26	2250348	2250409	1714	1775	61	LEFT	M60a.EDF	M60	1
26	2251965	2252063	3331	3429	98	LEFT	M60a.EDF	M60	1
27	2256443	2256536	93	186	93	LEFT	M60a.EDF	M60	1
27	2257102	2257192	752	842	90	LEFT	M60a.EDF	M60	1
27	2257509	2257613	1159	1263	104	LEFT	M60a.EDF	M60	1
28	2263809	2263933	58	182	124	LEFT	M60a.EDF	M60	1
28	2264667	2264731	916	980	64	LEFT	M60a.EDF	M60	1
29	2273392	2273498	288	394	106	LEFT	M60a.EDF	M60	1
29	2274114	2274184	1010	1080	70	LEFT	M60a.EDF	M60	1
29	2278659	2278711	5555	5607	52	LEFT	M60a.EDF	M60	1
29	2279226	2279343	6122	6239	117	LEFT	M60a.EDF	M60	1
30	2282904	2283005	323	424	101	LEFT	M60a.EDF	M60	1
30	2283525	2283615	944	1034	90	LEFT	M60a.EDF	M60	1
30	2284226	2284321	1645	1740	95	LEFT	M60a.EDF	M60	1
31	2292819	2292920	228	329	101	LEFT	M60a.EDF	M60	1
31	2293781	2293854	1190	1263	73	LEFT	M60a.EDF	M60	1
32	2301770	2301874	308	412	104	LEFT	M60a.EDF	M60	1
32	2302524	2302605	1062	1143	81	LEFT	M60a.EDF	M60	1
33	2310949	2311048	388	487	99	LEFT	M60a.EDF	M60	1
33	2311594	2311677	1033	1116	83	LEFT	M60a.EDF	M60	1
34	2318971	2319048	244	321	77	LEFT	M60a.EDF	M60	1
34	2319588	2319686	861	959	98	LEFT	M60a.EDF	M60	1
34	2324569	2324667	5842	5940	98	LEFT	M60a.EDF	M60	1
34	2324909	2324919	6182	6192	10	LEFT	M60a.EDF	M60	1
35	2328128	2328151	58	81	23	LEFT	M60a.EDF	M60	1
35	2328816	2328917	746	847	101	LEFT	M60a.EDF	M60	1
35	2329541	2329642	1471	1572	101	LEFT	M60a.EDF	M60	1
36	2337047	2337134	492	579	87	LEFT	M60a.EDF	M60	1
36	2337817	2337920	1262	1365	103	LEFT	M60a.EDF	M60	1
37	2348302	2348392	228	318	90	LEFT	M60a.EDF	M60	1
37	2348849	2348917	775	843	68	LEFT	M60a.EDF	M60	1
37	2349105	2349180	1031	1106	75	LEFT	M60a.EDF	M60	1
37	2352546	2352638	4472	4564	92	LEFT	M60a.EDF	M60	1
37	2353589	2353650	5515	5576	61	LEFT	M60a.EDF	M60	1
38	2357465	2357499	58	92	34	LEFT	M60a.EDF	M60	1
38	2357730	2357825	323	418	95	LEFT	M60a.EDF	M60	1
38	2358342	2358437	935	1030	95	LEFT	M60a.EDF	M60	1
39	2364074	2364237	58	221	163	LEFT	M60a.EDF	M60	1
40	2371640	2371728	244	332	88	LEFT	M60a.EDF	M60	1
40	2372494	2372573	1098	1177	79	LEFT	M60a.EDF	M60	1
41	2380001	2380131	76	206	130	LEFT	M60a.EDF	M60	1
41	2380662	2380746	737	821	84	LEFT	M60a.EDF	M60	1
41	2381527	2381634	1602	1709	107	LEFT	M60a.EDF	M60	1
42	2389268	2389405	125	262	137	LEFT	M60a.EDF	M60	1
42	2389815	2389906	672	763	91	LEFT	M60a.EDF	M60	1
43	2396831	2396936	195	300	105	LEFT	M60a.EDF	M60	1
43	2397594	2397692	958	1056	98	LEFT	M60a.EDF	M60	1
44	2406096	2406172	458	534	76	LEFT	M60a.EDF	M60	1
44	2406886	2406979	1248	1341	93	LEFT	M60a.EDF	M60	1
44	2408997	2409100	3359	3462	103	LEFT	M60a.EDF	M60	1
44	2409392	2409483	3754	3845	91	LEFT	M60a.EDF	M60	1
44	2409846	2409944	4208	4306	98	LEFT	M60a.EDF	M60	1
45	2412514	2412601	210	297	87	LEFT	M60a.EDF	M60	1
46	2421246	2421350	186	290	104	LEFT	M60a.EDF	M60	1
46	2422147	2422232	1087	1172	85	LEFT	M60a.EDF	M60	1
47	2428501	2428531	58	88	30	LEFT	M60a.EDF	M60	1
47	2428831	2428925	388	482	94	LEFT	M60a.EDF	M60	1
47	2429976	2430060	1533	1617	84	LEFT	M60a.EDF	M60	1
48	2438230	2438324	139	233	94	LEFT	M60a.EDF	M60	1
48	2439583	2439658	1492	1567	75	LEFT	M60a.EDF	M60	1
49	2448564	2448703	198	337	139	LEFT	M60a.EDF	M60	1
49	2449205	2449301	839	935	96	LEFT	M60a.EDF	M60	1
49	2449703	2449796	1337	1430	93	LEFT	M60a.EDF	M60	1
50	2455521	2455615	210	304	94	LEFT	M60a.EDF	M60	1
50	2456517	2456597	1206	1286	80	LEFT	M60a.EDF	M60	1
51	2464774	2464876	127	229	102	LEFT	M60a.EDF	M60	1
51	2465526	2465627	879	980	101	LEFT	M60a.EDF	M60	1
52	2474351	2474388	58	95	37	LEFT	M60a.EDF	M60	1
52	2474631	2475556	338	1263	925	LEFT	M60a.EDF	M60	1
52	2476056	2476120	1763	1827	64	LEFT	M60a.EDF	M60	1
53	2482295	2482364	58	127	69	LEFT	M60a.EDF	M60	1
53	2482607	2482687	370	450	80	LEFT	M60a.EDF	M60	1
53	2483245	2483333	1008	1096	88	LEFT	M60a.EDF	M60	1
54	2490193	2490301	224	332	108	LEFT	M60a.EDF	M60	1
55	2499173	2499210	58	95	37	LEFT	M60a.EDF	M60	1
55	2500258	2500334	1143	1219	76	LEFT	M60a.EDF	M60	1
56	2508311	2508433	108	230	122	LEFT	M60a.EDF	M60	1
56	2509310	2509403	1107	1200	93	LEFT	M60a.EDF	M60	1
57	2519038	2519123	73	158	85	LEFT	M60a.EDF	M60	1
57	2519553	2519635	588	670	82	LEFT	M60a.EDF	M60	1
57	2519945	2520014	980	1049	69	LEFT	M60a.EDF	M60	1
57	2520296	2520422	1331	1457	126	LEFT	M60a.EDF	M60	1
57	2520674	2520770	1709	1805	96	LEFT	M60a.EDF	M60	1
57	2521383	2521451	2418	2486	68	LEFT	M60a.EDF	M60	1
57	2521765	2521854	2800	2889	89	LEFT	M60a.EDF	M60	1
57	2522169	2522242	3204	3277	73	LEFT	M60a.EDF	M60	1
57	2522498	2522565	3533	3600	67	LEFT	M60a.EDF	M60	1
58	2526308	2526401	57	150	93	LEFT	M60a.EDF	M60	1
58	2526987	2527069	736	818	82	LEFT	M60a.EDF	M60	1
59	2534189	2534269	332	412	80	LEFT	M60a.EDF	M60	1
60	2541666	2541767	236	337	101	LEFT	M60a.EDF	M60	1
60	2542531	2542607	1101	1177	76	LEFT	M60a.EDF	M60	1
60	2543609	2543683	2179	2253	74	LEFT	M60a.EDF	M60	1
61	2551393	2551490	406	503	97	LEFT	M60a.EDF	M60	1
62	2560514	2560631	189	306	117	LEFT	M60a.EDF	M60	1
62	2561604	2561699	1279	1374	95	LEFT	M60a.EDF	M60	1
63	2568123	2568221	225	323	98	LEFT	M60a.EDF	M60	1
63	2570063	2570149	2165	2251	86	LEFT	M60a.EDF	M60	1
64	2577614	2577728	100	214	114	LEFT	M60a.EDF	M60	1
64	2578380	2578436	866	922	56	LEFT	M60a.EDF	M60	1
64	2579046	2579146	1532	1632	100	LEFT	M60a.EDF	M60	1
64	2583009	2583009	5495	5495	0	LEFT	M60a.EDF	M60	1
65	2586073	2586169	100	196	96	LEFT	M60a.EDF	M60	1
65	2587188	2587277	1215	1304	89	LEFT	M60a.EDF	M60	1
65	2587767	2587844	1794	1871	77	LEFT	M60a.EDF	M60	1
66	2594957	2595060	279	382	103	LEFT	M60a.EDF	M60	1
66	2596233	2596343	1555	1665	110	LEFT	M60a.EDF	M60	1
67	2605440	2605523	426	509	83	LEFT	M60a.EDF	M60	1
67	2606251	2606340	1237	1326	89	LEFT	M60a.EDF	M60	1
68	2613500	2613602	123	225	102	LEFT	M60a.EDF	M60	1
68	2614295	2614366	918	989	71	LEFT	M60a.EDF	M60	1
68	2614744	2614816	1367	1439	72	LEFT	M60a.EDF	M60	1
69	2621510	2621575	58	123	65	LEFT	M60a.EDF	M60	1
69	2622183	2622286	731	834	103	LEFT	M60a.EDF	M60	1
69	2622609	2622688	1157	1236	79	LEFT	M60a.EDF	M60	1
69	2623003	2623099	1551	1647	96	LEFT	M60a.EDF	M60	1
70	2630158	2630268	282	392	110	LEFT	M60a.EDF	M60	1
70	2631283	2631359	1407	1483	76	LEFT	M60a.EDF	M60	1
71	2639262	2639305	58	101	43	LEFT	M60a.EDF	M60	1
71	2640045	2640105	841	901	60	LEFT	M60a.EDF	M60	1
72	2647193	2647270	293	370	77	LEFT	M60a.EDF	M60	1
72	2648006	2648087	1106	1187	81	LEFT	M60a.EDF	M60	1
73	2656509	2656619	679	789	110	LEFT	M60a.EDF	M60	1
73	2657229	2657341	1399	1511	112	LEFT	M60a.EDF	M60	1
73	2657698	2657775	1868	1945	77	LEFT	M60a.EDF	M60	1
73	2659565	2659702	3735	3872	137	LEFT	M60a.EDF	M60	1
73	2659996	2660097	4166	4267	101	LEFT	M60a.EDF	M60	1
74	2665071	2665191	115	235	120	LEFT	M60a.EDF	M60	1
74	2665789	2665867	833	911	78	LEFT	M60a.EDF	M60	1
74	2670991	2671101	6035	6145	110	LEFT	M60a.EDF	M60	1
74	2671515	2671594	6559	6638	79	LEFT	M60a.EDF	M60	1
75	2674717	2674808	191	282	91	LEFT	M60a.EDF	M60	1
75	2675414	2675481	888	955	67	LEFT	M60a.EDF	M60	1
76	2684150	2684208	58	116	58	LEFT	M60a.EDF	M60	1
76	2684792	2684883	700	791	91	LEFT	M60a.EDF	M60	1
77	2692265	2692383	288	406	118	LEFT	M60a.EDF	M60	1
77	2693133	2693214	1156	1237	81	LEFT	M60a.EDF	M60	1
78	2699823	2699900	452	529	77	LEFT	M60a.EDF	M60	1
79	2709829	2709925	310	406	96	LEFT	M60a.EDF	M60	1
79	2710743	2710841	1224	1322	98	LEFT	M60a.EDF	M60	1
79	2711536	2711619	2017	2100	83	LEFT	M60a.EDF	M60	1
80	2719873	2719970	207	304	97	LEFT	M60a.EDF	M60	1
80	2720856	2720928	1190	1262	72	LEFT	M60a.EDF	M60	1
80	2721266	2721338	1600	1672	72	LEFT	M60a.EDF	M60	1
80	2721574	2721631	1908	1965	57	LEFT	M60a.EDF	M60	1
81	2728738	2728786	58	106	48	LEFT	M60a.EDF	M60	1
81	2729003	2729105	323	425	102	LEFT	M60a.EDF	M60	1
81	2729676	2729745	996	1065	69	LEFT	M60a.EDF	M60	1
81	2730759	2730834	2079	2154	75	LEFT	M60a.EDF	M60	1
82	2736629	2736726	718	815	97	LEFT	M60a.EDF	M60	1
83	2744926	2744958	59	91	32	LEFT	M60a.EDF	M60	1
83	2745761	2745838	894	971	77	LEFT	M60a.EDF	M60	1
83	2746063	2746155	1196	1288	92	LEFT	M60a.EDF	M60	1
84	2752617	2752724	782	889	107	LEFT	M60a.EDF	M60	1
85	2761096	2761211	1336	1451	115	LEFT	M60a.EDF	M60	1
86	2771118	2771234	223	339	116	LEFT	M60a.EDF	M60	1
86	2772339	2772430	1444	1535	91	LEFT	M60a.EDF	M60	1
87	2780263	2780371	733	841	108	LEFT	M60a.EDF	M60	1
87	2784224	2784348	4694	4818	124	LEFT	M60a.EDF	M60	1
87	2784639	2784713	5109	5183	74	LEFT	M60a.EDF	M60	1
87	2785367	2785473	5837	5943	106	LEFT	M60a.EDF	M60	1
87	2785749	2785818	6219	6288	69	LEFT	M60a.EDF	M60	1
88	2788548	2788629	513	594	81	LEFT	M60a.EDF	M60	1
88	2788999	2789101	964	1066	102	LEFT	M60a.EDF	M60	1
88	2789325	2789420	1290	1385	95	LEFT	M60a.EDF	M60	1
89	2795460	2795541	58	139	81	LEFT	M60a.EDF	M60	1
89	2796891	2796986	1489	1584	95	LEFT	M60a.EDF	M60	1
90	2804150	2804226	774	850	76	LEFT	M60a.EDF	M60	1
90	2807037	2807126	3661	3750	89	LEFT	M60a.EDF	M60	1
90	2809642	2809668	6266	6292	26	LEFT	M60a.EDF	M60	1
91	2812390	2812469	513	592	79	LEFT	M60a.EDF	M60	1
92	2819074	2819167	950	1043	93	LEFT	M60a.EDF	M60	1
93	2825488	2825606	58	176	118	LEFT	M60a.EDF	M60	1
94	2833851	2833949	277	375	98	LEFT	M60a.EDF	M60	1
94	2834281	2834375	707	801	94	LEFT	M60a.EDF	M60	1
94	2835169	2835248	1595	1674	79	LEFT	M60a.EDF	M60	1
95	2841869	2841952	741	824	83	LEFT	M60a.EDF	M60	1
95	2842694	2842767	1566	1639	73	LEFT	M60a.EDF	M60	1
96	2848878	2848919	58	99	41	LEFT	M60a.EDF	M60	1
96	2849824	2849918	1004	1098	94	LEFT	M60a.EDF	M60	1
97	2856591	2856702	233	344	111	LEFT	M60a.EDF	M60	1
97	2857897	2857979	1539	1621	82	LEFT	M60a.EDF	M60	1
98	2863462	2863549	58	145	87	LEFT	M60a.EDF	M60	1
99	2871401	2871493	768	860	92	LEFT	M60a.EDF	M60	1
99	2873815	2873985	3182	3352	170	LEFT	M60a.EDF	M60	1
99	2874493	2874571	3860	3938	78	LEFT	M60a.EDF	M60	1
101	2887883	2887914	59	90	31	LEFT	M60a.EDF	M60	1
102	2897231	2897348	128	245	117	LEFT	M60a.EDF	M60	1
103	2905095	2905168	207	280	73	LEFT	M60a.EDF	M60	1
103	2905937	2906041	1049	1153	104	LEFT	M60a.EDF	M60	1
104	2916262	2916366	811	915	104	LEFT	M60a.EDF	M60	1
104	2916632	2916703	1181	1252	71	LEFT	M60a.EDF	M60	1
105	2922713	2922793	165	245	80	LEFT	M60a.EDF	M60	1
105	2926884	2926974	4336	4426	90	LEFT	M60a.EDF	M60	1
106	2930271	2930347	58	134	76	LEFT	M60a.EDF	M60	1
106	2930588	2930659	375	446	71	LEFT	M60a.EDF	M60	1
106	2931231	2931307	1018	1094	76	LEFT	M60a.EDF	M60	1
107	2938133	2938230	168	265	97	LEFT	M60a.EDF	M60	1
107	2938826	2938918	861	953	92	LEFT	M60a.EDF	M60	1
108	2947569	2947709	58	198	140	LEFT	M60a.EDF	M60	1
109	2955344	2955425	255	336	81	LEFT	M60a.EDF	M60	1
109	2956480	2956548	1391	1459	68	LEFT	M60a.EDF	M60	1
110	2964010	2964102	2096	2188	92	LEFT	M60a.EDF	M60	1
111	2972377	2972491	130	244	114	LEFT	M60a.EDF	M60	1
111	2974039	2974128	1792	1881	89	LEFT	M60a.EDF	M60	1
112	2980630	2980721	58	149	91	LEFT	M60a.EDF	M60	1
112	2981447	2981490	875	918	43	LEFT	M60a.EDF	M60	1
113	2989126	2989234	729	837	108	LEFT	M60a.EDF	M60	1
114	2999319	2999399	903	983	80	LEFT	M60a.EDF	M60	1
115	3007831	3007910	751	830	79	LEFT	M60a.EDF	M60	1
115	3008801	3008904	1721	1824	103	LEFT	M60a.EDF	M60	1
115	3012360	3012461	5280	5381	101	LEFT	M60a.EDF	M60	1
116	3015391	3015482	544	635	91	LEFT	M60a.EDF	M60	1
116	3016277	3016340	1430	1493	63	LEFT	M60a.EDF	M60	1
117	3024835	3024940	2184	2289	105	LEFT	M60a.EDF	M60	1
117	3026052	3026167	3401	3516	115	LEFT	M60a.EDF	M60	1
117	3026512	3026589	3861	3938	77	LEFT	M60a.EDF	M60	1
118	3030524	3030621	58	155	97	LEFT	M60a.EDF	M60	1
118	3031344	3031430	878	964	86	LEFT	M60a.EDF	M60	1
119	3040045	3040105	57	117	60	LEFT	M60a.EDF	M60	1
119	3041521	3041635	1533	1647	114	LEFT	M60a.EDF	M60	1
120	3049731	3049792	877	938	61	LEFT	M60a.EDF	M60	1
1	4147001	4147081	1616	1696	80	LEFT	M60b.EDF	M60	2
2	4154335	4154427	127	219	92	LEFT	M60b.EDF	M60	2
2	4155240	4155363	1032	1155	123	LEFT	M60b.EDF	M60	2
2	4155639	4155706	1431	1498	67	LEFT	M60b.EDF	M60	2
2	4160569	4160675	6361	6467	106	LEFT	M60b.EDF	M60	2
3	4166517	4166567	2932	2982	50	LEFT	M60b.EDF	M60	2
4	4171889	4171965	58	134	76	LEFT	M60b.EDF	M60	2
4	4172819	4172906	988	1075	87	LEFT	M60b.EDF	M60	2
5	4179411	4179534	85	208	123	LEFT	M60b.EDF	M60	2
5	4180701	4180731	1375	1405	30	LEFT	M60b.EDF	M60	2
7	4195771	4195856	355	440	85	LEFT	M60b.EDF	M60	2
7	4197068	4197160	1652	1744	92	LEFT	M60b.EDF	M60	2
8	4205603	4205700	129	226	97	LEFT	M60b.EDF	M60	2
8	4206494	4206576	1020	1102	82	LEFT	M60b.EDF	M60	2
9	4214837	4214904	288	355	67	LEFT	M60b.EDF	M60	2
9	4215717	4215778	1168	1229	61	LEFT	M60b.EDF	M60	2
10	4223227	4223294	852	919	67	LEFT	M60b.EDF	M60	2
11	4232302	4232385	637	720	83	LEFT	M60b.EDF	M60	2
11	4233045	4233125	1380	1460	80	LEFT	M60b.EDF	M60	2
12	4239827	4239912	373	458	85	LEFT	M60b.EDF	M60	2
13	4247060	4247141	532	613	81	LEFT	M60b.EDF	M60	2
14	4254786	4254904	57	175	118	LEFT	M60b.EDF	M60	2
14	4255459	4255528	730	799	69	LEFT	M60b.EDF	M60	2
16	4270932	4271007	371	446	75	LEFT	M60b.EDF	M60	2
17	4281075	4281164	696	785	89	LEFT	M60b.EDF	M60	2
17	4281782	4281855	1403	1476	73	LEFT	M60b.EDF	M60	2
18	4289425	4289502	349	426	77	LEFT	M60b.EDF	M60	2
18	4290387	4290473	1311	1397	86	LEFT	M60b.EDF	M60	2
19	4296915	4297015	785	885	100	LEFT	M60b.EDF	M60	2
22	4319784	4319864	362	442	80	LEFT	M60b.EDF	M60	2
22	4320783	4320883	1361	1461	100	LEFT	M60b.EDF	M60	2
23	4328790	4328870	705	785	80	LEFT	M60b.EDF	M60	2
25	4346700	4346785	340	425	85	LEFT	M60b.EDF	M60	2
25	4347296	4347424	936	1064	128	LEFT	M60b.EDF	M60	2
26	4355420	4355498	697	775	78	LEFT	M60b.EDF	M60	2
26	4356524	4356579	1801	1856	55	LEFT	M60b.EDF	M60	2
27	4363488	4363587	779	878	99	LEFT	M60b.EDF	M60	2
28	4370696	4370811	176	291	115	LEFT	M60b.EDF	M60	2
28	4371477	4371565	957	1045	88	LEFT	M60b.EDF	M60	2
29	4379429	4379510	803	884	81	LEFT	M60b.EDF	M60	2
30	4388087	4388177	713	803	90	LEFT	M60b.EDF	M60	2
31	4397264	4397469	843	1048	205	LEFT	M60b.EDF	M60	2
32	4405248	4405329	1233	1314	81	LEFT	M60b.EDF	M60	2
33	4413156	4413227	827	898	71	LEFT	M60b.EDF	M60	2
34	4420397	4420468	343	414	71	LEFT	M60b.EDF	M60	2
35	4427606	4427632	57	83	26	LEFT	M60b.EDF	M60	2
36	4435545	4435632	734	821	87	LEFT	M60b.EDF	M60	2
37	4443115	4443182	827	894	67	LEFT	M60b.EDF	M60	2
38	4452158	4452265	284	391	107	LEFT	M60b.EDF	M60	2
38	4453090	4453164	1216	1290	74	LEFT	M60b.EDF	M60	2
40	4470348	4470439	236	327	91	LEFT	M60b.EDF	M60	2
40	4471054	4471144	942	1032	90	LEFT	M60b.EDF	M60	2
41	4478256	4478352	324	420	96	LEFT	M60b.EDF	M60	2
42	4486259	4486374	156	271	115	LEFT	M60b.EDF	M60	2
43	4494574	4494666	154	246	92	LEFT	M60b.EDF	M60	2
43	4495410	4495482	990	1062	72	LEFT	M60b.EDF	M60	2
43	4496307	4496355	1887	1935	48	LEFT	M60b.EDF	M60	2
43	4497164	4497304	2744	2884	140	LEFT	M60b.EDF	M60	2
43	4498080	4498200	3660	3780	120	LEFT	M60b.EDF	M60	2
43	4498985	4499069	4565	4649	84	LEFT	M60b.EDF	M60	2
44	4502824	4502916	817	909	92	LEFT	M60b.EDF	M60	2
45	4509767	4509869	497	599	102	LEFT	M60b.EDF	M60	2
46	4519721	4519809	1146	1234	88	LEFT	M60b.EDF	M60	2
47	4528385	4528466	758	839	81	LEFT	M60b.EDF	M60	2
48	4537548	4537634	856	942	86	LEFT	M60b.EDF	M60	2
49	4546074	4546161	594	681	87	LEFT	M60b.EDF	M60	2
51	4561772	4561849	572	649	77	LEFT	M60b.EDF	M60	2
53	4577876	4577976	365	465	100	LEFT	M60b.EDF	M60	2
54	4588858	4588945	614	701	87	LEFT	M60b.EDF	M60	2
54	4589249	4589354	1005	1110	105	LEFT	M60b.EDF	M60	2
54	4590040	4590122	1796	1878	82	LEFT	M60b.EDF	M60	2
55	4597523	4597611	158	246	88	LEFT	M60b.EDF	M60	2
56	4606031	4606120	1253	1342	89	LEFT	M60b.EDF	M60	2
58	4623073	4623164	795	886	91	LEFT	M60b.EDF	M60	2
59	4630253	4630364	213	324	111	LEFT	M60b.EDF	M60	2
60	4638353	4638526	79	252	173	LEFT	M60b.EDF	M60	2
61	4645723	4645817	113	207	94	LEFT	M60b.EDF	M60	2
62	4654994	4655088	1466	1560	94	LEFT	M60b.EDF	M60	2
63	4663669	4663742	956	1029	73	LEFT	M60b.EDF	M60	2
64	4671845	4671915	769	839	70	LEFT	M60b.EDF	M60	2
65	4681129	4681226	1555	1652	97	LEFT	M60b.EDF	M60	2
66	4690270	4690352	530	612	82	LEFT	M60b.EDF	M60	2
66	4691377	4691432	1637	1692	55	LEFT	M60b.EDF	M60	2
66	4692443	4692562	2703	2822	119	LEFT	M60b.EDF	M60	2
66	4692906	4693013	3166	3273	107	LEFT	M60b.EDF	M60	2
67	4698748	4698819	57	128	71	LEFT	M60b.EDF	M60	2
67	4699769	4699868	1078	1177	99	LEFT	M60b.EDF	M60	2
68	4707079	4707191	158	270	112	LEFT	M60b.EDF	M60	2
69	4716707	4716831	731	855	124	LEFT	M60b.EDF	M60	2
69	4718657	4718834	2681	2858	177	LEFT	M60b.EDF	M60	2
70	4724672	4724773	895	996	101	LEFT	M60b.EDF	M60	2
71	4731777	4731831	691	745	54	LEFT	M60b.EDF	M60	2
71	4732364	4732439	1278	1353	75	LEFT	M60b.EDF	M60	2
72	4739419	4739587	630	798	168	LEFT	M60b.EDF	M60	2
73	4748737	4748814	932	1009	77	LEFT	M60b.EDF	M60	2
74	4758157	4758269	2019	2131	112	LEFT	M60b.EDF	M60	2
76	4773784	4773873	372	461	89	LEFT	M60b.EDF	M60	2
76	4774896	4774954	1484	1542	58	LEFT	M60b.EDF	M60	2
77	4782876	4782954	638	716	78	LEFT	M60b.EDF	M60	2
77	4784082	4784169	1844	1931	87	LEFT	M60b.EDF	M60	2
79	4798154	4798212	697	755	58	LEFT	M60b.EDF	M60	2
79	4798739	4798833	1282	1376	94	LEFT	M60b.EDF	M60	2
79	4799100	4799168	1643	1711	68	LEFT	M60b.EDF	M60	2
79	4800072	4800148	2615	2691	76	LEFT	M60b.EDF	M60	2
80	4805672	4805772	111	211	100	LEFT	M60b.EDF	M60	2
80	4807317	4807381	1756	1820	64	LEFT	M60b.EDF	M60	2
81	4816093	4816188	1451	1546	95	LEFT	M60b.EDF	M60	2
82	4823785	4823875	596	686	90	LEFT	M60b.EDF	M60	2
82	4824665	4824750	1476	1561	85	LEFT	M60b.EDF	M60	2
83	4832844	4832866	57	79	22	LEFT	M60b.EDF	M60	2
83	4833406	4833449	619	662	43	LEFT	M60b.EDF	M60	2
83	4834106	4834195	1319	1408	89	LEFT	M60b.EDF	M60	2
84	4841330	4841438	827	935	108	LEFT	M60b.EDF	M60	2
85	4849589	4849702	181	294	113	LEFT	M60b.EDF	M60	2
85	4851052	4851143	1644	1735	91	LEFT	M60b.EDF	M60	2
86	4858637	4858749	1373	1485	112	LEFT	M60b.EDF	M60	2
87	4869574	4869648	864	938	74	LEFT	M60b.EDF	M60	2
88	4878962	4879080	799	917	118	LEFT	M60b.EDF	M60	2
90	4894074	4894128	57	111	54	LEFT	M60b.EDF	M60	2
91	4904760	4904829	763	832	69	LEFT	M60b.EDF	M60	2
91	4908372	4908475	4375	4478	103	LEFT	M60b.EDF	M60	2
93	4922605	4922663	573	631	58	LEFT	M60b.EDF	M60	2
93	4923479	4923535	1447	1503	56	LEFT	M60b.EDF	M60	2
93	4924113	4924208	2081	2176	95	LEFT	M60b.EDF	M60	2
93	4924484	4924616	2452	2584	132	LEFT	M60b.EDF	M60	2
93	4925528	4925579	3496	3547	51	LEFT	M60b.EDF	M60	2
93	4926191	4926281	4159	4249	90	LEFT	M60b.EDF	M60	2
93	4926915	4926985	4883	4953	70	LEFT	M60b.EDF	M60	2
93	4927787	4927878	5755	5846	91	LEFT	M60b.EDF	M60	2
94	4931304	4931405	84	185	101	LEFT	M60b.EDF	M60	2
94	4932191	4932318	971	1098	127	LEFT	M60b.EDF	M60	2
95	4938916	4939116	126	326	200	LEFT	M60b.EDF	M60	2
95	4940139	4940226	1349	1436	87	LEFT	M60b.EDF	M60	2
96	4946251	4946344	274	367	93	LEFT	M60b.EDF	M60	2
96	4947619	4947718	1642	1741	99	LEFT	M60b.EDF	M60	2
97	4954459	4954535	587	663	76	LEFT	M60b.EDF	M60	2
97	4955307	4955394	1435	1522	87	LEFT	M60b.EDF	M60	2
98	4963132	4963221	572	661	89	LEFT	M60b.EDF	M60	2
98	4963517	4963611	957	1051	94	LEFT	M60b.EDF	M60	2
98	4964086	4964182	1526	1622	96	LEFT	M60b.EDF	M60	2
99	4973097	4973211	651	765	114	LEFT	M60b.EDF	M60	2
100	4982376	4982493	268	385	117	LEFT	M60b.EDF	M60	2
100	4983003	4983068	895	960	65	LEFT	M60b.EDF	M60	2
100	4985350	4985483	3242	3375	133	LEFT	M60b.EDF	M60	2
101	4991633	4991727	729	823	94	LEFT	M60b.EDF	M60	2
101	4992716	4992776	1812	1872	60	LEFT	M60b.EDF	M60	2
102	5000372	5000466	741	835	94	LEFT	M60b.EDF	M60	2
104	5016240	5016262	57	79	22	LEFT	M60b.EDF	M60	2
104	5016819	5016899	636	716	80	LEFT	M60b.EDF	M60	2
104	5017609	5017689	1426	1506	80	LEFT	M60b.EDF	M60	2
106	5038863	5038987	5000	5124	124	LEFT	M60b.EDF	M60	2
107	5042810	5042898	715	803	88	LEFT	M60b.EDF	M60	2
108	5051567	5051646	779	858	79	LEFT	M60b.EDF	M60	2
109	5065433	5065451	6205	6223	18	LEFT	M60b.EDF	M60	2
111	5077911	5078071	2574	2734	160	LEFT	M60b.EDF	M60	2
111	5078523	5078636	3186	3299	113	LEFT	M60b.EDF	M60	2
113	5091513	5091685	275	447	172	LEFT	M60b.EDF	M60	2
114	5098596	5098703	144	251	107	LEFT	M60b.EDF	M60	2
115	5107473	5107567	196	290	94	LEFT	M60b.EDF	M60	2
115	5110178	5110421	2901	3144	243	LEFT	M60b.EDF	M60	2
115	5110990	5111114	3713	3837	124	LEFT	M60b.EDF	M60	2
117	5123775	5123902	67	194	127	LEFT	M60b.EDF	M60	2
120	5150679	5150888	58	267	209	LEFT	M60b.EDF	M60	2
2	5602290	5602374	180	264	84	LEFT	M60c.EDF	M60	3
3	5610634	5610689	685	740	55	LEFT	M60c.EDF	M60	3
3	5611276	5611348	1327	1399	72	LEFT	M60c.EDF	M60	3
3	5611560	5611625	1611	1676	65	LEFT	M60c.EDF	M60	3
4	5617482	5617555	322	395	73	LEFT	M60c.EDF	M60	3
4	5618235	5618279	1075	1119	44	LEFT	M60c.EDF	M60	3
5	5625574	5625659	206	291	85	LEFT	M60c.EDF	M60	3
5	5626222	5626305	854	937	83	LEFT	M60c.EDF	M60	3
6	5633904	5633988	193	277	84	LEFT	M60c.EDF	M60	3
6	5634277	5634349	566	638	72	LEFT	M60c.EDF	M60	3
7	5642556	5642627	58	129	71	LEFT	M60c.EDF	M60	3
8	5651785	5651858	334	407	73	LEFT	M60c.EDF	M60	3
8	5652535	5652602	1084	1151	67	LEFT	M60c.EDF	M60	3
9	5660860	5660950	200	290	90	LEFT	M60c.EDF	M60	3
9	5661549	5661625	889	965	76	LEFT	M60c.EDF	M60	3
10	5669002	5669080	461	539	78	LEFT	M60c.EDF	M60	3
10	5669457	5669561	916	1020	104	LEFT	M60c.EDF	M60	3
10	5673897	5674106	5356	5565	209	LEFT	M60c.EDF	M60	3
10	5674821	5674895	6280	6354	74	LEFT	M60c.EDF	M60	3
11	5680197	5680285	687	775	88	LEFT	M60c.EDF	M60	3
11	5681093	5681142	1583	1632	49	LEFT	M60c.EDF	M60	3
12	5692886	5693057	5062	5233	171	LEFT	M60c.EDF	M60	3
13	5696292	5696384	1115	1207	92	LEFT	M60c.EDF	M60	3
14	5703431	5703537	58	164	106	LEFT	M60c.EDF	M60	3
14	5703912	5703976	539	603	64	LEFT	M60c.EDF	M60	3
15	5713298	5713395	258	355	97	LEFT	M60c.EDF	M60	3
16	5722542	5722611	57	126	69	LEFT	M60c.EDF	M60	3
16	5722899	5722970	414	485	71	LEFT	M60c.EDF	M60	3
16	5723523	5723602	1038	1117	79	LEFT	M60c.EDF	M60	3
16	5723785	5723855	1300	1370	70	LEFT	M60c.EDF	M60	3
17	5732317	5732414	229	326	97	LEFT	M60c.EDF	M60	3
17	5732978	5733054	890	966	76	LEFT	M60c.EDF	M60	3
19	5749692	5749794	265	367	102	LEFT	M60c.EDF	M60	3
19	5750916	5751030	1489	1603	114	LEFT	M60c.EDF	M60	3
20	5758470	5758564	261	355	94	LEFT	M60c.EDF	M60	3
20	5759357	5759444	1148	1235	87	LEFT	M60c.EDF	M60	3
21	5765910	5765962	58	110	52	LEFT	M60c.EDF	M60	3
22	5774377	5774472	783	878	95	LEFT	M60c.EDF	M60	3
23	5783154	5783256	304	406	102	LEFT	M60c.EDF	M60	3
23	5783998	5784073	1148	1223	75	LEFT	M60c.EDF	M60	3
24	5790972	5791042	613	683	70	LEFT	M60c.EDF	M60	3
24	5792391	5792449	2032	2090	58	LEFT	M60c.EDF	M60	3
25	5798823	5798931	58	166	108	LEFT	M60c.EDF	M60	3
25	5799851	5799951	1086	1186	100	LEFT	M60c.EDF	M60	3
27	5816658	5816745	765	852	87	LEFT	M60c.EDF	M60	3
28	5825384	5825410	58	84	26	LEFT	M60c.EDF	M60	3
28	5826026	5826118	700	792	92	LEFT	M60c.EDF	M60	3
29	5833854	5833954	568	668	100	LEFT	M60c.EDF	M60	3
30	5842783	5842888	805	910	105	LEFT	M60c.EDF	M60	3
32	5859323	5859427	1326	1430	104	LEFT	M60c.EDF	M60	3
33	5865704	5865808	57	161	104	LEFT	M60c.EDF	M60	3
33	5866059	5866155	412	508	96	LEFT	M60c.EDF	M60	3
33	5866888	5866944	1241	1297	56	LEFT	M60c.EDF	M60	3
33	5869200	5869300	3553	3653	100	LEFT	M60c.EDF	M60	3
33	5869966	5870052	4319	4405	86	LEFT	M60c.EDF	M60	3
34	5874033	5874118	668	753	85	LEFT	M60c.EDF	M60	3
36	5889417	5889510	59	152	93	LEFT	M60c.EDF	M60	3
36	5889766	5889828	408	470	62	LEFT	M60c.EDF	M60	3
36	5890761	5890841	1403	1483	80	LEFT	M60c.EDF	M60	3
37	5898958	5899045	813	900	87	LEFT	M60c.EDF	M60	3
38	5905672	5905766	273	367	94	LEFT	M60c.EDF	M60	3
39	5916158	5916236	2244	2322	78	LEFT	M60c.EDF	M60	3
40	5921860	5922001	74	215	141	LEFT	M60c.EDF	M60	3
40	5922343	5922438	557	652	95	LEFT	M60c.EDF	M60	3
40	5923142	5923226	1356	1440	84	LEFT	M60c.EDF	M60	3
41	5931471	5931547	1077	1153	76	LEFT	M60c.EDF	M60	3
43	5947825	5947896	691	762	71	LEFT	M60c.EDF	M60	3
43	5949873	5949963	2739	2829	90	LEFT	M60c.EDF	M60	3
44	5957501	5957639	2681	2819	138	LEFT	M60c.EDF	M60	3
45	5964476	5964548	962	1034	72	LEFT	M60c.EDF	M60	3
46	5972216	5972306	607	697	90	LEFT	M60c.EDF	M60	3
46	5977122	5977352	5513	5743	230	LEFT	M60c.EDF	M60	3
48	5989102	5989185	1227	1310	83	LEFT	M60c.EDF	M60	3
49	5996580	5996667	239	326	87	LEFT	M60c.EDF	M60	3
49	5997841	5997907	1500	1566	66	LEFT	M60c.EDF	M60	3
52	6021235	6021277	58	100	42	LEFT	M60c.EDF	M60	3
52	6021767	6021827	590	650	60	LEFT	M60c.EDF	M60	3
53	6031217	6031353	68	204	136	LEFT	M60c.EDF	M60	3
53	6032639	6032740	1490	1591	101	LEFT	M60c.EDF	M60	3
57	6065122	6065207	225	310	85	LEFT	M60c.EDF	M60	3
58	6072743	6072819	592	668	76	LEFT	M60c.EDF	M60	3
59	6080697	6080796	123	222	99	LEFT	M60c.EDF	M60	3
60	6087288	6087384	57	153	96	LEFT	M60c.EDF	M60	3
60	6088304	6088530	1073	1299	226	LEFT	M60c.EDF	M60	3
61	6094692	6094827	98	233	135	LEFT	M60c.EDF	M60	3
61	6095208	6095329	614	735	121	LEFT	M60c.EDF	M60	3
62	6102778	6102905	58	185	127	LEFT	M60c.EDF	M60	3
62	6104232	6104393	1512	1673	161	LEFT	M60c.EDF	M60	3
63	6111302	6111425	847	970	123	LEFT	M60c.EDF	M60	3
65	6128069	6128146	1444	1521	77	LEFT	M60c.EDF	M60	3
66	6135858	6135946	748	836	88	LEFT	M60c.EDF	M60	3
67	6143162	6143269	598	705	107	LEFT	M60c.EDF	M60	3
67	6144573	6144654	2009	2090	81	LEFT	M60c.EDF	M60	3
68	6151988	6152212	1106	1330	224	LEFT	M60c.EDF	M60	3
69	6159955	6160074	1121	1240	119	LEFT	M60c.EDF	M60	3
70	6166507	6166603	751	847	96	LEFT	M60c.EDF	M60	3
71	6175368	6175461	745	838	93	LEFT	M60c.EDF	M60	3
71	6176467	6176565	1844	1942	98	LEFT	M60c.EDF	M60	3
72	6183419	6183498	749	828	79	LEFT	M60c.EDF	M60	3
72	6184444	6184525	1774	1855	81	LEFT	M60c.EDF	M60	3
73	6191454	6191554	875	975	100	LEFT	M60c.EDF	M60	3
74	6199432	6199560	282	410	128	LEFT	M60c.EDF	M60	3
75	6208593	6208700	57	164	107	LEFT	M60c.EDF	M60	3
75	6209095	6209134	559	598	39	LEFT	M60c.EDF	M60	3
76	6217538	6217578	58	98	40	LEFT	M60c.EDF	M60	3
76	6218340	6218410	860	930	70	LEFT	M60c.EDF	M60	3
78	6233700	6233784	710	794	84	LEFT	M60c.EDF	M60	3
78	6234025	6234093	1035	1103	68	LEFT	M60c.EDF	M60	3
78	6236014	6236105	3024	3115	91	LEFT	M60c.EDF	M60	3
79	6242132	6242244	165	277	112	LEFT	M60c.EDF	M60	3
79	6242844	6242923	877	956	79	LEFT	M60c.EDF	M60	3
81	6259700	6259808	625	733	108	LEFT	M60c.EDF	M60	3
81	6260376	6260471	1301	1396	95	LEFT	M60c.EDF	M60	3
82	6268813	6268886	591	664	73	LEFT	M60c.EDF	M60	3
82	6269523	6269592	1301	1370	69	LEFT	M60c.EDF	M60	3
82	6270212	6270972	1990	2750	760	LEFT	M60c.EDF	M60	3
82	6272022	6272033	3800	3811	11	LEFT	M60c.EDF	M60	3
82	6272054	6272054	3832	3832	0	LEFT	M60c.EDF	M60	3
83	6275977	6276074	1001	1098	97	LEFT	M60c.EDF	M60	3
83	6278913	6279032	3937	4056	119	LEFT	M60c.EDF	M60	3
84	6283329	6283460	167	298	131	LEFT	M60c.EDF	M60	3
85	6292273	6292334	547	608	61	LEFT	M60c.EDF	M60	3
86	6300632	6300737	1669	1774	105	LEFT	M60c.EDF	M60	3
87	6309003	6309110	777	884	107	LEFT	M60c.EDF	M60	3
87	6309916	6309970	1690	1744	54	LEFT	M60c.EDF	M60	3
87	6310226	6310331	2000	2105	105	LEFT	M60c.EDF	M60	3
87	6310743	6310824	2517	2598	81	LEFT	M60c.EDF	M60	3
87	6311066	6311165	2840	2939	99	LEFT	M60c.EDF	M60	3
87	6311445	6311535	3219	3309	90	LEFT	M60c.EDF	M60	3
87	6311870	6311973	3644	3747	103	LEFT	M60c.EDF	M60	3
87	6312175	6312401	3949	4175	226	LEFT	M60c.EDF	M60	3
87	6312585	6312860	4359	4634	275	LEFT	M60c.EDF	M60	3
87	6313457	6313543	5231	5317	86	LEFT	M60c.EDF	M60	3
88	6316948	6317056	789	897	108	LEFT	M60c.EDF	M60	3
89	6325640	6325740	833	933	100	LEFT	M60c.EDF	M60	3
89	6326385	6326474	1578	1667	89	LEFT	M60c.EDF	M60	3
89	6327476	6327643	2669	2836	167	LEFT	M60c.EDF	M60	3
90	6335168	6335258	216	306	90	LEFT	M60c.EDF	M60	3
91	6343749	6343825	709	785	76	LEFT	M60c.EDF	M60	3
92	6350690	6350773	57	140	83	LEFT	M60c.EDF	M60	3
93	6360297	6360410	57	170	113	LEFT	M60c.EDF	M60	3
93	6361115	6361208	875	968	93	LEFT	M60c.EDF	M60	3
94	6368572	6368697	57	182	125	LEFT	M60c.EDF	M60	3
94	6370294	6370473	1779	1958	179	LEFT	M60c.EDF	M60	3
95	6376155	6376217	58	120	62	LEFT	M60c.EDF	M60	3
95	6378256	6378257	2159	2160	1	LEFT	M60c.EDF	M60	3
95	6378331	6378337	2234	2240	6	LEFT	M60c.EDF	M60	3
96	6385216	6385299	761	844	83	LEFT	M60c.EDF	M60	3
97	6393717	6393797	898	978	80	LEFT	M60c.EDF	M60	3
100	6419653	6419808	780	935	155	LEFT	M60c.EDF	M60	3
100	6420480	6420555	1607	1682	75	LEFT	M60c.EDF	M60	3
101	6428069	6428239	56	226	170	LEFT	M60c.EDF	M60	3
101	6429410	6429463	1397	1450	53	LEFT	M60c.EDF	M60	3
103	6444795	6444885	533	623	90	LEFT	M60c.EDF	M60	3
103	6445165	6445326	903	1064	161	LEFT	M60c.EDF	M60	3
103	6445679	6445782	1417	1520	103	LEFT	M60c.EDF	M60	3
104	6453257	6453279	58	80	22	LEFT	M60c.EDF	M60	3
104	6453982	6454068	783	869	86	LEFT	M60c.EDF	M60	3
104	6454724	6454786	1525	1587	62	LEFT	M60c.EDF	M60	3
105	6460570	6460590	58	78	20	LEFT	M60c.EDF	M60	3
106	6468987	6469091	245	349	104	LEFT	M60c.EDF	M60	3
107	6476376	6476589	90	303	213	LEFT	M60c.EDF	M60	3
108	6487057	6487170	901	1014	113	LEFT	M60c.EDF	M60	3
109	6496143	6496235	477	569	92	LEFT	M60c.EDF	M60	3
109	6496794	6496915	1128	1249	121	LEFT	M60c.EDF	M60	3
109	6498920	6499086	3254	3420	166	LEFT	M60c.EDF	M60	3
110	6504785	6505017	96	328	232	LEFT	M60c.EDF	M60	3
111	6513147	6513254	58	165	107	LEFT	M60c.EDF	M60	3
112	6523746	6523891	79	224	145	LEFT	M60c.EDF	M60	3
113	6531067	6531173	57	163	106	LEFT	M60c.EDF	M60	3
114	6538886	6538991	57	162	105	LEFT	M60c.EDF	M60	3
114	6539740	6539840	911	1011	100	LEFT	M60c.EDF	M60	3
115	6546127	6546332	195	400	205	LEFT	M60c.EDF	M60	3
116	6556430	6556621	814	1005	191	LEFT	M60c.EDF	M60	3
116	6556936	6557035	1320	1419	99	LEFT	M60c.EDF	M60	3
117	6566068	6566277	3262	3471	209	LEFT	M60c.EDF	M60	3
118	6569748	6569813	57	122	65	LEFT	M60c.EDF	M60	3
118	6570810	6570892	1119	1201	82	LEFT	M60c.EDF	M60	3
119	6580468	6580570	2267	2369	102	LEFT	M60c.EDF	M60	3
119	6581587	6581665	3386	3464	78	LEFT	M60c.EDF	M60	3
119	6582848	6582921	4647	4720	73	LEFT	M60c.EDF	M60	3
120	6587335	6587388	1381	1434	53	LEFT	M60c.EDF	M60	3
120	6588726	6588853	2772	2899	127	LEFT	M60c.EDF	M60	3
120	6589584	6589672	3630	3718	88	LEFT	M60c.EDF	M60	3
1	4297756	4297834	1096	1174	78	LEFT	N17a.EDF	N17	1
2	4309043	4309578	4263	4798	535	LEFT	N17a.EDF	N17	1
3	4313613	4313698	1009	1094	85	LEFT	N17a.EDF	N17	1
4	4322646	4322997	58	409	351	LEFT	N17a.EDF	N17	1
4	4323235	4323383	647	795	148	LEFT	N17a.EDF	N17	1
5	4329631	4329681	108	158	50	LEFT	N17a.EDF	N17	1
6	4337286	4337394	1816	1924	108	LEFT	N17a.EDF	N17	1
7	4346109	4346134	4266	4291	25	LEFT	N17a.EDF	N17	1
7	4346303	4346370	4460	4527	67	LEFT	N17a.EDF	N17	1
8	4350263	4350655	98	490	392	LEFT	N17a.EDF	N17	1
9	4358564	4358618	226	280	54	LEFT	N17a.EDF	N17	1
10	4367136	4367725	110	699	589	LEFT	N17a.EDF	N17	1
11	4376963	4377029	650	716	66	LEFT	N17a.EDF	N17	1
11	4379131	4379190	2818	2877	59	LEFT	N17a.EDF	N17	1
12	4387752	4388214	4253	4715	462	LEFT	N17a.EDF	N17	1
13	4392680	4393968	58	1346	1288	LEFT	N17a.EDF	N17	1
14	4404746	4404789	2416	2459	43	LEFT	N17a.EDF	N17	1
15	4416157	4416248	2860	2951	91	LEFT	N17a.EDF	N17	1
16	4423966	4424068	334	436	102	LEFT	N17a.EDF	N17	1
18	4436416	4436554	278	416	138	LEFT	N17a.EDF	N17	1
18	4437317	4437395	1179	1257	78	LEFT	N17a.EDF	N17	1
19	4444223	4444304	571	652	81	LEFT	N17a.EDF	N17	1
20	4455042	4455111	2069	2138	69	LEFT	N17a.EDF	N17	1
22	4470450	4470535	3721	3806	85	LEFT	N17a.EDF	N17	1
24	4481900	4481992	325	417	92	LEFT	N17a.EDF	N17	1
26	4496464	4496515	380	431	51	LEFT	N17a.EDF	N17	1
26	4498348	4498359	2264	2275	11	LEFT	N17a.EDF	N17	1
28	4515566	4515623	2203	2260	57	LEFT	N17a.EDF	N17	1
30	4530331	4530416	708	793	85	LEFT	N17a.EDF	N17	1
30	4530688	4530722	1065	1099	34	LEFT	N17a.EDF	N17	1
32	4545991	4546029	1439	1477	38	LEFT	N17a.EDF	N17	1
34	4559327	4559484	229	386	157	LEFT	N17a.EDF	N17	1
36	4577439	4577588	3259	3408	149	LEFT	N17a.EDF	N17	1
37	4586046	4586169	3459	3582	123	LEFT	N17a.EDF	N17	1
39	4596546	4596634	358	446	88	LEFT	N17a.EDF	N17	1
42	4615375	4615415	390	430	40	LEFT	N17a.EDF	N17	1
43	4623408	4623506	2054	2152	98	LEFT	N17a.EDF	N17	1
45	4637244	4637350	367	473	106	LEFT	N17a.EDF	N17	1
45	4639117	4639316	2240	2439	199	LEFT	N17a.EDF	N17	1
49	4665620	4665854	58	292	234	LEFT	N17a.EDF	N17	1
50	4672659	4672747	456	544	88	LEFT	N17a.EDF	N17	1
51	4680809	4680878	1636	1705	69	LEFT	N17a.EDF	N17	1
51	4683095	4683157	3922	3984	62	LEFT	N17a.EDF	N17	1
52	4686115	4686165	439	489	50	LEFT	N17a.EDF	N17	1
53	4692875	4692904	594	623	29	LEFT	N17a.EDF	N17	1
54	4702839	4702942	483	586	103	LEFT	N17a.EDF	N17	1
55	4712808	4712868	2319	2379	60	LEFT	N17a.EDF	N17	1
55	4713612	4713698	3123	3209	86	LEFT	N17a.EDF	N17	1
57	4726251	4726292	545	586	41	LEFT	N17a.EDF	N17	1
62	4759245	4759338	704	797	93	LEFT	N17a.EDF	N17	1
62	4759538	4759602	997	1061	64	LEFT	N17a.EDF	N17	1
63	4768489	4768556	613	680	67	LEFT	N17a.EDF	N17	1
66	4790465	4790620	373	528	155	LEFT	N17a.EDF	N17	1
67	4796679	4796825	403	549	146	LEFT	N17a.EDF	N17	1
69	4812325	4812415	483	573	90	LEFT	N17a.EDF	N17	1
70	4820558	4820608	546	596	50	LEFT	N17a.EDF	N17	1
72	4835586	4835700	222	336	114	LEFT	N17a.EDF	N17	1
74	4851128	4851209	459	540	81	LEFT	N17a.EDF	N17	1
79	4889746	4889834	479	567	88	LEFT	N17a.EDF	N17	1
80	4896350	4896441	829	920	91	LEFT	N17a.EDF	N17	1
86	4938128	4938201	61	134	73	LEFT	N17a.EDF	N17	1
86	4938398	4938533	331	466	135	LEFT	N17a.EDF	N17	1
88	4955396	4955452	493	549	56	LEFT	N17a.EDF	N17	1
88	4956079	4956240	1176	1337	161	LEFT	N17a.EDF	N17	1
89	4962753	4962854	477	578	101	LEFT	N17a.EDF	N17	1
90	4968768	4968868	324	424	100	LEFT	N17a.EDF	N17	1
91	4976497	4976830	141	474	333	LEFT	N17a.EDF	N17	1
91	4977407	4979190	1051	2834	1783	LEFT	N17a.EDF	N17	1
95	5002891	5002977	235	321	86	LEFT	N17a.EDF	N17	1
96	5009183	5009239	73	129	56	LEFT	N17a.EDF	N17	1
96	5009428	5009529	318	419	101	LEFT	N17a.EDF	N17	1
97	5015967	5016073	318	424	106	LEFT	N17a.EDF	N17	1
98	5022301	5022574	58	331	273	LEFT	N17a.EDF	N17	1
100	5037175	5037261	429	515	86	LEFT	N17a.EDF	N17	1
103	5058174	5058239	559	624	65	LEFT	N17a.EDF	N17	1
105	5070572	5070671	450	549	99	LEFT	N17a.EDF	N17	1
106	5076436	5076561	280	405	125	LEFT	N17a.EDF	N17	1
106	5077134	5077232	978	1076	98	LEFT	N17a.EDF	N17	1
107	5083363	5083477	1236	1350	114	LEFT	N17a.EDF	N17	1
110	5103392	5103431	553	592	39	LEFT	N17a.EDF	N17	1
112	5115534	5115665	302	433	131	LEFT	N17a.EDF	N17	1
113	5121642	5121707	107	172	65	LEFT	N17a.EDF	N17	1
114	5128890	5129025	316	451	135	LEFT	N17a.EDF	N17	1
115	5135520	5135677	148	305	157	LEFT	N17a.EDF	N17	1
116	5142101	5142225	394	518	124	LEFT	N17a.EDF	N17	1
117	5149451	5149531	557	637	80	LEFT	N17a.EDF	N17	1
118	5156183	5156293	389	499	110	LEFT	N17a.EDF	N17	1
118	5157251	5157334	1457	1540	83	LEFT	N17a.EDF	N17	1
119	5163335	5163493	360	518	158	LEFT	N17a.EDF	N17	1
120	5175202	5175291	483	572	89	LEFT	N17a.EDF	N17	1
1	5528106	5528164	199	257	58	LEFT	N17b.EDF	N17	2
1	5528354	5528469	447	562	115	LEFT	N17b.EDF	N17	2
1	5528635	5528752	728	845	117	LEFT	N17b.EDF	N17	2
1	5529007	5529126	1100	1219	119	LEFT	N17b.EDF	N17	2
1	5529666	5529791	1759	1884	125	LEFT	N17b.EDF	N17	2
2	5535005	5535076	203	274	71	LEFT	N17b.EDF	N17	2
3	5544616	5544744	400	528	128	LEFT	N17b.EDF	N17	2
4	5550285	5550360	58	133	75	LEFT	N17b.EDF	N17	2
5	5557797	5557944	261	408	147	LEFT	N17b.EDF	N17	2
6	5564628	5564742	331	445	114	LEFT	N17b.EDF	N17	2
6	5565012	5566030	715	1733	1018	LEFT	N17b.EDF	N17	2
7	5574038	5574108	267	337	70	LEFT	N17b.EDF	N17	2
8	5581308	5581359	80	131	51	LEFT	N17b.EDF	N17	2
8	5581514	5581675	286	447	161	LEFT	N17b.EDF	N17	2
9	5588100	5588165	58	123	65	LEFT	N17b.EDF	N17	2
10	5594828	5595357	331	860	529	LEFT	N17b.EDF	N17	2
10	5595770	5595785	1273	1288	15	LEFT	N17b.EDF	N17	2
11	5600752	5601274	58	580	522	LEFT	N17b.EDF	N17	2
11	5601357	5601422	663	728	65	LEFT	N17b.EDF	N17	2
11	5601604	5601981	910	1287	377	LEFT	N17b.EDF	N17	2
12	5608081	5608322	179	420	241	LEFT	N17b.EDF	N17	2
14	5622280	5622425	60	205	145	LEFT	N17b.EDF	N17	2
15	5628991	5629117	58	184	126	LEFT	N17b.EDF	N17	2
16	5636781	5636926	195	340	145	LEFT	N17b.EDF	N17	2
17	5642994	5643049	330	385	55	LEFT	N17b.EDF	N17	2
18	5648949	5649042	58	151	93	LEFT	N17b.EDF	N17	2
19	5655816	5656043	317	544	227	LEFT	N17b.EDF	N17	2
19	5656590	5656784	1091	1285	194	LEFT	N17b.EDF	N17	2
20	5662473	5662560	58	145	87	LEFT	N17b.EDF	N17	2
20	5662700	5663044	285	629	344	LEFT	N17b.EDF	N17	2
22	5676084	5676261	339	516	177	LEFT	N17b.EDF	N17	2
23	5683619	5683774	494	649	155	LEFT	N17b.EDF	N17	2
24	5689283	5689729	66	512	446	LEFT	N17b.EDF	N17	2
24	5690488	5692275	1271	3058	1787	LEFT	N17b.EDF	N17	2
24	5692496	5692654	3279	3437	158	LEFT	N17b.EDF	N17	2
25	5696863	5697060	262	459	197	LEFT	N17b.EDF	N17	2
25	5697334	5697576	733	975	242	LEFT	N17b.EDF	N17	2
25	5697615	5697631	1014	1030	16	LEFT	N17b.EDF	N17	2
25	5697702	5698299	1101	1698	597	LEFT	N17b.EDF	N17	2
25	5698334	5698379	1733	1778	45	LEFT	N17b.EDF	N17	2
25	5698912	5699253	2311	2652	341	LEFT	N17b.EDF	N17	2
29	5725048	5725212	126	290	164	LEFT	N17b.EDF	N17	2
31	5737557	5737986	88	517	429	LEFT	N17b.EDF	N17	2
36	5772842	5772975	389	522	133	LEFT	N17b.EDF	N17	2
38	5789160	5789269	3001	3110	109	LEFT	N17b.EDF	N17	2
39	5793010	5793329	337	656	319	LEFT	N17b.EDF	N17	2
40	5802346	5802620	516	790	274	LEFT	N17b.EDF	N17	2
42	5814394	5814546	327	479	152	LEFT	N17b.EDF	N17	2
43	5820765	5820915	455	605	150	LEFT	N17b.EDF	N17	2
44	5827174	5827329	247	402	155	LEFT	N17b.EDF	N17	2
45	5833473	5833589	466	582	116	LEFT	N17b.EDF	N17	2
46	5839614	5839704	164	254	90	LEFT	N17b.EDF	N17	2
47	5846046	5846092	450	496	46	LEFT	N17b.EDF	N17	2
48	5852230	5852682	142	594	452	LEFT	N17b.EDF	N17	2
48	5852739	5852959	651	871	220	LEFT	N17b.EDF	N17	2
48	5853154	5853156	1066	1068	2	LEFT	N17b.EDF	N17	2
48	5853185	5853397	1097	1309	212	LEFT	N17b.EDF	N17	2
48	5853534	5853914	1446	1826	380	LEFT	N17b.EDF	N17	2
48	5854411	5854646	2323	2558	235	LEFT	N17b.EDF	N17	2
48	5854911	5855201	2823	3113	290	LEFT	N17b.EDF	N17	2
49	5859612	5860027	59	474	415	LEFT	N17b.EDF	N17	2
49	5860510	5860531	957	978	21	LEFT	N17b.EDF	N17	2
50	5871129	5871199	3052	3122	70	LEFT	N17b.EDF	N17	2
50	5872679	5872696	4602	4619	17	LEFT	N17b.EDF	N17	2
50	5872720	5872721	4643	4644	1	LEFT	N17b.EDF	N17	2
52	5881516	5881620	167	271	104	LEFT	N17b.EDF	N17	2
52	5882967	5883076	1618	1727	109	LEFT	N17b.EDF	N17	2
53	5889155	5889191	58	94	36	LEFT	N17b.EDF	N17	2
53	5889428	5889666	331	569	238	LEFT	N17b.EDF	N17	2
53	5890293	5890569	1196	1472	276	LEFT	N17b.EDF	N17	2
53	5890650	5890697	1553	1600	47	LEFT	N17b.EDF	N17	2
53	5890789	5890804	1692	1707	15	LEFT	N17b.EDF	N17	2
53	5890849	5891229	1752	2132	380	LEFT	N17b.EDF	N17	2
53	5891283	5892166	2186	3069	883	LEFT	N17b.EDF	N17	2
53	5892201	5892202	3104	3105	1	LEFT	N17b.EDF	N17	2
53	5892307	5893617	3210	4520	1310	LEFT	N17b.EDF	N17	2
54	5896037	5896427	277	667	390	LEFT	N17b.EDF	N17	2
54	5896449	5896450	689	690	1	LEFT	N17b.EDF	N17	2
54	5897053	5897076	1293	1316	23	LEFT	N17b.EDF	N17	2
54	5897098	5897099	1338	1339	1	LEFT	N17b.EDF	N17	2
55	5903003	5903024	58	79	21	LEFT	N17b.EDF	N17	2
55	5903144	5903367	199	422	223	LEFT	N17b.EDF	N17	2
55	5903420	5903612	475	667	192	LEFT	N17b.EDF	N17	2
57	5915846	5915903	666	723	57	LEFT	N17b.EDF	N17	2
57	5918469	5918651	3289	3471	182	LEFT	N17b.EDF	N17	2
58	5921695	5921765	58	128	70	LEFT	N17b.EDF	N17	2
58	5922098	5922279	461	642	181	LEFT	N17b.EDF	N17	2
59	5928010	5928014	200	204	4	LEFT	N17b.EDF	N17	2
59	5929809	5930111	1999	2301	302	LEFT	N17b.EDF	N17	2
60	5936572	5937093	124	645	521	LEFT	N17b.EDF	N17	2
61	5943279	5943774	59	554	495	LEFT	N17b.EDF	N17	2
62	5951757	5951985	83	311	228	LEFT	N17b.EDF	N17	2
62	5952139	5952353	465	679	214	LEFT	N17b.EDF	N17	2
63	5958458	5958635	103	280	177	LEFT	N17b.EDF	N17	2
63	5960619	5960845	2264	2490	226	LEFT	N17b.EDF	N17	2
64	5966483	5966718	281	516	235	LEFT	N17b.EDF	N17	2
65	5972484	5972734	58	308	250	LEFT	N17b.EDF	N17	2
66	5978606	5978784	353	531	178	LEFT	N17b.EDF	N17	2
67	5985749	5985934	115	300	185	LEFT	N17b.EDF	N17	2
67	5987515	5987541	1881	1907	26	LEFT	N17b.EDF	N17	2
67	5987954	5988144	2320	2510	190	LEFT	N17b.EDF	N17	2
68	5992298	5992555	407	664	257	LEFT	N17b.EDF	N17	2
69	5999840	5999926	58	144	86	LEFT	N17b.EDF	N17	2
69	6000095	6000365	313	583	270	LEFT	N17b.EDF	N17	2
69	6000473	6000705	691	923	232	LEFT	N17b.EDF	N17	2
70	6007031	6007345	294	608	314	LEFT	N17b.EDF	N17	2
71	6014828	6014906	58	136	78	LEFT	N17b.EDF	N17	2
71	6015025	6015256	255	486	231	LEFT	N17b.EDF	N17	2
72	6021620	6021923	300	603	303	LEFT	N17b.EDF	N17	2
73	6028875	6029005	59	189	130	LEFT	N17b.EDF	N17	2
73	6029085	6029380	269	564	295	LEFT	N17b.EDF	N17	2
74	6035286	6035531	283	528	245	LEFT	N17b.EDF	N17	2
75	6042392	6042775	280	663	383	LEFT	N17b.EDF	N17	2
76	6047999	6048229	66	296	230	LEFT	N17b.EDF	N17	2
76	6048312	6048549	379	616	237	LEFT	N17b.EDF	N17	2
77	6055204	6055418	334	548	214	LEFT	N17b.EDF	N17	2
78	6061502	6061756	307	561	254	LEFT	N17b.EDF	N17	2
79	6068538	6068550	1630	1642	12	LEFT	N17b.EDF	N17	2
80	6075694	6075695	145	146	1	LEFT	N17b.EDF	N17	2
80	6075724	6075915	175	366	191	LEFT	N17b.EDF	N17	2
81	6082305	6082371	59	125	66	LEFT	N17b.EDF	N17	2
81	6082621	6082814	375	568	193	LEFT	N17b.EDF	N17	2
83	6094573	6094613	224	264	40	LEFT	N17b.EDF	N17	2
83	6094644	6095098	295	749	454	LEFT	N17b.EDF	N17	2
83	6095805	6096428	1456	2079	623	LEFT	N17b.EDF	N17	2
83	6096451	6096452	2102	2103	1	LEFT	N17b.EDF	N17	2
83	6096534	6096545	2185	2196	11	LEFT	N17b.EDF	N17	2
83	6097861	6098810	3512	4461	949	LEFT	N17b.EDF	N17	2
83	6098837	6098839	4488	4490	2	LEFT	N17b.EDF	N17	2
83	6099221	6099229	4872	4880	8	LEFT	N17b.EDF	N17	2
84	6100695	6100874	59	238	179	LEFT	N17b.EDF	N17	2
84	6100968	6100977	332	341	9	LEFT	N17b.EDF	N17	2
84	6101044	6101069	408	433	25	LEFT	N17b.EDF	N17	2
84	6101990	6102218	1354	1582	228	LEFT	N17b.EDF	N17	2
84	6103850	6103860	3214	3224	10	LEFT	N17b.EDF	N17	2
84	6103896	6103898	3260	3262	2	LEFT	N17b.EDF	N17	2
85	6107939	6107981	58	100	42	LEFT	N17b.EDF	N17	2
85	6108188	6108436	307	555	248	LEFT	N17b.EDF	N17	2
85	6109600	6111143	1719	3262	1543	LEFT	N17b.EDF	N17	2
85	6111172	6111177	3291	3296	5	LEFT	N17b.EDF	N17	2
85	6111207	6111267	3326	3386	60	LEFT	N17b.EDF	N17	2
85	6111347	6111348	3466	3467	1	LEFT	N17b.EDF	N17	2
85	6112393	6112420	4512	4539	27	LEFT	N17b.EDF	N17	2
85	6112447	6112519	4566	4638	72	LEFT	N17b.EDF	N17	2
85	6112572	6112619	4691	4738	47	LEFT	N17b.EDF	N17	2
85	6112660	6112661	4779	4780	1	LEFT	N17b.EDF	N17	2
85	6112794	6112816	4913	4935	22	LEFT	N17b.EDF	N17	2
85	6112848	6112851	4967	4970	3	LEFT	N17b.EDF	N17	2
85	6112874	6112966	4993	5085	92	LEFT	N17b.EDF	N17	2
85	6112988	6113037	5107	5156	49	LEFT	N17b.EDF	N17	2
86	6115153	6115686	59	592	533	LEFT	N17b.EDF	N17	2
86	6115710	6115711	616	617	1	LEFT	N17b.EDF	N17	2
86	6117606	6117607	2512	2513	1	LEFT	N17b.EDF	N17	2
86	6117707	6117708	2613	2614	1	LEFT	N17b.EDF	N17	2
86	6117731	6117734	2637	2640	3	LEFT	N17b.EDF	N17	2
86	6117774	6117779	2680	2685	5	LEFT	N17b.EDF	N17	2
87	6121413	6121855	135	577	442	LEFT	N17b.EDF	N17	2
87	6122073	6122195	795	917	122	LEFT	N17b.EDF	N17	2
87	6122216	6122227	938	949	11	LEFT	N17b.EDF	N17	2
87	6122255	6122255	977	977	0	LEFT	N17b.EDF	N17	2
87	6122416	6122417	1138	1139	1	LEFT	N17b.EDF	N17	2
87	6122461	6122468	1183	1190	7	LEFT	N17b.EDF	N17	2
87	6122500	6122536	1222	1258	36	LEFT	N17b.EDF	N17	2
87	6122564	6122596	1286	1318	32	LEFT	N17b.EDF	N17	2
87	6122646	6123013	1368	1735	367	LEFT	N17b.EDF	N17	2
87	6124046	6124396	2768	3118	350	LEFT	N17b.EDF	N17	2
87	6125498	6125508	4220	4230	10	LEFT	N17b.EDF	N17	2
88	6127788	6128950	58	1220	1162	LEFT	N17b.EDF	N17	2
88	6129261	6129617	1531	1887	356	LEFT	N17b.EDF	N17	2
88	6129640	6129669	1910	1939	29	LEFT	N17b.EDF	N17	2
88	6130196	6130315	2466	2585	119	LEFT	N17b.EDF	N17	2
88	6130362	6130408	2632	2678	46	LEFT	N17b.EDF	N17	2
88	6130437	6130438	2707	2708	1	LEFT	N17b.EDF	N17	2
88	6130468	6131576	2738	3846	1108	LEFT	N17b.EDF	N17	2
89	6135320	6135321	404	405	1	LEFT	N17b.EDF	N17	2
89	6135349	6135952	433	1036	603	LEFT	N17b.EDF	N17	2
90	6141229	6141493	59	323	264	LEFT	N17b.EDF	N17	2
90	6141562	6141813	392	643	251	LEFT	N17b.EDF	N17	2
91	6147613	6148554	59	1000	941	LEFT	N17b.EDF	N17	2
92	6153985	6154836	58	909	851	LEFT	N17b.EDF	N17	2
92	6154858	6154922	931	995	64	LEFT	N17b.EDF	N17	2
92	6154974	6155001	1047	1074	27	LEFT	N17b.EDF	N17	2
92	6155595	6155608	1668	1681	13	LEFT	N17b.EDF	N17	2
93	6162050	6162133	58	141	83	LEFT	N17b.EDF	N17	2
93	6162314	6162576	322	584	262	LEFT	N17b.EDF	N17	2
94	6168316	6168633	59	376	317	LEFT	N17b.EDF	N17	2
94	6168903	6168911	646	654	8	LEFT	N17b.EDF	N17	2
94	6168980	6169067	723	810	87	LEFT	N17b.EDF	N17	2
95	6175440	6175668	411	639	228	LEFT	N17b.EDF	N17	2
95	6178420	6178428	3391	3399	8	LEFT	N17b.EDF	N17	2
96	6183151	6183212	128	189	61	LEFT	N17b.EDF	N17	2
96	6184905	6184994	1882	1971	89	LEFT	N17b.EDF	N17	2
97	6189536	6189700	439	603	164	LEFT	N17b.EDF	N17	2
97	6190366	6190547	1269	1450	181	LEFT	N17b.EDF	N17	2
97	6190781	6190932	1684	1835	151	LEFT	N17b.EDF	N17	2
97	6191112	6191232	2015	2135	120	LEFT	N17b.EDF	N17	2
97	6193067	6193232	3970	4135	165	LEFT	N17b.EDF	N17	2
98	6198577	6198713	329	465	136	LEFT	N17b.EDF	N17	2
99	6204751	6204913	227	389	162	LEFT	N17b.EDF	N17	2
100	6211290	6211482	192	384	192	LEFT	N17b.EDF	N17	2
101	6218192	6218214	102	124	22	LEFT	N17b.EDF	N17	2
101	6218435	6218605	345	515	170	LEFT	N17b.EDF	N17	2
102	6224252	6224399	153	300	147	LEFT	N17b.EDF	N17	2
103	6231615	6231805	334	524	190	LEFT	N17b.EDF	N17	2
105	6245320	6245645	366	691	325	LEFT	N17b.EDF	N17	2
106	6252467	6252686	151	370	219	LEFT	N17b.EDF	N17	2
107	6259006	6259089	73	156	83	LEFT	N17b.EDF	N17	2
107	6259248	6259662	315	729	414	LEFT	N17b.EDF	N17	2
107	6260464	6260493	1531	1560	29	LEFT	N17b.EDF	N17	2
107	6260522	6260681	1589	1748	159	LEFT	N17b.EDF	N17	2
107	6260763	6262770	1830	3837	2007	LEFT	N17b.EDF	N17	2
107	6263402	6263403	4469	4470	1	LEFT	N17b.EDF	N17	2
107	6263439	6263510	4506	4577	71	LEFT	N17b.EDF	N17	2
108	6264961	6265738	58	835	777	LEFT	N17b.EDF	N17	2
108	6265763	6265764	860	861	1	LEFT	N17b.EDF	N17	2
108	6265929	6266076	1026	1173	147	LEFT	N17b.EDF	N17	2
108	6266103	6266404	1200	1501	301	LEFT	N17b.EDF	N17	2
108	6266447	6266448	1544	1545	1	LEFT	N17b.EDF	N17	2
108	6266474	6266477	1571	1574	3	LEFT	N17b.EDF	N17	2
108	6266588	6266589	1685	1686	1	LEFT	N17b.EDF	N17	2
108	6266617	6266618	1714	1715	1	LEFT	N17b.EDF	N17	2
108	6266680	6266799	1777	1896	119	LEFT	N17b.EDF	N17	2
108	6267432	6269671	2529	4768	2239	LEFT	N17b.EDF	N17	2
109	6273657	6273980	512	835	323	LEFT	N17b.EDF	N17	2
109	6274861	6274869	1716	1724	8	LEFT	N17b.EDF	N17	2
109	6275562	6275697	2417	2552	135	LEFT	N17b.EDF	N17	2
109	6275817	6276787	2672	3642	970	LEFT	N17b.EDF	N17	2
109	6276871	6277727	3726	4582	856	LEFT	N17b.EDF	N17	2
109	6277754	6277763	4609	4618	9	LEFT	N17b.EDF	N17	2
109	6277800	6277889	4655	4744	89	LEFT	N17b.EDF	N17	2
109	6277916	6277939	4771	4794	23	LEFT	N17b.EDF	N17	2
109	6277960	6277982	4815	4837	22	LEFT	N17b.EDF	N17	2
110	6280314	6280669	350	705	355	LEFT	N17b.EDF	N17	2
110	6281048	6281073	1084	1109	25	LEFT	N17b.EDF	N17	2
110	6282400	6282417	2436	2453	17	LEFT	N17b.EDF	N17	2
111	6286601	6286653	58	110	52	LEFT	N17b.EDF	N17	2
111	6286905	6287155	362	612	250	LEFT	N17b.EDF	N17	2
112	6293575	6293625	58	108	50	LEFT	N17b.EDF	N17	2
112	6293810	6294148	293	631	338	LEFT	N17b.EDF	N17	2
112	6295266	6295405	1749	1888	139	LEFT	N17b.EDF	N17	2
113	6299534	6299768	194	428	234	LEFT	N17b.EDF	N17	2
113	6301456	6301666	2116	2326	210	LEFT	N17b.EDF	N17	2
114	6305426	6305979	91	644	553	LEFT	N17b.EDF	N17	2
114	6309324	6309506	3989	4171	182	LEFT	N17b.EDF	N17	2
114	6309528	6309549	4193	4214	21	LEFT	N17b.EDF	N17	2
114	6309574	6309577	4239	4242	3	LEFT	N17b.EDF	N17	2
114	6309601	6309618	4266	4283	17	LEFT	N17b.EDF	N17	2
115	6311991	6312589	84	682	598	LEFT	N17b.EDF	N17	2
116	6318247	6318494	180	427	247	LEFT	N17b.EDF	N17	2
117	6324295	6324414	210	329	119	LEFT	N17b.EDF	N17	2
118	6330453	6330575	67	189	122	LEFT	N17b.EDF	N17	2
118	6330818	6331056	432	670	238	LEFT	N17b.EDF	N17	2
118	6332517	6332675	2131	2289	158	LEFT	N17b.EDF	N17	2
119	6337099	6337399	214	514	300	LEFT	N17b.EDF	N17	2
120	6343236	6343534	110	408	298	LEFT	N17b.EDF	N17	2
2	2901458	2901568	194	304	110	LEFT	N64a.EDF	N64	1
2	2902416	2902570	1152	1306	154	LEFT	N64a.EDF	N64	1
3	2909661	2909752	992	1083	91	LEFT	N64a.EDF	N64	1
4	2919740	2919919	701	880	179	LEFT	N64a.EDF	N64	1
4	2920524	2920678	1485	1639	154	LEFT	N64a.EDF	N64	1
4	2920699	2920715	1660	1676	16	LEFT	N64a.EDF	N64	1
5	2932695	2932891	864	1060	196	LEFT	N64a.EDF	N64	1
6	2943035	2943049	637	651	14	LEFT	N64a.EDF	N64	1
6	2943510	2943621	1112	1223	111	LEFT	N64a.EDF	N64	1
6	2943648	2943662	1250	1264	14	LEFT	N64a.EDF	N64	1
7	2951736	2951854	932	1050	118	LEFT	N64a.EDF	N64	1
8	2961423	2961510	983	1070	87	LEFT	N64a.EDF	N64	1
8	2961533	2961555	1093	1115	22	LEFT	N64a.EDF	N64	1
9	2971260	2971402	1054	1196	142	LEFT	N64a.EDF	N64	1
9	2971433	2971454	1227	1248	21	LEFT	N64a.EDF	N64	1
10	2983610	2983795	147	332	185	LEFT	N64a.EDF	N64	1
10	2984221	2984397	758	934	176	LEFT	N64a.EDF	N64	1
10	2984425	2984440	962	977	15	LEFT	N64a.EDF	N64	1
11	2993526	2993692	204	370	166	LEFT	N64a.EDF	N64	1
11	2993713	2993725	391	403	12	LEFT	N64a.EDF	N64	1
11	2994283	2994434	961	1112	151	LEFT	N64a.EDF	N64	1
11	2994457	2994474	1135	1152	17	LEFT	N64a.EDF	N64	1
12	3003963	3004102	730	869	139	LEFT	N64a.EDF	N64	1
12	3004129	3004143	896	910	14	LEFT	N64a.EDF	N64	1
12	3008048	3008235	4815	5002	187	LEFT	N64a.EDF	N64	1
13	3013612	3013703	272	363	91	LEFT	N64a.EDF	N64	1
13	3014257	3014386	917	1046	129	LEFT	N64a.EDF	N64	1
13	3014418	3014428	1078	1088	10	LEFT	N64a.EDF	N64	1
13	3015142	3015261	1802	1921	119	LEFT	N64a.EDF	N64	1
13	3015291	3015311	1951	1971	20	LEFT	N64a.EDF	N64	1
14	3025648	3025972	590	914	324	LEFT	N64a.EDF	N64	1
15	3037590	3037782	636	828	192	LEFT	N64a.EDF	N64	1
16	3050137	3050378	630	871	241	LEFT	N64a.EDF	N64	1
16	3050406	3050418	899	911	12	LEFT	N64a.EDF	N64	1
17	3060828	3060898	58	128	70	LEFT	N64a.EDF	N64	1
17	3060935	3060940	165	170	5	LEFT	N64a.EDF	N64	1
17	3061601	3061781	831	1011	180	LEFT	N64a.EDF	N64	1
17	3061810	3061828	1040	1058	18	LEFT	N64a.EDF	N64	1
18	3070353	3070543	308	498	190	LEFT	N64a.EDF	N64	1
18	3071424	3071563	1379	1518	139	LEFT	N64a.EDF	N64	1
18	3071594	3071606	1549	1561	12	LEFT	N64a.EDF	N64	1
19	3081380	3081507	58	185	127	LEFT	N64a.EDF	N64	1
19	3081684	3081843	362	521	159	LEFT	N64a.EDF	N64	1
19	3082387	3082657	1065	1335	270	LEFT	N64a.EDF	N64	1
19	3082692	3082713	1370	1391	21	LEFT	N64a.EDF	N64	1
19	3083498	3083535	2176	2213	37	LEFT	N64a.EDF	N64	1
19	3084534	3084646	3212	3324	112	LEFT	N64a.EDF	N64	1
19	3086143	3086232	4821	4910	89	LEFT	N64a.EDF	N64	1
20	3093835	3093924	343	432	89	LEFT	N64a.EDF	N64	1
20	3094832	3095119	1340	1627	287	LEFT	N64a.EDF	N64	1
20	3098289	3098393	4797	4901	104	LEFT	N64a.EDF	N64	1
21	3102622	3102762	57	197	140	LEFT	N64a.EDF	N64	1
21	3103349	3103570	784	1005	221	LEFT	N64a.EDF	N64	1
21	3107514	3107728	4949	5163	214	LEFT	N64a.EDF	N64	1
22	3117929	3118196	614	881	267	LEFT	N64a.EDF	N64	1
23	3129702	3129787	616	701	85	LEFT	N64a.EDF	N64	1
23	3129810	3129829	724	743	19	LEFT	N64a.EDF	N64	1
23	3130535	3130667	1449	1581	132	LEFT	N64a.EDF	N64	1
23	3130698	3130717	1612	1631	19	LEFT	N64a.EDF	N64	1
23	3134381	3134501	5295	5415	120	LEFT	N64a.EDF	N64	1
24	3138084	3138145	58	119	61	LEFT	N64a.EDF	N64	1
24	3142295	3142432	4269	4406	137	LEFT	N64a.EDF	N64	1
24	3142456	3142492	4430	4466	36	LEFT	N64a.EDF	N64	1
24	3143846	3144015	5820	5989	169	LEFT	N64a.EDF	N64	1
24	3144044	3144061	6018	6035	17	LEFT	N64a.EDF	N64	1
25	3148257	3148276	63	82	19	LEFT	N64a.EDF	N64	1
25	3149433	3149580	1239	1386	147	LEFT	N64a.EDF	N64	1
25	3149617	3149638	1423	1444	21	LEFT	N64a.EDF	N64	1
26	3157945	3158033	967	1055	88	LEFT	N64a.EDF	N64	1
26	3158074	3158093	1096	1115	19	LEFT	N64a.EDF	N64	1
26	3161158	3161324	4180	4346	166	LEFT	N64a.EDF	N64	1
27	3170792	3170939	346	493	147	LEFT	N64a.EDF	N64	1
27	3170976	3170984	530	538	8	LEFT	N64a.EDF	N64	1
27	3171637	3171940	1191	1494	303	LEFT	N64a.EDF	N64	1
27	3175892	3176039	5446	5593	147	LEFT	N64a.EDF	N64	1
28	3187120	3187326	938	1144	206	LEFT	N64a.EDF	N64	1
28	3192165	3192348	5983	6166	183	LEFT	N64a.EDF	N64	1
29	3200008	3200233	894	1119	225	LEFT	N64a.EDF	N64	1
30	3209469	3209548	59	138	79	LEFT	N64a.EDF	N64	1
30	3210547	3210654	1137	1244	107	LEFT	N64a.EDF	N64	1
30	3210686	3210705	1276	1295	19	LEFT	N64a.EDF	N64	1
31	3217933	3217957	58	82	24	LEFT	N64a.EDF	N64	1
31	3217980	3218003	105	128	23	LEFT	N64a.EDF	N64	1
31	3218030	3218031	155	156	1	LEFT	N64a.EDF	N64	1
31	3218906	3219040	1031	1165	134	LEFT	N64a.EDF	N64	1
31	3219071	3219089	1196	1214	18	LEFT	N64a.EDF	N64	1
31	3222898	3223057	5023	5182	159	LEFT	N64a.EDF	N64	1
32	3231690	3231882	735	927	192	LEFT	N64a.EDF	N64	1
32	3231910	3231928	955	973	18	LEFT	N64a.EDF	N64	1
33	3241577	3241597	58	78	20	LEFT	N64a.EDF	N64	1
33	3242187	3242407	668	888	220	LEFT	N64a.EDF	N64	1
34	3254014	3254141	266	393	127	LEFT	N64a.EDF	N64	1
34	3254171	3254175	423	427	4	LEFT	N64a.EDF	N64	1
34	3254914	3254994	1166	1246	80	LEFT	N64a.EDF	N64	1
34	3255021	3255041	1273	1293	20	LEFT	N64a.EDF	N64	1
34	3257323	3257490	3575	3742	167	LEFT	N64a.EDF	N64	1
34	3257537	3257537	3789	3789	0	LEFT	N64a.EDF	N64	1
34	3259721	3259907	5973	6159	186	LEFT	N64a.EDF	N64	1
35	3267349	3267459	358	468	110	LEFT	N64a.EDF	N64	1
35	3267480	3267486	489	495	6	LEFT	N64a.EDF	N64	1
35	3268069	3268240	1078	1249	171	LEFT	N64a.EDF	N64	1
35	3268272	3268295	1281	1304	23	LEFT	N64a.EDF	N64	1
36	3278645	3278806	842	1003	161	LEFT	N64a.EDF	N64	1
36	3278843	3278865	1040	1062	22	LEFT	N64a.EDF	N64	1
37	3288296	3288415	227	346	119	LEFT	N64a.EDF	N64	1
37	3288438	3288479	369	410	41	LEFT	N64a.EDF	N64	1
37	3292490	3292644	4421	4575	154	LEFT	N64a.EDF	N64	1
37	3292681	3292689	4612	4620	8	LEFT	N64a.EDF	N64	1
38	3296551	3296564	86	99	13	LEFT	N64a.EDF	N64	1
38	3297503	3297588	1038	1123	85	LEFT	N64a.EDF	N64	1
38	3297630	3297648	1165	1183	18	LEFT	N64a.EDF	N64	1
39	3306869	3307027	768	926	158	LEFT	N64a.EDF	N64	1
39	3307051	3307071	950	970	20	LEFT	N64a.EDF	N64	1
39	3310351	3310572	4250	4471	221	LEFT	N64a.EDF	N64	1
40	3316032	3316248	612	828	216	LEFT	N64a.EDF	N64	1
40	3316280	3316297	860	877	17	LEFT	N64a.EDF	N64	1
40	3317607	3317611	2187	2191	4	LEFT	N64a.EDF	N64	1
40	3317658	3317658	2238	2238	0	LEFT	N64a.EDF	N64	1
41	3325770	3325831	58	119	61	LEFT	N64a.EDF	N64	1
41	3332118	3332259	6406	6547	141	LEFT	N64a.EDF	N64	1
42	3337422	3337558	1074	1210	136	LEFT	N64a.EDF	N64	1
42	3337586	3337609	1238	1261	23	LEFT	N64a.EDF	N64	1
42	3340607	3340781	4259	4433	174	LEFT	N64a.EDF	N64	1
42	3340811	3340843	4463	4495	32	LEFT	N64a.EDF	N64	1
44	3360246	3360546	302	602	300	LEFT	N64a.EDF	N64	1
44	3360579	3360600	635	656	21	LEFT	N64a.EDF	N64	1
45	3368646	3368668	58	80	22	LEFT	N64a.EDF	N64	1
45	3369201	3369417	613	829	216	LEFT	N64a.EDF	N64	1
45	3369445	3369471	857	883	26	LEFT	N64a.EDF	N64	1
46	3377574	3377765	791	982	191	LEFT	N64a.EDF	N64	1
46	3382081	3382206	5298	5423	125	LEFT	N64a.EDF	N64	1
47	3388605	3388893	689	977	288	LEFT	N64a.EDF	N64	1
48	3400343	3400641	265	563	298	LEFT	N64a.EDF	N64	1
48	3405661	3405800	5583	5722	139	LEFT	N64a.EDF	N64	1
49	3415688	3415705	5533	5550	17	LEFT	N64a.EDF	N64	1
50	3421598	3421756	665	823	158	LEFT	N64a.EDF	N64	1
50	3425654	3425764	4721	4831	110	LEFT	N64a.EDF	N64	1
51	3433452	3433648	224	420	196	LEFT	N64a.EDF	N64	1
51	3434282	3434516	1054	1288	234	LEFT	N64a.EDF	N64	1
51	3434540	3434559	1312	1331	19	LEFT	N64a.EDF	N64	1
51	3437572	3437703	4344	4475	131	LEFT	N64a.EDF	N64	1
51	3437728	3437728	4500	4500	0	LEFT	N64a.EDF	N64	1
52	3447381	3447457	4492	4568	76	LEFT	N64a.EDF	N64	1
52	3447485	3447506	4596	4617	21	LEFT	N64a.EDF	N64	1
53	3452848	3452872	58	82	24	LEFT	N64a.EDF	N64	1
54	3461674	3461754	57	137	80	LEFT	N64a.EDF	N64	1
54	3462284	3462559	667	942	275	LEFT	N64a.EDF	N64	1
55	3473064	3473195	1281	1412	131	LEFT	N64a.EDF	N64	1
55	3473232	3473255	1449	1472	23	LEFT	N64a.EDF	N64	1
55	3477349	3477472	5566	5689	123	LEFT	N64a.EDF	N64	1
55	3477509	3477529	5726	5746	20	LEFT	N64a.EDF	N64	1
56	3483667	3483765	58	156	98	LEFT	N64a.EDF	N64	1
56	3483813	3483833	204	224	20	LEFT	N64a.EDF	N64	1
56	3484597	3484725	988	1116	128	LEFT	N64a.EDF	N64	1
56	3484765	3484803	1156	1194	38	LEFT	N64a.EDF	N64	1
58	3503474	3503496	59	81	22	LEFT	N64a.EDF	N64	1
58	3503578	3503578	163	163	0	LEFT	N64a.EDF	N64	1
58	3503602	3503616	187	201	14	LEFT	N64a.EDF	N64	1
58	3503643	3503646	228	231	3	LEFT	N64a.EDF	N64	1
58	3509429	3509615	6014	6200	186	LEFT	N64a.EDF	N64	1
59	3513563	3513564	95	96	1	LEFT	N64a.EDF	N64	1
59	3513606	3513637	138	169	31	LEFT	N64a.EDF	N64	1
59	3513668	3513682	200	214	14	LEFT	N64a.EDF	N64	1
60	3523502	3523577	58	133	75	LEFT	N64a.EDF	N64	1
60	3524353	3524618	909	1174	265	LEFT	N64a.EDF	N64	1
60	3524642	3524662	1198	1218	20	LEFT	N64a.EDF	N64	1
60	3525454	3525516	2010	2072	62	LEFT	N64a.EDF	N64	1
60	3525554	3525628	2110	2184	74	LEFT	N64a.EDF	N64	1
61	3534390	3534526	390	526	136	LEFT	N64a.EDF	N64	1
61	3535094	3535260	1094	1260	166	LEFT	N64a.EDF	N64	1
61	3535308	3535332	1308	1332	24	LEFT	N64a.EDF	N64	1
62	3545279	3545538	638	897	259	LEFT	N64a.EDF	N64	1
64	3565277	3565281	1214	1218	4	LEFT	N64a.EDF	N64	1
64	3565302	3565393	1239	1330	91	LEFT	N64a.EDF	N64	1
64	3565458	3565477	1395	1414	19	LEFT	N64a.EDF	N64	1
65	3572884	3572885	127	128	1	LEFT	N64a.EDF	N64	1
65	3574644	3574809	1887	2052	165	LEFT	N64a.EDF	N64	1
65	3575068	3575068	2311	2311	0	LEFT	N64a.EDF	N64	1
65	3575094	3575110	2337	2353	16	LEFT	N64a.EDF	N64	1
65	3579387	3579421	6630	6664	34	LEFT	N64a.EDF	N64	1
66	3584640	3584850	58	268	210	LEFT	N64a.EDF	N64	1
66	3584880	3584945	298	363	65	LEFT	N64a.EDF	N64	1
66	3584969	3584994	387	412	25	LEFT	N64a.EDF	N64	1
66	3585437	3585597	855	1015	160	LEFT	N64a.EDF	N64	1
66	3585630	3585649	1048	1067	19	LEFT	N64a.EDF	N64	1
66	3591294	3591499	6712	6917	205	LEFT	N64a.EDF	N64	1
67	3596578	3596793	560	775	215	LEFT	N64a.EDF	N64	1
67	3596831	3596850	813	832	19	LEFT	N64a.EDF	N64	1
67	3597609	3597734	1591	1716	125	LEFT	N64a.EDF	N64	1
67	3597758	3597766	1740	1748	8	LEFT	N64a.EDF	N64	1
68	3606533	3606657	218	342	124	LEFT	N64a.EDF	N64	1
68	3606680	3606685	365	370	5	LEFT	N64a.EDF	N64	1
68	3607683	3607883	1368	1568	200	LEFT	N64a.EDF	N64	1
68	3611444	3611527	5129	5212	83	LEFT	N64a.EDF	N64	1
68	3612556	3612590	6241	6275	34	LEFT	N64a.EDF	N64	1
69	3617651	3617856	1078	1283	205	LEFT	N64a.EDF	N64	1
69	3617896	3617918	1323	1345	22	LEFT	N64a.EDF	N64	1
69	3623253	3623280	6680	6707	27	LEFT	N64a.EDF	N64	1
70	3630331	3630546	696	911	215	LEFT	N64a.EDF	N64	1
70	3630573	3630595	938	960	22	LEFT	N64a.EDF	N64	1
70	3636397	3636555	6762	6920	158	LEFT	N64a.EDF	N64	1
71	3640814	3640891	57	134	77	LEFT	N64a.EDF	N64	1
71	3640937	3640952	180	195	15	LEFT	N64a.EDF	N64	1
72	3652465	3652603	371	509	138	LEFT	N64a.EDF	N64	1
73	3662343	3662551	634	842	208	LEFT	N64a.EDF	N64	1
73	3662583	3662598	874	889	15	LEFT	N64a.EDF	N64	1
73	3668000	3668092	6291	6383	92	LEFT	N64a.EDF	N64	1
73	3668120	3668122	6411	6413	2	LEFT	N64a.EDF	N64	1
74	3675400	3675581	243	424	181	LEFT	N64a.EDF	N64	1
74	3675614	3675621	457	464	7	LEFT	N64a.EDF	N64	1
74	3676502	3676655	1345	1498	153	LEFT	N64a.EDF	N64	1
74	3676683	3676697	1526	1540	14	LEFT	N64a.EDF	N64	1
74	3679406	3679506	4249	4349	100	LEFT	N64a.EDF	N64	1
74	3679532	3679548	4375	4391	16	LEFT	N64a.EDF	N64	1
75	3685720	3685853	706	839	133	LEFT	N64a.EDF	N64	1
75	3685881	3685893	867	879	12	LEFT	N64a.EDF	N64	1
75	3688789	3688855	3775	3841	66	LEFT	N64a.EDF	N64	1
76	3696889	3697156	1023	1290	267	LEFT	N64a.EDF	N64	1
76	3700313	3700459	4447	4593	146	LEFT	N64a.EDF	N64	1
76	3702050	3702162	6184	6296	112	LEFT	N64a.EDF	N64	1
77	3707757	3707934	1111	1288	177	LEFT	N64a.EDF	N64	1
77	3707962	3707980	1316	1334	18	LEFT	N64a.EDF	N64	1
78	3716566	3716587	83	104	21	LEFT	N64a.EDF	N64	1
78	3717497	3717610	1014	1127	113	LEFT	N64a.EDF	N64	1
78	3717652	3717688	1169	1205	36	LEFT	N64a.EDF	N64	1
78	3720518	3720642	4035	4159	124	LEFT	N64a.EDF	N64	1
79	3728738	3728964	969	1195	226	LEFT	N64a.EDF	N64	1
80	3737861	3738018	175	332	157	LEFT	N64a.EDF	N64	1
80	3738057	3738069	371	383	12	LEFT	N64a.EDF	N64	1
80	3738580	3738754	894	1068	174	LEFT	N64a.EDF	N64	1
80	3738781	3738806	1095	1120	25	LEFT	N64a.EDF	N64	1
81	3749318	3749324	216	222	6	LEFT	N64a.EDF	N64	1
81	3749350	3749503	248	401	153	LEFT	N64a.EDF	N64	1
81	3749532	3749548	430	446	16	LEFT	N64a.EDF	N64	1
81	3750320	3750470	1218	1368	150	LEFT	N64a.EDF	N64	1
81	3750517	3750537	1415	1435	20	LEFT	N64a.EDF	N64	1
82	3759057	3759200	58	201	143	LEFT	N64a.EDF	N64	1
82	3764465	3764617	5466	5618	152	LEFT	N64a.EDF	N64	1
83	3768745	3768883	178	316	138	LEFT	N64a.EDF	N64	1
83	3768908	3768931	341	364	23	LEFT	N64a.EDF	N64	1
83	3769797	3769926	1230	1359	129	LEFT	N64a.EDF	N64	1
83	3769952	3769978	1385	1411	26	LEFT	N64a.EDF	N64	1
83	3773023	3773102	4456	4535	79	LEFT	N64a.EDF	N64	1
83	3773128	3773130	4561	4563	2	LEFT	N64a.EDF	N64	1
83	3774482	3774601	5915	6034	119	LEFT	N64a.EDF	N64	1
83	3774628	3774631	6061	6064	3	LEFT	N64a.EDF	N64	1
84	3781651	3781923	717	989	272	LEFT	N64a.EDF	N64	1
84	3785244	3785453	4310	4519	209	LEFT	N64a.EDF	N64	1
85	3790056	3790078	58	80	22	LEFT	N64a.EDF	N64	1
85	3790132	3790140	134	142	8	LEFT	N64a.EDF	N64	1
86	3799945	3800087	218	360	142	LEFT	N64a.EDF	N64	1
87	3809081	3809165	321	405	84	LEFT	N64a.EDF	N64	1
87	3810046	3810142	1286	1382	96	LEFT	N64a.EDF	N64	1
87	3810177	3810199	1417	1439	22	LEFT	N64a.EDF	N64	1
87	3813082	3813175	4322	4415	93	LEFT	N64a.EDF	N64	1
88	3817891	3818109	651	869	218	LEFT	N64a.EDF	N64	1
88	3818135	3818156	895	916	21	LEFT	N64a.EDF	N64	1
89	3829429	3829580	207	358	151	LEFT	N64a.EDF	N64	1
89	3830142	3830297	920	1075	155	LEFT	N64a.EDF	N64	1
89	3830337	3830362	1115	1140	25	LEFT	N64a.EDF	N64	1
89	3834103	3834262	4881	5040	159	LEFT	N64a.EDF	N64	1
90	3844884	3845115	6082	6313	231	LEFT	N64a.EDF	N64	1
91	3848772	3848921	58	207	149	LEFT	N64a.EDF	N64	1
91	3852883	3853064	4169	4350	181	LEFT	N64a.EDF	N64	1
92	3858123	3858287	232	396	164	LEFT	N64a.EDF	N64	1
92	3858308	3858326	417	435	18	LEFT	N64a.EDF	N64	1
92	3858834	3859033	943	1142	199	LEFT	N64a.EDF	N64	1
92	3859065	3859089	1174	1198	24	LEFT	N64a.EDF	N64	1
92	3862903	3863035	5012	5144	132	LEFT	N64a.EDF	N64	1
92	3864470	3864563	6579	6672	93	LEFT	N64a.EDF	N64	1
93	3869413	3869582	207	376	169	LEFT	N64a.EDF	N64	1
93	3870644	3870745	1438	1539	101	LEFT	N64a.EDF	N64	1
93	3870782	3870813	1576	1607	31	LEFT	N64a.EDF	N64	1
93	3874807	3874944	5601	5738	137	LEFT	N64a.EDF	N64	1
94	3883276	3883400	71	195	124	LEFT	N64a.EDF	N64	1
94	3884747	3884881	1542	1676	134	LEFT	N64a.EDF	N64	1
95	3893318	3893430	265	377	112	LEFT	N64a.EDF	N64	1
95	3894298	3894466	1245	1413	168	LEFT	N64a.EDF	N64	1
95	3894501	3894530	1448	1477	29	LEFT	N64a.EDF	N64	1
96	3905548	3905727	179	358	179	LEFT	N64a.EDF	N64	1
96	3905766	3905774	397	405	8	LEFT	N64a.EDF	N64	1
96	3906546	3906721	1177	1352	175	LEFT	N64a.EDF	N64	1
96	3906760	3906784	1391	1415	24	LEFT	N64a.EDF	N64	1
96	3907754	3908372	2385	3003	618	LEFT	N64a.EDF	N64	1
96	3908404	3908581	3035	3212	177	LEFT	N64a.EDF	N64	1
96	3908612	3908744	3243	3375	132	LEFT	N64a.EDF	N64	1
97	3915629	3915950	164	485	321	LEFT	N64a.EDF	N64	1
97	3917432	3917544	1967	2079	112	LEFT	N64a.EDF	N64	1
98	3924699	3924887	59	247	188	LEFT	N64a.EDF	N64	1
98	3924922	3924924	282	284	2	LEFT	N64a.EDF	N64	1
98	3926537	3926537	1897	1897	0	LEFT	N64a.EDF	N64	1
100	3943627	3943791	140	304	164	LEFT	N64a.EDF	N64	1
100	3943812	3943848	325	361	36	LEFT	N64a.EDF	N64	1
100	3944601	3944861	1114	1374	260	LEFT	N64a.EDF	N64	1
100	3944883	3944929	1396	1442	46	LEFT	N64a.EDF	N64	1
101	3952266	3952356	57	147	90	LEFT	N64a.EDF	N64	1
101	3952393	3952466	184	257	73	LEFT	N64a.EDF	N64	1
101	3957977	3958104	5768	5895	127	LEFT	N64a.EDF	N64	1
102	3960841	3960926	58	143	85	LEFT	N64a.EDF	N64	1
103	3973234	3973490	314	570	256	LEFT	N64a.EDF	N64	1
103	3973518	3973551	598	631	33	LEFT	N64a.EDF	N64	1
104	3983746	3983950	80	284	204	LEFT	N64a.EDF	N64	1
104	3983979	3983999	313	333	20	LEFT	N64a.EDF	N64	1
105	3992272	3992512	58	298	240	LEFT	N64a.EDF	N64	1
105	3993327	3993510	1113	1296	183	LEFT	N64a.EDF	N64	1
105	3993546	3993565	1332	1351	19	LEFT	N64a.EDF	N64	1
105	3998180	3998358	5966	6144	178	LEFT	N64a.EDF	N64	1
106	4005028	4005120	667	759	92	LEFT	N64a.EDF	N64	1
106	4005146	4005162	785	801	16	LEFT	N64a.EDF	N64	1
107	4015179	4015340	57	218	161	LEFT	N64a.EDF	N64	1
107	4015380	4015392	258	270	12	LEFT	N64a.EDF	N64	1
107	4016933	4017021	1811	1899	88	LEFT	N64a.EDF	N64	1
107	4017051	4017075	1929	1953	24	LEFT	N64a.EDF	N64	1
108	4025772	4025873	57	158	101	LEFT	N64a.EDF	N64	1
108	4025910	4025934	195	219	24	LEFT	N64a.EDF	N64	1
108	4026786	4026928	1071	1213	142	LEFT	N64a.EDF	N64	1
108	4030272	4030444	4557	4729	172	LEFT	N64a.EDF	N64	1
109	4034265	4034359	57	151	94	LEFT	N64a.EDF	N64	1
109	4035984	4036122	1776	1914	138	LEFT	N64a.EDF	N64	1
109	4038497	4038681	4289	4473	184	LEFT	N64a.EDF	N64	1
110	4044128	4044192	84	148	64	LEFT	N64a.EDF	N64	1
110	4045099	4045196	1055	1152	97	LEFT	N64a.EDF	N64	1
111	4055349	4055526	129	306	177	LEFT	N64a.EDF	N64	1
111	4055548	4055598	328	378	50	LEFT	N64a.EDF	N64	1
111	4059284	4059457	4064	4237	173	LEFT	N64a.EDF	N64	1
112	4065052	4065196	740	884	144	LEFT	N64a.EDF	N64	1
112	4065228	4065276	916	964	48	LEFT	N64a.EDF	N64	1
112	4069436	4069604	5124	5292	168	LEFT	N64a.EDF	N64	1
113	4076024	4076220	196	392	196	LEFT	N64a.EDF	N64	1
114	4086203	4086327	1320	1444	124	LEFT	N64a.EDF	N64	1
114	4086350	4086372	1467	1489	22	LEFT	N64a.EDF	N64	1
115	4099130	4099321	259	450	191	LEFT	N64a.EDF	N64	1
116	4109152	4109249	57	154	97	LEFT	N64a.EDF	N64	1
116	4109285	4109299	190	204	14	LEFT	N64a.EDF	N64	1
116	4110482	4110637	1387	1542	155	LEFT	N64a.EDF	N64	1
116	4110664	4110684	1569	1589	20	LEFT	N64a.EDF	N64	1
117	4117591	4117748	61	218	157	LEFT	N64a.EDF	N64	1
117	4117785	4117857	255	327	72	LEFT	N64a.EDF	N64	1
118	4126225	4126261	59	95	36	LEFT	N64a.EDF	N64	1
118	4126321	4126335	155	169	14	LEFT	N64a.EDF	N64	1
118	4131808	4132006	5642	5840	198	LEFT	N64a.EDF	N64	1
119	4135631	4135647	65	81	16	LEFT	N64a.EDF	N64	1
119	4141472	4141620	5906	6054	148	LEFT	N64a.EDF	N64	1
120	4148144	4148303	85	244	159	LEFT	N64a.EDF	N64	1
120	4148351	4148366	292	307	15	LEFT	N64a.EDF	N64	1
1	5150008	5150223	1200	1415	215	LEFT	N64b.EDF	N64	2
1	5154094	5154096	5286	5288	2	LEFT	N64b.EDF	N64	2
2	5162594	5162805	251	462	211	LEFT	N64b.EDF	N64	2
2	5163472	5163664	1129	1321	192	LEFT	N64b.EDF	N64	2
2	5167441	5167520	5098	5177	79	LEFT	N64b.EDF	N64	2
3	5173917	5174107	244	434	190	LEFT	N64b.EDF	N64	2
4	5184117	5184303	799	985	186	LEFT	N64b.EDF	N64	2
4	5188370	5188383	5052	5065	13	LEFT	N64b.EDF	N64	2
4	5189892	5189984	6574	6666	92	LEFT	N64b.EDF	N64	2
5	5194320	5194498	1200	1378	178	LEFT	N64b.EDF	N64	2
6	5203427	5203707	192	472	280	LEFT	N64b.EDF	N64	2
6	5203734	5203742	499	507	8	LEFT	N64b.EDF	N64	2
7	5213059	5213312	297	550	253	LEFT	N64b.EDF	N64	2
7	5214372	5214511	1610	1749	139	LEFT	N64b.EDF	N64	2
8	5223215	5223504	58	347	289	LEFT	N64b.EDF	N64	2
8	5229147	5229153	5990	5996	6	LEFT	N64b.EDF	N64	2
9	5233228	5233549	205	526	321	LEFT	N64b.EDF	N64	2
10	5242670	5242935	174	439	265	LEFT	N64b.EDF	N64	2
10	5246193	5246204	3697	3708	11	LEFT	N64b.EDF	N64	2
10	5249786	5249951	7290	7455	165	LEFT	N64b.EDF	N64	2
11	5255097	5255303	86	292	206	LEFT	N64b.EDF	N64	2
11	5256516	5256735	1505	1724	219	LEFT	N64b.EDF	N64	2
11	5260182	5260453	5171	5442	271	LEFT	N64b.EDF	N64	2
11	5260790	5260790	5779	5779	0	LEFT	N64b.EDF	N64	2
12	5266228	5266272	57	101	44	LEFT	N64b.EDF	N64	2
12	5272598	5272739	6427	6568	141	LEFT	N64b.EDF	N64	2
13	5277024	5277298	66	340	274	LEFT	N64b.EDF	N64	2
13	5281586	5281728	4628	4770	142	LEFT	N64b.EDF	N64	2
14	5287552	5287779	617	844	227	LEFT	N64b.EDF	N64	2
14	5292331	5292462	5396	5527	131	LEFT	N64b.EDF	N64	2
16	5307853	5307913	57	117	60	LEFT	N64b.EDF	N64	2
16	5307965	5307998	169	202	33	LEFT	N64b.EDF	N64	2
16	5308769	5308986	973	1190	217	LEFT	N64b.EDF	N64	2
16	5312987	5313013	5191	5217	26	LEFT	N64b.EDF	N64	2
17	5317246	5317446	712	912	200	LEFT	N64b.EDF	N64	2
18	5326822	5327062	693	933	240	LEFT	N64b.EDF	N64	2
18	5331869	5332005	5740	5876	136	LEFT	N64b.EDF	N64	2
19	5336603	5336839	719	955	236	LEFT	N64b.EDF	N64	2
19	5339345	5339512	3461	3628	167	LEFT	N64b.EDF	N64	2
20	5345439	5345700	610	871	261	LEFT	N64b.EDF	N64	2
21	5355159	5355462	393	696	303	LEFT	N64b.EDF	N64	2
21	5361680	5361850	6914	7084	170	LEFT	N64b.EDF	N64	2
22	5365099	5365274	57	232	175	LEFT	N64b.EDF	N64	2
23	5375367	5375592	260	485	225	LEFT	N64b.EDF	N64	2
24	5386699	5386851	103	255	152	LEFT	N64b.EDF	N64	2
24	5386875	5386904	279	308	29	LEFT	N64b.EDF	N64	2
24	5392476	5392477	5880	5881	1	LEFT	N64b.EDF	N64	2
25	5396510	5396624	57	171	114	LEFT	N64b.EDF	N64	2
25	5402486	5402667	6033	6214	181	LEFT	N64b.EDF	N64	2
26	5407427	5407762	57	392	335	LEFT	N64b.EDF	N64	2
27	5416499	5416569	57	127	70	LEFT	N64b.EDF	N64	2
27	5416598	5416630	156	188	32	LEFT	N64b.EDF	N64	2
28	5427907	5428031	57	181	124	LEFT	N64b.EDF	N64	2
28	5428525	5428827	675	977	302	LEFT	N64b.EDF	N64	2
28	5431429	5431429	3579	3579	0	LEFT	N64b.EDF	N64	2
28	5432039	5432148	4189	4298	109	LEFT	N64b.EDF	N64	2
28	5432177	5432197	4327	4347	20	LEFT	N64b.EDF	N64	2
28	5432231	5432232	4381	4382	1	LEFT	N64b.EDF	N64	2
28	5432253	5432268	4403	4418	15	LEFT	N64b.EDF	N64	2
28	5432306	5432319	4456	4469	13	LEFT	N64b.EDF	N64	2
28	5432358	5432358	4508	4508	0	LEFT	N64b.EDF	N64	2
28	5432388	5432390	4538	4540	2	LEFT	N64b.EDF	N64	2
28	5432742	5432966	4892	5116	224	LEFT	N64b.EDF	N64	2
28	5432990	5433044	5140	5194	54	LEFT	N64b.EDF	N64	2
29	5438035	5438055	57	77	20	LEFT	N64b.EDF	N64	2
29	5438077	5438135	99	157	58	LEFT	N64b.EDF	N64	2
29	5443128	5443326	5150	5348	198	LEFT	N64b.EDF	N64	2
30	5448888	5449006	773	891	118	LEFT	N64b.EDF	N64	2
30	5449028	5449082	913	967	54	LEFT	N64b.EDF	N64	2
31	5457906	5457906	134	134	0	LEFT	N64b.EDF	N64	2
31	5458384	5458592	612	820	208	LEFT	N64b.EDF	N64	2
31	5458621	5458660	849	888	39	LEFT	N64b.EDF	N64	2
32	5467023	5467268	58	303	245	LEFT	N64b.EDF	N64	2
32	5471643	5471866	4678	4901	223	LEFT	N64b.EDF	N64	2
33	5476260	5476419	89	248	159	LEFT	N64b.EDF	N64	2
33	5476440	5476500	269	329	60	LEFT	N64b.EDF	N64	2
33	5481992	5482163	5821	5992	171	LEFT	N64b.EDF	N64	2
34	5486416	5486443	58	85	27	LEFT	N64b.EDF	N64	2
34	5486465	5486527	107	169	62	LEFT	N64b.EDF	N64	2
34	5492884	5492886	6526	6528	2	LEFT	N64b.EDF	N64	2
34	5493443	5493443	7085	7085	0	LEFT	N64b.EDF	N64	2
35	5499443	5499577	1001	1135	134	LEFT	N64b.EDF	N64	2
35	5499599	5499642	1157	1200	43	LEFT	N64b.EDF	N64	2
36	5507839	5507951	57	169	112	LEFT	N64b.EDF	N64	2
36	5507983	5508007	201	225	24	LEFT	N64b.EDF	N64	2
36	5513906	5514107	6124	6325	201	LEFT	N64b.EDF	N64	2
37	5518818	5518971	720	873	153	LEFT	N64b.EDF	N64	2
37	5518992	5519020	894	922	28	LEFT	N64b.EDF	N64	2
37	5519909	5520031	1811	1933	122	LEFT	N64b.EDF	N64	2
37	5520059	5520089	1961	1991	30	LEFT	N64b.EDF	N64	2
38	5528450	5528639	157	346	189	LEFT	N64b.EDF	N64	2
38	5533463	5533655	5170	5362	192	LEFT	N64b.EDF	N64	2
38	5533682	5533696	5389	5403	14	LEFT	N64b.EDF	N64	2
39	5540037	5540201	295	459	164	LEFT	N64b.EDF	N64	2
39	5540235	5540264	493	522	29	LEFT	N64b.EDF	N64	2
39	5544668	5544917	4926	5175	249	LEFT	N64b.EDF	N64	2
39	5544951	5544984	5209	5242	33	LEFT	N64b.EDF	N64	2
39	5545021	5545038	5279	5296	17	LEFT	N64b.EDF	N64	2
39	5545110	5545178	5368	5436	68	LEFT	N64b.EDF	N64	2
39	5545201	5545202	5459	5460	1	LEFT	N64b.EDF	N64	2
40	5551212	5551244	58	90	32	LEFT	N64b.EDF	N64	2
40	5551324	5551343	170	189	19	LEFT	N64b.EDF	N64	2
41	5560900	5560995	57	152	95	LEFT	N64b.EDF	N64	2
42	5570247	5570441	689	883	194	LEFT	N64b.EDF	N64	2
42	5570487	5570537	929	979	50	LEFT	N64b.EDF	N64	2
42	5573665	5573924	4107	4366	259	LEFT	N64b.EDF	N64	2
43	5578783	5579040	820	1077	257	LEFT	N64b.EDF	N64	2
43	5579068	5579092	1105	1129	24	LEFT	N64b.EDF	N64	2
43	5579120	5579123	1157	1160	3	LEFT	N64b.EDF	N64	2
44	5587876	5588069	1058	1251	193	LEFT	N64b.EDF	N64	2
44	5588095	5588138	1277	1320	43	LEFT	N64b.EDF	N64	2
44	5591901	5592052	5083	5234	151	LEFT	N64b.EDF	N64	2
45	5595001	5595044	57	100	43	LEFT	N64b.EDF	N64	2
46	5604256	5604285	56	85	29	LEFT	N64b.EDF	N64	2
46	5604318	5604337	118	137	19	LEFT	N64b.EDF	N64	2
46	5605348	5605493	1148	1293	145	LEFT	N64b.EDF	N64	2
46	5605537	5605553	1337	1353	16	LEFT	N64b.EDF	N64	2
46	5609586	5609799	5386	5599	213	LEFT	N64b.EDF	N64	2
47	5615777	5615953	93	269	176	LEFT	N64b.EDF	N64	2
47	5615978	5615996	294	312	18	LEFT	N64b.EDF	N64	2
48	5626471	5626544	57	130	73	LEFT	N64b.EDF	N64	2
48	5626575	5626616	161	202	41	LEFT	N64b.EDF	N64	2
48	5630233	5630326	3819	3912	93	LEFT	N64b.EDF	N64	2
48	5632630	5632681	6216	6267	51	LEFT	N64b.EDF	N64	2
49	5636757	5636866	56	165	109	LEFT	N64b.EDF	N64	2
49	5641538	5641742	4837	5041	204	LEFT	N64b.EDF	N64	2
50	5644327	5644537	73	283	210	LEFT	N64b.EDF	N64	2
51	5654249	5654278	58	87	29	LEFT	N64b.EDF	N64	2
51	5654971	5655094	780	903	123	LEFT	N64b.EDF	N64	2
51	5655122	5655157	931	966	35	LEFT	N64b.EDF	N64	2
51	5659213	5659397	5022	5206	184	LEFT	N64b.EDF	N64	2
51	5660771	5660964	6580	6773	193	LEFT	N64b.EDF	N64	2
52	5667297	5667303	162	168	6	LEFT	N64b.EDF	N64	2
52	5667389	5667594	254	459	205	LEFT	N64b.EDF	N64	2
52	5667631	5667647	496	512	16	LEFT	N64b.EDF	N64	2
52	5671327	5671372	4192	4237	45	LEFT	N64b.EDF	N64	2
53	5676660	5676856	116	312	196	LEFT	N64b.EDF	N64	2
54	5689110	5689239	187	316	129	LEFT	N64b.EDF	N64	2
56	5708352	5708565	177	390	213	LEFT	N64b.EDF	N64	2
57	5718059	5718099	57	97	40	LEFT	N64b.EDF	N64	2
57	5718145	5718159	143	157	14	LEFT	N64b.EDF	N64	2
58	5727116	5727209	57	150	93	LEFT	N64b.EDF	N64	2
58	5732432	5732475	5373	5416	43	LEFT	N64b.EDF	N64	2
59	5738210	5738222	70	82	12	LEFT	N64b.EDF	N64	2
60	5748840	5749023	1474	1657	183	LEFT	N64b.EDF	N64	2
60	5753173	5753281	5807	5915	108	LEFT	N64b.EDF	N64	2
61	5758156	5758428	59	331	272	LEFT	N64b.EDF	N64	2
61	5764148	5764243	6051	6146	95	LEFT	N64b.EDF	N64	2
62	5768290	5768382	58	150	92	LEFT	N64b.EDF	N64	2
62	5768410	5768434	178	202	24	LEFT	N64b.EDF	N64	2
63	5778637	5778665	58	86	28	LEFT	N64b.EDF	N64	2
64	5790401	5790478	57	134	77	LEFT	N64b.EDF	N64	2
64	5790519	5790528	175	184	9	LEFT	N64b.EDF	N64	2
64	5791356	5791607	1012	1263	251	LEFT	N64b.EDF	N64	2
64	5795636	5795728	5292	5384	92	LEFT	N64b.EDF	N64	2
65	5801209	5801328	57	176	119	LEFT	N64b.EDF	N64	2
66	5810215	5810274	57	116	59	LEFT	N64b.EDF	N64	2
66	5810306	5810341	148	183	35	LEFT	N64b.EDF	N64	2
67	5818740	5818844	58	162	104	LEFT	N64b.EDF	N64	2
67	5819828	5820042	1146	1360	214	LEFT	N64b.EDF	N64	2
67	5820073	5820109	1391	1427	36	LEFT	N64b.EDF	N64	2
68	5828796	5829024	57	285	228	LEFT	N64b.EDF	N64	2
68	5829048	5829070	309	331	22	LEFT	N64b.EDF	N64	2
68	5829815	5829899	1076	1160	84	LEFT	N64b.EDF	N64	2
68	5829929	5829954	1190	1215	25	LEFT	N64b.EDF	N64	2
69	5837650	5837862	57	269	212	LEFT	N64b.EDF	N64	2
69	5837885	5837918	292	325	33	LEFT	N64b.EDF	N64	2
69	5838533	5838765	940	1172	232	LEFT	N64b.EDF	N64	2
69	5841886	5841990	4293	4397	104	LEFT	N64b.EDF	N64	2
70	5846864	5847076	57	269	212	LEFT	N64b.EDF	N64	2
70	5853017	5853176	6210	6369	159	LEFT	N64b.EDF	N64	2
71	5858003	5858090	57	144	87	LEFT	N64b.EDF	N64	2
71	5858121	5858138	175	192	17	LEFT	N64b.EDF	N64	2
71	5858998	5859163	1052	1217	165	LEFT	N64b.EDF	N64	2
71	5859204	5859231	1258	1285	27	LEFT	N64b.EDF	N64	2
72	5867849	5867883	57	91	34	LEFT	N64b.EDF	N64	2
72	5867917	5867940	125	148	23	LEFT	N64b.EDF	N64	2
73	5876915	5876959	57	101	44	LEFT	N64b.EDF	N64	2
73	5877822	5877992	964	1134	170	LEFT	N64b.EDF	N64	2
73	5878016	5878040	1158	1182	24	LEFT	N64b.EDF	N64	2
74	5886090	5886167	57	134	77	LEFT	N64b.EDF	N64	2
74	5886198	5886236	165	203	38	LEFT	N64b.EDF	N64	2
75	5896237	5896287	57	107	50	LEFT	N64b.EDF	N64	2
75	5896961	5897279	781	1099	318	LEFT	N64b.EDF	N64	2
76	5905442	5905529	57	144	87	LEFT	N64b.EDF	N64	2
76	5905553	5905565	168	180	12	LEFT	N64b.EDF	N64	2
76	5906599	5906687	1214	1302	88	LEFT	N64b.EDF	N64	2
76	5906718	5906736	1333	1351	18	LEFT	N64b.EDF	N64	2
76	5908902	5909021	3517	3636	119	LEFT	N64b.EDF	N64	2
77	5915257	5915384	57	184	127	LEFT	N64b.EDF	N64	2
77	5915406	5915429	206	229	23	LEFT	N64b.EDF	N64	2
77	5916217	5916476	1017	1276	259	LEFT	N64b.EDF	N64	2
78	5924878	5924902	60	84	24	LEFT	N64b.EDF	N64	2
78	5930064	5930125	5246	5307	61	LEFT	N64b.EDF	N64	2
78	5930162	5930167	5344	5349	5	LEFT	N64b.EDF	N64	2
80	5947169	5947306	57	194	137	LEFT	N64b.EDF	N64	2
80	5948536	5948665	1424	1553	129	LEFT	N64b.EDF	N64	2
80	5948691	5948708	1579	1596	17	LEFT	N64b.EDF	N64	2
80	5951260	5951441	4148	4329	181	LEFT	N64b.EDF	N64	2
81	5956333	5956366	57	90	33	LEFT	N64b.EDF	N64	2
81	5956388	5956422	112	146	34	LEFT	N64b.EDF	N64	2
81	5961262	5961449	4986	5173	187	LEFT	N64b.EDF	N64	2
83	5973682	5973703	56	77	21	LEFT	N64b.EDF	N64	2
84	5984761	5984952	56	247	191	LEFT	N64b.EDF	N64	2
85	5992739	5992747	90	98	8	LEFT	N64b.EDF	N64	2
85	5993397	5993615	748	966	218	LEFT	N64b.EDF	N64	2
85	5993644	5993667	995	1018	23	LEFT	N64b.EDF	N64	2
86	6003114	6003196	188	270	82	LEFT	N64b.EDF	N64	2
86	6003228	6003241	302	315	13	LEFT	N64b.EDF	N64	2
87	6011014	6011042	60	88	28	LEFT	N64b.EDF	N64	2
87	6016223	6016376	5269	5422	153	LEFT	N64b.EDF	N64	2
90	6037819	6037834	73	88	15	LEFT	N64b.EDF	N64	2
90	6042786	6042947	5040	5201	161	LEFT	N64b.EDF	N64	2
91	6048631	6048666	57	92	35	LEFT	N64b.EDF	N64	2
91	6048692	6048712	118	138	20	LEFT	N64b.EDF	N64	2
91	6052419	6052515	3845	3941	96	LEFT	N64b.EDF	N64	2
91	6053850	6053966	5276	5392	116	LEFT	N64b.EDF	N64	2
92	6058299	6058306	99	106	7	LEFT	N64b.EDF	N64	2
93	6066190	6066251	57	118	61	LEFT	N64b.EDF	N64	2
93	6066304	6066315	171	182	11	LEFT	N64b.EDF	N64	2
94	6074206	6074283	57	134	77	LEFT	N64b.EDF	N64	2
94	6075462	6075599	1313	1450	137	LEFT	N64b.EDF	N64	2
94	6075656	6075674	1507	1525	18	LEFT	N64b.EDF	N64	2
94	6079455	6079546	5306	5397	91	LEFT	N64b.EDF	N64	2
95	6084830	6084913	57	140	83	LEFT	N64b.EDF	N64	2
95	6084955	6084973	182	200	18	LEFT	N64b.EDF	N64	2
95	6085608	6085767	835	994	159	LEFT	N64b.EDF	N64	2
95	6085822	6085834	1049	1061	12	LEFT	N64b.EDF	N64	2
96	6093028	6093052	57	81	24	LEFT	N64b.EDF	N64	2
96	6093089	6093112	118	141	23	LEFT	N64b.EDF	N64	2
96	6097145	6097268	4174	4297	123	LEFT	N64b.EDF	N64	2
96	6099468	6099600	6497	6629	132	LEFT	N64b.EDF	N64	2
97	6104126	6104226	56	156	100	LEFT	N64b.EDF	N64	2
97	6104258	6104285	188	215	27	LEFT	N64b.EDF	N64	2
98	6113901	6114061	57	217	160	LEFT	N64b.EDF	N64	2
98	6118211	6118344	4367	4500	133	LEFT	N64b.EDF	N64	2
99	6123103	6123124	94	115	21	LEFT	N64b.EDF	N64	2
100	6132729	6132756	57	84	27	LEFT	N64b.EDF	N64	2
100	6132807	6132827	135	155	20	LEFT	N64b.EDF	N64	2
100	6133914	6134131	1242	1459	217	LEFT	N64b.EDF	N64	2
100	6134190	6134205	1518	1533	15	LEFT	N64b.EDF	N64	2
101	6143168	6143200	57	89	32	LEFT	N64b.EDF	N64	2
102	6152116	6152192	57	133	76	LEFT	N64b.EDF	N64	2
102	6153243	6153464	1184	1405	221	LEFT	N64b.EDF	N64	2
102	6153517	6153548	1458	1489	31	LEFT	N64b.EDF	N64	2
103	6160361	6160502	57	198	141	LEFT	N64b.EDF	N64	2
103	6160530	6160586	226	282	56	LEFT	N64b.EDF	N64	2
104	6168297	6168384	57	144	87	LEFT	N64b.EDF	N64	2
104	6168447	6168449	207	209	2	LEFT	N64b.EDF	N64	2
104	6169383	6169536	1143	1296	153	LEFT	N64b.EDF	N64	2
104	6169572	6169591	1332	1351	19	LEFT	N64b.EDF	N64	2
104	6172049	6172168	3809	3928	119	LEFT	N64b.EDF	N64	2
105	6176861	6176889	58	86	28	LEFT	N64b.EDF	N64	2
105	6176915	6176978	112	175	63	LEFT	N64b.EDF	N64	2
105	6179935	6180041	3132	3238	106	LEFT	N64b.EDF	N64	2
106	6184955	6184985	57	87	30	LEFT	N64b.EDF	N64	2
107	6195077	6195169	957	1049	92	LEFT	N64b.EDF	N64	2
107	6195203	6195227	1083	1107	24	LEFT	N64b.EDF	N64	2
108	6202957	6203012	56	111	55	LEFT	N64b.EDF	N64	2
108	6208256	6208389	5355	5488	133	LEFT	N64b.EDF	N64	2
109	6211703	6211717	80	94	14	LEFT	N64b.EDF	N64	2
110	6222797	6222926	57	186	129	LEFT	N64b.EDF	N64	2
110	6223006	6223024	266	284	18	LEFT	N64b.EDF	N64	2
110	6223690	6223917	950	1177	227	LEFT	N64b.EDF	N64	2
110	6223947	6223993	1207	1253	46	LEFT	N64b.EDF	N64	2
111	6230223	6230390	57	224	167	LEFT	N64b.EDF	N64	2
111	6230426	6230475	260	309	49	LEFT	N64b.EDF	N64	2
112	6239036	6239069	58	91	33	LEFT	N64b.EDF	N64	2
112	6239125	6239154	147	176	29	LEFT	N64b.EDF	N64	2
112	6243047	6243178	4069	4200	131	LEFT	N64b.EDF	N64	2
112	6243966	6244106	4988	5128	140	LEFT	N64b.EDF	N64	2
113	6249574	6249615	57	98	41	LEFT	N64b.EDF	N64	2
113	6249637	6249674	120	157	37	LEFT	N64b.EDF	N64	2
114	6260051	6260142	57	148	91	LEFT	N64b.EDF	N64	2
114	6260163	6260189	169	195	26	LEFT	N64b.EDF	N64	2
114	6261024	6261184	1030	1190	160	LEFT	N64b.EDF	N64	2
114	6261215	6261237	1221	1243	22	LEFT	N64b.EDF	N64	2
114	6264848	6265046	4854	5052	198	LEFT	N64b.EDF	N64	2
115	6268746	6268788	57	99	42	LEFT	N64b.EDF	N64	2
115	6268809	6268852	120	163	43	LEFT	N64b.EDF	N64	2
115	6273543	6273640	4854	4951	97	LEFT	N64b.EDF	N64	2
115	6274589	6274728	5900	6039	139	LEFT	N64b.EDF	N64	2
116	6278593	6278664	57	128	71	LEFT	N64b.EDF	N64	2
116	6279657	6279983	1121	1447	326	LEFT	N64b.EDF	N64	2
116	6283476	6283552	4940	5016	76	LEFT	N64b.EDF	N64	2
117	6295894	6296096	6362	6564	202	LEFT	N64b.EDF	N64	2
118	6301646	6301724	57	135	78	LEFT	N64b.EDF	N64	2
120	6322178	6322214	57	93	36	LEFT	N64b.EDF	N64	2
1	7445492	7445611	1512	1631	119	LEFT	N64c.EDF	N64	3
1	7447006	7447158	3026	3178	152	LEFT	N64c.EDF	N64	3
2	7458969	7459138	726	895	169	LEFT	N64c.EDF	N64	3
3	7469341	7469465	1068	1192	124	LEFT	N64c.EDF	N64	3
4	7476828	7476916	58	146	88	LEFT	N64c.EDF	N64	3
5	7486489	7486697	58	266	208	LEFT	N64c.EDF	N64	3
6	7497205	7497282	59	136	77	LEFT	N64c.EDF	N64	3
6	7497311	7497325	165	179	14	LEFT	N64c.EDF	N64	3
9	7526025	7526167	58	200	142	LEFT	N64c.EDF	N64	3
10	7535619	7535762	58	201	143	LEFT	N64c.EDF	N64	3
10	7540278	7540388	4717	4827	110	LEFT	N64c.EDF	N64	3
12	7555469	7555557	57	145	88	LEFT	N64c.EDF	N64	3
13	7564897	7564931	58	92	34	LEFT	N64c.EDF	N64	3
14	7574802	7574925	58	181	123	LEFT	N64c.EDF	N64	3
14	7579148	7579265	4404	4521	117	LEFT	N64c.EDF	N64	3
15	7585586	7585643	58	115	57	LEFT	N64c.EDF	N64	3
16	7593718	7593802	58	142	84	LEFT	N64c.EDF	N64	3
16	7598936	7598981	5276	5321	45	LEFT	N64c.EDF	N64	3
17	7603089	7603162	58	131	73	LEFT	N64c.EDF	N64	3
19	7621600	7621723	58	181	123	LEFT	N64c.EDF	N64	3
19	7622405	7622624	863	1082	219	LEFT	N64c.EDF	N64	3
20	7631543	7631755	936	1148	212	LEFT	N64c.EDF	N64	3
21	7640442	7640493	59	110	51	LEFT	N64c.EDF	N64	3
22	7655597	7655666	5447	5516	69	LEFT	N64c.EDF	N64	3
24	7670008	7670074	57	123	66	LEFT	N64c.EDF	N64	3
24	7670103	7670122	152	171	19	LEFT	N64c.EDF	N64	3
24	7671227	7671375	1276	1424	148	LEFT	N64c.EDF	N64	3
24	7671397	7671414	1446	1463	17	LEFT	N64c.EDF	N64	3
25	7679736	7679808	58	130	72	LEFT	N64c.EDF	N64	3
26	7688740	7688869	58	187	129	LEFT	N64c.EDF	N64	3
27	7698896	7699004	58	166	108	LEFT	N64c.EDF	N64	3
27	7699724	7699961	886	1123	237	LEFT	N64c.EDF	N64	3
27	7702584	7702791	3746	3953	207	LEFT	N64c.EDF	N64	3
28	7708200	7708312	58	170	112	LEFT	N64c.EDF	N64	3
28	7708363	7708380	221	238	17	LEFT	N64c.EDF	N64	3
29	7718568	7718596	58	86	28	LEFT	N64c.EDF	N64	3
29	7718621	7718639	111	129	18	LEFT	N64c.EDF	N64	3
30	7726594	7726669	58	133	75	LEFT	N64c.EDF	N64	3
30	7726768	7726792	232	256	24	LEFT	N64c.EDF	N64	3
31	7737201	7737273	59	131	72	LEFT	N64c.EDF	N64	3
31	7737296	7737317	154	175	21	LEFT	N64c.EDF	N64	3
31	7738218	7738425	1076	1283	207	LEFT	N64c.EDF	N64	3
32	7746457	7746534	58	135	77	LEFT	N64c.EDF	N64	3
32	7750904	7750942	4505	4543	38	LEFT	N64c.EDF	N64	3
33	7758114	7758201	58	145	87	LEFT	N64c.EDF	N64	3
33	7758244	7758253	188	197	9	LEFT	N64c.EDF	N64	3
34	7768046	7768057	93	104	11	LEFT	N64c.EDF	N64	3
36	7786066	7786110	59	103	44	LEFT	N64c.EDF	N64	3
39	7815730	7815918	59	247	188	LEFT	N64c.EDF	N64	3
41	7835003	7835050	1788	1835	47	LEFT	N64c.EDF	N64	3
41	7838045	7838118	4830	4903	73	LEFT	N64c.EDF	N64	3
43	7851642	7851920	59	337	278	LEFT	N64c.EDF	N64	3
44	7861446	7861542	58	154	96	LEFT	N64c.EDF	N64	3
44	7862148	7862378	760	990	230	LEFT	N64c.EDF	N64	3
45	7870814	7870833	58	77	19	LEFT	N64c.EDF	N64	3
46	7884182	7884287	58	163	105	LEFT	N64c.EDF	N64	3
46	7884925	7885122	801	998	197	LEFT	N64c.EDF	N64	3
47	7895246	7895261	61	76	15	LEFT	N64c.EDF	N64	3
47	7896686	7896886	1501	1701	200	LEFT	N64c.EDF	N64	3
48	7903963	7904088	57	182	125	LEFT	N64c.EDF	N64	3
49	7914050	7914172	58	180	122	LEFT	N64c.EDF	N64	3
49	7915300	7915628	1308	1636	328	LEFT	N64c.EDF	N64	3
52	7940491	7940572	58	139	81	LEFT	N64c.EDF	N64	3
52	7946548	7946593	6115	6160	45	LEFT	N64c.EDF	N64	3
53	7950442	7950663	658	879	221	LEFT	N64c.EDF	N64	3
54	7958646	7958719	58	131	73	LEFT	N64c.EDF	N64	3
55	7968464	7968629	58	223	165	LEFT	N64c.EDF	N64	3
56	7977749	7977845	58	154	96	LEFT	N64c.EDF	N64	3
57	7986602	7986621	65	84	19	LEFT	N64c.EDF	N64	3
57	7987435	7987561	898	1024	126	LEFT	N64c.EDF	N64	3
58	7995181	7995200	59	78	19	LEFT	N64c.EDF	N64	3
60	8013731	8013790	58	117	59	LEFT	N64c.EDF	N64	3
60	8013814	8013823	141	150	9	LEFT	N64c.EDF	N64	3
61	8023255	8023405	657	807	150	LEFT	N64c.EDF	N64	3
62	8033681	8033827	1523	1669	146	LEFT	N64c.EDF	N64	3
63	8041678	8041945	952	1219	267	LEFT	N64c.EDF	N64	3
65	8060821	8060956	58	193	135	LEFT	N64c.EDF	N64	3
65	8061041	8061050	278	287	9	LEFT	N64c.EDF	N64	3
65	8066430	8066602	5667	5839	172	LEFT	N64c.EDF	N64	3
65	8066633	8066638	5870	5875	5	LEFT	N64c.EDF	N64	3
66	8071506	8071577	58	129	71	LEFT	N64c.EDF	N64	3
66	8071610	8071663	162	215	53	LEFT	N64c.EDF	N64	3
66	8072384	8072723	936	1275	339	LEFT	N64c.EDF	N64	3
66	8075409	8075576	3961	4128	167	LEFT	N64c.EDF	N64	3
66	8076867	8077093	5419	5645	226	LEFT	N64c.EDF	N64	3
67	8083006	8083076	58	128	70	LEFT	N64c.EDF	N64	3
67	8084257	8084521	1309	1573	264	LEFT	N64c.EDF	N64	3
68	8093146	8093169	85	108	23	LEFT	N64c.EDF	N64	3
68	8094532	8094771	1471	1710	239	LEFT	N64c.EDF	N64	3
68	8094802	8094845	1741	1784	43	LEFT	N64c.EDF	N64	3
69	8102406	8102446	58	98	40	LEFT	N64c.EDF	N64	3
69	8102469	8102494	121	146	25	LEFT	N64c.EDF	N64	3
70	8111167	8111287	58	178	120	LEFT	N64c.EDF	N64	3
71	8120304	8120332	64	92	28	LEFT	N64c.EDF	N64	3
72	8128297	8128321	63	87	24	LEFT	N64c.EDF	N64	3
73	8137817	8137953	58	194	136	LEFT	N64c.EDF	N64	3
74	8146523	8146721	58	256	198	LEFT	N64c.EDF	N64	3
76	8163776	8163971	1366	1561	195	LEFT	N64c.EDF	N64	3
76	8166174	8166285	3764	3875	111	LEFT	N64c.EDF	N64	3
77	8172548	8172573	67	92	25	LEFT	N64c.EDF	N64	3
79	8193210	8193300	57	147	90	LEFT	N64c.EDF	N64	3
80	8201026	8201083	58	115	57	LEFT	N64c.EDF	N64	3
81	8209304	8209374	58	128	70	LEFT	N64c.EDF	N64	3
81	8209410	8209415	164	169	5	LEFT	N64c.EDF	N64	3
83	8227649	8227852	920	1123	203	LEFT	N64c.EDF	N64	3
84	8238659	8238751	58	150	92	LEFT	N64c.EDF	N64	3
84	8239624	8239877	1023	1276	253	LEFT	N64c.EDF	N64	3
85	8251213	8251454	934	1175	241	LEFT	N64c.EDF	N64	3
86	8259622	8259696	57	131	74	LEFT	N64c.EDF	N64	3
86	8260719	8260926	1154	1361	207	LEFT	N64c.EDF	N64	3
87	8270045	8270393	1084	1432	348	LEFT	N64c.EDF	N64	3
88	8277618	8277681	58	121	63	LEFT	N64c.EDF	N64	3
88	8282636	8282879	5076	5319	243	LEFT	N64c.EDF	N64	3
89	8286999	8287096	58	155	97	LEFT	N64c.EDF	N64	3
90	8295746	8296020	919	1193	274	LEFT	N64c.EDF	N64	3
91	8304906	8304921	73	88	15	LEFT	N64c.EDF	N64	3
92	8316067	8316241	58	232	174	LEFT	N64c.EDF	N64	3
92	8317305	8317496	1296	1487	191	LEFT	N64c.EDF	N64	3
93	8324903	8324960	58	115	57	LEFT	N64c.EDF	N64	3
94	8337856	8338074	863	1081	218	LEFT	N64c.EDF	N64	3
95	8346080	8346176	57	153	96	LEFT	N64c.EDF	N64	3
97	8370645	8370706	5624	5685	61	LEFT	N64c.EDF	N64	3
98	8374933	8374994	58	119	61	LEFT	N64c.EDF	N64	3
101	8403591	8403787	58	254	196	LEFT	N64c.EDF	N64	3
107	8462434	8462666	4531	4763	232	LEFT	N64c.EDF	N64	3
109	8476487	8476539	58	110	52	LEFT	N64c.EDF	N64	3
110	8485322	8485410	58	146	88	LEFT	N64c.EDF	N64	3
110	8491500	8491720	6236	6456	220	LEFT	N64c.EDF	N64	3
111	8495618	8495660	58	100	42	LEFT	N64c.EDF	N64	3
111	8496769	8496928	1209	1368	159	LEFT	N64c.EDF	N64	3
111	8499054	8499250	3494	3690	196	LEFT	N64c.EDF	N64	3
112	8505118	8505308	828	1018	190	LEFT	N64c.EDF	N64	3
112	8510576	8510662	6286	6372	86	LEFT	N64c.EDF	N64	3
113	8515770	8515839	58	127	69	LEFT	N64c.EDF	N64	3
113	8515865	8515879	153	167	14	LEFT	N64c.EDF	N64	3
113	8517007	8517185	1295	1473	178	LEFT	N64c.EDF	N64	3
115	8539517	8539646	6263	6392	129	LEFT	N64c.EDF	N64	3
116	8543482	8543501	62	81	19	LEFT	N64c.EDF	N64	3
117	8552544	8552590	59	105	46	LEFT	N64c.EDF	N64	3
118	8562622	8562748	1911	2037	126	LEFT	N64c.EDF	N64	3
118	8564870	8565004	4159	4293	134	LEFT	N64c.EDF	N64	3
119	8569423	8569440	63	80	17	LEFT	N64c.EDF	N64	3
120	8578643	8578831	892	1080	188	LEFT	N64c.EDF	N64	3
120	8579564	8579719	1813	1968	155	LEFT	N64c.EDF	N64	3
120	8582407	8582529	4656	4778	122	LEFT	N64c.EDF	N64	3
1	16074963	16075037	1978	2052	74	RIGHT	P23a.EDF	P23	1
10	16149264	16149267	331	334	3	RIGHT	P23a.EDF	P23	1
10	16149863	16149993	930	1060	130	RIGHT	P23a.EDF	P23	1
13	16176426	16176537	1008	1119	111	RIGHT	P23a.EDF	P23	1
13	16176559	16176563	1141	1145	4	RIGHT	P23a.EDF	P23	1
13	16177059	16177193	1641	1775	134	RIGHT	P23a.EDF	P23	1
17	16209698	16209884	328	514	186	RIGHT	P23a.EDF	P23	1
21	16245852	16245910	3943	4001	58	RIGHT	P23a.EDF	P23	1
21	16245972	16245972	4063	4063	0	RIGHT	P23a.EDF	P23	1
21	16246426	16246432	4517	4523	6	RIGHT	P23a.EDF	P23	1
21	16246454	16246510	4545	4601	56	RIGHT	P23a.EDF	P23	1
21	16246531	16246534	4622	4625	3	RIGHT	P23a.EDF	P23	1
21	16246558	16246563	4649	4654	5	RIGHT	P23a.EDF	P23	1
21	16246602	16246612	4693	4703	10	RIGHT	P23a.EDF	P23	1
22	16249873	16249970	1502	1599	97	RIGHT	P23a.EDF	P23	1
25	16273814	16274042	1637	1865	228	RIGHT	P23a.EDF	P23	1
33	16336275	16336394	200	319	119	RIGHT	P23a.EDF	P23	1
33	16336439	16336439	364	364	0	RIGHT	P23a.EDF	P23	1
33	16337958	16338101	1883	2026	143	RIGHT	P23a.EDF	P23	1
37	16371358	16371523	839	1004	165	RIGHT	P23a.EDF	P23	1
37	16371560	16371564	1041	1045	4	RIGHT	P23a.EDF	P23	1
38	16378042	16378143	300	401	101	RIGHT	P23a.EDF	P23	1
38	16378199	16378200	457	458	1	RIGHT	P23a.EDF	P23	1
39	16385283	16385404	565	686	121	RIGHT	P23a.EDF	P23	1
39	16385435	16385437	717	719	2	RIGHT	P23a.EDF	P23	1
40	16394126	16394285	223	382	159	RIGHT	P23a.EDF	P23	1
40	16394324	16394327	421	424	3	RIGHT	P23a.EDF	P23	1
41	16403125	16403284	576	735	159	RIGHT	P23a.EDF	P23	1
41	16403325	16403325	776	776	0	RIGHT	P23a.EDF	P23	1
41	16404183	16404352	1634	1803	169	RIGHT	P23a.EDF	P23	1
41	16404396	16404398	1847	1849	2	RIGHT	P23a.EDF	P23	1
43	16418912	16419031	1675	1794	119	RIGHT	P23a.EDF	P23	1
44	16427562	16427701	739	878	139	RIGHT	P23a.EDF	P23	1
44	16427735	16427738	912	915	3	RIGHT	P23a.EDF	P23	1
45	16437753	16437938	793	978	185	RIGHT	P23a.EDF	P23	1
45	16437963	16437966	1003	1006	3	RIGHT	P23a.EDF	P23	1
45	16438101	16438167	1141	1207	66	RIGHT	P23a.EDF	P23	1
45	16438373	16438473	1413	1513	100	RIGHT	P23a.EDF	P23	1
45	16438527	16438527	1567	1567	0	RIGHT	P23a.EDF	P23	1
45	16438799	16438917	1839	1957	118	RIGHT	P23a.EDF	P23	1
47	16453246	16453457	59	270	211	RIGHT	P23a.EDF	P23	1
48	16466987	16467095	6543	6651	108	RIGHT	P23a.EDF	P23	1
48	16467144	16467151	6700	6707	7	RIGHT	P23a.EDF	P23	1
49	16471898	16471950	58	110	52	RIGHT	P23a.EDF	P23	1
49	16471984	16471999	144	159	15	RIGHT	P23a.EDF	P23	1
49	16472902	16473064	1062	1224	162	RIGHT	P23a.EDF	P23	1
49	16473102	16473102	1262	1262	0	RIGHT	P23a.EDF	P23	1
52	16495889	16496063	225	399	174	RIGHT	P23a.EDF	P23	1
52	16496098	16496101	434	437	3	RIGHT	P23a.EDF	P23	1
54	16512984	16513117	569	702	133	RIGHT	P23a.EDF	P23	1
56	16530297	16530438	961	1102	141	RIGHT	P23a.EDF	P23	1
56	16530475	16530478	1139	1142	3	RIGHT	P23a.EDF	P23	1
56	16530732	16530886	1396	1550	154	RIGHT	P23a.EDF	P23	1
56	16530919	16530919	1583	1583	0	RIGHT	P23a.EDF	P23	1
58	16548776	16548900	709	833	124	RIGHT	P23a.EDF	P23	1
58	16548932	16548934	865	867	2	RIGHT	P23a.EDF	P23	1
59	16557537	16557639	473	575	102	RIGHT	P23a.EDF	P23	1
59	16557675	16557678	611	614	3	RIGHT	P23a.EDF	P23	1
61	16575571	16575768	177	374	197	RIGHT	P23a.EDF	P23	1
63	16592401	16592496	727	822	95	RIGHT	P23a.EDF	P23	1
64	16600867	16601020	1587	1740	153	RIGHT	P23a.EDF	P23	1
64	16601056	16601060	1776	1780	4	RIGHT	P23a.EDF	P23	1
67	16625282	16625412	57	187	130	RIGHT	P23a.EDF	P23	1
67	16625440	16625443	215	218	3	RIGHT	P23a.EDF	P23	1
68	16634982	16635115	492	625	133	RIGHT	P23a.EDF	P23	1
68	16635151	16635155	661	665	4	RIGHT	P23a.EDF	P23	1
68	16635338	16635498	848	1008	160	RIGHT	P23a.EDF	P23	1
68	16635531	16635531	1041	1041	0	RIGHT	P23a.EDF	P23	1
68	16635751	16635943	1261	1453	192	RIGHT	P23a.EDF	P23	1
68	16635999	16636041	1509	1551	42	RIGHT	P23a.EDF	P23	1
68	16636313	16636569	1823	2079	256	RIGHT	P23a.EDF	P23	1
68	16636800	16636803	2310	2313	3	RIGHT	P23a.EDF	P23	1
68	16636928	16636928	2438	2438	0	RIGHT	P23a.EDF	P23	1
68	16636957	16637079	2467	2589	122	RIGHT	P23a.EDF	P23	1
69	16644083	16644221	57	195	138	RIGHT	P23a.EDF	P23	1
73	16677387	16677566	170	349	179	RIGHT	P23a.EDF	P23	1
73	16679044	16679161	1827	1944	117	RIGHT	P23a.EDF	P23	1
73	16679200	16679210	1983	1993	10	RIGHT	P23a.EDF	P23	1
74	16685712	16685712	501	501	0	RIGHT	P23a.EDF	P23	1
74	16685748	16685777	537	566	29	RIGHT	P23a.EDF	P23	1
74	16685817	16685819	606	608	2	RIGHT	P23a.EDF	P23	1
76	16704099	16704502	265	668	403	RIGHT	P23a.EDF	P23	1
76	16705188	16705343	1354	1509	155	RIGHT	P23a.EDF	P23	1
76	16705381	16705389	1547	1555	8	RIGHT	P23a.EDF	P23	1
80	16737077	16737206	94	223	129	RIGHT	P23a.EDF	P23	1
80	16737245	16737247	262	264	2	RIGHT	P23a.EDF	P23	1
80	16737814	16737998	831	1015	184	RIGHT	P23a.EDF	P23	1
80	16738039	16738042	1056	1059	3	RIGHT	P23a.EDF	P23	1
81	16745526	16745594	829	897	68	RIGHT	P23a.EDF	P23	1
81	16745634	16745635	937	938	1	RIGHT	P23a.EDF	P23	1
83	16763975	16764097	675	797	122	RIGHT	P23a.EDF	P23	1
83	16764135	16764138	835	838	3	RIGHT	P23a.EDF	P23	1
83	16764394	16764563	1094	1263	169	RIGHT	P23a.EDF	P23	1
83	16764610	16764613	1310	1313	3	RIGHT	P23a.EDF	P23	1
84	16772444	16772850	77	483	406	RIGHT	P23a.EDF	P23	1
84	16772883	16772885	516	518	2	RIGHT	P23a.EDF	P23	1
84	16773436	16773589	1069	1222	153	RIGHT	P23a.EDF	P23	1
84	16773633	16773637	1266	1270	4	RIGHT	P23a.EDF	P23	1
85	16780971	16781063	231	323	92	RIGHT	P23a.EDF	P23	1
85	16781109	16781113	369	373	4	RIGHT	P23a.EDF	P23	1
85	16781963	16782115	1223	1375	152	RIGHT	P23a.EDF	P23	1
85	16782155	16782156	1415	1416	1	RIGHT	P23a.EDF	P23	1
88	16806291	16806388	984	1081	97	RIGHT	P23a.EDF	P23	1
88	16806435	16806442	1128	1135	7	RIGHT	P23a.EDF	P23	1
89	16815650	16815831	780	961	181	RIGHT	P23a.EDF	P23	1
89	16815867	16815869	997	999	2	RIGHT	P23a.EDF	P23	1
90	16823753	16823845	394	486	92	RIGHT	P23a.EDF	P23	1
91	16833011	16833190	57	236	179	RIGHT	P23a.EDF	P23	1
91	16833530	16833679	576	725	149	RIGHT	P23a.EDF	P23	1
91	16833724	16833729	770	775	5	RIGHT	P23a.EDF	P23	1
91	16833913	16834063	959	1109	150	RIGHT	P23a.EDF	P23	1
91	16834091	16834097	1137	1143	6	RIGHT	P23a.EDF	P23	1
91	16834275	16834472	1321	1518	197	RIGHT	P23a.EDF	P23	1
91	16834640	16834699	1686	1745	59	RIGHT	P23a.EDF	P23	1
91	16834720	16834720	1766	1766	0	RIGHT	P23a.EDF	P23	1
91	16835085	16835447	2131	2493	362	RIGHT	P23a.EDF	P23	1
94	16858567	16858593	57	83	26	RIGHT	P23a.EDF	P23	1
94	16859344	16859486	834	976	142	RIGHT	P23a.EDF	P23	1
1	17389075	17389376	108	409	301	RIGHT	P23b.EDF	P23	2
1	17389791	17390002	824	1035	211	RIGHT	P23b.EDF	P23	2
1	17390602	17390619	1635	1652	17	RIGHT	P23b.EDF	P23	2
1	17390670	17390689	1703	1722	19	RIGHT	P23b.EDF	P23	2
1	17390733	17390733	1766	1766	0	RIGHT	P23b.EDF	P23	2
1	17390757	17390758	1790	1791	1	RIGHT	P23b.EDF	P23	2
1	17391421	17391808	2454	2841	387	RIGHT	P23b.EDF	P23	2
2	17400151	17400158	3126	3133	7	RIGHT	P23b.EDF	P23	2
2	17400297	17400299	3272	3274	2	RIGHT	P23b.EDF	P23	2
2	17400335	17400336	3310	3311	1	RIGHT	P23b.EDF	P23	2
4	17413606	17413783	686	863	177	RIGHT	P23b.EDF	P23	2
4	17414375	17414375	1455	1455	0	RIGHT	P23b.EDF	P23	2
6	17431850	17432063	1208	1421	213	RIGHT	P23b.EDF	P23	2
6	17432893	17432981	2251	2339	88	RIGHT	P23b.EDF	P23	2
8	17448144	17448384	151	391	240	RIGHT	P23b.EDF	P23	2
9	17458770	17458774	280	284	4	RIGHT	P23b.EDF	P23	2
9	17459680	17459873	1190	1383	193	RIGHT	P23b.EDF	P23	2
11	17475826	17475926	57	157	100	RIGHT	P23b.EDF	P23	2
11	17476615	17476856	846	1087	241	RIGHT	P23b.EDF	P23	2
12	17484757	17485004	144	391	247	RIGHT	P23b.EDF	P23	2
14	17503176	17503376	1073	1273	200	RIGHT	P23b.EDF	P23	2
16	17521341	17521562	956	1177	221	RIGHT	P23b.EDF	P23	2
16	17524653	17524880	4268	4495	227	RIGHT	P23b.EDF	P23	2
17	17527567	17527841	65	339	274	RIGHT	P23b.EDF	P23	2
17	17528444	17528701	942	1199	257	RIGHT	P23b.EDF	P23	2
18	17534991	17535163	57	229	172	RIGHT	P23b.EDF	P23	2
19	17543456	17543696	465	705	240	RIGHT	P23b.EDF	P23	2
19	17544177	17544517	1186	1526	340	RIGHT	P23b.EDF	P23	2
19	17544685	17544987	1694	1996	302	RIGHT	P23b.EDF	P23	2
20	17552168	17552397	192	421	229	RIGHT	P23b.EDF	P23	2
20	17552900	17553162	924	1186	262	RIGHT	P23b.EDF	P23	2
20	17553479	17553752	1503	1776	273	RIGHT	P23b.EDF	P23	2
21	17561598	17561786	57	245	188	RIGHT	P23b.EDF	P23	2
21	17562328	17562578	787	1037	250	RIGHT	P23b.EDF	P23	2
21	17563037	17563274	1496	1733	237	RIGHT	P23b.EDF	P23	2
22	17570243	17570515	57	329	272	RIGHT	P23b.EDF	P23	2
22	17571723	17572029	1537	1843	306	RIGHT	P23b.EDF	P23	2
22	17572067	17573133	1881	2947	1066	RIGHT	P23b.EDF	P23	2
26	17604030	17604294	1104	1368	264	RIGHT	P23b.EDF	P23	2
27	17610564	17610783	84	303	219	RIGHT	P23b.EDF	P23	2
27	17610805	17610812	325	332	7	RIGHT	P23b.EDF	P23	2
27	17611295	17611584	815	1104	289	RIGHT	P23b.EDF	P23	2
27	17614725	17614976	4245	4496	251	RIGHT	P23b.EDF	P23	2
28	17618724	17619105	57	438	381	RIGHT	P23b.EDF	P23	2
28	17619194	17619657	527	990	463	RIGHT	P23b.EDF	P23	2
30	17636755	17636874	57	176	119	RIGHT	P23b.EDF	P23	2
30	17637161	17637398	463	700	237	RIGHT	P23b.EDF	P23	2
30	17638210	17638484	1512	1786	274	RIGHT	P23b.EDF	P23	2
32	17652974	17653041	57	124	67	RIGHT	P23b.EDF	P23	2
32	17653962	17654305	1045	1388	343	RIGHT	P23b.EDF	P23	2
33	17663300	17663705	696	1101	405	RIGHT	P23b.EDF	P23	2
33	17663801	17664209	1197	1605	408	RIGHT	P23b.EDF	P23	2
33	17665259	17665440	2655	2836	181	RIGHT	P23b.EDF	P23	2
34	17671651	17672687	193	1229	1036	RIGHT	P23b.EDF	P23	2
34	17673555	17673771	2097	2313	216	RIGHT	P23b.EDF	P23	2
34	17673854	17674081	2396	2623	227	RIGHT	P23b.EDF	P23	2
35	17680692	17681007	76	391	315	RIGHT	P23b.EDF	P23	2
35	17681053	17681063	437	447	10	RIGHT	P23b.EDF	P23	2
35	17681119	17681370	503	754	251	RIGHT	P23b.EDF	P23	2
36	17689672	17690025	213	566	353	RIGHT	P23b.EDF	P23	2
36	17690047	17690048	588	589	1	RIGHT	P23b.EDF	P23	2
36	17690128	17690475	669	1016	347	RIGHT	P23b.EDF	P23	2
36	17690713	17690937	1254	1478	224	RIGHT	P23b.EDF	P23	2
37	17698692	17698844	57	209	152	RIGHT	P23b.EDF	P23	2
38	17706829	17706923	57	151	94	RIGHT	P23b.EDF	P23	2
38	17706948	17706962	176	190	14	RIGHT	P23b.EDF	P23	2
38	17707114	17707468	342	696	354	RIGHT	P23b.EDF	P23	2
38	17707665	17709148	893	2376	1483	RIGHT	P23b.EDF	P23	2
38	17709182	17709238	2410	2466	56	RIGHT	P23b.EDF	P23	2
38	17709992	17710299	3220	3527	307	RIGHT	P23b.EDF	P23	2
38	17710324	17710518	3552	3746	194	RIGHT	P23b.EDF	P23	2
38	17710549	17710549	3777	3777	0	RIGHT	P23b.EDF	P23	2
38	17712595	17712595	5823	5823	0	RIGHT	P23b.EDF	P23	2
38	17712707	17712708	5935	5936	1	RIGHT	P23b.EDF	P23	2
38	17712732	17712746	5960	5974	14	RIGHT	P23b.EDF	P23	2
38	17712863	17712863	6091	6091	0	RIGHT	P23b.EDF	P23	2
38	17712994	17713014	6222	6242	20	RIGHT	P23b.EDF	P23	2
38	17713038	17713039	6266	6267	1	RIGHT	P23b.EDF	P23	2
38	17713065	17713154	6293	6382	89	RIGHT	P23b.EDF	P23	2
38	17713221	17713221	6449	6449	0	RIGHT	P23b.EDF	P23	2
38	17713260	17713265	6488	6493	5	RIGHT	P23b.EDF	P23	2
39	17715864	17716345	57	538	481	RIGHT	P23b.EDF	P23	2
39	17718975	17719549	3168	3742	574	RIGHT	P23b.EDF	P23	2
39	17719646	17720031	3839	4224	385	RIGHT	P23b.EDF	P23	2
40	17724889	17725411	57	579	522	RIGHT	P23b.EDF	P23	2
40	17725464	17725886	632	1054	422	RIGHT	P23b.EDF	P23	2
40	17725961	17725978	1129	1146	17	RIGHT	P23b.EDF	P23	2
40	17726021	17727362	1189	2530	1341	RIGHT	P23b.EDF	P23	2
41	17731648	17731896	164	412	248	RIGHT	P23b.EDF	P23	2
41	17732380	17732613	896	1129	233	RIGHT	P23b.EDF	P23	2
42	17738207	17738439	57	289	232	RIGHT	P23b.EDF	P23	2
43	17746080	17746273	216	409	193	RIGHT	P23b.EDF	P23	2
43	17747177	17747435	1313	1571	258	RIGHT	P23b.EDF	P23	2
45	17761208	17761499	393	684	291	RIGHT	P23b.EDF	P23	2
45	17761663	17762127	848	1312	464	RIGHT	P23b.EDF	P23	2
45	17762203	17762548	1388	1733	345	RIGHT	P23b.EDF	P23	2
45	17763347	17763530	2532	2715	183	RIGHT	P23b.EDF	P23	2
45	17764017	17764021	3202	3206	4	RIGHT	P23b.EDF	P23	2
46	17767835	17767951	66	182	116	RIGHT	P23b.EDF	P23	2
46	17768258	17768513	489	744	255	RIGHT	P23b.EDF	P23	2
46	17769115	17769424	1346	1655	309	RIGHT	P23b.EDF	P23	2
47	17775289	17775564	57	332	275	RIGHT	P23b.EDF	P23	2
47	17775809	17775972	577	740	163	RIGHT	P23b.EDF	P23	2
48	17785307	17785546	57	296	239	RIGHT	P23b.EDF	P23	2
48	17785573	17785608	323	358	35	RIGHT	P23b.EDF	P23	2
48	17785629	17785941	379	691	312	RIGHT	P23b.EDF	P23	2
48	17786150	17786420	900	1170	270	RIGHT	P23b.EDF	P23	2
48	17786617	17786859	1367	1609	242	RIGHT	P23b.EDF	P23	2
49	17792800	17792967	57	224	167	RIGHT	P23b.EDF	P23	2
50	17802113	17802387	213	487	274	RIGHT	P23b.EDF	P23	2
50	17802836	17803151	936	1251	315	RIGHT	P23b.EDF	P23	2
50	17803400	17803728	1500	1828	328	RIGHT	P23b.EDF	P23	2
51	17809015	17809265	329	579	250	RIGHT	P23b.EDF	P23	2
52	17816224	17816382	57	215	158	RIGHT	P23b.EDF	P23	2
52	17816418	17816472	251	305	54	RIGHT	P23b.EDF	P23	2
52	17816571	17816888	404	721	317	RIGHT	P23b.EDF	P23	2
53	17824772	17825175	57	460	403	RIGHT	P23b.EDF	P23	2
53	17825570	17825996	855	1281	426	RIGHT	P23b.EDF	P23	2
53	17828751	17828797	4036	4082	46	RIGHT	P23b.EDF	P23	2
53	17828828	17828942	4113	4227	114	RIGHT	P23b.EDF	P23	2
53	17829000	17829000	4285	4285	0	RIGHT	P23b.EDF	P23	2
53	17829083	17829099	4368	4384	16	RIGHT	P23b.EDF	P23	2
53	17829141	17829163	4426	4448	22	RIGHT	P23b.EDF	P23	2
53	17829482	17829645	4767	4930	163	RIGHT	P23b.EDF	P23	2
54	17832454	17833551	57	1154	1097	RIGHT	P23b.EDF	P23	2
55	17838913	17839189	134	410	276	RIGHT	P23b.EDF	P23	2
55	17839438	17839713	659	934	275	RIGHT	P23b.EDF	P23	2
55	17840115	17840353	1336	1574	238	RIGHT	P23b.EDF	P23	2
56	17850090	17850287	1681	1878	197	RIGHT	P23b.EDF	P23	2
56	17851182	17853745	2773	5336	2563	RIGHT	P23b.EDF	P23	2
56	17853778	17853812	5369	5403	34	RIGHT	P23b.EDF	P23	2
56	17853873	17853897	5464	5488	24	RIGHT	P23b.EDF	P23	2
57	17856632	17856832	150	350	200	RIGHT	P23b.EDF	P23	2
57	17857407	17857678	925	1196	271	RIGHT	P23b.EDF	P23	2
57	17858552	17858785	2070	2303	233	RIGHT	P23b.EDF	P23	2
57	17859942	17860120	3460	3638	178	RIGHT	P23b.EDF	P23	2
58	17866216	17867217	57	1058	1001	RIGHT	P23b.EDF	P23	2
58	17870905	17870906	4746	4747	1	RIGHT	P23b.EDF	P23	2
58	17870928	17870929	4769	4770	1	RIGHT	P23b.EDF	P23	2
58	17870965	17871020	4806	4861	55	RIGHT	P23b.EDF	P23	2
58	17871057	17871085	4898	4926	28	RIGHT	P23b.EDF	P23	2
58	17871987	17871987	5828	5828	0	RIGHT	P23b.EDF	P23	2
58	17872009	17872010	5850	5851	1	RIGHT	P23b.EDF	P23	2
58	17872032	17872233	5873	6074	201	RIGHT	P23b.EDF	P23	2
59	17875183	17875559	57	433	376	RIGHT	P23b.EDF	P23	2
59	17877577	17878638	2451	3512	1061	RIGHT	P23b.EDF	P23	2
60	17884530	17884718	1021	1209	188	RIGHT	P23b.EDF	P23	2
62	17903512	17903984	2903	3375	472	RIGHT	P23b.EDF	P23	2
63	17907922	17908179	57	314	257	RIGHT	P23b.EDF	P23	2
63	17908577	17908913	712	1048	336	RIGHT	P23b.EDF	P23	2
63	17909348	17909600	1483	1735	252	RIGHT	P23b.EDF	P23	2
63	17911195	17911340	3330	3475	145	RIGHT	P23b.EDF	P23	2
63	17911388	17911506	3523	3641	118	RIGHT	P23b.EDF	P23	2
64	17916299	17916357	58	116	58	RIGHT	P23b.EDF	P23	2
64	17916649	17917138	408	897	489	RIGHT	P23b.EDF	P23	2
64	17921112	17921232	4871	4991	120	RIGHT	P23b.EDF	P23	2
64	17921802	17921992	5561	5751	190	RIGHT	P23b.EDF	P23	2
64	17922741	17923051	6500	6810	310	RIGHT	P23b.EDF	P23	2
65	17925994	17926548	57	611	554	RIGHT	P23b.EDF	P23	2
65	17929203	17929659	3266	3722	456	RIGHT	P23b.EDF	P23	2
65	17930171	17930553	4234	4616	382	RIGHT	P23b.EDF	P23	2
65	17931510	17931909	5573	5972	399	RIGHT	P23b.EDF	P23	2
66	17934893	17935300	72	479	407	RIGHT	P23b.EDF	P23	2
66	17935517	17935883	696	1062	366	RIGHT	P23b.EDF	P23	2
66	17936228	17936246	1407	1425	18	RIGHT	P23b.EDF	P23	2
66	17936272	17937147	1451	2326	875	RIGHT	P23b.EDF	P23	2
67	17942318	17942582	201	465	264	RIGHT	P23b.EDF	P23	2
67	17943009	17943306	892	1189	297	RIGHT	P23b.EDF	P23	2
68	17950488	17950948	86	546	460	RIGHT	P23b.EDF	P23	2
68	17951640	17951655	1238	1253	15	RIGHT	P23b.EDF	P23	2
68	17951695	17951697	1293	1295	2	RIGHT	P23b.EDF	P23	2
68	17951726	17951919	1324	1517	193	RIGHT	P23b.EDF	P23	2
68	17951943	17951946	1541	1544	3	RIGHT	P23b.EDF	P23	2
69	17958355	17958537	197	379	182	RIGHT	P23b.EDF	P23	2
69	17959244	17959574	1086	1416	330	RIGHT	P23b.EDF	P23	2
70	17966880	17967224	57	401	344	RIGHT	P23b.EDF	P23	2
70	17967556	17967844	733	1021	288	RIGHT	P23b.EDF	P23	2
70	17971004	17971192	4181	4369	188	RIGHT	P23b.EDF	P23	2
70	17972846	17972975	6023	6152	129	RIGHT	P23b.EDF	P23	2
71	17976375	17976617	408	650	242	RIGHT	P23b.EDF	P23	2
71	17976769	17977743	802	1776	974	RIGHT	P23b.EDF	P23	2
72	17982830	17983035	251	456	205	RIGHT	P23b.EDF	P23	2
72	17983740	17983973	1161	1394	233	RIGHT	P23b.EDF	P23	2
73	17990171	17990345	64	238	174	RIGHT	P23b.EDF	P23	2
74	17999533	17999686	273	426	153	RIGHT	P23b.EDF	P23	2
74	17999723	17999729	463	469	6	RIGHT	P23b.EDF	P23	2
74	18000165	18000407	905	1147	242	RIGHT	P23b.EDF	P23	2
74	18000831	18001046	1571	1786	215	RIGHT	P23b.EDF	P23	2
75	18008935	18009189	568	822	254	RIGHT	P23b.EDF	P23	2
75	18009386	18009686	1019	1319	300	RIGHT	P23b.EDF	P23	2
75	18011802	18012018	3435	3651	216	RIGHT	P23b.EDF	P23	2
76	18018240	18018273	57	90	33	RIGHT	P23b.EDF	P23	2
76	18018403	18018700	220	517	297	RIGHT	P23b.EDF	P23	2
77	18027075	18027157	57	139	82	RIGHT	P23b.EDF	P23	2
77	18030533	18030583	3515	3565	50	RIGHT	P23b.EDF	P23	2
77	18030800	18030862	3782	3844	62	RIGHT	P23b.EDF	P23	2
77	18031057	18033552	4039	6534	2495	RIGHT	P23b.EDF	P23	2
78	18035591	18036435	57	901	844	RIGHT	P23b.EDF	P23	2
78	18036900	18037854	1366	2320	954	RIGHT	P23b.EDF	P23	2
78	18038635	18038724	3101	3190	89	RIGHT	P23b.EDF	P23	2
78	18038822	18038832	3288	3298	10	RIGHT	P23b.EDF	P23	2
78	18038864	18040343	3330	4809	1479	RIGHT	P23b.EDF	P23	2
78	18040415	18040415	4881	4881	0	RIGHT	P23b.EDF	P23	2
78	18040770	18041517	5236	5983	747	RIGHT	P23b.EDF	P23	2
79	18046143	18046493	463	813	350	RIGHT	P23b.EDF	P23	2
79	18046897	18047253	1217	1573	356	RIGHT	P23b.EDF	P23	2
79	18048008	18048325	2328	2645	317	RIGHT	P23b.EDF	P23	2
80	18053942	18054190	57	305	248	RIGHT	P23b.EDF	P23	2
80	18054626	18054972	741	1087	346	RIGHT	P23b.EDF	P23	2
81	18063078	18063407	546	875	329	RIGHT	P23b.EDF	P23	2
81	18063996	18064357	1464	1825	361	RIGHT	P23b.EDF	P23	2
81	18067926	18067933	5394	5401	7	RIGHT	P23b.EDF	P23	2
81	18067971	18068654	5439	6122	683	RIGHT	P23b.EDF	P23	2
82	18071262	18071584	57	379	322	RIGHT	P23b.EDF	P23	2
82	18072420	18072635	1215	1430	215	RIGHT	P23b.EDF	P23	2
83	18080366	18080474	57	165	108	RIGHT	P23b.EDF	P23	2
83	18083605	18083628	3296	3319	23	RIGHT	P23b.EDF	P23	2
83	18083654	18083685	3345	3376	31	RIGHT	P23b.EDF	P23	2
83	18083730	18084745	3421	4436	1015	RIGHT	P23b.EDF	P23	2
83	18084774	18084862	4465	4553	88	RIGHT	P23b.EDF	P23	2
83	18084885	18084903	4576	4594	18	RIGHT	P23b.EDF	P23	2
83	18084954	18084954	4645	4645	0	RIGHT	P23b.EDF	P23	2
83	18085022	18087455	4713	7146	2433	RIGHT	P23b.EDF	P23	2
84	18091402	18091570	185	353	168	RIGHT	P23b.EDF	P23	2
84	18092222	18092445	1005	1228	223	RIGHT	P23b.EDF	P23	2
84	18094833	18095176	3616	3959	343	RIGHT	P23b.EDF	P23	2
85	18101668	18101880	225	437	212	RIGHT	P23b.EDF	P23	2
85	18103138	18103382	1695	1939	244	RIGHT	P23b.EDF	P23	2
86	18110566	18110832	1017	1283	266	RIGHT	P23b.EDF	P23	2
87	18117819	18118130	57	368	311	RIGHT	P23b.EDF	P23	2
87	18118154	18118154	392	392	0	RIGHT	P23b.EDF	P23	2
87	18118175	18118185	413	423	10	RIGHT	P23b.EDF	P23	2
87	18118209	18118234	447	472	25	RIGHT	P23b.EDF	P23	2
87	18118531	18118860	769	1098	329	RIGHT	P23b.EDF	P23	2
87	18119195	18119781	1433	2019	586	RIGHT	P23b.EDF	P23	2
87	18119811	18119821	2049	2059	10	RIGHT	P23b.EDF	P23	2
88	18126397	18126589	129	321	192	RIGHT	P23b.EDF	P23	2
90	18143305	18143531	84	310	226	RIGHT	P23b.EDF	P23	2
90	18143553	18143553	332	332	0	RIGHT	P23b.EDF	P23	2
90	18144471	18144738	1250	1517	267	RIGHT	P23b.EDF	P23	2
90	18147003	18147080	3782	3859	77	RIGHT	P23b.EDF	P23	2
90	18147351	18147430	4130	4209	79	RIGHT	P23b.EDF	P23	2
90	18147558	18147558	4337	4337	0	RIGHT	P23b.EDF	P23	2
90	18147582	18150364	4361	7143	2782	RIGHT	P23b.EDF	P23	2
91	18154430	18154470	93	133	40	RIGHT	P23b.EDF	P23	2
91	18155310	18155479	973	1142	169	RIGHT	P23b.EDF	P23	2
92	18161559	18161637	57	135	78	RIGHT	P23b.EDF	P23	2
92	18162219	18162378	717	876	159	RIGHT	P23b.EDF	P23	2
92	18162872	18163074	1370	1572	202	RIGHT	P23b.EDF	P23	2
92	18163101	18163290	1599	1788	189	RIGHT	P23b.EDF	P23	2
92	18166327	18166524	4825	5022	197	RIGHT	P23b.EDF	P23	2
93	18168781	18168997	96	312	216	RIGHT	P23b.EDF	P23	2
93	18169318	18169550	633	865	232	RIGHT	P23b.EDF	P23	2
93	18169858	18170151	1173	1466	293	RIGHT	P23b.EDF	P23	2
94	18177739	18177885	57	203	146	RIGHT	P23b.EDF	P23	2
95	18187162	18187431	105	374	269	RIGHT	P23b.EDF	P23	2
96	18194957	18195257	57	357	300	RIGHT	P23b.EDF	P23	2
96	18200286	18200685	5386	5785	399	RIGHT	P23b.EDF	P23	2
96	18200942	18201916	6042	7016	974	RIGHT	P23b.EDF	P23	2
2	19624337	19624465	1293	1421	128	RIGHT	P23c.EDF	P23	3
3	19631671	19631803	75	207	132	RIGHT	P23c.EDF	P23	3
10	19688426	19688591	57	222	165	RIGHT	P23c.EDF	P23	3
11	19698052	19698195	573	716	143	RIGHT	P23c.EDF	P23	3
15	19727561	19727670	57	166	109	RIGHT	P23c.EDF	P23	3
18	19754774	19754922	1363	1511	148	RIGHT	P23c.EDF	P23	3
21	19777845	19778015	349	519	170	RIGHT	P23c.EDF	P23	3
22	19785896	19786123	324	551	227	RIGHT	P23c.EDF	P23	3
28	19838700	19838862	807	969	162	RIGHT	P23c.EDF	P23	3
29	19846289	19846439	1283	1433	150	RIGHT	P23c.EDF	P23	3
29	19846776	19846969	1770	1963	193	RIGHT	P23c.EDF	P23	3
32	19871270	19871456	1700	1886	186	RIGHT	P23c.EDF	P23	3
46	19981595	19981778	704	887	183	RIGHT	P23c.EDF	P23	3
51	20021964	20022097	1460	1593	133	RIGHT	P23c.EDF	P23	3
58	20077645	20077837	275	467	192	RIGHT	P23c.EDF	P23	3
58	20078358	20078532	988	1162	174	RIGHT	P23c.EDF	P23	3
59	20085302	20085464	688	850	162	RIGHT	P23c.EDF	P23	3
62	20109559	20109714	68	223	155	RIGHT	P23c.EDF	P23	3
64	20126375	20126546	175	346	171	RIGHT	P23c.EDF	P23	3
66	20141798	20141980	340	522	182	RIGHT	P23c.EDF	P23	3
67	20151040	20151209	696	865	169	RIGHT	P23c.EDF	P23	3
68	20159012	20159155	290	433	143	RIGHT	P23c.EDF	P23	3
68	20159188	20159276	466	554	88	RIGHT	P23c.EDF	P23	3
68	20159302	20159302	580	580	0	RIGHT	P23c.EDF	P23	3
68	20159935	20160123	1213	1401	188	RIGHT	P23c.EDF	P23	3
69	20167514	20167649	68	203	135	RIGHT	P23c.EDF	P23	3
69	20167677	20167688	231	242	11	RIGHT	P23c.EDF	P23	3
70	20175837	20176053	126	342	216	RIGHT	P23c.EDF	P23	3
72	20193549	20193670	57	178	121	RIGHT	P23c.EDF	P23	3
75	20217828	20218003	1363	1538	175	RIGHT	P23c.EDF	P23	3
77	20232438	20232616	75	253	178	RIGHT	P23c.EDF	P23	3
78	20241408	20241547	169	308	139	RIGHT	P23c.EDF	P23	3
79	20249281	20249437	1275	1431	156	RIGHT	P23c.EDF	P23	3
79	20250889	20251049	2883	3043	160	RIGHT	P23c.EDF	P23	3
81	20262770	20262910	57	197	140	RIGHT	P23c.EDF	P23	3
81	20267589	20267667	4876	4954	78	RIGHT	P23c.EDF	P23	3
82	20271020	20271217	1442	1639	197	RIGHT	P23c.EDF	P23	3
83	20279304	20279494	1259	1449	190	RIGHT	P23c.EDF	P23	3
84	20286787	20286916	58	187	129	RIGHT	P23c.EDF	P23	3
86	20302604	20302822	105	323	218	RIGHT	P23c.EDF	P23	3
88	20319202	20319332	57	187	130	RIGHT	P23c.EDF	P23	3
88	20319738	20319930	593	785	192	RIGHT	P23c.EDF	P23	3
88	20320386	20320602	1241	1457	216	RIGHT	P23c.EDF	P23	3
89	20328487	20328626	141	280	139	RIGHT	P23c.EDF	P23	3
89	20332090	20332310	3744	3964	220	RIGHT	P23c.EDF	P23	3
91	20343042	20343275	130	363	233	RIGHT	P23c.EDF	P23	3
92	20352038	20352157	57	176	119	RIGHT	P23c.EDF	P23	3
92	20352864	20353047	883	1066	183	RIGHT	P23c.EDF	P23	3
92	20353467	20353691	1486	1710	224	RIGHT	P23c.EDF	P23	3
93	20360267	20360442	96	271	175	RIGHT	P23c.EDF	P23	3
95	20378642	20378784	57	199	142	RIGHT	P23c.EDF	P23	3
2	9239807	9239827	57	77	20	RIGHT	P54a.EDF	P54	1
2	9240773	9240935	1023	1185	162	RIGHT	P54a.EDF	P54	1
4	9259581	9259702	1345	1466	121	RIGHT	P54a.EDF	P54	1
5	9268542	9268623	504	585	81	RIGHT	P54a.EDF	P54	1
5	9269162	9269243	1124	1205	81	RIGHT	P54a.EDF	P54	1
5	9273281	9273388	5243	5350	107	RIGHT	P54a.EDF	P54	1
6	9277434	9277563	80	209	129	RIGHT	P54a.EDF	P54	1
6	9278852	9279014	1498	1660	162	RIGHT	P54a.EDF	P54	1
7	9286803	9286901	183	281	98	RIGHT	P54a.EDF	P54	1
7	9287353	9287486	733	866	133	RIGHT	P54a.EDF	P54	1
7	9288045	9288168	1425	1548	123	RIGHT	P54a.EDF	P54	1
8	9297452	9297633	234	415	181	RIGHT	P54a.EDF	P54	1
8	9297953	9298173	735	955	220	RIGHT	P54a.EDF	P54	1
8	9298614	9298760	1396	1542	146	RIGHT	P54a.EDF	P54	1
8	9301765	9301892	4547	4674	127	RIGHT	P54a.EDF	P54	1
9	9306899	9306940	57	98	41	RIGHT	P54a.EDF	P54	1
9	9307482	9307666	640	824	184	RIGHT	P54a.EDF	P54	1
9	9308080	9308204	1238	1362	124	RIGHT	P54a.EDF	P54	1
11	9325896	9325997	430	531	101	RIGHT	P54a.EDF	P54	1
11	9326681	9326810	1215	1344	129	RIGHT	P54a.EDF	P54	1
12	9333442	9333567	336	461	125	RIGHT	P54a.EDF	P54	1
12	9334005	9334121	899	1015	116	RIGHT	P54a.EDF	P54	1
13	9343355	9343542	138	325	187	RIGHT	P54a.EDF	P54	1
13	9343837	9344030	620	813	193	RIGHT	P54a.EDF	P54	1
13	9344153	9344328	936	1111	175	RIGHT	P54a.EDF	P54	1
13	9344642	9344795	1425	1578	153	RIGHT	P54a.EDF	P54	1
14	9352525	9352698	293	466	173	RIGHT	P54a.EDF	P54	1
14	9352951	9353194	719	962	243	RIGHT	P54a.EDF	P54	1
14	9353284	9353454	1052	1222	170	RIGHT	P54a.EDF	P54	1
15	9362752	9362807	58	113	55	RIGHT	P54a.EDF	P54	1
15	9363423	9363619	729	925	196	RIGHT	P54a.EDF	P54	1
15	9364043	9364183	1349	1489	140	RIGHT	P54a.EDF	P54	1
15	9366746	9366863	4052	4169	117	RIGHT	P54a.EDF	P54	1
15	9369106	9369324	6412	6630	218	RIGHT	P54a.EDF	P54	1
16	9372753	9372882	58	187	129	RIGHT	P54a.EDF	P54	1
16	9373270	9373551	575	856	281	RIGHT	P54a.EDF	P54	1
16	9373745	9373923	1050	1228	178	RIGHT	P54a.EDF	P54	1
16	9374440	9374557	1745	1862	117	RIGHT	P54a.EDF	P54	1
17	9383359	9383504	289	434	145	RIGHT	P54a.EDF	P54	1
17	9384016	9384147	946	1077	131	RIGHT	P54a.EDF	P54	1
17	9384528	9384612	1458	1542	84	RIGHT	P54a.EDF	P54	1
18	9392861	9393014	341	494	153	RIGHT	P54a.EDF	P54	1
18	9394174	9394269	1654	1749	95	RIGHT	P54a.EDF	P54	1
19	9403089	9403381	610	902	292	RIGHT	P54a.EDF	P54	1
19	9403736	9403915	1257	1436	179	RIGHT	P54a.EDF	P54	1
20	9413388	9413488	1495	1595	100	RIGHT	P54a.EDF	P54	1
21	9420535	9420678	201	344	143	RIGHT	P54a.EDF	P54	1
21	9421026	9421242	692	908	216	RIGHT	P54a.EDF	P54	1
21	9421580	9421748	1246	1414	168	RIGHT	P54a.EDF	P54	1
21	9425626	9425775	5292	5441	149	RIGHT	P54a.EDF	P54	1
22	9428916	9429076	277	437	160	RIGHT	P54a.EDF	P54	1
22	9429611	9429783	972	1144	172	RIGHT	P54a.EDF	P54	1
22	9430160	9430294	1521	1655	134	RIGHT	P54a.EDF	P54	1
23	9436533	9436609	58	134	76	RIGHT	P54a.EDF	P54	1
23	9437094	9437387	619	912	293	RIGHT	P54a.EDF	P54	1
23	9437520	9437726	1045	1251	206	RIGHT	P54a.EDF	P54	1
23	9437852	9438024	1377	1549	172	RIGHT	P54a.EDF	P54	1
23	9439825	9439936	3350	3461	111	RIGHT	P54a.EDF	P54	1
24	9445263	9445421	367	525	158	RIGHT	P54a.EDF	P54	1
25	9454635	9454810	84	259	175	RIGHT	P54a.EDF	P54	1
25	9455075	9455606	524	1055	531	RIGHT	P54a.EDF	P54	1
25	9456152	9456312	1601	1761	160	RIGHT	P54a.EDF	P54	1
25	9457568	9457684	3017	3133	116	RIGHT	P54a.EDF	P54	1
26	9463585	9463700	139	254	115	RIGHT	P54a.EDF	P54	1
26	9463997	9464261	551	815	264	RIGHT	P54a.EDF	P54	1
26	9464667	9464799	1221	1353	132	RIGHT	P54a.EDF	P54	1
26	9467996	9468120	4550	4674	124	RIGHT	P54a.EDF	P54	1
27	9471689	9471845	75	231	156	RIGHT	P54a.EDF	P54	1
27	9472445	9472595	831	981	150	RIGHT	P54a.EDF	P54	1
27	9472645	9472807	1031	1193	162	RIGHT	P54a.EDF	P54	1
28	9479816	9480156	57	397	340	RIGHT	P54a.EDF	P54	1
28	9480950	9481091	1191	1332	141	RIGHT	P54a.EDF	P54	1
29	9488199	9488376	474	651	177	RIGHT	P54a.EDF	P54	1
29	9489126	9489238	1401	1513	112	RIGHT	P54a.EDF	P54	1
30	9495774	9495886	58	170	112	RIGHT	P54a.EDF	P54	1
30	9496247	9496814	531	1098	567	RIGHT	P54a.EDF	P54	1
30	9497469	9497607	1753	1891	138	RIGHT	P54a.EDF	P54	1
31	9506318	9506658	487	827	340	RIGHT	P54a.EDF	P54	1
31	9507016	9507233	1185	1402	217	RIGHT	P54a.EDF	P54	1
31	9507697	9507824	1866	1993	127	RIGHT	P54a.EDF	P54	1
32	9515282	9515401	805	924	119	RIGHT	P54a.EDF	P54	1
32	9518991	9519211	4514	4734	220	RIGHT	P54a.EDF	P54	1
33	9524563	9524716	1096	1249	153	RIGHT	P54a.EDF	P54	1
34	9531938	9532129	617	808	191	RIGHT	P54a.EDF	P54	1
34	9532862	9532981	1541	1660	119	RIGHT	P54a.EDF	P54	1
35	9539765	9539913	287	435	148	RIGHT	P54a.EDF	P54	1
35	9540306	9540462	828	984	156	RIGHT	P54a.EDF	P54	1
35	9540696	9540825	1218	1347	129	RIGHT	P54a.EDF	P54	1
35	9542926	9543091	3448	3613	165	RIGHT	P54a.EDF	P54	1
35	9544230	9544354	4752	4876	124	RIGHT	P54a.EDF	P54	1
36	9547947	9548223	235	511	276	RIGHT	P54a.EDF	P54	1
36	9548624	9548823	912	1111	199	RIGHT	P54a.EDF	P54	1
36	9549312	9549458	1600	1746	146	RIGHT	P54a.EDF	P54	1
37	9557878	9558013	338	473	135	RIGHT	P54a.EDF	P54	1
37	9558290	9558473	750	933	183	RIGHT	P54a.EDF	P54	1
37	9558632	9558789	1092	1249	157	RIGHT	P54a.EDF	P54	1
37	9559546	9559675	2006	2135	129	RIGHT	P54a.EDF	P54	1
38	9566228	9566390	298	460	162	RIGHT	P54a.EDF	P54	1
38	9566838	9567002	908	1072	164	RIGHT	P54a.EDF	P54	1
38	9567533	9567663	1603	1733	130	RIGHT	P54a.EDF	P54	1
38	9571687	9571783	5757	5853	96	RIGHT	P54a.EDF	P54	1
39	9575717	9575877	247	407	160	RIGHT	P54a.EDF	P54	1
39	9576370	9576522	900	1052	152	RIGHT	P54a.EDF	P54	1
40	9583727	9583887	663	823	160	RIGHT	P54a.EDF	P54	1
40	9584433	9584546	1369	1482	113	RIGHT	P54a.EDF	P54	1
41	9593783	9593886	140	243	103	RIGHT	P54a.EDF	P54	1
41	9594011	9594196	368	553	185	RIGHT	P54a.EDF	P54	1
41	9594262	9594552	619	909	290	RIGHT	P54a.EDF	P54	1
41	9594633	9594827	990	1184	194	RIGHT	P54a.EDF	P54	1
41	9595104	9595280	1461	1637	176	RIGHT	P54a.EDF	P54	1
42	9603675	9603846	1293	1464	171	RIGHT	P54a.EDF	P54	1
43	9611012	9611173	215	376	161	RIGHT	P54a.EDF	P54	1
43	9611468	9611586	671	789	118	RIGHT	P54a.EDF	P54	1
43	9612087	9612221	1290	1424	134	RIGHT	P54a.EDF	P54	1
43	9612642	9612809	1845	2012	167	RIGHT	P54a.EDF	P54	1
44	9619754	9619913	291	450	159	RIGHT	P54a.EDF	P54	1
44	9620279	9620420	816	957	141	RIGHT	P54a.EDF	P54	1
44	9620859	9620978	1396	1515	119	RIGHT	P54a.EDF	P54	1
45	9627170	9627219	58	107	49	RIGHT	P54a.EDF	P54	1
45	9627655	9627942	543	830	287	RIGHT	P54a.EDF	P54	1
45	9628407	9628525	1295	1413	118	RIGHT	P54a.EDF	P54	1
46	9636495	9636602	388	495	107	RIGHT	P54a.EDF	P54	1
47	9645140	9645347	582	789	207	RIGHT	P54a.EDF	P54	1
47	9645785	9645943	1227	1385	158	RIGHT	P54a.EDF	P54	1
47	9646376	9646529	1818	1971	153	RIGHT	P54a.EDF	P54	1
48	9652693	9652828	505	640	135	RIGHT	P54a.EDF	P54	1
48	9653368	9653489	1180	1301	121	RIGHT	P54a.EDF	P54	1
49	9660193	9660343	336	486	150	RIGHT	P54a.EDF	P54	1
49	9661268	9661415	1411	1558	147	RIGHT	P54a.EDF	P54	1
50	9669287	9669423	211	347	136	RIGHT	P54a.EDF	P54	1
50	9669671	9670034	595	958	363	RIGHT	P54a.EDF	P54	1
50	9670495	9670637	1419	1561	142	RIGHT	P54a.EDF	P54	1
50	9672276	9672441	3200	3365	165	RIGHT	P54a.EDF	P54	1
50	9673965	9674089	4889	5013	124	RIGHT	P54a.EDF	P54	1
51	9679020	9679215	296	491	195	RIGHT	P54a.EDF	P54	1
51	9679348	9679552	624	828	204	RIGHT	P54a.EDF	P54	1
51	9679877	9680059	1153	1335	182	RIGHT	P54a.EDF	P54	1
52	9688236	9688604	438	806	368	RIGHT	P54a.EDF	P54	1
52	9688880	9689031	1082	1233	151	RIGHT	P54a.EDF	P54	1
52	9689389	9689535	1591	1737	146	RIGHT	P54a.EDF	P54	1
54	9707025	9707185	58	218	160	RIGHT	P54a.EDF	P54	1
54	9707387	9707511	420	544	124	RIGHT	P54a.EDF	P54	1
54	9707563	9708018	596	1051	455	RIGHT	P54a.EDF	P54	1
54	9708432	9708594	1465	1627	162	RIGHT	P54a.EDF	P54	1
55	9716462	9716596	1164	1298	134	RIGHT	P54a.EDF	P54	1
55	9718190	9718350	2892	3052	160	RIGHT	P54a.EDF	P54	1
55	9719111	9719265	3813	3967	154	RIGHT	P54a.EDF	P54	1
57	9732744	9732819	58	133	75	RIGHT	P54a.EDF	P54	1
57	9733299	9733489	613	803	190	RIGHT	P54a.EDF	P54	1
57	9734051	9734270	1365	1584	219	RIGHT	P54a.EDF	P54	1
57	9734547	9734695	1861	2009	148	RIGHT	P54a.EDF	P54	1
57	9736733	9736878	4047	4192	145	RIGHT	P54a.EDF	P54	1
58	9743857	9744010	1080	1233	153	RIGHT	P54a.EDF	P54	1
59	9751225	9751379	77	231	154	RIGHT	P54a.EDF	P54	1
59	9751853	9751970	705	822	117	RIGHT	P54a.EDF	P54	1
59	9752217	9752672	1069	1524	455	RIGHT	P54a.EDF	P54	1
59	9755068	9755281	3920	4133	213	RIGHT	P54a.EDF	P54	1
60	9760222	9760426	609	813	204	RIGHT	P54a.EDF	P54	1
60	9762941	9763153	3328	3540	212	RIGHT	P54a.EDF	P54	1
62	9778426	9778637	662	873	211	RIGHT	P54a.EDF	P54	1
62	9779085	9779264	1321	1500	179	RIGHT	P54a.EDF	P54	1
63	9788400	9788551	194	345	151	RIGHT	P54a.EDF	P54	1
63	9789067	9789217	861	1011	150	RIGHT	P54a.EDF	P54	1
63	9789676	9789842	1470	1636	166	RIGHT	P54a.EDF	P54	1
63	9793043	9793225	4837	5019	182	RIGHT	P54a.EDF	P54	1
64	9796376	9796526	750	900	150	RIGHT	P54a.EDF	P54	1
64	9797063	9797191	1437	1565	128	RIGHT	P54a.EDF	P54	1
65	9803474	9803619	302	447	145	RIGHT	P54a.EDF	P54	1
65	9804174	9804394	1002	1222	220	RIGHT	P54a.EDF	P54	1
65	9804832	9804956	1660	1784	124	RIGHT	P54a.EDF	P54	1
66	9810863	9811025	343	505	162	RIGHT	P54a.EDF	P54	1
67	9820507	9820650	478	621	143	RIGHT	P54a.EDF	P54	1
67	9820789	9820952	760	923	163	RIGHT	P54a.EDF	P54	1
68	9830888	9831051	782	945	163	RIGHT	P54a.EDF	P54	1
68	9831774	9831978	1668	1872	204	RIGHT	P54a.EDF	P54	1
68	9832801	9832976	2695	2870	175	RIGHT	P54a.EDF	P54	1
70	9848556	9848689	1761	1894	133	RIGHT	P54a.EDF	P54	1
72	9867931	9868123	661	853	192	RIGHT	P54a.EDF	P54	1
72	9868425	9868580	1155	1310	155	RIGHT	P54a.EDF	P54	1
74	9886256	9886448	600	792	192	RIGHT	P54a.EDF	P54	1
75	9895669	9895958	428	717	289	RIGHT	P54a.EDF	P54	1
75	9896075	9896303	834	1062	228	RIGHT	P54a.EDF	P54	1
76	9902841	9903034	58	251	193	RIGHT	P54a.EDF	P54	1
77	9912806	9912998	314	506	192	RIGHT	P54a.EDF	P54	1
78	9922247	9922454	719	926	207	RIGHT	P54a.EDF	P54	1
78	9923186	9923364	1658	1836	178	RIGHT	P54a.EDF	P54	1
78	9923928	9924921	2400	3393	993	RIGHT	P54a.EDF	P54	1
79	9931604	9932052	375	823	448	RIGHT	P54a.EDF	P54	1
79	9932090	9932191	861	962	101	RIGHT	P54a.EDF	P54	1
80	9941036	9941333	267	564	297	RIGHT	P54a.EDF	P54	1
80	9942311	9942627	1542	1858	316	RIGHT	P54a.EDF	P54	1
81	9948503	9948535	58	90	32	RIGHT	P54a.EDF	P54	1
81	9949747	9950061	1302	1616	314	RIGHT	P54a.EDF	P54	1
82	9957605	9957752	58	205	147	RIGHT	P54a.EDF	P54	1
82	9957893	9957910	346	363	17	RIGHT	P54a.EDF	P54	1
82	9957933	9958028	386	481	95	RIGHT	P54a.EDF	P54	1
82	9958058	9958622	511	1075	564	RIGHT	P54a.EDF	P54	1
82	9958757	9959114	1210	1567	357	RIGHT	P54a.EDF	P54	1
83	9966935	9967276	58	399	341	RIGHT	P54a.EDF	P54	1
83	9967306	9967622	429	745	316	RIGHT	P54a.EDF	P54	1
83	9967646	9967748	769	871	102	RIGHT	P54a.EDF	P54	1
83	9967954	9968282	1077	1405	328	RIGHT	P54a.EDF	P54	1
83	9968321	9968399	1444	1522	78	RIGHT	P54a.EDF	P54	1
83	9968514	9968726	1637	1849	212	RIGHT	P54a.EDF	P54	1
83	9968755	9968760	1878	1883	5	RIGHT	P54a.EDF	P54	1
83	9968797	9968861	1920	1984	64	RIGHT	P54a.EDF	P54	1
84	9976105	9976134	57	86	29	RIGHT	P54a.EDF	P54	1
84	9976346	9976451	298	403	105	RIGHT	P54a.EDF	P54	1
84	9976478	9976590	430	542	112	RIGHT	P54a.EDF	P54	1
84	9979105	9979202	3057	3154	97	RIGHT	P54a.EDF	P54	1
84	9979232	9979312	3184	3264	80	RIGHT	P54a.EDF	P54	1
85	9984983	9985286	231	534	303	RIGHT	P54a.EDF	P54	1
85	9985454	9985773	702	1021	319	RIGHT	P54a.EDF	P54	1
86	9993722	9993940	509	727	218	RIGHT	P54a.EDF	P54	1
86	9994005	9994060	792	847	55	RIGHT	P54a.EDF	P54	1
86	9994533	9994887	1320	1674	354	RIGHT	P54a.EDF	P54	1
87	10000444	10000667	57	280	223	RIGHT	P54a.EDF	P54	1
88	10010035	10010764	57	786	729	RIGHT	P54a.EDF	P54	1
88	10010882	10011231	904	1253	349	RIGHT	P54a.EDF	P54	1
88	10013098	10013392	3120	3414	294	RIGHT	P54a.EDF	P54	1
89	10019447	10019748	57	358	301	RIGHT	P54a.EDF	P54	1
89	10020136	10020448	746	1058	312	RIGHT	P54a.EDF	P54	1
89	10020996	10021292	1606	1902	296	RIGHT	P54a.EDF	P54	1
90	10028527	10028657	57	187	130	RIGHT	P54a.EDF	P54	1
90	10029141	10029443	671	973	302	RIGHT	P54a.EDF	P54	1
90	10030825	10031050	2355	2580	225	RIGHT	P54a.EDF	P54	1
90	10032032	10032357	3562	3887	325	RIGHT	P54a.EDF	P54	1
91	10037757	10038434	57	734	677	RIGHT	P54a.EDF	P54	1
91	10038533	10039493	833	1793	960	RIGHT	P54a.EDF	P54	1
92	10047347	10048832	58	1543	1485	RIGHT	P54a.EDF	P54	1
92	10048951	10049546	1662	2257	595	RIGHT	P54a.EDF	P54	1
93	10054282	10054436	57	211	154	RIGHT	P54a.EDF	P54	1
93	10055015	10055453	790	1228	438	RIGHT	P54a.EDF	P54	1
94	10062763	10063098	57	392	335	RIGHT	P54a.EDF	P54	1
94	10063427	10063920	721	1214	493	RIGHT	P54a.EDF	P54	1
94	10064017	10064579	1311	1873	562	RIGHT	P54a.EDF	P54	1
96	10080057	10080142	58	143	85	RIGHT	P54a.EDF	P54	1
96	10080290	10080297	291	298	7	RIGHT	P54a.EDF	P54	1
96	10080319	10080608	320	609	289	RIGHT	P54a.EDF	P54	1
96	10080678	10081207	679	1208	529	RIGHT	P54a.EDF	P54	1
96	10081360	10081482	1361	1483	122	RIGHT	P54a.EDF	P54	1
96	10081528	10081686	1529	1687	158	RIGHT	P54a.EDF	P54	1
97	10089722	10089794	58	130	72	RIGHT	P54a.EDF	P54	1
97	10090024	10090238	360	574	214	RIGHT	P54a.EDF	P54	1
97	10090259	10090374	595	710	115	RIGHT	P54a.EDF	P54	1
97	10092343	10092595	2679	2931	252	RIGHT	P54a.EDF	P54	1
97	10093529	10093793	3865	4129	264	RIGHT	P54a.EDF	P54	1
97	10095401	10095830	5737	6166	429	RIGHT	P54a.EDF	P54	1
98	10100485	10100554	58	127	69	RIGHT	P54a.EDF	P54	1
98	10100903	10101592	476	1165	689	RIGHT	P54a.EDF	P54	1
98	10101832	10102119	1405	1692	287	RIGHT	P54a.EDF	P54	1
99	10110401	10110519	57	175	118	RIGHT	P54a.EDF	P54	1
99	10111013	10111212	669	868	199	RIGHT	P54a.EDF	P54	1
99	10111233	10111346	889	1002	113	RIGHT	P54a.EDF	P54	1
99	10111561	10111739	1217	1395	178	RIGHT	P54a.EDF	P54	1
99	10111765	10111903	1421	1559	138	RIGHT	P54a.EDF	P54	1
99	10113007	10113260	2663	2916	253	RIGHT	P54a.EDF	P54	1
99	10113855	10114029	3511	3685	174	RIGHT	P54a.EDF	P54	1
100	10118931	10119207	839	1115	276	RIGHT	P54a.EDF	P54	1
100	10119630	10119632	1538	1540	2	RIGHT	P54a.EDF	P54	1
100	10119653	10120087	1561	1995	434	RIGHT	P54a.EDF	P54	1
101	10126264	10126265	75	76	1	RIGHT	P54a.EDF	P54	1
101	10126862	10127122	673	933	260	RIGHT	P54a.EDF	P54	1
101	10127174	10127623	985	1434	449	RIGHT	P54a.EDF	P54	1
101	10127830	10128207	1641	2018	377	RIGHT	P54a.EDF	P54	1
102	10134921	10135675	58	812	754	RIGHT	P54a.EDF	P54	1
102	10137487	10137813	2624	2950	326	RIGHT	P54a.EDF	P54	1
103	10143247	10143360	58	171	113	RIGHT	P54a.EDF	P54	1
103	10147746	10147920	4557	4731	174	RIGHT	P54a.EDF	P54	1
103	10147951	10148046	4762	4857	95	RIGHT	P54a.EDF	P54	1
104	10151481	10151643	621	783	162	RIGHT	P54a.EDF	P54	1
104	10151675	10151763	815	903	88	RIGHT	P54a.EDF	P54	1
104	10153223	10153367	2363	2507	144	RIGHT	P54a.EDF	P54	1
104	10153422	10153497	2562	2637	75	RIGHT	P54a.EDF	P54	1
105	10158974	10159132	179	337	158	RIGHT	P54a.EDF	P54	1
105	10159158	10159160	363	365	2	RIGHT	P54a.EDF	P54	1
105	10159192	10159266	397	471	74	RIGHT	P54a.EDF	P54	1
105	10160126	10160282	1331	1487	156	RIGHT	P54a.EDF	P54	1
105	10160322	10160418	1527	1623	96	RIGHT	P54a.EDF	P54	1
105	10161277	10161463	2482	2668	186	RIGHT	P54a.EDF	P54	1
105	10161508	10161605	2713	2810	97	RIGHT	P54a.EDF	P54	1
106	10167157	10167190	57	90	33	RIGHT	P54a.EDF	P54	1
107	10176099	10176406	601	908	307	RIGHT	P54a.EDF	P54	1
107	10176761	10176959	1263	1461	198	RIGHT	P54a.EDF	P54	1
107	10176981	10177027	1483	1529	46	RIGHT	P54a.EDF	P54	1
107	10179824	10180058	4326	4560	234	RIGHT	P54a.EDF	P54	1
108	10184246	10184627	646	1027	381	RIGHT	P54a.EDF	P54	1
108	10184804	10184988	1204	1388	184	RIGHT	P54a.EDF	P54	1
108	10185011	10185140	1411	1540	129	RIGHT	P54a.EDF	P54	1
108	10186425	10186805	2825	3205	380	RIGHT	P54a.EDF	P54	1
109	10191752	10191832	58	138	80	RIGHT	P54a.EDF	P54	1
110	10200662	10200908	57	303	246	RIGHT	P54a.EDF	P54	1
110	10200929	10201091	324	486	162	RIGHT	P54a.EDF	P54	1
110	10202529	10202607	1924	2002	78	RIGHT	P54a.EDF	P54	1
110	10202632	10202732	2027	2127	100	RIGHT	P54a.EDF	P54	1
111	10210168	10210608	57	497	440	RIGHT	P54a.EDF	P54	1
111	10210883	10211289	772	1178	406	RIGHT	P54a.EDF	P54	1
111	10211588	10211903	1477	1792	315	RIGHT	P54a.EDF	P54	1
112	10218343	10218448	77	182	105	RIGHT	P54a.EDF	P54	1
112	10218737	10219011	471	745	274	RIGHT	P54a.EDF	P54	1
112	10219424	10219605	1158	1339	181	RIGHT	P54a.EDF	P54	1
112	10219632	10219694	1366	1428	62	RIGHT	P54a.EDF	P54	1
113	10227203	10227952	573	1322	749	RIGHT	P54a.EDF	P54	1
113	10228272	10228742	1642	2112	470	RIGHT	P54a.EDF	P54	1
114	10235394	10235642	58	306	248	RIGHT	P54a.EDF	P54	1
115	10242536	10242789	57	310	253	RIGHT	P54a.EDF	P54	1
115	10243145	10243614	666	1135	469	RIGHT	P54a.EDF	P54	1
115	10244037	10244560	1558	2081	523	RIGHT	P54a.EDF	P54	1
115	10244649	10244707	2170	2228	58	RIGHT	P54a.EDF	P54	1
116	10251273	10251367	57	151	94	RIGHT	P54a.EDF	P54	1
116	10251482	10251500	266	284	18	RIGHT	P54a.EDF	P54	1
116	10251521	10251855	305	639	334	RIGHT	P54a.EDF	P54	1
116	10252163	10252532	947	1316	369	RIGHT	P54a.EDF	P54	1
116	10252929	10252937	1713	1721	8	RIGHT	P54a.EDF	P54	1
116	10252961	10253186	1745	1970	225	RIGHT	P54a.EDF	P54	1
117	10260468	10261605	57	1194	1137	RIGHT	P54a.EDF	P54	1
118	10269912	10270021	58	167	109	RIGHT	P54a.EDF	P54	1
118	10270869	10271998	1015	2144	1129	RIGHT	P54a.EDF	P54	1
119	10279599	10279734	85	220	135	RIGHT	P54a.EDF	P54	1
119	10280535	10280905	1021	1391	370	RIGHT	P54a.EDF	P54	1
120	10287906	10288289	57	440	383	RIGHT	P54a.EDF	P54	1
2	11365459	11365548	57	146	89	RIGHT	P54b.EDF	P54	2
2	11365767	11365881	365	479	114	RIGHT	P54b.EDF	P54	2
2	11366968	11367081	1566	1679	113	RIGHT	P54b.EDF	P54	2
3	11376279	11376431	118	270	152	RIGHT	P54b.EDF	P54	2
3	11376636	11376905	475	744	269	RIGHT	P54b.EDF	P54	2
3	11377320	11377498	1159	1337	178	RIGHT	P54b.EDF	P54	2
4	11384019	11384196	72	249	177	RIGHT	P54b.EDF	P54	2
4	11384307	11384533	360	586	226	RIGHT	P54b.EDF	P54	2
4	11384630	11384835	683	888	205	RIGHT	P54b.EDF	P54	2
6	11404772	11404857	339	424	85	RIGHT	P54b.EDF	P54	2
6	11405071	11405322	638	889	251	RIGHT	P54b.EDF	P54	2
6	11407363	11407541	2930	3108	178	RIGHT	P54b.EDF	P54	2
7	11412074	11412201	686	813	127	RIGHT	P54b.EDF	P54	2
7	11412731	11412873	1343	1485	142	RIGHT	P54b.EDF	P54	2
7	11414742	11414870	3354	3482	128	RIGHT	P54b.EDF	P54	2
8	11419288	11419405	58	175	117	RIGHT	P54b.EDF	P54	2
8	11419690	11419862	460	632	172	RIGHT	P54b.EDF	P54	2
8	11420004	11420197	774	967	193	RIGHT	P54b.EDF	P54	2
8	11422332	11422513	3102	3283	181	RIGHT	P54b.EDF	P54	2
8	11424181	11424304	4951	5074	123	RIGHT	P54b.EDF	P54	2
9	11428822	11428982	458	618	160	RIGHT	P54b.EDF	P54	2
9	11430726	11430857	2362	2493	131	RIGHT	P54b.EDF	P54	2
10	11436714	11436873	705	864	159	RIGHT	P54b.EDF	P54	2
10	11436988	11437164	979	1155	176	RIGHT	P54b.EDF	P54	2
11	11444610	11444856	57	303	246	RIGHT	P54b.EDF	P54	2
11	11444916	11445119	363	566	203	RIGHT	P54b.EDF	P54	2
11	11446048	11446211	1495	1658	163	RIGHT	P54b.EDF	P54	2
12	11453239	11453374	192	327	135	RIGHT	P54b.EDF	P54	2
12	11453633	11453913	586	866	280	RIGHT	P54b.EDF	P54	2
12	11454066	11454245	1019	1198	179	RIGHT	P54b.EDF	P54	2
12	11454784	11454941	1737	1894	157	RIGHT	P54b.EDF	P54	2
12	11455625	11455757	2578	2710	132	RIGHT	P54b.EDF	P54	2
13	11462322	11462478	282	438	156	RIGHT	P54b.EDF	P54	2
13	11463725	11463841	1685	1801	116	RIGHT	P54b.EDF	P54	2
14	11470137	11470347	275	485	210	RIGHT	P54b.EDF	P54	2
14	11470483	11470762	621	900	279	RIGHT	P54b.EDF	P54	2
14	11470867	11471308	1005	1446	441	RIGHT	P54b.EDF	P54	2
16	11488025	11488203	713	891	178	RIGHT	P54b.EDF	P54	2
17	11496836	11496957	58	179	121	RIGHT	P54b.EDF	P54	2
17	11498302	11498441	1524	1663	139	RIGHT	P54b.EDF	P54	2
17	11499323	11499516	2545	2738	193	RIGHT	P54b.EDF	P54	2
17	11500845	11501026	4067	4248	181	RIGHT	P54b.EDF	P54	2
18	11504573	11504778	268	473	205	RIGHT	P54b.EDF	P54	2
18	11505106	11505293	801	988	187	RIGHT	P54b.EDF	P54	2
18	11505736	11505882	1431	1577	146	RIGHT	P54b.EDF	P54	2
20	11522831	11523595	58	822	764	RIGHT	P54b.EDF	P54	2
20	11523716	11523866	943	1093	150	RIGHT	P54b.EDF	P54	2
20	11525124	11525323	2351	2550	199	RIGHT	P54b.EDF	P54	2
21	11531352	11531537	57	242	185	RIGHT	P54b.EDF	P54	2
21	11532735	11532884	1440	1589	149	RIGHT	P54b.EDF	P54	2
22	11540273	11540476	200	403	203	RIGHT	P54b.EDF	P54	2
22	11540741	11541040	668	967	299	RIGHT	P54b.EDF	P54	2
22	11541325	11541498	1252	1425	173	RIGHT	P54b.EDF	P54	2
22	11541781	11541969	1708	1896	188	RIGHT	P54b.EDF	P54	2
22	11542629	11542834	2556	2761	205	RIGHT	P54b.EDF	P54	2
22	11544010	11544188	3937	4115	178	RIGHT	P54b.EDF	P54	2
23	11549549	11549674	57	182	125	RIGHT	P54b.EDF	P54	2
23	11549810	11549975	318	483	165	RIGHT	P54b.EDF	P54	2
23	11550273	11550574	781	1082	301	RIGHT	P54b.EDF	P54	2
24	11560391	11560538	799	946	147	RIGHT	P54b.EDF	P54	2
24	11560939	11561100	1347	1508	161	RIGHT	P54b.EDF	P54	2
25	11569490	11569699	338	547	209	RIGHT	P54b.EDF	P54	2
25	11570057	11570324	905	1172	267	RIGHT	P54b.EDF	P54	2
25	11570884	11570999	1732	1847	115	RIGHT	P54b.EDF	P54	2
25	11571690	11571827	2538	2675	137	RIGHT	P54b.EDF	P54	2
26	11579391	11579594	258	461	203	RIGHT	P54b.EDF	P54	2
26	11579760	11580089	627	956	329	RIGHT	P54b.EDF	P54	2
26	11580267	11580496	1134	1363	229	RIGHT	P54b.EDF	P54	2
26	11580723	11581174	1590	2041	451	RIGHT	P54b.EDF	P54	2
26	11581752	11581985	2619	2852	233	RIGHT	P54b.EDF	P54	2
27	11587874	11588035	851	1012	161	RIGHT	P54b.EDF	P54	2
27	11588533	11588725	1510	1702	192	RIGHT	P54b.EDF	P54	2
28	11596126	11596280	270	424	154	RIGHT	P54b.EDF	P54	2
29	11603726	11603873	221	368	147	RIGHT	P54b.EDF	P54	2
30	11612989	11613119	206	336	130	RIGHT	P54b.EDF	P54	2
31	11621480	11621623	421	564	143	RIGHT	P54b.EDF	P54	2
32	11627951	11628097	58	204	146	RIGHT	P54b.EDF	P54	2
32	11628767	11628901	874	1008	134	RIGHT	P54b.EDF	P54	2
32	11629382	11629541	1489	1648	159	RIGHT	P54b.EDF	P54	2
33	11636067	11636270	57	260	203	RIGHT	P54b.EDF	P54	2
34	11644587	11644753	213	379	166	RIGHT	P54b.EDF	P54	2
34	11645468	11645609	1094	1235	141	RIGHT	P54b.EDF	P54	2
35	11652950	11653090	125	265	140	RIGHT	P54b.EDF	P54	2
35	11653228	11653435	403	610	207	RIGHT	P54b.EDF	P54	2
35	11653488	11653752	663	927	264	RIGHT	P54b.EDF	P54	2
36	11662241	11662511	476	746	270	RIGHT	P54b.EDF	P54	2
36	11662937	11663103	1172	1338	166	RIGHT	P54b.EDF	P54	2
36	11663380	11663537	1615	1772	157	RIGHT	P54b.EDF	P54	2
37	11670151	11670350	232	431	199	RIGHT	P54b.EDF	P54	2
37	11672424	11672600	2505	2681	176	RIGHT	P54b.EDF	P54	2
38	11678303	11678492	198	387	189	RIGHT	P54b.EDF	P54	2
39	11686928	11687123	57	252	195	RIGHT	P54b.EDF	P54	2
39	11687346	11687517	475	646	171	RIGHT	P54b.EDF	P54	2
39	11688203	11688338	1332	1467	135	RIGHT	P54b.EDF	P54	2
39	11688900	11689048	2029	2177	148	RIGHT	P54b.EDF	P54	2
40	11697011	11697201	401	591	190	RIGHT	P54b.EDF	P54	2
40	11698079	11698224	1469	1614	145	RIGHT	P54b.EDF	P54	2
42	11712869	11713120	126	377	251	RIGHT	P54b.EDF	P54	2
43	11722235	11722400	299	464	165	RIGHT	P54b.EDF	P54	2
43	11722730	11722941	794	1005	211	RIGHT	P54b.EDF	P54	2
44	11729050	11729275	89	314	225	RIGHT	P54b.EDF	P54	2
44	11729671	11729821	710	860	150	RIGHT	P54b.EDF	P54	2
45	11738766	11739228	190	652	462	RIGHT	P54b.EDF	P54	2
45	11740316	11740468	1740	1892	152	RIGHT	P54b.EDF	P54	2
48	11763055	11763331	252	528	276	RIGHT	P54b.EDF	P54	2
48	11763704	11763883	901	1080	179	RIGHT	P54b.EDF	P54	2
48	11764431	11764588	1628	1785	157	RIGHT	P54b.EDF	P54	2
49	11772285	11772506	139	360	221	RIGHT	P54b.EDF	P54	2
49	11772968	11773153	822	1007	185	RIGHT	P54b.EDF	P54	2
50	11781440	11781614	57	231	174	RIGHT	P54b.EDF	P54	2
51	11790896	11791067	131	302	171	RIGHT	P54b.EDF	P54	2
51	11791411	11791570	646	805	159	RIGHT	P54b.EDF	P54	2
51	11792192	11792363	1427	1598	171	RIGHT	P54b.EDF	P54	2
51	11793479	11793613	2714	2848	134	RIGHT	P54b.EDF	P54	2
52	11803734	11804318	694	1278	584	RIGHT	P54b.EDF	P54	2
52	11804696	11804841	1656	1801	145	RIGHT	P54b.EDF	P54	2
53	11812260	11812396	58	194	136	RIGHT	P54b.EDF	P54	2
53	11812982	11813165	780	963	183	RIGHT	P54b.EDF	P54	2
53	11813791	11813944	1589	1742	153	RIGHT	P54b.EDF	P54	2
54	11822889	11823076	671	858	187	RIGHT	P54b.EDF	P54	2
54	11823515	11823665	1297	1447	150	RIGHT	P54b.EDF	P54	2
55	11830632	11830786	58	212	154	RIGHT	P54b.EDF	P54	2
55	11831169	11831381	595	807	212	RIGHT	P54b.EDF	P54	2
55	11832275	11832411	1701	1837	136	RIGHT	P54b.EDF	P54	2
56	11839935	11840142	1597	1804	207	RIGHT	P54b.EDF	P54	2
57	11846569	11846733	231	395	164	RIGHT	P54b.EDF	P54	2
57	11847001	11847270	663	932	269	RIGHT	P54b.EDF	P54	2
57	11847514	11847732	1176	1394	218	RIGHT	P54b.EDF	P54	2
57	11847993	11848181	1655	1843	188	RIGHT	P54b.EDF	P54	2
58	11855574	11855717	305	448	143	RIGHT	P54b.EDF	P54	2
58	11855973	11856176	704	907	203	RIGHT	P54b.EDF	P54	2
58	11856872	11857023	1603	1754	151	RIGHT	P54b.EDF	P54	2
59	11863872	11864022	858	1008	150	RIGHT	P54b.EDF	P54	2
60	11871352	11871460	328	436	108	RIGHT	P54b.EDF	P54	2
60	11871713	11871977	689	953	264	RIGHT	P54b.EDF	P54	2
60	11872092	11872279	1068	1255	187	RIGHT	P54b.EDF	P54	2
60	11872409	11872673	1385	1649	264	RIGHT	P54b.EDF	P54	2
61	11879694	11879875	290	471	181	RIGHT	P54b.EDF	P54	2
61	11880403	11880543	999	1139	140	RIGHT	P54b.EDF	P54	2
61	11880926	11881086	1522	1682	160	RIGHT	P54b.EDF	P54	2
62	11888541	11888773	615	847	232	RIGHT	P54b.EDF	P54	2
62	11888967	11889206	1041	1280	239	RIGHT	P54b.EDF	P54	2
62	11889589	11889773	1663	1847	184	RIGHT	P54b.EDF	P54	2
63	11896955	11897261	57	363	306	RIGHT	P54b.EDF	P54	2
63	11897884	11898098	986	1200	214	RIGHT	P54b.EDF	P54	2
63	11898485	11898708	1587	1810	223	RIGHT	P54b.EDF	P54	2
64	11906074	11906233	57	216	159	RIGHT	P54b.EDF	P54	2
64	11907015	11907217	998	1200	202	RIGHT	P54b.EDF	P54	2
65	11914827	11914990	1403	1566	163	RIGHT	P54b.EDF	P54	2
66	11924582	11924802	305	525	220	RIGHT	P54b.EDF	P54	2
66	11925292	11925454	1015	1177	162	RIGHT	P54b.EDF	P54	2
66	11925844	11926028	1567	1751	184	RIGHT	P54b.EDF	P54	2
67	11934646	11934843	888	1085	197	RIGHT	P54b.EDF	P54	2
67	11935248	11935456	1490	1698	208	RIGHT	P54b.EDF	P54	2
68	11943291	11943490	1239	1438	199	RIGHT	P54b.EDF	P54	2
69	11949806	11950026	209	429	220	RIGHT	P54b.EDF	P54	2
69	11950571	11950784	974	1187	213	RIGHT	P54b.EDF	P54	2
69	11951097	11951298	1500	1701	201	RIGHT	P54b.EDF	P54	2
71	11968125	11968371	68	314	246	RIGHT	P54b.EDF	P54	2
71	11969183	11969357	1126	1300	174	RIGHT	P54b.EDF	P54	2
72	11977443	11977636	683	876	193	RIGHT	P54b.EDF	P54	2
72	11977951	11978144	1191	1384	193	RIGHT	P54b.EDF	P54	2
72	11978791	11978967	2031	2207	176	RIGHT	P54b.EDF	P54	2
73	11984692	11984884	723	915	192	RIGHT	P54b.EDF	P54	2
73	11985483	11985672	1514	1703	189	RIGHT	P54b.EDF	P54	2
74	11992511	11992674	116	279	163	RIGHT	P54b.EDF	P54	2
75	12002056	12002244	358	546	188	RIGHT	P54b.EDF	P54	2
75	12004172	12004469	2474	2771	297	RIGHT	P54b.EDF	P54	2
75	12004541	12004832	2843	3134	291	RIGHT	P54b.EDF	P54	2
76	12010168	12010416	344	592	248	RIGHT	P54b.EDF	P54	2
76	12010841	12011027	1017	1203	186	RIGHT	P54b.EDF	P54	2
76	12011308	12011518	1484	1694	210	RIGHT	P54b.EDF	P54	2
77	12018922	12019159	57	294	237	RIGHT	P54b.EDF	P54	2
77	12019741	12019937	876	1072	196	RIGHT	P54b.EDF	P54	2
77	12020440	12020596	1575	1731	156	RIGHT	P54b.EDF	P54	2
78	12028069	12028240	701	872	171	RIGHT	P54b.EDF	P54	2
78	12028834	12029018	1466	1650	184	RIGHT	P54b.EDF	P54	2
79	12038018	12038259	686	927	241	RIGHT	P54b.EDF	P54	2
79	12038357	12038572	1025	1240	215	RIGHT	P54b.EDF	P54	2
80	12045793	12045985	136	328	192	RIGHT	P54b.EDF	P54	2
81	12055254	12055458	1202	1406	204	RIGHT	P54b.EDF	P54	2
81	12055783	12055941	1731	1889	158	RIGHT	P54b.EDF	P54	2
82	12062664	12062836	890	1062	172	RIGHT	P54b.EDF	P54	2
82	12063274	12063437	1500	1663	163	RIGHT	P54b.EDF	P54	2
83	12070083	12070291	697	905	208	RIGHT	P54b.EDF	P54	2
84	12077119	12077282	57	220	163	RIGHT	P54b.EDF	P54	2
84	12077600	12077879	538	817	279	RIGHT	P54b.EDF	P54	2
84	12078164	12078480	1102	1418	316	RIGHT	P54b.EDF	P54	2
84	12079342	12079565	2280	2503	223	RIGHT	P54b.EDF	P54	2
85	12086498	12086726	726	954	228	RIGHT	P54b.EDF	P54	2
85	12086921	12087199	1149	1427	278	RIGHT	P54b.EDF	P54	2
85	12088252	12088496	2480	2724	244	RIGHT	P54b.EDF	P54	2
85	12092798	12093015	7026	7243	217	RIGHT	P54b.EDF	P54	2
86	12095812	12096083	260	531	271	RIGHT	P54b.EDF	P54	2
86	12096390	12096578	838	1026	188	RIGHT	P54b.EDF	P54	2
86	12096907	12097136	1355	1584	229	RIGHT	P54b.EDF	P54	2
87	12103238	12103441	881	1084	203	RIGHT	P54b.EDF	P54	2
88	12111125	12111306	933	1114	181	RIGHT	P54b.EDF	P54	2
89	12117951	12118208	208	465	257	RIGHT	P54b.EDF	P54	2
90	12128558	12128824	1186	1452	266	RIGHT	P54b.EDF	P54	2
91	12136846	12136883	57	94	37	RIGHT	P54b.EDF	P54	2
91	12138146	12138305	1357	1516	159	RIGHT	P54b.EDF	P54	2
92	12145580	12145806	1004	1230	226	RIGHT	P54b.EDF	P54	2
92	12146841	12147065	2265	2489	224	RIGHT	P54b.EDF	P54	2
93	12152709	12152750	58	99	41	RIGHT	P54b.EDF	P54	2
93	12153358	12153704	707	1053	346	RIGHT	P54b.EDF	P54	2
93	12154095	12154356	1444	1705	261	RIGHT	P54b.EDF	P54	2
94	12161607	12161721	58	172	114	RIGHT	P54b.EDF	P54	2
94	12161936	12162106	387	557	170	RIGHT	P54b.EDF	P54	2
94	12162534	12162778	985	1229	244	RIGHT	P54b.EDF	P54	2
94	12163060	12163279	1511	1730	219	RIGHT	P54b.EDF	P54	2
95	12171771	12172124	499	852	353	RIGHT	P54b.EDF	P54	2
95	12172578	12172810	1306	1538	232	RIGHT	P54b.EDF	P54	2
97	12188813	12189032	392	611	219	RIGHT	P54b.EDF	P54	2
97	12189110	12189369	689	948	259	RIGHT	P54b.EDF	P54	2
97	12189990	12190218	1569	1797	228	RIGHT	P54b.EDF	P54	2
98	12197694	12197952	608	866	258	RIGHT	P54b.EDF	P54	2
100	12214275	12214491	57	273	216	RIGHT	P54b.EDF	P54	2
100	12214762	12215037	544	819	275	RIGHT	P54b.EDF	P54	2
100	12215429	12215643	1211	1425	214	RIGHT	P54b.EDF	P54	2
100	12216103	12216293	1885	2075	190	RIGHT	P54b.EDF	P54	2
101	12222572	12222853	651	932	281	RIGHT	P54b.EDF	P54	2
101	12223795	12224001	1874	2080	206	RIGHT	P54b.EDF	P54	2
102	12231642	12231919	674	951	277	RIGHT	P54b.EDF	P54	2
102	12232773	12232963	1805	1995	190	RIGHT	P54b.EDF	P54	2
102	12234882	12235088	3914	4120	206	RIGHT	P54b.EDF	P54	2
103	12240130	12240393	836	1099	263	RIGHT	P54b.EDF	P54	2
103	12240702	12240963	1408	1669	261	RIGHT	P54b.EDF	P54	2
104	12246873	12246931	58	116	58	RIGHT	P54b.EDF	P54	2
104	12247510	12247762	695	947	252	RIGHT	P54b.EDF	P54	2
104	12248167	12248356	1352	1541	189	RIGHT	P54b.EDF	P54	2
106	12264753	12264806	57	110	53	RIGHT	P54b.EDF	P54	2
106	12265371	12265628	675	932	257	RIGHT	P54b.EDF	P54	2
107	12275048	12275321	1270	1543	273	RIGHT	P54b.EDF	P54	2
107	12276107	12276377	2329	2599	270	RIGHT	P54b.EDF	P54	2
109	12290899	12291167	677	945	268	RIGHT	P54b.EDF	P54	2
111	12308702	12308937	57	292	235	RIGHT	P54b.EDF	P54	2
111	12309328	12309549	683	904	221	RIGHT	P54b.EDF	P54	2
111	12310193	12310356	1548	1711	163	RIGHT	P54b.EDF	P54	2
112	12316610	12316802	1067	1259	192	RIGHT	P54b.EDF	P54	2
113	12324337	12324614	271	548	277	RIGHT	P54b.EDF	P54	2
113	12325202	12325429	1136	1363	227	RIGHT	P54b.EDF	P54	2
114	12333698	12333952	899	1153	254	RIGHT	P54b.EDF	P54	2
115	12343027	12343428	757	1158	401	RIGHT	P54b.EDF	P54	2
118	12368118	12368167	58	107	49	RIGHT	P54b.EDF	P54	2
118	12368639	12369164	579	1104	525	RIGHT	P54b.EDF	P54	2
118	12369533	12369829	1473	1769	296	RIGHT	P54b.EDF	P54	2
119	12377397	12377635	650	888	238	RIGHT	P54b.EDF	P54	2
119	12378038	12378316	1291	1569	278	RIGHT	P54b.EDF	P54	2
119	12378548	12378770	1801	2023	222	RIGHT	P54b.EDF	P54	2
119	12379896	12380096	3149	3349	200	RIGHT	P54b.EDF	P54	2
120	12386295	12386541	1044	1290	246	RIGHT	P54b.EDF	P54	2
120	12387073	12387341	1822	2090	268	RIGHT	P54b.EDF	P54	2
120	12388027	12388271	2776	3020	244	RIGHT	P54b.EDF	P54	2
2	13523421	13523630	695	904	209	RIGHT	P54c.EDF	P54	3
2	13524026	13524097	1300	1371	71	RIGHT	P54c.EDF	P54	3
3	13531951	13532009	785	843	58	RIGHT	P54c.EDF	P54	3
4	13541548	13541710	418	580	162	RIGHT	P54c.EDF	P54	3
4	13542670	13542724	1540	1594	54	RIGHT	P54c.EDF	P54	3
5	13548871	13549002	58	189	131	RIGHT	P54c.EDF	P54	3
6	13558335	13558448	95	208	113	RIGHT	P54c.EDF	P54	3
7	13566410	13566508	322	420	98	RIGHT	P54c.EDF	P54	3
7	13567130	13567206	1042	1118	76	RIGHT	P54c.EDF	P54	3
9	13585581	13585724	302	445	143	RIGHT	P54c.EDF	P54	3
9	13586083	13586296	804	1017	213	RIGHT	P54c.EDF	P54	3
9	13586351	13586493	1072	1214	142	RIGHT	P54c.EDF	P54	3
9	13586811	13586936	1532	1657	125	RIGHT	P54c.EDF	P54	3
9	13588683	13588791	3404	3512	108	RIGHT	P54c.EDF	P54	3
10	13593203	13593287	175	259	84	RIGHT	P54c.EDF	P54	3
10	13594064	13594120	1036	1092	56	RIGHT	P54c.EDF	P54	3
11	13603166	13603363	707	904	197	RIGHT	P54c.EDF	P54	3
11	13603750	13603870	1291	1411	120	RIGHT	P54c.EDF	P54	3
12	13610959	13611112	57	210	153	RIGHT	P54c.EDF	P54	3
12	13611260	13611382	358	480	122	RIGHT	P54c.EDF	P54	3
12	13611623	13611771	721	869	148	RIGHT	P54c.EDF	P54	3
13	13620259	13620366	143	250	107	RIGHT	P54c.EDF	P54	3
13	13620679	13620952	563	836	273	RIGHT	P54c.EDF	P54	3
13	13621321	13621409	1205	1293	88	RIGHT	P54c.EDF	P54	3
13	13622116	13622181	2000	2065	65	RIGHT	P54c.EDF	P54	3
14	13629732	13629890	107	265	158	RIGHT	P54c.EDF	P54	3
14	13630269	13630410	644	785	141	RIGHT	P54c.EDF	P54	3
14	13630731	13630846	1106	1221	115	RIGHT	P54c.EDF	P54	3
14	13631246	13631337	1621	1712	91	RIGHT	P54c.EDF	P54	3
15	13638567	13638698	57	188	131	RIGHT	P54c.EDF	P54	3
15	13638960	13639279	450	769	319	RIGHT	P54c.EDF	P54	3
15	13639688	13639756	1178	1246	68	RIGHT	P54c.EDF	P54	3
16	13646466	13646749	580	863	283	RIGHT	P54c.EDF	P54	3
16	13647074	13647274	1188	1388	200	RIGHT	P54c.EDF	P54	3
17	13655497	13655654	1500	1657	157	RIGHT	P54c.EDF	P54	3
17	13655933	13656096	1936	2099	163	RIGHT	P54c.EDF	P54	3
17	13656717	13656915	2720	2918	198	RIGHT	P54c.EDF	P54	3
18	13661844	13662022	269	447	178	RIGHT	P54c.EDF	P54	3
18	13662626	13662770	1051	1195	144	RIGHT	P54c.EDF	P54	3
18	13664497	13664674	2922	3099	177	RIGHT	P54c.EDF	P54	3
19	13668996	13669462	58	524	466	RIGHT	P54c.EDF	P54	3
21	13685511	13685761	205	455	250	RIGHT	P54c.EDF	P54	3
23	13702947	13703064	57	174	117	RIGHT	P54c.EDF	P54	3
23	13703657	13703874	767	984	217	RIGHT	P54c.EDF	P54	3
23	13704144	13704355	1254	1465	211	RIGHT	P54c.EDF	P54	3
24	13711292	13711484	272	464	192	RIGHT	P54c.EDF	P54	3
25	13721090	13721335	852	1097	245	RIGHT	P54c.EDF	P54	3
25	13721506	13721700	1268	1462	194	RIGHT	P54c.EDF	P54	3
26	13728980	13729207	948	1175	227	RIGHT	P54c.EDF	P54	3
26	13729889	13730050	1857	2018	161	RIGHT	P54c.EDF	P54	3
27	13737876	13737981	57	162	105	RIGHT	P54c.EDF	P54	3
27	13738034	13738718	215	899	684	RIGHT	P54c.EDF	P54	3
27	13738919	13739125	1100	1306	206	RIGHT	P54c.EDF	P54	3
28	13745875	13746077	57	259	202	RIGHT	P54c.EDF	P54	3
28	13746426	13746700	608	882	274	RIGHT	P54c.EDF	P54	3
28	13746992	13747175	1174	1357	183	RIGHT	P54c.EDF	P54	3
28	13747542	13747721	1724	1903	179	RIGHT	P54c.EDF	P54	3
28	13749466	13749647	3648	3829	181	RIGHT	P54c.EDF	P54	3
29	13754632	13754787	464	619	155	RIGHT	P54c.EDF	P54	3
29	13755139	13755289	971	1121	150	RIGHT	P54c.EDF	P54	3
29	13755617	13755767	1449	1599	150	RIGHT	P54c.EDF	P54	3
30	13762535	13762586	58	109	51	RIGHT	P54c.EDF	P54	3
30	13763105	13763278	628	801	173	RIGHT	P54c.EDF	P54	3
30	13764072	13764242	1595	1765	170	RIGHT	P54c.EDF	P54	3
31	13772756	13772929	181	354	173	RIGHT	P54c.EDF	P54	3
31	13773230	13773430	655	855	200	RIGHT	P54c.EDF	P54	3
31	13773646	13773910	1071	1335	264	RIGHT	P54c.EDF	P54	3
32	13781653	13781836	689	872	183	RIGHT	P54c.EDF	P54	3
32	13783398	13783642	2434	2678	244	RIGHT	P54c.EDF	P54	3
33	13790718	13790897	248	427	179	RIGHT	P54c.EDF	P54	3
33	13792799	13793017	2329	2547	218	RIGHT	P54c.EDF	P54	3
34	13801029	13801170	1513	1654	141	RIGHT	P54c.EDF	P54	3
35	13808508	13808695	1152	1339	187	RIGHT	P54c.EDF	P54	3
37	13824017	13824212	276	471	195	RIGHT	P54c.EDF	P54	3
37	13825182	13825347	1441	1606	165	RIGHT	P54c.EDF	P54	3
38	13831933	13832143	1023	1233	210	RIGHT	P54c.EDF	P54	3
38	13832463	13832666	1553	1756	203	RIGHT	P54c.EDF	P54	3
38	13835930	13836091	5020	5181	161	RIGHT	P54c.EDF	P54	3
38	13836882	13837051	5972	6141	169	RIGHT	P54c.EDF	P54	3
39	13840265	13840445	370	550	180	RIGHT	P54c.EDF	P54	3
39	13841103	13841305	1208	1410	202	RIGHT	P54c.EDF	P54	3
39	13842313	13842547	2418	2652	234	RIGHT	P54c.EDF	P54	3
40	13848902	13849081	191	370	179	RIGHT	P54c.EDF	P54	3
40	13849408	13849617	697	906	209	RIGHT	P54c.EDF	P54	3
41	13859187	13859398	1152	1363	211	RIGHT	P54c.EDF	P54	3
42	13866184	13866387	57	260	203	RIGHT	P54c.EDF	P54	3
42	13866777	13866969	650	842	192	RIGHT	P54c.EDF	P54	3
42	13867377	13867559	1250	1432	182	RIGHT	P54c.EDF	P54	3
43	13874669	13874836	228	395	167	RIGHT	P54c.EDF	P54	3
43	13875536	13875730	1095	1289	194	RIGHT	P54c.EDF	P54	3
43	13876047	13876243	1606	1802	196	RIGHT	P54c.EDF	P54	3
44	13883642	13883820	705	883	178	RIGHT	P54c.EDF	P54	3
45	13893017	13893329	913	1225	312	RIGHT	P54c.EDF	P54	3
45	13894380	13894558	2276	2454	178	RIGHT	P54c.EDF	P54	3
46	13902194	13902725	614	1145	531	RIGHT	P54c.EDF	P54	3
46	13903051	13903234	1471	1654	183	RIGHT	P54c.EDF	P54	3
46	13904320	13904474	2740	2894	154	RIGHT	P54c.EDF	P54	3
46	13905479	13905627	3899	4047	148	RIGHT	P54c.EDF	P54	3
46	13907042	13907169	5462	5589	127	RIGHT	P54c.EDF	P54	3
46	13907765	13907897	6185	6317	132	RIGHT	P54c.EDF	P54	3
48	13917614	13917787	95	268	173	RIGHT	P54c.EDF	P54	3
48	13918106	13918586	587	1067	480	RIGHT	P54c.EDF	P54	3
48	13918762	13918937	1243	1418	175	RIGHT	P54c.EDF	P54	3
48	13919341	13919509	1822	1990	168	RIGHT	P54c.EDF	P54	3
48	13920022	13920198	2503	2679	176	RIGHT	P54c.EDF	P54	3
49	13924772	13924971	244	443	199	RIGHT	P54c.EDF	P54	3
49	13925616	13925786	1088	1258	170	RIGHT	P54c.EDF	P54	3
51	13942924	13943107	1213	1396	183	RIGHT	P54c.EDF	P54	3
52	13949971	13950188	745	962	217	RIGHT	P54c.EDF	P54	3
52	13950591	13950788	1365	1562	197	RIGHT	P54c.EDF	P54	3
53	13958912	13959116	997	1201	204	RIGHT	P54c.EDF	P54	3
53	13960553	13960802	2638	2887	249	RIGHT	P54c.EDF	P54	3
55	13973560	13973783	205	428	223	RIGHT	P54c.EDF	P54	3
55	13974163	13974437	808	1082	274	RIGHT	P54c.EDF	P54	3
55	13974500	13974713	1145	1358	213	RIGHT	P54c.EDF	P54	3
56	13982410	13982688	212	490	278	RIGHT	P54c.EDF	P54	3
57	13990308	13990480	739	911	172	RIGHT	P54c.EDF	P54	3
58	13998924	13999074	672	822	150	RIGHT	P54c.EDF	P54	3
60	14017423	14017703	953	1233	280	RIGHT	P54c.EDF	P54	3
61	14025611	14025844	1188	1421	233	RIGHT	P54c.EDF	P54	3
62	14032258	14032279	57	78	21	RIGHT	P54c.EDF	P54	3
62	14033028	14033256	827	1055	228	RIGHT	P54c.EDF	P54	3
63	14040923	14041088	1023	1188	165	RIGHT	P54c.EDF	P54	3
64	14048528	14048834	403	709	306	RIGHT	P54c.EDF	P54	3
65	14055688	14055940	93	345	252	RIGHT	P54c.EDF	P54	3
65	14056292	14056475	697	880	183	RIGHT	P54c.EDF	P54	3
65	14057575	14057704	1980	2109	129	RIGHT	P54c.EDF	P54	3
66	14063911	14064162	87	338	251	RIGHT	P54c.EDF	P54	3
67	14074186	14074243	57	114	57	RIGHT	P54c.EDF	P54	3
68	14081796	14082055	203	462	259	RIGHT	P54c.EDF	P54	3
69	14092044	14092290	681	927	246	RIGHT	P54c.EDF	P54	3
69	14092556	14092912	1193	1549	356	RIGHT	P54c.EDF	P54	3
69	14093057	14093299	1694	1936	242	RIGHT	P54c.EDF	P54	3
70	14101493	14101693	1352	1552	200	RIGHT	P54c.EDF	P54	3
70	14102864	14103091	2723	2950	227	RIGHT	P54c.EDF	P54	3
71	14108155	14108361	147	353	206	RIGHT	P54c.EDF	P54	3
71	14109165	14109369	1157	1361	204	RIGHT	P54c.EDF	P54	3
72	14117686	14117862	365	541	176	RIGHT	P54c.EDF	P54	3
74	14133049	14133113	57	121	64	RIGHT	P54c.EDF	P54	3
74	14134017	14134262	1025	1270	245	RIGHT	P54c.EDF	P54	3
75	14142604	14142836	1207	1439	232	RIGHT	P54c.EDF	P54	3
77	14156735	14156955	134	354	220	RIGHT	P54c.EDF	P54	3
77	14157284	14157487	683	886	203	RIGHT	P54c.EDF	P54	3
78	14164319	14164483	57	221	164	RIGHT	P54c.EDF	P54	3
78	14164803	14165030	541	768	227	RIGHT	P54c.EDF	P54	3
78	14165375	14165615	1113	1353	240	RIGHT	P54c.EDF	P54	3
79	14174400	14174819	627	1046	419	RIGHT	P54c.EDF	P54	3
79	14174928	14175143	1155	1370	215	RIGHT	P54c.EDF	P54	3
79	14175526	14175691	1753	1918	165	RIGHT	P54c.EDF	P54	3
80	14182055	14182279	63	287	224	RIGHT	P54c.EDF	P54	3
80	14182724	14182904	732	912	180	RIGHT	P54c.EDF	P54	3
80	14183319	14183482	1327	1490	163	RIGHT	P54c.EDF	P54	3
81	14191221	14191461	795	1035	240	RIGHT	P54c.EDF	P54	3
82	14199503	14199772	1116	1385	269	RIGHT	P54c.EDF	P54	3
83	14208459	14208488	57	86	29	RIGHT	P54c.EDF	P54	3
83	14209307	14209991	905	1589	684	RIGHT	P54c.EDF	P54	3
83	14210431	14210530	2029	2128	99	RIGHT	P54c.EDF	P54	3
85	14226234	14226312	803	881	78	RIGHT	P54c.EDF	P54	3
86	14234868	14235137	145	414	269	RIGHT	P54c.EDF	P54	3
86	14235471	14235600	748	877	129	RIGHT	P54c.EDF	P54	3
89	14259010	14259115	391	496	105	RIGHT	P54c.EDF	P54	3
90	14268668	14268880	152	364	212	RIGHT	P54c.EDF	P54	3
90	14269288	14269388	772	872	100	RIGHT	P54c.EDF	P54	3
92	14287005	14287228	898	1121	223	RIGHT	P54c.EDF	P54	3
93	14294501	14294681	355	535	180	RIGHT	P54c.EDF	P54	3
93	14294983	14295233	837	1087	250	RIGHT	P54c.EDF	P54	3
93	14295639	14295719	1493	1573	80	RIGHT	P54c.EDF	P54	3
93	14295786	14295943	1640	1797	157	RIGHT	P54c.EDF	P54	3
94	14303222	14303411	265	454	189	RIGHT	P54c.EDF	P54	3
94	14303864	14304005	907	1048	141	RIGHT	P54c.EDF	P54	3
95	14311632	14311797	156	321	165	RIGHT	P54c.EDF	P54	3
95	14311933	14312126	457	650	193	RIGHT	P54c.EDF	P54	3
95	14312939	14313051	1463	1575	112	RIGHT	P54c.EDF	P54	3
96	14321249	14321417	71	239	168	RIGHT	P54c.EDF	P54	3
96	14321787	14321992	609	814	205	RIGHT	P54c.EDF	P54	3
96	14322362	14322536	1184	1358	174	RIGHT	P54c.EDF	P54	3
97	14329805	14329896	84	175	91	RIGHT	P54c.EDF	P54	3
97	14330393	14330553	672	832	160	RIGHT	P54c.EDF	P54	3
98	14339259	14339435	680	856	176	RIGHT	P54c.EDF	P54	3
98	14342900	14343139	4321	4560	239	RIGHT	P54c.EDF	P54	3
99	14346894	14346944	57	107	50	RIGHT	P54c.EDF	P54	3
99	14348036	14348123	1199	1286	87	RIGHT	P54c.EDF	P54	3
99	14349086	14349252	2249	2415	166	RIGHT	P54c.EDF	P54	3
100	14356463	14357557	181	1275	1094	RIGHT	P54c.EDF	P54	3
100	14357801	14357897	1519	1615	96	RIGHT	P54c.EDF	P54	3
100	14361197	14361297	4915	5015	100	RIGHT	P54c.EDF	P54	3
101	14365701	14365821	132	252	120	RIGHT	P54c.EDF	P54	3
101	14366690	14366770	1121	1201	80	RIGHT	P54c.EDF	P54	3
101	14372778	14372850	7209	7281	72	RIGHT	P54c.EDF	P54	3
102	14382287	14382355	5751	5819	68	RIGHT	P54c.EDF	P54	3
103	14387296	14387381	1092	1177	85	RIGHT	P54c.EDF	P54	3
103	14390614	14390691	4410	4487	77	RIGHT	P54c.EDF	P54	3
103	14394098	14394158	7894	7954	60	RIGHT	P54c.EDF	P54	3
103	14395198	14395259	8994	9055	61	RIGHT	P54c.EDF	P54	3
104	14400002	14400094	877	969	92	RIGHT	P54c.EDF	P54	3
104	14401042	14401118	1917	1993	76	RIGHT	P54c.EDF	P54	3
104	14401724	14401799	2599	2674	75	RIGHT	P54c.EDF	P54	3
104	14402502	14402573	3377	3448	71	RIGHT	P54c.EDF	P54	3
104	14403947	14404034	4822	4909	87	RIGHT	P54c.EDF	P54	3
104	14404585	14404662	5460	5537	77	RIGHT	P54c.EDF	P54	3
104	14406328	14406377	7203	7252	49	RIGHT	P54c.EDF	P54	3
104	14407336	14407403	8211	8278	67	RIGHT	P54c.EDF	P54	3
105	14411342	14411395	116	169	53	RIGHT	P54c.EDF	P54	3
105	14411512	14411645	286	419	133	RIGHT	P54c.EDF	P54	3
105	14412094	14412176	868	950	82	RIGHT	P54c.EDF	P54	3
105	14412763	14412842	1537	1616	79	RIGHT	P54c.EDF	P54	3
105	14413549	14413619	2323	2393	70	RIGHT	P54c.EDF	P54	3
105	14414268	14414335	3042	3109	67	RIGHT	P54c.EDF	P54	3
105	14416569	14416631	5343	5405	62	RIGHT	P54c.EDF	P54	3
105	14417780	14417843	6554	6617	63	RIGHT	P54c.EDF	P54	3
106	14420741	14420850	57	166	109	RIGHT	P54c.EDF	P54	3
106	14421508	14421596	824	912	88	RIGHT	P54c.EDF	P54	3
106	14422143	14422234	1459	1550	91	RIGHT	P54c.EDF	P54	3
106	14422775	14422845	2091	2161	70	RIGHT	P54c.EDF	P54	3
107	14431320	14431417	523	620	97	RIGHT	P54c.EDF	P54	3
107	14431949	14432053	1152	1256	104	RIGHT	P54c.EDF	P54	3
107	14432754	14432825	1957	2028	71	RIGHT	P54c.EDF	P54	3
108	14440187	14440289	300	402	102	RIGHT	P54c.EDF	P54	3
108	14440743	14440827	856	940	84	RIGHT	P54c.EDF	P54	3
108	14441425	14441531	1538	1644	106	RIGHT	P54c.EDF	P54	3
108	14443820	14443862	3933	3975	42	RIGHT	P54c.EDF	P54	3
108	14446751	14446888	6864	7001	137	RIGHT	P54c.EDF	P54	3
109	14449990	14450210	588	808	220	RIGHT	P54c.EDF	P54	3
109	14450624	14450721	1222	1319	97	RIGHT	P54c.EDF	P54	3
109	14451142	14451251	1740	1849	109	RIGHT	P54c.EDF	P54	3
110	14459922	14460146	1005	1229	224	RIGHT	P54c.EDF	P54	3
110	14460532	14460625	1615	1708	93	RIGHT	P54c.EDF	P54	3
111	14467514	14467591	734	811	77	RIGHT	P54c.EDF	P54	3
111	14468080	14468210	1300	1430	130	RIGHT	P54c.EDF	P54	3
112	14476048	14476158	224	334	110	RIGHT	P54c.EDF	P54	3
113	14484623	14485040	442	859	417	RIGHT	P54c.EDF	P54	3
113	14485109	14485325	928	1144	216	RIGHT	P54c.EDF	P54	3
113	14485660	14485824	1479	1643	164	RIGHT	P54c.EDF	P54	3
113	14488832	14489036	4651	4855	204	RIGHT	P54c.EDF	P54	3
114	14492224	14492333	57	166	109	RIGHT	P54c.EDF	P54	3
114	14492817	14493033	650	866	216	RIGHT	P54c.EDF	P54	3
115	14502279	14502524	755	1000	245	RIGHT	P54c.EDF	P54	3
115	14503212	14503426	1688	1902	214	RIGHT	P54c.EDF	P54	3
116	14511727	14511893	57	223	166	RIGHT	P54c.EDF	P54	3
116	14512294	14512494	624	824	200	RIGHT	P54c.EDF	P54	3
116	14513001	14513180	1331	1510	179	RIGHT	P54c.EDF	P54	3
116	14514240	14514496	2570	2826	256	RIGHT	P54c.EDF	P54	3
117	14520044	14520272	389	617	228	RIGHT	P54c.EDF	P54	3
117	14521055	14521270	1400	1615	215	RIGHT	P54c.EDF	P54	3
117	14525430	14525598	5775	5943	168	RIGHT	P54c.EDF	P54	3
118	14531240	14531393	1047	1200	153	RIGHT	P54c.EDF	P54	3
119	14539278	14539469	245	436	191	RIGHT	P54c.EDF	P54	3
119	14539941	14540086	908	1053	145	RIGHT	P54c.EDF	P54	3
119	14541176	14541329	2143	2296	153	RIGHT	P54c.EDF	P54	3
119	14542244	14542370	3211	3337	126	RIGHT	P54c.EDF	P54	3
119	14544428	14544599	5395	5566	171	RIGHT	P54c.EDF	P54	3
119	14544998	14545174	5965	6141	176	RIGHT	P54c.EDF	P54	3
120	14547962	14548008	57	103	46	RIGHT	P54c.EDF	P54	3
120	14548396	14548573	491	668	177	RIGHT	P54c.EDF	P54	3
120	14552262	14552417	4357	4512	155	RIGHT	P54c.EDF	P54	3
120	14553609	14553777	5704	5872	168	RIGHT	P54c.EDF	P54	3
121	15959049	15959431	377	759	382	RIGHT	P54c.EDF	P54	3
121	15959478	15960853	806	2181	1375	RIGHT	P54c.EDF	P54	3
121	15961589	15961712	2917	3040	123	RIGHT	P54c.EDF	P54	3
121	15961738	15961854	3066	3182	116	RIGHT	P54c.EDF	P54	3
121	15961884	15961914	3212	3242	30	RIGHT	P54c.EDF	P54	3
121	15961989	15961995	3317	3323	6	RIGHT	P54c.EDF	P54	3
121	15962017	15962783	3345	4111	766	RIGHT	P54c.EDF	P54	3
121	15963981	15963996	5309	5324	15	RIGHT	P54c.EDF	P54	3
121	15964019	15968709	5347	10037	4690	RIGHT	P54c.EDF	P54	3
1	4391144	4391204	1879	1939	60	RIGHT	P67a.EDF	P67	1
2	4397032	4397159	687	814	127	RIGHT	P67a.EDF	P67	1
2	4398207	4398313	1862	1968	106	RIGHT	P67a.EDF	P67	1
3	4411444	4411582	784	922	138	RIGHT	P67a.EDF	P67	1
3	4411944	4412067	1284	1407	123	RIGHT	P67a.EDF	P67	1
3	4412536	4412655	1876	1995	119	RIGHT	P67a.EDF	P67	1
4	4422844	4422977	689	822	133	RIGHT	P67a.EDF	P67	1
4	4423394	4423518	1239	1363	124	RIGHT	P67a.EDF	P67	1
5	4434604	4434746	976	1118	142	RIGHT	P67a.EDF	P67	1
6	4442576	4442706	653	783	130	RIGHT	P67a.EDF	P67	1
6	4443381	4443514	1458	1591	133	RIGHT	P67a.EDF	P67	1
7	4453118	4453251	159	292	133	RIGHT	P67a.EDF	P67	1
7	4453822	4453964	863	1005	142	RIGHT	P67a.EDF	P67	1
7	4454420	4454552	1461	1593	132	RIGHT	P67a.EDF	P67	1
12	4506542	4506663	762	883	121	RIGHT	P67a.EDF	P67	1
12	4507147	4507287	1367	1507	140	RIGHT	P67a.EDF	P67	1
13	4514475	4514608	600	733	133	RIGHT	P67a.EDF	P67	1
13	4515295	4515416	1420	1541	121	RIGHT	P67a.EDF	P67	1
14	4523066	4523205	125	264	139	RIGHT	P67a.EDF	P67	1
14	4525641	4525736	2700	2795	95	RIGHT	P67a.EDF	P67	1
15	4532984	4533126	789	931	142	RIGHT	P67a.EDF	P67	1
16	4544639	4544781	122	264	142	RIGHT	P67a.EDF	P67	1
16	4545372	4545552	855	1035	180	RIGHT	P67a.EDF	P67	1
17	4553700	4553853	791	944	153	RIGHT	P67a.EDF	P67	1
17	4554355	4554478	1446	1569	123	RIGHT	P67a.EDF	P67	1
18	4562098	4562233	880	1015	135	RIGHT	P67a.EDF	P67	1
18	4562853	4562920	1635	1702	67	RIGHT	P67a.EDF	P67	1
19	4574746	4574883	94	231	137	RIGHT	P67a.EDF	P67	1
19	4575831	4575976	1179	1324	145	RIGHT	P67a.EDF	P67	1
20	4583760	4583903	131	274	143	RIGHT	P67a.EDF	P67	1
20	4584621	4584770	992	1141	149	RIGHT	P67a.EDF	P67	1
20	4585306	4585385	1677	1756	79	RIGHT	P67a.EDF	P67	1
21	4594349	4594449	135	235	100	RIGHT	P67a.EDF	P67	1
21	4594881	4595265	667	1051	384	RIGHT	P67a.EDF	P67	1
22	4604422	4604574	840	992	152	RIGHT	P67a.EDF	P67	1
23	4611568	4611672	58	162	104	RIGHT	P67a.EDF	P67	1
23	4612493	4612633	983	1123	140	RIGHT	P67a.EDF	P67	1
24	4628727	4628851	172	296	124	RIGHT	P67a.EDF	P67	1
24	4629482	4629613	927	1058	131	RIGHT	P67a.EDF	P67	1
25	4640287	4640437	685	835	150	RIGHT	P67a.EDF	P67	1
26	4650341	4650473	273	405	132	RIGHT	P67a.EDF	P67	1
26	4651032	4651169	964	1101	137	RIGHT	P67a.EDF	P67	1
27	4660181	4660211	58	88	30	RIGHT	P67a.EDF	P67	1
27	4660640	4660798	517	675	158	RIGHT	P67a.EDF	P67	1
27	4661210	4661362	1087	1239	152	RIGHT	P67a.EDF	P67	1
27	4665559	4665698	5436	5575	139	RIGHT	P67a.EDF	P67	1
28	4672387	4672511	58	182	124	RIGHT	P67a.EDF	P67	1
28	4673002	4673140	673	811	138	RIGHT	P67a.EDF	P67	1
28	4673801	4673960	1472	1631	159	RIGHT	P67a.EDF	P67	1
28	4677799	4677941	5470	5612	142	RIGHT	P67a.EDF	P67	1
29	4687359	4687395	58	94	36	RIGHT	P67a.EDF	P67	1
29	4688699	4688830	1398	1529	131	RIGHT	P67a.EDF	P67	1
30	4696191	4696331	885	1025	140	RIGHT	P67a.EDF	P67	1
30	4696949	4697047	1643	1741	98	RIGHT	P67a.EDF	P67	1
31	4707721	4707839	748	866	118	RIGHT	P67a.EDF	P67	1
31	4708678	4708816	1705	1843	138	RIGHT	P67a.EDF	P67	1
32	4715716	4715826	58	168	110	RIGHT	P67a.EDF	P67	1
32	4716640	4716776	982	1118	136	RIGHT	P67a.EDF	P67	1
33	4733448	4733499	58	109	51	RIGHT	P67a.EDF	P67	1
33	4734222	4734345	832	955	123	RIGHT	P67a.EDF	P67	1
33	4735094	4735213	1704	1823	119	RIGHT	P67a.EDF	P67	1
34	4742379	4742518	604	743	139	RIGHT	P67a.EDF	P67	1
34	4743052	4743198	1277	1423	146	RIGHT	P67a.EDF	P67	1
35	4753381	4753512	1026	1157	131	RIGHT	P67a.EDF	P67	1
36	4763130	4763260	892	1022	130	RIGHT	P67a.EDF	P67	1
37	4773390	4773524	696	830	134	RIGHT	P67a.EDF	P67	1
37	4774245	4774307	1551	1613	62	RIGHT	P67a.EDF	P67	1
38	4781270	4781375	71	176	105	RIGHT	P67a.EDF	P67	1
38	4782475	4782617	1276	1418	142	RIGHT	P67a.EDF	P67	1
39	4790788	4790925	804	941	137	RIGHT	P67a.EDF	P67	1
39	4791494	4791619	1510	1635	125	RIGHT	P67a.EDF	P67	1
40	4817121	4817259	224	362	138	RIGHT	P67a.EDF	P67	1
40	4818111	4818244	1214	1347	133	RIGHT	P67a.EDF	P67	1
40	4823187	4823188	6290	6291	1	RIGHT	P67a.EDF	P67	1
41	4827512	4827624	594	706	112	RIGHT	P67a.EDF	P67	1
42	4835632	4835766	417	551	134	RIGHT	P67a.EDF	P67	1
42	4836636	4836780	1421	1565	144	RIGHT	P67a.EDF	P67	1
43	4844636	4844741	58	163	105	RIGHT	P67a.EDF	P67	1
43	4845191	4845320	613	742	129	RIGHT	P67a.EDF	P67	1
43	4845857	4845989	1279	1411	132	RIGHT	P67a.EDF	P67	1
44	4854112	4854205	58	151	93	RIGHT	P67a.EDF	P67	1
44	4855361	4855478	1307	1424	117	RIGHT	P67a.EDF	P67	1
45	4864393	4864393	202	202	0	RIGHT	P67a.EDF	P67	1
45	4864722	4864876	531	685	154	RIGHT	P67a.EDF	P67	1
46	4874943	4875091	727	875	148	RIGHT	P67a.EDF	P67	1
47	4885535	4885645	938	1048	110	RIGHT	P67a.EDF	P67	1
48	4900861	4900961	138	238	100	RIGHT	P67a.EDF	P67	1
48	4901378	4901500	655	777	122	RIGHT	P67a.EDF	P67	1
48	4902391	4902497	1668	1774	106	RIGHT	P67a.EDF	P67	1
49	4910338	4910465	499	626	127	RIGHT	P67a.EDF	P67	1
49	4911290	4911417	1451	1578	127	RIGHT	P67a.EDF	P67	1
50	4918732	4918855	809	932	123	RIGHT	P67a.EDF	P67	1
51	4926590	4926728	512	650	138	RIGHT	P67a.EDF	P67	1
51	4927291	4927392	1213	1314	101	RIGHT	P67a.EDF	P67	1
53	4944418	4944554	148	284	136	RIGHT	P67a.EDF	P67	1
53	4944968	4945080	698	810	112	RIGHT	P67a.EDF	P67	1
54	4953010	4953157	575	722	147	RIGHT	P67a.EDF	P67	1
56	4974920	4975047	1261	1388	127	RIGHT	P67a.EDF	P67	1
57	4983974	4984098	840	964	124	RIGHT	P67a.EDF	P67	1
58	4991127	4991155	59	87	28	RIGHT	P67a.EDF	P67	1
58	4991948	4992047	880	979	99	RIGHT	P67a.EDF	P67	1
59	5000220	5000345	80	205	125	RIGHT	P67a.EDF	P67	1
59	5001625	5001688	1485	1548	63	RIGHT	P67a.EDF	P67	1
60	5008926	5009055	76	205	129	RIGHT	P67a.EDF	P67	1
60	5009691	5009818	841	968	127	RIGHT	P67a.EDF	P67	1
61	5018145	5018167	58	80	22	RIGHT	P67a.EDF	P67	1
61	5018643	5018756	556	669	113	RIGHT	P67a.EDF	P67	1
61	5019315	5019448	1228	1361	133	RIGHT	P67a.EDF	P67	1
62	5027969	5028024	58	113	55	RIGHT	P67a.EDF	P67	1
62	5028876	5028983	965	1072	107	RIGHT	P67a.EDF	P67	1
63	5037065	5037218	177	330	153	RIGHT	P67a.EDF	P67	1
63	5038065	5038220	1177	1332	155	RIGHT	P67a.EDF	P67	1
64	5046876	5046897	57	78	21	RIGHT	P67a.EDF	P67	1
64	5048014	5048143	1195	1324	129	RIGHT	P67a.EDF	P67	1
65	5059618	5059760	1479	1621	142	RIGHT	P67a.EDF	P67	1
66	5067584	5067717	58	191	133	RIGHT	P67a.EDF	P67	1
66	5068649	5068788	1123	1262	139	RIGHT	P67a.EDF	P67	1
79	5196847	5197009	683	845	162	RIGHT	P67a.EDF	P67	1
80	5204899	5204934	58	93	35	RIGHT	P67a.EDF	P67	1
80	5205716	5205837	875	996	121	RIGHT	P67a.EDF	P67	1
81	5215045	5215128	58	141	83	RIGHT	P67a.EDF	P67	1
82	5228148	5228160	4307	4319	12	RIGHT	P67a.EDF	P67	1
82	5230128	5230232	6287	6391	104	RIGHT	P67a.EDF	P67	1
83	5234362	5236854	163	2655	2492	RIGHT	P67a.EDF	P67	1
83	5237455	5237555	3256	3356	100	RIGHT	P67a.EDF	P67	1
83	5238138	5238265	3939	4066	127	RIGHT	P67a.EDF	P67	1
84	5242854	5242986	780	912	132	RIGHT	P67a.EDF	P67	1
84	5243551	5243665	1477	1591	114	RIGHT	P67a.EDF	P67	1
85	5251645	5251796	745	896	151	RIGHT	P67a.EDF	P67	1
86	5261664	5261782	668	786	118	RIGHT	P67a.EDF	P67	1
87	5272052	5272151	1321	1420	99	RIGHT	P67a.EDF	P67	1
88	5281386	5281442	664	720	56	RIGHT	P67a.EDF	P67	1
88	5282355	5282487	1633	1765	132	RIGHT	P67a.EDF	P67	1
89	5291170	5291297	636	763	127	RIGHT	P67a.EDF	P67	1
90	5301187	5301241	57	111	54	RIGHT	P67a.EDF	P67	1
90	5301629	5301784	499	654	155	RIGHT	P67a.EDF	P67	1
90	5302400	5302547	1270	1417	147	RIGHT	P67a.EDF	P67	1
92	5320543	5320614	462	533	71	RIGHT	P67a.EDF	P67	1
92	5321826	5321944	1745	1863	118	RIGHT	P67a.EDF	P67	1
93	5330374	5330525	595	746	151	RIGHT	P67a.EDF	P67	1
94	5338153	5338257	71	175	104	RIGHT	P67a.EDF	P67	1
95	5351419	5351532	152	265	113	RIGHT	P67a.EDF	P67	1
95	5351697	5354944	430	3677	3247	RIGHT	P67a.EDF	P67	1
95	5354986	5355100	3719	3833	114	RIGHT	P67a.EDF	P67	1
95	5355650	5357657	4383	6390	2007	RIGHT	P67a.EDF	P67	1
96	5710815	5710916	643	744	101	RIGHT	P67a.EDF	P67	1
96	5711450	5711555	1278	1383	105	RIGHT	P67a.EDF	P67	1
97	5719430	5719546	440	556	116	RIGHT	P67a.EDF	P67	1
98	5728451	5728529	58	136	78	RIGHT	P67a.EDF	P67	1
99	5739567	5739608	58	99	41	RIGHT	P67a.EDF	P67	1
100	5749497	5749550	58	111	53	RIGHT	P67a.EDF	P67	1
100	5750072	5750180	633	741	108	RIGHT	P67a.EDF	P67	1
102	5768609	5768740	1459	1590	131	RIGHT	P67a.EDF	P67	1
103	5775121	5775178	59	116	57	RIGHT	P67a.EDF	P67	1
104	5786011	5786132	412	533	121	RIGHT	P67a.EDF	P67	1
105	5794234	5794347	710	823	113	RIGHT	P67a.EDF	P67	1
107	5809986	5810008	58	80	22	RIGHT	P67a.EDF	P67	1
109	5827833	5827854	58	79	21	RIGHT	P67a.EDF	P67	1
109	5828389	5828492	614	717	103	RIGHT	P67a.EDF	P67	1
109	5829363	5829452	1588	1677	89	RIGHT	P67a.EDF	P67	1
110	5837633	5837734	202	303	101	RIGHT	P67a.EDF	P67	1
111	5847051	5847157	405	511	106	RIGHT	P67a.EDF	P67	1
112	5858360	5858458	1183	1281	98	RIGHT	P67a.EDF	P67	1
113	5867795	5867910	486	601	115	RIGHT	P67a.EDF	P67	1
114	5878098	5878219	924	1045	121	RIGHT	P67a.EDF	P67	1
115	5884898	5884951	145	198	53	RIGHT	P67a.EDF	P67	1
115	5885257	5885387	504	634	130	RIGHT	P67a.EDF	P67	1
115	5886455	5886588	1702	1835	133	RIGHT	P67a.EDF	P67	1
116	5894914	5895022	778	886	108	RIGHT	P67a.EDF	P67	1
118	5912836	5912882	59	105	46	RIGHT	P67a.EDF	P67	1
118	5914242	5914348	1465	1571	106	RIGHT	P67a.EDF	P67	1
119	5921436	5921576	939	1079	140	RIGHT	P67a.EDF	P67	1
120	5930039	5930163	108	232	124	RIGHT	P67a.EDF	P67	1
120	5931134	5931283	1203	1352	149	RIGHT	P67a.EDF	P67	1
1	7203392	7203451	382	441	59	RIGHT	P67b.EDF	P67	2
2	7212385	7212408	59	82	23	RIGHT	P67b.EDF	P67	2
3	7221822	7221929	153	260	107	RIGHT	P67b.EDF	P67	2
3	7223072	7223196	1403	1527	124	RIGHT	P67b.EDF	P67	2
4	7233038	7233158	506	626	120	RIGHT	P67b.EDF	P67	2
4	7233649	7233764	1117	1232	115	RIGHT	P67b.EDF	P67	2
5	7241781	7241883	1259	1361	102	RIGHT	P67b.EDF	P67	2
6	7250757	7250836	58	137	79	RIGHT	P67b.EDF	P67	2
6	7251237	7251386	538	687	149	RIGHT	P67b.EDF	P67	2
6	7251721	7251852	1022	1153	131	RIGHT	P67b.EDF	P67	2
6	7252374	7252500	1675	1801	126	RIGHT	P67b.EDF	P67	2
7	7262243	7262337	397	491	94	RIGHT	P67b.EDF	P67	2
8	7273260	7273408	618	766	148	RIGHT	P67b.EDF	P67	2
8	7274267	7274390	1625	1748	123	RIGHT	P67b.EDF	P67	2
9	7284423	7284549	1183	1309	126	RIGHT	P67b.EDF	P67	2
11	7305595	7305771	210	386	176	RIGHT	P67b.EDF	P67	2
11	7306758	7306922	1373	1537	164	RIGHT	P67b.EDF	P67	2
12	7316027	7316180	451	604	153	RIGHT	P67b.EDF	P67	2
12	7316309	7316451	733	875	142	RIGHT	P67b.EDF	P67	2
13	7326071	7326197	96	222	126	RIGHT	P67b.EDF	P67	2
13	7326728	7326840	753	865	112	RIGHT	P67b.EDF	P67	2
14	7341372	7341506	758	892	134	RIGHT	P67b.EDF	P67	2
15	7348699	7348808	652	761	109	RIGHT	P67b.EDF	P67	2
16	7356813	7356937	75	199	124	RIGHT	P67b.EDF	P67	2
16	7358556	7358671	1818	1933	115	RIGHT	P67b.EDF	P67	2
17	7365059	7365127	853	921	68	RIGHT	P67b.EDF	P67	2
18	7374286	7374497	414	625	211	RIGHT	P67b.EDF	P67	2
18	7374672	7374842	800	970	170	RIGHT	P67b.EDF	P67	2
18	7375216	7375342	1344	1470	126	RIGHT	P67b.EDF	P67	2
19	7381554	7381650	58	154	96	RIGHT	P67b.EDF	P67	2
19	7382082	7382177	586	681	95	RIGHT	P67b.EDF	P67	2
20	7390829	7390896	416	483	67	RIGHT	P67b.EDF	P67	2
20	7391099	7391230	686	817	131	RIGHT	P67b.EDF	P67	2
20	7391877	7391986	1464	1573	109	RIGHT	P67b.EDF	P67	2
21	7400545	7400642	1177	1274	97	RIGHT	P67b.EDF	P67	2
22	7410353	7410474	478	599	121	RIGHT	P67b.EDF	P67	2
22	7411094	7411233	1219	1358	139	RIGHT	P67b.EDF	P67	2
23	7417676	7417855	264	443	179	RIGHT	P67b.EDF	P67	2
23	7418099	7418254	687	842	155	RIGHT	P67b.EDF	P67	2
23	7418723	7418846	1311	1434	123	RIGHT	P67b.EDF	P67	2
25	7434190	7434337	671	818	147	RIGHT	P67b.EDF	P67	2
26	7442761	7442853	464	556	92	RIGHT	P67b.EDF	P67	2
26	7443500	7443586	1203	1289	86	RIGHT	P67b.EDF	P67	2
27	7452918	7453058	797	937	140	RIGHT	P67b.EDF	P67	2
28	7462115	7462213	732	830	98	RIGHT	P67b.EDF	P67	2
29	7471901	7472027	738	864	126	RIGHT	P67b.EDF	P67	2
29	7472382	7472504	1219	1341	122	RIGHT	P67b.EDF	P67	2
29	7472707	7472862	1544	1699	155	RIGHT	P67b.EDF	P67	2
30	7481586	7481711	468	593	125	RIGHT	P67b.EDF	P67	2
30	7482483	7482600	1365	1482	117	RIGHT	P67b.EDF	P67	2
30	7485146	7485251	4028	4133	105	RIGHT	P67b.EDF	P67	2
30	7486686	7486802	5568	5684	116	RIGHT	P67b.EDF	P67	2
31	7490583	7490674	489	580	91	RIGHT	P67b.EDF	P67	2
33	7505537	7505678	204	345	141	RIGHT	P67b.EDF	P67	2
34	7514309	7514434	59	184	125	RIGHT	P67b.EDF	P67	2
34	7514686	7514806	436	556	120	RIGHT	P67b.EDF	P67	2
34	7519429	7519543	5179	5293	114	RIGHT	P67b.EDF	P67	2
35	7527081	7527194	499	612	113	RIGHT	P67b.EDF	P67	2
36	7536925	7537045	883	1003	120	RIGHT	P67b.EDF	P67	2
37	7545106	7545272	487	653	166	RIGHT	P67b.EDF	P67	2
38	7553709	7553800	687	778	91	RIGHT	P67b.EDF	P67	2
38	7554309	7554406	1287	1384	97	RIGHT	P67b.EDF	P67	2
39	7561385	7561507	148	270	122	RIGHT	P67b.EDF	P67	2
39	7561918	7562046	681	809	128	RIGHT	P67b.EDF	P67	2
40	7571063	7571159	73	169	96	RIGHT	P67b.EDF	P67	2
40	7571572	7571691	582	701	119	RIGHT	P67b.EDF	P67	2
40	7572290	7572402	1300	1412	112	RIGHT	P67b.EDF	P67	2
41	7580056	7580077	57	78	21	RIGHT	P67b.EDF	P67	2
41	7581553	7581675	1554	1676	122	RIGHT	P67b.EDF	P67	2
42	7589327	7589425	140	238	98	RIGHT	P67b.EDF	P67	2
42	7589726	7589862	539	675	136	RIGHT	P67b.EDF	P67	2
42	7590490	7590605	1303	1418	115	RIGHT	P67b.EDF	P67	2
43	7597933	7598052	483	602	119	RIGHT	P67b.EDF	P67	2
43	7598758	7598903	1308	1453	145	RIGHT	P67b.EDF	P67	2
44	7607943	7608058	516	631	115	RIGHT	P67b.EDF	P67	2
45	7619512	7619614	1185	1287	102	RIGHT	P67b.EDF	P67	2
46	7628786	7628885	456	555	99	RIGHT	P67b.EDF	P67	2
47	7637769	7637875	528	634	106	RIGHT	P67b.EDF	P67	2
47	7641480	7641609	4239	4368	129	RIGHT	P67b.EDF	P67	2
48	7647419	7647458	57	96	39	RIGHT	P67b.EDF	P67	2
48	7648390	7648514	1028	1152	124	RIGHT	P67b.EDF	P67	2
49	7658666	7658784	487	605	118	RIGHT	P67b.EDF	P67	2
49	7659941	7660032	1762	1853	91	RIGHT	P67b.EDF	P67	2
50	7666925	7667025	1503	1603	100	RIGHT	P67b.EDF	P67	2
51	7674126	7674240	58	172	114	RIGHT	P67b.EDF	P67	2
51	7674784	7674889	716	821	105	RIGHT	P67b.EDF	P67	2
52	7683608	7683729	441	562	121	RIGHT	P67b.EDF	P67	2
53	7693231	7693394	370	533	163	RIGHT	P67b.EDF	P67	2
53	7693829	7693974	968	1113	145	RIGHT	P67b.EDF	P67	2
54	7703095	7703240	1080	1225	145	RIGHT	P67b.EDF	P67	2
55	7714584	7714683	1362	1461	99	RIGHT	P67b.EDF	P67	2
56	7723145	7723264	1159	1278	119	RIGHT	P67b.EDF	P67	2
57	7737728	7737866	132	270	138	RIGHT	P67b.EDF	P67	2
57	7738238	7738376	642	780	138	RIGHT	P67b.EDF	P67	2
57	7739201	7739279	1605	1683	78	RIGHT	P67b.EDF	P67	2
58	7747374	7747513	463	602	139	RIGHT	P67b.EDF	P67	2
59	7755842	7755965	479	602	123	RIGHT	P67b.EDF	P67	2
60	7763962	7764055	97	190	93	RIGHT	P67b.EDF	P67	2
60	7764540	7764666	675	801	126	RIGHT	P67b.EDF	P67	2
61	7772407	7772555	449	597	148	RIGHT	P67b.EDF	P67	2
62	7780656	7780778	943	1065	122	RIGHT	P67b.EDF	P67	2
63	7788596	7788741	888	1033	145	RIGHT	P67b.EDF	P67	2
63	7789211	7789292	1503	1584	81	RIGHT	P67b.EDF	P67	2
64	7796576	7796702	489	615	126	RIGHT	P67b.EDF	P67	2
65	7807880	7807995	1379	1494	115	RIGHT	P67b.EDF	P67	2
66	7815930	7816047	427	544	117	RIGHT	P67b.EDF	P67	2
67	7823262	7823388	551	677	126	RIGHT	P67b.EDF	P67	2
68	7833236	7833350	310	424	114	RIGHT	P67b.EDF	P67	2
68	7834497	7834569	1571	1643	72	RIGHT	P67b.EDF	P67	2
69	7844253	7844350	1223	1320	97	RIGHT	P67b.EDF	P67	2
70	7853811	7853951	58	198	140	RIGHT	P67b.EDF	P67	2
70	7854277	7854416	524	663	139	RIGHT	P67b.EDF	P67	2
70	7854846	7854970	1093	1217	124	RIGHT	P67b.EDF	P67	2
71	7862902	7863025	668	791	123	RIGHT	P67b.EDF	P67	2
72	7872203	7872349	684	830	146	RIGHT	P67b.EDF	P67	2
72	7872849	7872967	1330	1448	118	RIGHT	P67b.EDF	P67	2
73	7881273	7881402	547	676	129	RIGHT	P67b.EDF	P67	2
73	7881958	7882082	1232	1356	124	RIGHT	P67b.EDF	P67	2
74	7893712	7893846	871	1005	134	RIGHT	P67b.EDF	P67	2
74	7894502	7894659	1661	1818	157	RIGHT	P67b.EDF	P67	2
75	7903060	7903208	332	480	148	RIGHT	P67b.EDF	P67	2
76	7911665	7911821	457	613	156	RIGHT	P67b.EDF	P67	2
77	7920254	7920407	195	348	153	RIGHT	P67b.EDF	P67	2
77	7920636	7920828	577	769	192	RIGHT	P67b.EDF	P67	2
77	7921212	7921341	1153	1282	129	RIGHT	P67b.EDF	P67	2
78	7929016	7929150	431	565	134	RIGHT	P67b.EDF	P67	2
78	7929730	7929870	1145	1285	140	RIGHT	P67b.EDF	P67	2
80	7948133	7948240	1213	1320	107	RIGHT	P67b.EDF	P67	2
81	7957086	7957217	1166	1297	131	RIGHT	P67b.EDF	P67	2
82	7965568	7965675	100	207	107	RIGHT	P67b.EDF	P67	2
82	7966324	7966461	856	993	137	RIGHT	P67b.EDF	P67	2
83	7975057	7975180	790	913	123	RIGHT	P67b.EDF	P67	2
84	7982764	7982877	723	836	113	RIGHT	P67b.EDF	P67	2
85	7990865	7990931	471	537	66	RIGHT	P67b.EDF	P67	2
86	8000249	8000389	270	410	140	RIGHT	P67b.EDF	P67	2
87	8008193	8008318	140	265	125	RIGHT	P67b.EDF	P67	2
87	8008955	8009090	902	1037	135	RIGHT	P67b.EDF	P67	2
88	8019010	8019112	826	928	102	RIGHT	P67b.EDF	P67	2
89	8029495	8029616	854	975	121	RIGHT	P67b.EDF	P67	2
90	8038549	8038672	377	500	123	RIGHT	P67b.EDF	P67	2
90	8039111	8039231	939	1059	120	RIGHT	P67b.EDF	P67	2
91	8048166	8048279	1038	1151	113	RIGHT	P67b.EDF	P67	2
92	8330730	8331295	58	623	565	RIGHT	P67b.EDF	P67	2
92	8331380	8331382	708	710	2	RIGHT	P67b.EDF	P67	2
92	8331416	8331857	744	1185	441	RIGHT	P67b.EDF	P67	2
92	8331890	8331893	1218	1221	3	RIGHT	P67b.EDF	P67	2
92	8331988	8332080	1316	1408	92	RIGHT	P67b.EDF	P67	2
92	8332291	8332306	1619	1634	15	RIGHT	P67b.EDF	P67	2
92	8332381	8332486	1709	1814	105	RIGHT	P67b.EDF	P67	2
93	8340450	8340491	102	143	41	RIGHT	P67b.EDF	P67	2
94	8352631	8352733	957	1059	102	RIGHT	P67b.EDF	P67	2
95	8359676	8359792	751	867	116	RIGHT	P67b.EDF	P67	2
99	8399414	8399502	139	227	88	RIGHT	P67b.EDF	P67	2
99	8399808	8399938	533	663	130	RIGHT	P67b.EDF	P67	2
99	8400372	8400496	1097	1221	124	RIGHT	P67b.EDF	P67	2
100	8411448	8411580	401	533	132	RIGHT	P67b.EDF	P67	2
100	8412498	8412615	1451	1568	117	RIGHT	P67b.EDF	P67	2
101	8420246	8420361	819	934	115	RIGHT	P67b.EDF	P67	2
102	8432823	8432994	388	559	171	RIGHT	P67b.EDF	P67	2
102	8433181	8433347	746	912	166	RIGHT	P67b.EDF	P67	2
102	8433706	8433855	1271	1420	149	RIGHT	P67b.EDF	P67	2
104	8455638	8455787	463	612	149	RIGHT	P67b.EDF	P67	2
105	8462719	8462843	66	190	124	RIGHT	P67b.EDF	P67	2
106	8471930	8472048	420	538	118	RIGHT	P67b.EDF	P67	2
106	8472347	8472481	837	971	134	RIGHT	P67b.EDF	P67	2
106	8472917	8472999	1407	1489	82	RIGHT	P67b.EDF	P67	2
107	8480879	8481005	451	577	126	RIGHT	P67b.EDF	P67	2
107	8482168	8482250	1740	1822	82	RIGHT	P67b.EDF	P67	2
108	8493660	8493807	247	394	147	RIGHT	P67b.EDF	P67	2
108	8494995	8495099	1582	1686	104	RIGHT	P67b.EDF	P67	2
109	8504185	8504276	114	205	91	RIGHT	P67b.EDF	P67	2
109	8504635	8504747	564	676	112	RIGHT	P67b.EDF	P67	2
111	8522289	8522367	58	136	78	RIGHT	P67b.EDF	P67	2
112	8532112	8532205	70	163	93	RIGHT	P67b.EDF	P67	2
112	8532572	8532672	530	630	100	RIGHT	P67b.EDF	P67	2
113	8542492	8542599	160	267	107	RIGHT	P67b.EDF	P67	2
114	8552795	8552924	885	1014	129	RIGHT	P67b.EDF	P67	2
114	8553538	8553648	1628	1738	110	RIGHT	P67b.EDF	P67	2
116	8568857	8568939	59	141	82	RIGHT	P67b.EDF	P67	2
116	8569512	8569635	714	837	123	RIGHT	P67b.EDF	P67	2
117	8579509	8579594	1054	1139	85	RIGHT	P67b.EDF	P67	2
118	8585797	8585876	58	137	79	RIGHT	P67b.EDF	P67	2
120	8606254	8606395	262	403	141	RIGHT	P67b.EDF	P67	2
1	9701165	9701267	752	854	102	RIGHT	P67c.EDF	P67	3
2	9711238	9711342	488	592	104	RIGHT	P67c.EDF	P67	3
2	9711924	9712043	1174	1293	119	RIGHT	P67c.EDF	P67	3
3	9719108	9719230	942	1064	122	RIGHT	P67c.EDF	P67	3
4	9728486	9728521	837	872	35	RIGHT	P67c.EDF	P67	3
5	9736895	9737051	65	221	156	RIGHT	P67c.EDF	P67	3
5	9737507	9737608	677	778	101	RIGHT	P67c.EDF	P67	3
6	9747300	9747364	1256	1320	64	RIGHT	P67c.EDF	P67	3
7	9758794	9758929	642	777	135	RIGHT	P67c.EDF	P67	3
7	9759729	9759851	1577	1699	122	RIGHT	P67c.EDF	P67	3
8	9768315	9768453	1256	1394	138	RIGHT	P67c.EDF	P67	3
9	9776651	9776779	448	576	128	RIGHT	P67c.EDF	P67	3
9	9777103	9777246	900	1043	143	RIGHT	P67c.EDF	P67	3
9	9777491	9777649	1288	1446	158	RIGHT	P67c.EDF	P67	3
10	9784622	9784742	924	1044	120	RIGHT	P67c.EDF	P67	3
11	9794262	9794389	724	851	127	RIGHT	P67c.EDF	P67	3
11	9795016	9795151	1478	1613	135	RIGHT	P67c.EDF	P67	3
12	9804544	9804663	744	863	119	RIGHT	P67c.EDF	P67	3
13	9812110	9812213	295	398	103	RIGHT	P67c.EDF	P67	3
13	9813310	9813400	1495	1585	90	RIGHT	P67c.EDF	P67	3
14	9819889	9820022	461	594	133	RIGHT	P67c.EDF	P67	3
16	9837432	9837468	57	93	36	RIGHT	P67c.EDF	P67	3
16	9838084	9838233	709	858	149	RIGHT	P67c.EDF	P67	3
16	9838688	9838794	1313	1419	106	RIGHT	P67c.EDF	P67	3
17	9846396	9846510	632	746	114	RIGHT	P67c.EDF	P67	3
18	9855835	9855944	544	653	109	RIGHT	P67c.EDF	P67	3
19	9864892	9865018	506	632	126	RIGHT	P67c.EDF	P67	3
19	9865467	9865593	1081	1207	126	RIGHT	P67c.EDF	P67	3
20	9873072	9873187	502	617	115	RIGHT	P67c.EDF	P67	3
21	9881302	9881378	106	182	76	RIGHT	P67c.EDF	P67	3
21	9881728	9881833	532	637	105	RIGHT	P67c.EDF	P67	3
22	9889268	9889409	215	356	141	RIGHT	P67c.EDF	P67	3
23	9897028	9897163	267	402	135	RIGHT	P67c.EDF	P67	3
23	9898196	9898312	1435	1551	116	RIGHT	P67c.EDF	P67	3
25	9914925	9915047	220	342	122	RIGHT	P67c.EDF	P67	3
25	9915505	9915632	800	927	127	RIGHT	P67c.EDF	P67	3
25	9916133	9916264	1428	1559	131	RIGHT	P67c.EDF	P67	3
26	9923922	9924069	428	575	147	RIGHT	P67c.EDF	P67	3
26	9924668	9924799	1174	1305	131	RIGHT	P67c.EDF	P67	3
27	9934188	9934342	330	484	154	RIGHT	P67c.EDF	P67	3
28	9943019	9943130	293	404	111	RIGHT	P67c.EDF	P67	3
29	9952510	9952619	79	188	109	RIGHT	P67c.EDF	P67	3
30	9962148	9962184	57	93	36	RIGHT	P67c.EDF	P67	3
30	9962520	9962667	429	576	147	RIGHT	P67c.EDF	P67	3
30	9963150	9963277	1059	1186	127	RIGHT	P67c.EDF	P67	3
31	9972191	9972289	929	1027	98	RIGHT	P67c.EDF	P67	3
31	9973020	9973154	1758	1892	134	RIGHT	P67c.EDF	P67	3
32	9981187	9981293	145	251	106	RIGHT	P67c.EDF	P67	3
32	9981658	9981773	616	731	115	RIGHT	P67c.EDF	P67	3
32	9982085	9982232	1043	1190	147	RIGHT	P67c.EDF	P67	3
32	9984859	9984977	3817	3935	118	RIGHT	P67c.EDF	P67	3
34	9999210	9999271	57	118	61	RIGHT	P67c.EDF	P67	3
35	10008491	10008622	61	192	131	RIGHT	P67c.EDF	P67	3
35	10009039	10009186	609	756	147	RIGHT	P67c.EDF	P67	3
35	10010217	10010343	1787	1913	126	RIGHT	P67c.EDF	P67	3
36	10017456	10017584	85	213	128	RIGHT	P67c.EDF	P67	3
36	10018019	10018148	648	777	129	RIGHT	P67c.EDF	P67	3
37	10026863	10026995	427	559	132	RIGHT	P67c.EDF	P67	3
38	10037799	10037944	587	732	145	RIGHT	P67c.EDF	P67	3
39	10046229	10046381	381	533	152	RIGHT	P67c.EDF	P67	3
40	10055320	10055483	376	539	163	RIGHT	P67c.EDF	P67	3
40	10055946	10056089	1002	1145	143	RIGHT	P67c.EDF	P67	3
41	10063244	10063370	816	942	126	RIGHT	P67c.EDF	P67	3
42	10070394	10070533	252	391	139	RIGHT	P67c.EDF	P67	3
42	10071312	10071461	1170	1319	149	RIGHT	P67c.EDF	P67	3
43	10078565	10078646	58	139	81	RIGHT	P67c.EDF	P67	3
43	10079260	10079380	753	873	120	RIGHT	P67c.EDF	P67	3
45	10100145	10100280	504	639	135	RIGHT	P67c.EDF	P67	3
45	10100441	10100580	800	939	139	RIGHT	P67c.EDF	P67	3
45	10100889	10101041	1248	1400	152	RIGHT	P67c.EDF	P67	3
46	10107632	10107704	57	129	72	RIGHT	P67c.EDF	P67	3
46	10108352	10108474	777	899	122	RIGHT	P67c.EDF	P67	3
47	10117638	10117742	462	566	104	RIGHT	P67c.EDF	P67	3
47	10118120	10118270	944	1094	150	RIGHT	P67c.EDF	P67	3
47	10123616	10123735	6440	6559	119	RIGHT	P67c.EDF	P67	3
48	10129001	10129144	443	586	143	RIGHT	P67c.EDF	P67	3
48	10129650	10129793	1092	1235	143	RIGHT	P67c.EDF	P67	3
50	10145857	10145884	57	84	27	RIGHT	P67c.EDF	P67	3
50	10146476	10146594	676	794	118	RIGHT	P67c.EDF	P67	3
50	10147160	10147268	1360	1468	108	RIGHT	P67c.EDF	P67	3
51	10155107	10155248	463	604	141	RIGHT	P67c.EDF	P67	3
51	10159309	10159372	4665	4728	63	RIGHT	P67c.EDF	P67	3
52	10165275	10165408	89	222	133	RIGHT	P67c.EDF	P67	3
52	10165755	10165911	569	725	156	RIGHT	P67c.EDF	P67	3
52	10166373	10166492	1187	1306	119	RIGHT	P67c.EDF	P67	3
53	10174256	10174396	298	438	140	RIGHT	P67c.EDF	P67	3
54	10183056	10183192	304	440	136	RIGHT	P67c.EDF	P67	3
55	10190868	10190980	820	932	112	RIGHT	P67c.EDF	P67	3
56	10198666	10198790	832	956	124	RIGHT	P67c.EDF	P67	3
57	10206508	10206648	90	230	140	RIGHT	P67c.EDF	P67	3
57	10207008	10207147	590	729	139	RIGHT	P67c.EDF	P67	3
58	10216197	10216333	274	410	136	RIGHT	P67c.EDF	P67	3
59	10225597	10225740	755	898	143	RIGHT	P67c.EDF	P67	3
60	10233428	10233538	194	304	110	RIGHT	P67c.EDF	P67	3
60	10233931	10234084	697	850	153	RIGHT	P67c.EDF	P67	3
60	10234403	10234556	1169	1322	153	RIGHT	P67c.EDF	P67	3
61	10241711	10241855	141	285	144	RIGHT	P67c.EDF	P67	3
61	10242634	10242757	1064	1187	123	RIGHT	P67c.EDF	P67	3
62	10248448	10248572	265	389	124	RIGHT	P67c.EDF	P67	3
63	10257756	10257881	269	394	125	RIGHT	P67c.EDF	P67	3
63	10258350	10258485	863	998	135	RIGHT	P67c.EDF	P67	3
64	10265325	10265446	231	352	121	RIGHT	P67c.EDF	P67	3
64	10265843	10265981	749	887	138	RIGHT	P67c.EDF	P67	3
65	10274727	10274849	518	640	122	RIGHT	P67c.EDF	P67	3
66	10284130	10284247	665	782	117	RIGHT	P67c.EDF	P67	3
66	10284684	10284801	1219	1336	117	RIGHT	P67c.EDF	P67	3
67	10294045	10294191	666	812	146	RIGHT	P67c.EDF	P67	3
67	10294854	10295002	1475	1623	148	RIGHT	P67c.EDF	P67	3
68	10301322	10301478	343	499	156	RIGHT	P67c.EDF	P67	3
68	10302200	10302334	1221	1355	134	RIGHT	P67c.EDF	P67	3
69	10309129	10309283	88	242	154	RIGHT	P67c.EDF	P67	3
69	10309963	10310100	922	1059	137	RIGHT	P67c.EDF	P67	3
70	10320359	10320453	58	152	94	RIGHT	P67c.EDF	P67	3
70	10320800	10320957	499	656	157	RIGHT	P67c.EDF	P67	3
70	10321778	10321898	1477	1597	120	RIGHT	P67c.EDF	P67	3
71	10329979	10330125	147	293	146	RIGHT	P67c.EDF	P67	3
71	10330982	10331128	1150	1296	146	RIGHT	P67c.EDF	P67	3
72	10338810	10338958	455	603	148	RIGHT	P67c.EDF	P67	3
72	10339230	10339393	875	1038	163	RIGHT	P67c.EDF	P67	3
72	10339788	10339942	1433	1587	154	RIGHT	P67c.EDF	P67	3
73	10347145	10347284	601	740	139	RIGHT	P67c.EDF	P67	3
74	10357015	10357152	1613	1750	137	RIGHT	P67c.EDF	P67	3
75	10367213	10367339	316	442	126	RIGHT	P67c.EDF	P67	3
76	10376205	10376344	447	586	139	RIGHT	P67c.EDF	P67	3
76	10376759	10376889	1001	1131	130	RIGHT	P67c.EDF	P67	3
77	10384467	10384604	280	417	137	RIGHT	P67c.EDF	P67	3
78	10394012	10394155	90	233	143	RIGHT	P67c.EDF	P67	3
78	10395371	10395472	1449	1550	101	RIGHT	P67c.EDF	P67	3
80	10412626	10412743	470	587	117	RIGHT	P67c.EDF	P67	3
81	10420806	10420958	417	569	152	RIGHT	P67c.EDF	P67	3
82	10428939	10429079	489	629	140	RIGHT	P67c.EDF	P67	3
83	10437625	10437748	654	777	123	RIGHT	P67c.EDF	P67	3
83	10438262	10438391	1291	1420	129	RIGHT	P67c.EDF	P67	3
84	10447499	10447638	792	931	139	RIGHT	P67c.EDF	P67	3
84	10448165	10448301	1458	1594	136	RIGHT	P67c.EDF	P67	3
85	10455997	10456097	67	167	100	RIGHT	P67c.EDF	P67	3
85	10456407	10456553	477	623	146	RIGHT	P67c.EDF	P67	3
85	10456971	10457094	1041	1164	123	RIGHT	P67c.EDF	P67	3
86	10464783	10464903	437	557	120	RIGHT	P67c.EDF	P67	3
86	10465315	10465450	969	1104	135	RIGHT	P67c.EDF	P67	3
86	10466000	10466083	1654	1737	83	RIGHT	P67c.EDF	P67	3
87	10474515	10474544	524	553	29	RIGHT	P67c.EDF	P67	3
87	10474834	10474946	843	955	112	RIGHT	P67c.EDF	P67	3
88	10484131	10484219	58	146	88	RIGHT	P67c.EDF	P67	3
88	10484569	10484670	496	597	101	RIGHT	P67c.EDF	P67	3
89	10492174	10492316	531	673	142	RIGHT	P67c.EDF	P67	3
89	10493109	10493249	1466	1606	140	RIGHT	P67c.EDF	P67	3
90	10503298	10503705	468	875	407	RIGHT	P67c.EDF	P67	3
91	10781619	10781712	57	150	93	RIGHT	P67c.EDF	P67	3
91	10782060	10782195	498	633	135	RIGHT	P67c.EDF	P67	3
91	10782824	10782957	1262	1395	133	RIGHT	P67c.EDF	P67	3
92	10792174	10792288	86	200	114	RIGHT	P67c.EDF	P67	3
93	10803899	10804018	128	247	119	RIGHT	P67c.EDF	P67	3
93	10804402	10804547	631	776	145	RIGHT	P67c.EDF	P67	3
93	10804669	10804819	898	1048	150	RIGHT	P67c.EDF	P67	3
93	10805033	10805176	1262	1405	143	RIGHT	P67c.EDF	P67	3
94	10813433	10813539	644	750	106	RIGHT	P67c.EDF	P67	3
95	10824592	10824694	741	843	102	RIGHT	P67c.EDF	P67	3
95	10825440	10825495	1589	1644	55	RIGHT	P67c.EDF	P67	3
96	10831743	10831818	139	214	75	RIGHT	P67c.EDF	P67	3
96	10832114	10832243	510	639	129	RIGHT	P67c.EDF	P67	3
96	10833083	10833150	1479	1546	67	RIGHT	P67c.EDF	P67	3
97	10840268	10840367	830	929	99	RIGHT	P67c.EDF	P67	3
98	10847815	10847917	434	536	102	RIGHT	P67c.EDF	P67	3
99	10856353	10856453	216	316	100	RIGHT	P67c.EDF	P67	3
99	10856818	10856941	681	804	123	RIGHT	P67c.EDF	P67	3
99	10857380	10857487	1243	1350	107	RIGHT	P67c.EDF	P67	3
100	10865985	10866073	56	144	88	RIGHT	P67c.EDF	P67	3
100	10866445	10866563	516	634	118	RIGHT	P67c.EDF	P67	3
101	10875404	10875499	85	180	95	RIGHT	P67c.EDF	P67	3
101	10875771	10876154	452	835	383	RIGHT	P67c.EDF	P67	3
101	10876653	10876783	1334	1464	130	RIGHT	P67c.EDF	P67	3
102	10884129	10884265	893	1029	136	RIGHT	P67c.EDF	P67	3
106	10915736	10915790	443	497	54	RIGHT	P67c.EDF	P67	3
108	10931712	10931826	258	372	114	RIGHT	P67c.EDF	P67	3
108	10932526	10932653	1072	1199	127	RIGHT	P67c.EDF	P67	3
109	10942459	10942541	1259	1341	82	RIGHT	P67c.EDF	P67	3
111	10960741	10960818	589	666	77	RIGHT	P67c.EDF	P67	3
111	10961654	10961757	1502	1605	103	RIGHT	P67c.EDF	P67	3
112	10969176	10969299	539	662	123	RIGHT	P67c.EDF	P67	3
113	10978263	10978363	706	806	100	RIGHT	P67c.EDF	P67	3
114	10987853	10987952	1527	1626	99	RIGHT	P67c.EDF	P67	3
115	10997470	10997593	817	940	123	RIGHT	P67c.EDF	P67	3
115	10998051	10998178	1398	1525	127	RIGHT	P67c.EDF	P67	3
116	11006280	11006397	591	708	117	RIGHT	P67c.EDF	P67	3
116	11007192	11007322	1503	1633	130	RIGHT	P67c.EDF	P67	3
117	11014156	11014255	267	366	99	RIGHT	P67c.EDF	P67	3
118	11023068	11023197	599	728	129	RIGHT	P67c.EDF	P67	3
118	11023725	11023849	1256	1380	124	RIGHT	P67c.EDF	P67	3
119	11032429	11032553	167	291	124	RIGHT	P67c.EDF	P67	3
119	11033335	11033460	1073	1198	125	RIGHT	P67c.EDF	P67	3
119	11037505	11037576	5243	5314	71	RIGHT	P67c.EDF	P67	3
120	11042272	11042390	590	708	118	RIGHT	P67c.EDF	P67	3
121	11410744	11421290	1	10547	10546	RIGHT	P67c.EDF	P67	3
121	11421403	11423191	10660	12448	1788	RIGHT	P67c.EDF	P67	3
121	11423601	11423756	12858	13013	155	RIGHT	P67c.EDF	P67	3
121	11423979	11424118	13236	13375	139	RIGHT	P67c.EDF	P67	3
121	11424407	11424568	13664	13825	161	RIGHT	P67c.EDF	P67	3
121	11424864	11424993	14121	14250	129	RIGHT	P67c.EDF	P67	3
121	11425396	11425559	14653	14816	163	RIGHT	P67c.EDF	P67	3
121	11428647	11428667	17904	17924	20	RIGHT	P67c.EDF	P67	3
121	11428995	11429008	18252	18265	13	RIGHT	P67c.EDF	P67	3
121	11433160	11433260	22417	22517	100	RIGHT	P67c.EDF	P67	3
121	11434707	11434735	23964	23992	28	RIGHT	P67c.EDF	P67	3
121	11435143	11435264	24400	24521	121	RIGHT	P67c.EDF	P67	3
121	11435872	11436896	25129	26153	1024	RIGHT	P67c.EDF	P67	3
121	11438038	11438053	27295	27310	15	RIGHT	P67c.EDF	P67	3
121	11438509	11438876	27766	28133	367	RIGHT	P67c.EDF	P67	3
121	11444926	11445011	34183	34268	85	RIGHT	P67c.EDF	P67	3
121	11449431	11449553	38688	38810	122	RIGHT	P67c.EDF	P67	3
121	11454517	11454622	43774	43879	105	RIGHT	P67c.EDF	P67	3
121	11461602	11461720	50859	50977	118	RIGHT	P67c.EDF	P67	3
121	11463047	11463157	52304	52414	110	RIGHT	P67c.EDF	P67	3
121	11466055	11466155	55312	55412	100	RIGHT	P67c.EDF	P67	3
121	11474772	11474907	64029	64164	135	RIGHT	P67c.EDF	P67	3
121	11480373	11480514	69630	69771	141	RIGHT	P67c.EDF	P67	3
121	11482010	11482143	71267	71400	133	RIGHT	P67c.EDF	P67	3
121	11483169	11483312	72426	72569	143	RIGHT	P67c.EDF	P67	3
121	11487599	11487692	76856	76949	93	RIGHT	P67c.EDF	P67	3
121	11491616	11491719	80873	80976	103	RIGHT	P67c.EDF	P67	3
121	11492485	11492643	81742	81900	158	RIGHT	P67c.EDF	P67	3
121	11493121	11493255	82378	82512	134	RIGHT	P67c.EDF	P67	3
121	11494970	11495105	84227	84362	135	RIGHT	P67c.EDF	P67	3
121	11495305	11495851	84562	85108	546	RIGHT	P67c.EDF	P67	3
121	11495930	11496261	85187	85518	331	RIGHT	P67c.EDF	P67	3
121	11497061	11497446	86318	86703	385	RIGHT	P67c.EDF	P67	3
121	11505110	11505196	94367	94453	86	RIGHT	P67c.EDF	P67	3
121	11506758	11506842	96015	96099	84	RIGHT	P67c.EDF	P67	3
121	11508673	11508807	97930	98064	134	RIGHT	P67c.EDF	P67	3
121	11509850	11509968	99107	99225	118	RIGHT	P67c.EDF	P67	3
121	11511752	11511872	101009	101129	120	RIGHT	P67c.EDF	P67	3
121	11513494	11513627	102751	102884	133	RIGHT	P67c.EDF	P67	3
121	11514444	11514579	103701	103836	135	RIGHT	P67c.EDF	P67	3
121	11516475	11516588	105732	105845	113	RIGHT	P67c.EDF	P67	3
121	11517180	11517262	106437	106519	82	RIGHT	P67c.EDF	P67	3
121	11518201	11518621	107458	107878	420	RIGHT	P67c.EDF	P67	3
121	11520441	11520553	109698	109810	112	RIGHT	P67c.EDF	P67	3
121	11521639	11521762	110896	111019	123	RIGHT	P67c.EDF	P67	3
121	11524142	11524247	113399	113504	105	RIGHT	P67c.EDF	P67	3
121	11527677	11527806	116934	117063	129	RIGHT	P67c.EDF	P67	3
121	11528069	11528224	117326	117481	155	RIGHT	P67c.EDF	P67	3
121	11531151	11531311	120408	120568	160	RIGHT	P67c.EDF	P67	3
121	11533468	11533568	122725	122825	100	RIGHT	P67c.EDF	P67	3
121	11535530	11535646	124787	124903	116	RIGHT	P67c.EDF	P67	3
121	11539423	11539550	128680	128807	127	RIGHT	P67c.EDF	P67	3
121	11541373	11541518	130630	130775	145	RIGHT	P67c.EDF	P67	3
121	11544257	11544386	133514	133643	129	RIGHT	P67c.EDF	P67	3
121	11545684	11545827	134941	135084	143	RIGHT	P67c.EDF	P67	3
121	11548960	11549092	138217	138349	132	RIGHT	P67c.EDF	P67	3
121	11550743	11550886	140000	140143	143	RIGHT	P67c.EDF	P67	3
121	11552557	11552672	141814	141929	115	RIGHT	P67c.EDF	P67	3
121	11554074	11554217	143331	143474	143	RIGHT	P67c.EDF	P67	3
121	11555829	11555917	145086	145174	88	RIGHT	P67c.EDF	P67	3
121	11557350	11557471	146607	146728	121	RIGHT	P67c.EDF	P67	3
121	11561381	11561503	150638	150760	122	RIGHT	P67c.EDF	P67	3
121	11562860	11562960	152117	152217	100	RIGHT	P67c.EDF	P67	3
121	11564682	11564819	153939	154076	137	RIGHT	P67c.EDF	P67	3
121	11569485	11569621	158742	158878	136	RIGHT	P67c.EDF	P67	3
121	11572776	11572920	162033	162177	144	RIGHT	P67c.EDF	P67	3
121	11574513	11574666	163770	163923	153	RIGHT	P67c.EDF	P67	3
121	11578185	11578301	167442	167558	116	RIGHT	P67c.EDF	P67	3
121	11580133	11580300	169390	169557	167	RIGHT	P67c.EDF	P67	3
121	11582427	11582554	171684	171811	127	RIGHT	P67c.EDF	P67	3
121	11583888	11584009	173145	173266	121	RIGHT	P67c.EDF	P67	3
121	11585824	11585974	175081	175231	150	RIGHT	P67c.EDF	P67	3
121	11587853	11588012	177110	177269	159	RIGHT	P67c.EDF	P67	3
121	11589488	11589614	178745	178871	126	RIGHT	P67c.EDF	P67	3
121	11591405	11591512	180662	180769	107	RIGHT	P67c.EDF	P67	3
121	11593938	11594060	183195	183317	122	RIGHT	P67c.EDF	P67	3
121	11595750	11595888	185007	185145	138	RIGHT	P67c.EDF	P67	3
121	11598339	11598688	187596	187945	349	RIGHT	P67c.EDF	P67	3
121	11602903	11603077	192160	192334	174	RIGHT	P67c.EDF	P67	3
121	11603648	11603809	192905	193066	161	RIGHT	P67c.EDF	P67	3
121	11605614	11605747	194871	195004	133	RIGHT	P67c.EDF	P67	3
121	11608648	11608996	197905	198253	348	RIGHT	P67c.EDF	P67	3
121	11611102	11611227	200359	200484	125	RIGHT	P67c.EDF	P67	3
121	11611530	11611663	200787	200920	133	RIGHT	P67c.EDF	P67	3
121	11614483	11614604	203740	203861	121	RIGHT	P67c.EDF	P67	3
121	11615814	11615939	205071	205196	125	RIGHT	P67c.EDF	P67	3
121	11618540	11618644	207797	207901	104	RIGHT	P67c.EDF	P67	3
121	11619000	11619188	208257	208445	188	RIGHT	P67c.EDF	P67	3
121	11619700	11619855	208957	209112	155	RIGHT	P67c.EDF	P67	3
121	11623403	11623529	212660	212786	126	RIGHT	P67c.EDF	P67	3
121	11625927	11626050	215184	215307	123	RIGHT	P67c.EDF	P67	3
121	11629836	11629966	219093	219223	130	RIGHT	P67c.EDF	P67	3
121	11631518	11631645	220775	220902	127	RIGHT	P67c.EDF	P67	3
121	11632907	11632995	222164	222252	88	RIGHT	P67c.EDF	P67	3
121	11637029	11637140	226286	226397	111	RIGHT	P67c.EDF	P67	3
121	11642935	11643074	232192	232331	139	RIGHT	P67c.EDF	P67	3
121	11644728	11644909	233985	234166	181	RIGHT	P67c.EDF	P67	3
121	11648336	11648462	237593	237719	126	RIGHT	P67c.EDF	P67	3
121	11650204	11650294	239461	239551	90	RIGHT	P67c.EDF	P67	3
121	11650557	11650716	239814	239973	159	RIGHT	P67c.EDF	P67	3
121	11653159	11653316	242416	242573	157	RIGHT	P67c.EDF	P67	3
121	11656886	11657053	246143	246310	167	RIGHT	P67c.EDF	P67	3
121	11659022	11659200	248279	248457	178	RIGHT	P67c.EDF	P67	3
121	11660990	11661114	250247	250371	124	RIGHT	P67c.EDF	P67	3
121	11662856	11663008	252113	252265	152	RIGHT	P67c.EDF	P67	3
121	11667117	11667231	256374	256488	114	RIGHT	P67c.EDF	P67	3
121	11668954	11669083	258211	258340	129	RIGHT	P67c.EDF	P67	3
121	11670877	11671024	260134	260281	147	RIGHT	P67c.EDF	P67	3
121	11673314	11673439	262571	262696	125	RIGHT	P67c.EDF	P67	3
121	11676888	11677060	266145	266317	172	RIGHT	P67c.EDF	P67	3
121	11677267	11677438	266524	266695	171	RIGHT	P67c.EDF	P67	3
121	11678830	11678972	268087	268229	142	RIGHT	P67c.EDF	P67	3
121	11682258	11682396	271515	271653	138	RIGHT	P67c.EDF	P67	3
121	11684953	11685099	274210	274356	146	RIGHT	P67c.EDF	P67	3
121	11688670	11688794	277927	278051	124	RIGHT	P67c.EDF	P67	3
121	11690361	11690495	279618	279752	134	RIGHT	P67c.EDF	P67	3
121	11692497	11692649	281754	281906	152	RIGHT	P67c.EDF	P67	3
121	11696222	11696333	285479	285590	111	RIGHT	P67c.EDF	P67	3
121	11698030	11698136	287287	287393	106	RIGHT	P67c.EDF	P67	3
121	11699485	11699670	288742	288927	185	RIGHT	P67c.EDF	P67	3
121	11701100	11701243	290357	290500	143	RIGHT	P67c.EDF	P67	3
121	11703224	11703396	292481	292653	172	RIGHT	P67c.EDF	P67	3
121	11703764	11703912	293021	293169	148	RIGHT	P67c.EDF	P67	3
121	11707850	11707949	297107	297206	99	RIGHT	P67c.EDF	P67	3
121	11708494	11711875	297751	301132	3381	RIGHT	P67c.EDF	P67	3
122	11795669	11795789	1401	1521	120	RIGHT	P67c.EDF	P67	3
122	11796218	11796359	1950	2091	141	RIGHT	P67c.EDF	P67	3
122	11796753	11797299	2485	3031	546	RIGHT	P67c.EDF	P67	3
122	11798427	11798563	4159	4295	136	RIGHT	P67c.EDF	P67	3
122	11800611	11800733	6343	6465	122	RIGHT	P67c.EDF	P67	3
122	11804064	11804209	9796	9941	145	RIGHT	P67c.EDF	P67	3
122	11804450	11804636	10182	10368	186	RIGHT	P67c.EDF	P67	3
122	11804786	11805549	10518	11281	763	RIGHT	P67c.EDF	P67	3
122	11806873	11807039	12605	12771	166	RIGHT	P67c.EDF	P67	3
122	11810541	11810696	16273	16428	155	RIGHT	P67c.EDF	P67	3
122	11812346	11812467	18078	18199	121	RIGHT	P67c.EDF	P67	3
122	11814125	11814227	19857	19959	102	RIGHT	P67c.EDF	P67	3
122	11816201	11816322	21933	22054	121	RIGHT	P67c.EDF	P67	3
122	11818372	11818508	24104	24240	136	RIGHT	P67c.EDF	P67	3
122	11821125	11821267	26857	26999	142	RIGHT	P67c.EDF	P67	3
122	11824214	11824338	29946	30070	124	RIGHT	P67c.EDF	P67	3
122	11826279	11826403	32011	32135	124	RIGHT	P67c.EDF	P67	3
122	11827468	11827609	33200	33341	141	RIGHT	P67c.EDF	P67	3
122	11829047	11829195	34779	34927	148	RIGHT	P67c.EDF	P67	3
122	11831264	11831406	36996	37138	142	RIGHT	P67c.EDF	P67	3
122	11831861	11832050	37593	37782	189	RIGHT	P67c.EDF	P67	3
122	11832516	11832675	38248	38407	159	RIGHT	P67c.EDF	P67	3
122	11836249	11836378	41981	42110	129	RIGHT	P67c.EDF	P67	3
122	11840379	11840531	46111	46263	152	RIGHT	P67c.EDF	P67	3
122	11841087	11841258	46819	46990	171	RIGHT	P67c.EDF	P67	3
122	11842120	11842289	47852	48021	169	RIGHT	P67c.EDF	P67	3
122	11844000	11844161	49732	49893	161	RIGHT	P67c.EDF	P67	3
122	11847632	11847818	53364	53550	186	RIGHT	P67c.EDF	P67	3
122	11849930	11850067	55662	55799	137	RIGHT	P67c.EDF	P67	3
122	11851621	11851776	57353	57508	155	RIGHT	P67c.EDF	P67	3
122	11853233	11853393	58965	59125	160	RIGHT	P67c.EDF	P67	3
122	11855001	11855179	60733	60911	178	RIGHT	P67c.EDF	P67	3
122	11857820	11857936	63552	63668	116	RIGHT	P67c.EDF	P67	3
122	11862181	11862355	67913	68087	174	RIGHT	P67c.EDF	P67	3
122	11863225	11863353	68957	69085	128	RIGHT	P67c.EDF	P67	3
122	11865450	11865580	71182	71312	130	RIGHT	P67c.EDF	P67	3
122	11869427	11869574	75159	75306	147	RIGHT	P67c.EDF	P67	3
122	11871545	11871678	77277	77410	133	RIGHT	P67c.EDF	P67	3
122	11872304	11872453	78036	78185	149	RIGHT	P67c.EDF	P67	3
122	11875072	11875214	80804	80946	142	RIGHT	P67c.EDF	P67	3
122	11876174	11876312	81906	82044	138	RIGHT	P67c.EDF	P67	3
122	11878571	11878721	84303	84453	150	RIGHT	P67c.EDF	P67	3
122	11879280	11879441	85012	85173	161	RIGHT	P67c.EDF	P67	3
122	11881589	11881719	87321	87451	130	RIGHT	P67c.EDF	P67	3
122	11882292	11882466	88024	88198	174	RIGHT	P67c.EDF	P67	3
122	11885612	11885752	91344	91484	140	RIGHT	P67c.EDF	P67	3
122	11886916	11887054	92648	92786	138	RIGHT	P67c.EDF	P67	3
122	11887996	11888154	93728	93886	158	RIGHT	P67c.EDF	P67	3
122	11890422	11890562	96154	96294	140	RIGHT	P67c.EDF	P67	3
122	11890991	11891104	96723	96836	113	RIGHT	P67c.EDF	P67	3
122	11895193	11895307	100925	101039	114	RIGHT	P67c.EDF	P67	3
122	11896915	11897061	102647	102793	146	RIGHT	P67c.EDF	P67	3
122	11898826	11898969	104558	104701	143	RIGHT	P67c.EDF	P67	3
122	11899505	11899642	105237	105374	137	RIGHT	P67c.EDF	P67	3
122	11901549	11901686	107281	107418	137	RIGHT	P67c.EDF	P67	3
122	11903940	11904027	109672	109759	87	RIGHT	P67c.EDF	P67	3
122	11904817	11904978	110549	110710	161	RIGHT	P67c.EDF	P67	3
122	11905739	11905902	111471	111634	163	RIGHT	P67c.EDF	P67	3
122	11908005	11908124	113737	113856	119	RIGHT	P67c.EDF	P67	3
122	11911663	11911706	117395	117438	43	RIGHT	P67c.EDF	P67	3
122	11911988	11912109	117720	117841	121	RIGHT	P67c.EDF	P67	3
122	11913713	11913845	119445	119577	132	RIGHT	P67c.EDF	P67	3
122	11915867	11916019	121599	121751	152	RIGHT	P67c.EDF	P67	3
122	11916994	11917156	122726	122888	162	RIGHT	P67c.EDF	P67	3
122	11917425	11917589	123157	123321	164	RIGHT	P67c.EDF	P67	3
122	11920271	11920441	126003	126173	170	RIGHT	P67c.EDF	P67	3
122	11921987	11922128	127719	127860	141	RIGHT	P67c.EDF	P67	3
122	11928200	11928332	133932	134064	132	RIGHT	P67c.EDF	P67	3
122	11928950	11929071	134682	134803	121	RIGHT	P67c.EDF	P67	3
122	11932466	11932573	138198	138305	107	RIGHT	P67c.EDF	P67	3
122	11934776	11934798	140508	140530	22	RIGHT	P67c.EDF	P67	3
122	11936284	11936430	142016	142162	146	RIGHT	P67c.EDF	P67	3
122	11940016	11940170	145748	145902	154	RIGHT	P67c.EDF	P67	3
122	11940479	11940645	146211	146377	166	RIGHT	P67c.EDF	P67	3
122	11946364	11946509	152096	152241	145	RIGHT	P67c.EDF	P67	3
122	11948445	11948617	154177	154349	172	RIGHT	P67c.EDF	P67	3
122	11950304	11950465	156036	156197	161	RIGHT	P67c.EDF	P67	3
122	11952979	11953051	158711	158783	72	RIGHT	P67c.EDF	P67	3
122	11958079	11958200	163811	163932	121	RIGHT	P67c.EDF	P67	3
122	11961660	11961843	167392	167575	183	RIGHT	P67c.EDF	P67	3
122	11963922	11964079	169654	169811	157	RIGHT	P67c.EDF	P67	3
122	11966258	11966396	171990	172128	138	RIGHT	P67c.EDF	P67	3
122	11969454	11969603	175186	175335	149	RIGHT	P67c.EDF	P67	3
122	11971499	11971635	177231	177367	136	RIGHT	P67c.EDF	P67	3
122	11975400	11975480	181132	181212	80	RIGHT	P67c.EDF	P67	3
122	11977337	11977480	183069	183212	143	RIGHT	P67c.EDF	P67	3
122	11979724	11979870	185456	185602	146	RIGHT	P67c.EDF	P67	3
122	11980442	11980569	186174	186301	127	RIGHT	P67c.EDF	P67	3
122	11982397	11982534	188129	188266	137	RIGHT	P67c.EDF	P67	3
122	11985222	11985359	190954	191091	137	RIGHT	P67c.EDF	P67	3
122	11986810	11986921	192542	192653	111	RIGHT	P67c.EDF	P67	3
122	11992957	11993099	198689	198831	142	RIGHT	P67c.EDF	P67	3
122	11993783	11993977	199515	199709	194	RIGHT	P67c.EDF	P67	3
122	11998688	11998788	204420	204520	100	RIGHT	P67c.EDF	P67	3
122	12000581	12000730	206313	206462	149	RIGHT	P67c.EDF	P67	3
122	12002582	12002739	208314	208471	157	RIGHT	P67c.EDF	P67	3
122	12002845	12003017	208577	208749	172	RIGHT	P67c.EDF	P67	3
122	12003095	12003533	208827	209265	438	RIGHT	P67c.EDF	P67	3
122	12003842	12004042	209574	209774	200	RIGHT	P67c.EDF	P67	3
122	12006691	12006816	212423	212548	125	RIGHT	P67c.EDF	P67	3
122	12010905	12011045	216637	216777	140	RIGHT	P67c.EDF	P67	3
122	12011502	12011652	217234	217384	150	RIGHT	P67c.EDF	P67	3
122	12015387	12015522	221119	221254	135	RIGHT	P67c.EDF	P67	3
122	12017505	12017639	223237	223371	134	RIGHT	P67c.EDF	P67	3
122	12018479	12018593	224211	224325	114	RIGHT	P67c.EDF	P67	3
122	12020304	12020434	226036	226166	130	RIGHT	P67c.EDF	P67	3
122	12020664	12020811	226396	226543	147	RIGHT	P67c.EDF	P67	3
122	12023031	12023154	228763	228886	123	RIGHT	P67c.EDF	P67	3
122	12027284	12027414	233016	233146	130	RIGHT	P67c.EDF	P67	3
122	12028451	12028603	234183	234335	152	RIGHT	P67c.EDF	P67	3
122	12030809	12030949	236541	236681	140	RIGHT	P67c.EDF	P67	3
122	12036032	12036162	241764	241894	130	RIGHT	P67c.EDF	P67	3
122	12036435	12036557	242167	242289	122	RIGHT	P67c.EDF	P67	3
122	12038609	12038706	244341	244438	97	RIGHT	P67c.EDF	P67	3
122	12040501	12040633	246233	246365	132	RIGHT	P67c.EDF	P67	3
122	12040856	12040995	246588	246727	139	RIGHT	P67c.EDF	P67	3
122	12042849	12042990	248581	248722	141	RIGHT	P67c.EDF	P67	3
122	12045014	12045147	250746	250879	133	RIGHT	P67c.EDF	P67	3
122	12047255	12047421	252987	253153	166	RIGHT	P67c.EDF	P67	3
122	12048696	12048815	254428	254547	119	RIGHT	P67c.EDF	P67	3
122	12050052	12050182	255784	255914	130	RIGHT	P67c.EDF	P67	3
122	12052124	12052260	257856	257992	136	RIGHT	P67c.EDF	P67	3
122	12056738	12056864	262470	262596	126	RIGHT	P67c.EDF	P67	3
122	12059977	12060113	265709	265845	136	RIGHT	P67c.EDF	P67	3
122	12061950	12062099	267682	267831	149	RIGHT	P67c.EDF	P67	3
122	12063458	12063629	269190	269361	171	RIGHT	P67c.EDF	P67	3
122	12067067	12067199	272799	272931	132	RIGHT	P67c.EDF	P67	3
122	12068293	12068404	274025	274136	111	RIGHT	P67c.EDF	P67	3
122	12070996	12071064	276728	276796	68	RIGHT	P67c.EDF	P67	3
122	12071559	12176148	277291	381880	104589	RIGHT	P67c.EDF	P67	3
123	12489409	12489482	10944	11017	73	RIGHT	P67c.EDF	P67	3
123	12491679	12491736	13214	13271	57	RIGHT	P67c.EDF	P67	3
123	12499475	12499536	21010	21071	61	RIGHT	P67c.EDF	P67	3
123	12503285	12503341	24820	24876	56	RIGHT	P67c.EDF	P67	3
123	12505114	12505172	26649	26707	58	RIGHT	P67c.EDF	P67	3
123	12514411	12514433	35946	35968	22	RIGHT	P67c.EDF	P67	3
123	12519700	12519735	41235	41270	35	RIGHT	P67c.EDF	P67	3
123	12529570	12529595	51105	51130	25	RIGHT	P67c.EDF	P67	3
123	12537817	12537859	59352	59394	42	RIGHT	P67c.EDF	P67	3
123	12541246	12541285	62781	62820	39	RIGHT	P67c.EDF	P67	3
123	12560394	12560438	81929	81973	44	RIGHT	P67c.EDF	P67	3
123	12560801	12560879	82336	82414	78	RIGHT	P67c.EDF	P67	3
123	12576212	12576276	97747	97811	64	RIGHT	P67c.EDF	P67	3
123	12584002	12584040	105537	105575	38	RIGHT	P67c.EDF	P67	3
123	12585875	12585910	107410	107445	35	RIGHT	P67c.EDF	P67	3
123	12598985	12599049	120520	120584	64	RIGHT	P67c.EDF	P67	3
123	12609564	12609611	131099	131146	47	RIGHT	P67c.EDF	P67	3
123	12622096	12622140	143631	143675	44	RIGHT	P67c.EDF	P67	3
123	12623684	12623730	145219	145265	46	RIGHT	P67c.EDF	P67	3
123	12635550	12635583	157085	157118	33	RIGHT	P67c.EDF	P67	3
123	12640263	12640287	161798	161822	24	RIGHT	P67c.EDF	P67	3
123	12642010	12642376	163545	163911	366	RIGHT	P67c.EDF	P67	3
123	12642431	12643809	163966	165344	1378	RIGHT	P67c.EDF	P67	3
123	12643908	12645320	165443	166855	1412	RIGHT	P67c.EDF	P67	3
123	12646258	12646440	167793	167975	182	RIGHT	P67c.EDF	P67	3
123	12647104	12647597	168639	169132	493	RIGHT	P67c.EDF	P67	3
123	12648156	12653605	169691	175140	5449	RIGHT	P67c.EDF	P67	3
123	12653703	12659905	175238	181440	6202	RIGHT	P67c.EDF	P67	3
124	12716428	12716474	2654	2700	46	RIGHT	P67c.EDF	P67	3
124	12723040	12723104	9266	9330	64	RIGHT	P67c.EDF	P67	3
124	12723254	12723340	9480	9566	86	RIGHT	P67c.EDF	P67	3
124	12723880	12723972	10106	10198	92	RIGHT	P67c.EDF	P67	3
124	12724804	12724858	11030	11084	54	RIGHT	P67c.EDF	P67	3
124	12726461	12726507	12687	12733	46	RIGHT	P67c.EDF	P67	3
124	12727868	12727886	14094	14112	18	RIGHT	P67c.EDF	P67	3
124	12733869	12733933	20095	20159	64	RIGHT	P67c.EDF	P67	3
124	12738068	12738219	24294	24445	151	RIGHT	P67c.EDF	P67	3
124	12741561	12741610	27787	27836	49	RIGHT	P67c.EDF	P67	3
124	12749167	12749194	35393	35420	27	RIGHT	P67c.EDF	P67	3
124	12750778	12750861	37004	37087	83	RIGHT	P67c.EDF	P67	3
124	12760082	12760126	46308	46352	44	RIGHT	P67c.EDF	P67	3
124	12762182	12762279	48408	48505	97	RIGHT	P67c.EDF	P67	3
124	12770545	12770614	56771	56840	69	RIGHT	P67c.EDF	P67	3
124	12773683	12773770	59909	59996	87	RIGHT	P67c.EDF	P67	3
124	12788202	12788316	74428	74542	114	RIGHT	P67c.EDF	P67	3
124	12789428	12789475	75654	75701	47	RIGHT	P67c.EDF	P67	3
124	12797150	12797192	83376	83418	42	RIGHT	P67c.EDF	P67	3
124	12801805	12801884	88031	88110	79	RIGHT	P67c.EDF	P67	3
124	12804967	12805046	91193	91272	79	RIGHT	P67c.EDF	P67	3
124	12809840	12809891	96066	96117	51	RIGHT	P67c.EDF	P67	3
124	12819632	12819699	105858	105925	67	RIGHT	P67c.EDF	P67	3
124	12821246	12821295	107472	107521	49	RIGHT	P67c.EDF	P67	3
124	12833049	12833095	119275	119321	46	RIGHT	P67c.EDF	P67	3
124	12836121	12836178	122347	122404	57	RIGHT	P67c.EDF	P67	3
124	12840498	12840539	126724	126765	41	RIGHT	P67c.EDF	P67	3
124	12861262	12861306	147488	147532	44	RIGHT	P67c.EDF	P67	3
124	12862718	12862749	148944	148975	31	RIGHT	P67c.EDF	P67	3
124	12865820	12865855	152046	152081	35	RIGHT	P67c.EDF	P67	3
124	12875651	12875721	161877	161947	70	RIGHT	P67c.EDF	P67	3
124	12879408	12879508	165634	165734	100	RIGHT	P67c.EDF	P67	3
124	12879740	12882495	165966	168721	2755	RIGHT	P67c.EDF	P67	3
2	13985905	13986013	58	166	108	RIGHT	R59a.EDF	R59	1
2	13986529	13986672	682	825	143	RIGHT	R59a.EDF	R59	1
16	14117572	14117693	171	292	121	RIGHT	R59a.EDF	R59	1
20	14153485	14153559	202	276	74	RIGHT	R59a.EDF	R59	1
38	14314663	14314807	655	799	144	RIGHT	R59a.EDF	R59	1
38	14315585	14318059	1577	4051	2474	RIGHT	R59a.EDF	R59	1
38	14318377	14318410	4369	4402	33	RIGHT	R59a.EDF	R59	1
39	14332358	14332581	465	688	223	RIGHT	R59a.EDF	R59	1
44	14383607	14383704	196	293	97	RIGHT	R59a.EDF	R59	1
46	14402471	14402514	57	100	43	RIGHT	R59a.EDF	R59	1
48	14420650	14420822	746	918	172	RIGHT	R59a.EDF	R59	1
48	14421029	14421178	1125	1274	149	RIGHT	R59a.EDF	R59	1
48	14423773	14423799	3869	3895	26	RIGHT	R59a.EDF	R59	1
52	14459184	14459243	451	510	59	RIGHT	R59a.EDF	R59	1
61	14536525	14536694	616	785	169	RIGHT	R59a.EDF	R59	1
63	14552604	14552746	59	201	142	RIGHT	R59a.EDF	R59	1
65	14573784	14573899	456	571	115	RIGHT	R59a.EDF	R59	1
67	14594749	14594856	895	1002	107	RIGHT	R59a.EDF	R59	1
68	14602973	14603227	498	752	254	RIGHT	R59a.EDF	R59	1
75	14661407	14661631	152	376	224	RIGHT	R59a.EDF	R59	1
75	14661839	14661942	584	687	103	RIGHT	R59a.EDF	R59	1
75	14662080	14662240	825	985	160	RIGHT	R59a.EDF	R59	1
75	14662359	14662495	1104	1240	136	RIGHT	R59a.EDF	R59	1
75	14662725	14662793	1470	1538	68	RIGHT	R59a.EDF	R59	1
75	14663384	14663436	2129	2181	52	RIGHT	R59a.EDF	R59	1
75	14663750	14666618	2495	5363	2868	RIGHT	R59a.EDF	R59	1
76	14737047	14737194	837	984	147	RIGHT	R59a.EDF	R59	1
86	14824806	14824943	83	220	137	RIGHT	R59a.EDF	R59	1
86	14825328	14825408	605	685	80	RIGHT	R59a.EDF	R59	1
90	14863512	14863670	696	854	158	RIGHT	R59a.EDF	R59	1
92	14882499	14882573	582	656	74	RIGHT	R59a.EDF	R59	1
96	14917357	14917525	508	676	168	RIGHT	R59a.EDF	R59	1
96	14917761	14917877	912	1028	116	RIGHT	R59a.EDF	R59	1
97	14926962	14927096	513	647	134	RIGHT	R59a.EDF	R59	1
98	14934856	14934944	352	440	88	RIGHT	R59a.EDF	R59	1
101	14963047	14963068	58	79	21	RIGHT	R59a.EDF	R59	1
101	14963671	14963766	682	777	95	RIGHT	R59a.EDF	R59	1
105	15004842	15005587	428	1173	745	RIGHT	R59a.EDF	R59	1
105	15005612	15005613	1198	1199	1	RIGHT	R59a.EDF	R59	1
105	15007408	15007561	2994	3147	153	RIGHT	R59a.EDF	R59	1
105	15007987	15008155	3573	3741	168	RIGHT	R59a.EDF	R59	1
105	15009165	15009174	4751	4760	9	RIGHT	R59a.EDF	R59	1
105	15009207	15009213	4793	4799	6	RIGHT	R59a.EDF	R59	1
105	15009535	15009615	5121	5201	80	RIGHT	R59a.EDF	R59	1
119	15121233	15121315	273	355	82	RIGHT	R59a.EDF	R59	1
5	16643327	16643488	621	782	161	RIGHT	R59b.EDF	R59	2
15	16737769	16738502	58	791	733	RIGHT	R59b.EDF	R59	2
25	16824228	16824294	134	200	66	RIGHT	R59b.EDF	R59	2
25	16824642	16824837	548	743	195	RIGHT	R59b.EDF	R59	2
26	16835701	16835803	3686	3788	102	RIGHT	R59b.EDF	R59	2
28	16849850	16849941	489	580	91	RIGHT	R59b.EDF	R59	2
29	16858465	16858559	179	273	94	RIGHT	R59b.EDF	R59	2
29	16858761	16858899	475	613	138	RIGHT	R59b.EDF	R59	2
30	16865937	16866019	116	198	82	RIGHT	R59b.EDF	R59	2
30	16866269	16866465	448	644	196	RIGHT	R59b.EDF	R59	2
30	16871609	16871696	5788	5875	87	RIGHT	R59b.EDF	R59	2
33	16893035	16893136	238	339	101	RIGHT	R59b.EDF	R59	2
33	16893393	16893455	596	658	62	RIGHT	R59b.EDF	R59	2
33	16897907	16898017	5110	5220	110	RIGHT	R59b.EDF	R59	2
35	16910869	16911139	477	747	270	RIGHT	R59b.EDF	R59	2
37	16927037	16927215	530	708	178	RIGHT	R59b.EDF	R59	2
48	17024928	17025060	450	582	132	RIGHT	R59b.EDF	R59	2
49	17033391	17033495	56	160	104	RIGHT	R59b.EDF	R59	2
49	17033767	17033877	432	542	110	RIGHT	R59b.EDF	R59	2
51	17055340	17055343	4716	4719	3	RIGHT	R59b.EDF	R59	2
54	17079157	17079243	57	143	86	RIGHT	R59b.EDF	R59	2
54	17079862	17080003	762	903	141	RIGHT	R59b.EDF	R59	2
56	17095969	17096739	57	827	770	RIGHT	R59b.EDF	R59	2
57	17108055	17108195	526	666	140	RIGHT	R59b.EDF	R59	2
57	17109195	17109294	1666	1765	99	RIGHT	R59b.EDF	R59	2
59	17124844	17125022	740	918	178	RIGHT	R59b.EDF	R59	2
60	17133634	17133749	529	644	115	RIGHT	R59b.EDF	R59	2
61	17143438	17143592	1119	1273	154	RIGHT	R59b.EDF	R59	2
62	17152482	17152717	154	389	235	RIGHT	R59b.EDF	R59	2
62	17152821	17152916	493	588	95	RIGHT	R59b.EDF	R59	2
62	17152960	17153289	632	961	329	RIGHT	R59b.EDF	R59	2
63	17163024	17163153	491	620	129	RIGHT	R59b.EDF	R59	2
65	17181929	17182102	881	1054	173	RIGHT	R59b.EDF	R59	2
69	17222182	17222343	503	664	161	RIGHT	R59b.EDF	R59	2
70	17231646	17231779	496	629	133	RIGHT	R59b.EDF	R59	2
73	17257914	17257958	548	592	44	RIGHT	R59b.EDF	R59	2
74	17266853	17266985	515	647	132	RIGHT	R59b.EDF	R59	2
74	17268208	17268264	1870	1926	56	RIGHT	R59b.EDF	R59	2
77	17291492	17291574	499	581	82	RIGHT	R59b.EDF	R59	2
82	17339793	17339888	241	336	95	RIGHT	R59b.EDF	R59	2
82	17340135	17340244	583	692	109	RIGHT	R59b.EDF	R59	2
83	17348156	17348265	223	332	109	RIGHT	R59b.EDF	R59	2
83	17348451	17348610	518	677	159	RIGHT	R59b.EDF	R59	2
83	17348740	17348880	807	947	140	RIGHT	R59b.EDF	R59	2
84	17358371	17358462	156	247	91	RIGHT	R59b.EDF	R59	2
84	17358976	17359097	761	882	121	RIGHT	R59b.EDF	R59	2
86	17375194	17375288	410	504	94	RIGHT	R59b.EDF	R59	2
87	17384142	17384275	58	191	133	RIGHT	R59b.EDF	R59	2
87	17384494	17384743	410	659	249	RIGHT	R59b.EDF	R59	2
87	17385608	17385735	1524	1651	127	RIGHT	R59b.EDF	R59	2
88	17392354	17392490	476	612	136	RIGHT	R59b.EDF	R59	2
93	17441541	17441706	626	791	165	RIGHT	R59b.EDF	R59	2
95	17457981	17458065	214	298	84	RIGHT	R59b.EDF	R59	2
95	17458350	17458699	583	932	349	RIGHT	R59b.EDF	R59	2
95	17458722	17458722	955	955	0	RIGHT	R59b.EDF	R59	2
95	17458845	17464822	1078	7055	5977	RIGHT	R59b.EDF	R59	2
96	17576393	17576501	373	481	108	RIGHT	R59b.EDF	R59	2
97	17584847	17584904	500	557	57	RIGHT	R59b.EDF	R59	2
98	17594653	17594739	278	364	86	RIGHT	R59b.EDF	R59	2
98	17594859	17594980	484	605	121	RIGHT	R59b.EDF	R59	2
98	17595128	17595238	753	863	110	RIGHT	R59b.EDF	R59	2
109	17695657	17695765	645	753	108	RIGHT	R59b.EDF	R59	2
120	17786480	17786622	451	593	142	RIGHT	R59b.EDF	R59	2
120	17786811	17786902	782	873	91	RIGHT	R59b.EDF	R59	2
5	18942599	18942720	57	178	121	RIGHT	R59c.EDF	R59	3
5	18943030	18943124	488	582	94	RIGHT	R59c.EDF	R59	3
6	18951151	18951304	455	608	153	RIGHT	R59c.EDF	R59	3
8	18968727	18968935	409	617	208	RIGHT	R59c.EDF	R59	3
9	18979213	18979312	469	568	99	RIGHT	R59c.EDF	R59	3
11	18994933	18995075	247	389	142	RIGHT	R59c.EDF	R59	3
11	18995416	18995542	730	856	126	RIGHT	R59c.EDF	R59	3
12	19004190	19004324	464	598	134	RIGHT	R59c.EDF	R59	3
15	19029811	19029940	159	288	129	RIGHT	R59c.EDF	R59	3
15	19030128	19030256	476	604	128	RIGHT	R59c.EDF	R59	3
16	19040281	19040414	156	289	133	RIGHT	R59c.EDF	R59	3
16	19040600	19040732	475	607	132	RIGHT	R59c.EDF	R59	3
17	19047958	19048134	203	379	176	RIGHT	R59c.EDF	R59	3
17	19048337	19048447	582	692	110	RIGHT	R59c.EDF	R59	3
18	19056809	19056922	399	512	113	RIGHT	R59c.EDF	R59	3
18	19057120	19057235	710	825	115	RIGHT	R59c.EDF	R59	3
18	19057693	19057809	1283	1399	116	RIGHT	R59c.EDF	R59	3
25	19119159	19119300	368	509	141	RIGHT	R59c.EDF	R59	3
27	19136819	19136934	210	325	115	RIGHT	R59c.EDF	R59	3
27	19137096	19137225	487	616	129	RIGHT	R59c.EDF	R59	3
28	19147071	19147215	665	809	144	RIGHT	R59c.EDF	R59	3
29	19156457	19156538	317	398	81	RIGHT	R59c.EDF	R59	3
29	19156763	19156880	623	740	117	RIGHT	R59c.EDF	R59	3
35	19212899	19213035	3660	3796	136	RIGHT	R59c.EDF	R59	3
38	19237435	19237508	565	638	73	RIGHT	R59c.EDF	R59	3
38	19237529	19237529	659	659	0	RIGHT	R59c.EDF	R59	3
50	19345590	19345660	582	652	70	RIGHT	R59c.EDF	R59	3
51	19354207	19354297	155	245	90	RIGHT	R59c.EDF	R59	3
61	19443856	19444010	438	592	154	RIGHT	R59c.EDF	R59	3
61	19444171	19444247	753	829	76	RIGHT	R59c.EDF	R59	3
62	19452195	19452279	322	406	84	RIGHT	R59c.EDF	R59	3
63	19459746	19459831	258	343	85	RIGHT	R59c.EDF	R59	3
63	19460083	19460192	595	704	109	RIGHT	R59c.EDF	R59	3
63	19460342	19460526	854	1038	184	RIGHT	R59c.EDF	R59	3
70	19520053	19520167	185	299	114	RIGHT	R59c.EDF	R59	3
70	19520357	19520466	489	598	109	RIGHT	R59c.EDF	R59	3
71	19529299	19529401	288	390	102	RIGHT	R59c.EDF	R59	3
74	19554781	19554896	58	173	115	RIGHT	R59c.EDF	R59	3
74	19555116	19555241	393	518	125	RIGHT	R59c.EDF	R59	3
74	19559192	19559304	4469	4581	112	RIGHT	R59c.EDF	R59	3
75	19562375	19562493	204	322	118	RIGHT	R59c.EDF	R59	3
75	19562740	19562864	569	693	124	RIGHT	R59c.EDF	R59	3
79	19599169	19599259	444	534	90	RIGHT	R59c.EDF	R59	3
88	19683005	19683117	298	410	112	RIGHT	R59c.EDF	R59	3
88	19683186	19683287	479	580	101	RIGHT	R59c.EDF	R59	3
91	20408030	20408234	1734	1938	204	RIGHT	R59c.EDF	R59	3
91	20408259	20408265	1963	1969	6	RIGHT	R59c.EDF	R59	3
91	20421097	20421237	14801	14941	140	RIGHT	R59c.EDF	R59	3
91	20421654	20421779	15358	15483	125	RIGHT	R59c.EDF	R59	3
91	20424862	20425463	18566	19167	601	RIGHT	R59c.EDF	R59	3
91	20430431	20430954	24135	24658	523	RIGHT	R59c.EDF	R59	3
91	20431007	20431039	24711	24743	32	RIGHT	R59c.EDF	R59	3
91	20432301	20432423	26005	26127	122	RIGHT	R59c.EDF	R59	3
91	20432445	20432450	26149	26154	5	RIGHT	R59c.EDF	R59	3
91	20434505	20434704	28209	28408	199	RIGHT	R59c.EDF	R59	3
91	20438463	20438632	32167	32336	169	RIGHT	R59c.EDF	R59	3
91	20443530	20443732	37234	37436	202	RIGHT	R59c.EDF	R59	3
91	20444131	20444293	37835	37997	162	RIGHT	R59c.EDF	R59	3
91	20445777	20445959	39481	39663	182	RIGHT	R59c.EDF	R59	3
91	20446123	20446333	39827	40037	210	RIGHT	R59c.EDF	R59	3
91	20450370	20450479	44074	44183	109	RIGHT	R59c.EDF	R59	3
91	20452265	20452432	45969	46136	167	RIGHT	R59c.EDF	R59	3
91	20459506	20459749	53210	53453	243	RIGHT	R59c.EDF	R59	3
91	20460724	20460839	54428	54543	115	RIGHT	R59c.EDF	R59	3
91	20462391	20462433	56095	56137	42	RIGHT	R59c.EDF	R59	3
91	20462723	20462836	56427	56540	113	RIGHT	R59c.EDF	R59	3
91	20463668	20463718	57372	57422	50	RIGHT	R59c.EDF	R59	3
91	20467429	20467624	61133	61328	195	RIGHT	R59c.EDF	R59	3
91	20467680	20467691	61384	61395	11	RIGHT	R59c.EDF	R59	3
91	20473224	20495587	66928	89291	22363	RIGHT	R59c.EDF	R59	3
91	20496421	20496734	90125	90438	313	RIGHT	R59c.EDF	R59	3
91	20501175	20501303	94879	95007	128	RIGHT	R59c.EDF	R59	3
91	20513477	20513615	107181	107319	138	RIGHT	R59c.EDF	R59	3
91	20516807	20517004	110511	110708	197	RIGHT	R59c.EDF	R59	3
91	20521465	20521636	115169	115340	171	RIGHT	R59c.EDF	R59	3
91	20521909	20521999	115613	115703	90	RIGHT	R59c.EDF	R59	3
91	20525116	20525171	118820	118875	55	RIGHT	R59c.EDF	R59	3
91	20525542	20525661	119246	119365	119	RIGHT	R59c.EDF	R59	3
91	20525954	20526198	119658	119902	244	RIGHT	R59c.EDF	R59	3
91	20531022	20531165	124726	124869	143	RIGHT	R59c.EDF	R59	3
91	20544989	20545188	138693	138892	199	RIGHT	R59c.EDF	R59	3
91	20549411	20549560	143115	143264	149	RIGHT	R59c.EDF	R59	3
91	20563493	20563672	157197	157376	179	RIGHT	R59c.EDF	R59	3
91	20565939	20566087	159643	159791	148	RIGHT	R59c.EDF	R59	3
91	20578913	20579092	172617	172796	179	RIGHT	R59c.EDF	R59	3
91	20580283	20580434	173987	174138	151	RIGHT	R59c.EDF	R59	3
91	20623195	20623395	216899	217099	200	RIGHT	R59c.EDF	R59	3
91	20635594	20636022	229298	229726	428	RIGHT	R59c.EDF	R59	3
91	20660605	20660918	254309	254622	313	RIGHT	R59c.EDF	R59	3
91	20660948	20661748	254652	255452	800	RIGHT	R59c.EDF	R59	3
91	20662774	20662875	256478	256579	101	RIGHT	R59c.EDF	R59	3
91	20663365	20768345	257069	362049	104980	RIGHT	R59c.EDF	R59	3
91	20769301	20769458	363005	363162	157	RIGHT	R59c.EDF	R59	3
91	20769602	20769703	363306	363407	101	RIGHT	R59c.EDF	R59	3
91	20769904	20770028	363608	363732	124	RIGHT	R59c.EDF	R59	3
91	20770843	20771013	364547	364717	170	RIGHT	R59c.EDF	R59	3
91	20772585	20772730	366289	366434	145	RIGHT	R59c.EDF	R59	3
91	20787289	20787452	380993	381156	163	RIGHT	R59c.EDF	R59	3
91	20789696	20789845	383400	383549	149	RIGHT	R59c.EDF	R59	3
91	20789869	20789873	383573	383577	4	RIGHT	R59c.EDF	R59	3
91	20791349	20791561	385053	385265	212	RIGHT	R59c.EDF	R59	3
91	20794475	20794568	388179	388272	93	RIGHT	R59c.EDF	R59	3
91	20798502	20798581	392206	392285	79	RIGHT	R59c.EDF	R59	3
91	20807918	20808524	401622	402228	606	RIGHT	R59c.EDF	R59	3
91	20808615	20808726	402319	402430	111	RIGHT	R59c.EDF	R59	3
91	20808876	20809013	402580	402717	137	RIGHT	R59c.EDF	R59	3
91	20813988	20814454	407692	408158	466	RIGHT	R59c.EDF	R59	3
91	20816484	20816893	410188	410597	409	RIGHT	R59c.EDF	R59	3
91	20818306	20818468	412010	412172	162	RIGHT	R59c.EDF	R59	3
91	20819734	20819816	413438	413520	82	RIGHT	R59c.EDF	R59	3
91	20822011	20822147	415715	415851	136	RIGHT	R59c.EDF	R59	3
91	20822535	20822654	416239	416358	119	RIGHT	R59c.EDF	R59	3
91	20823040	20823172	416744	416876	132	RIGHT	R59c.EDF	R59	3
91	20827784	20827960	421488	421664	176	RIGHT	R59c.EDF	R59	3
91	20830167	20831789	423871	425493	1622	RIGHT	R59c.EDF	R59	3
91	20840463	20842183	434167	435887	1720	RIGHT	R59c.EDF	R59	3
91	20842771	20843237	436475	436941	466	RIGHT	R59c.EDF	R59	3
91	20843525	20843915	437229	437619	390	RIGHT	R59c.EDF	R59	3
91	20844370	20845103	438074	438807	733	RIGHT	R59c.EDF	R59	3
91	20845224	20845749	438928	439453	525	RIGHT	R59c.EDF	R59	3
91	20845771	20845775	439475	439479	4	RIGHT	R59c.EDF	R59	3
91	20854184	20854312	447888	448016	128	RIGHT	R59c.EDF	R59	3
91	20856446	20856696	450150	450400	250	RIGHT	R59c.EDF	R59	3
91	20858279	20858391	451983	452095	112	RIGHT	R59c.EDF	R59	3
91	20861933	20862417	455637	456121	484	RIGHT	R59c.EDF	R59	3
91	20862501	20862643	456205	456347	142	RIGHT	R59c.EDF	R59	3
91	20864943	20865074	458647	458778	131	RIGHT	R59c.EDF	R59	3
91	20866899	20867403	460603	461107	504	RIGHT	R59c.EDF	R59	3
91	20872069	20872477	465773	466181	408	RIGHT	R59c.EDF	R59	3
91	20879684	20879818	473388	473522	134	RIGHT	R59c.EDF	R59	3
91	20880135	20880423	473839	474127	288	RIGHT	R59c.EDF	R59	3
91	20881312	20882424	475016	476128	1112	RIGHT	R59c.EDF	R59	3
91	20882947	20883083	476651	476787	136	RIGHT	R59c.EDF	R59	3
91	20883796	20884072	477500	477776	276	RIGHT	R59c.EDF	R59	3
91	20885832	20886159	479536	479863	327	RIGHT	R59c.EDF	R59	3
91	20886447	20887482	480151	481186	1035	RIGHT	R59c.EDF	R59	3
91	20888309	20888448	482013	482152	139	RIGHT	R59c.EDF	R59	3
91	20889195	20889319	482899	483023	124	RIGHT	R59c.EDF	R59	3
91	20890262	20890440	483966	484144	178	RIGHT	R59c.EDF	R59	3
91	20891926	20891995	485630	485699	69	RIGHT	R59c.EDF	R59	3
91	20893704	20893978	487408	487682	274	RIGHT	R59c.EDF	R59	3
91	20896217	20896376	489921	490080	159	RIGHT	R59c.EDF	R59	3
91	20897634	20897795	491338	491499	161	RIGHT	R59c.EDF	R59	3
91	20901356	20901590	495060	495294	234	RIGHT	R59c.EDF	R59	3
91	20901842	20901971	495546	495675	129	RIGHT	R59c.EDF	R59	3
91	20909396	20909570	503100	503274	174	RIGHT	R59c.EDF	R59	3
91	20909923	20910074	503627	503778	151	RIGHT	R59c.EDF	R59	3
91	20914657	20915123	508361	508827	466	RIGHT	R59c.EDF	R59	3
91	20916915	20917005	510619	510709	90	RIGHT	R59c.EDF	R59	3
91	20922650	20922798	516354	516502	148	RIGHT	R59c.EDF	R59	3
91	20923045	20923097	516749	516801	52	RIGHT	R59c.EDF	R59	3
91	20927147	20927422	520851	521126	275	RIGHT	R59c.EDF	R59	3
91	20928446	20928779	522150	522483	333	RIGHT	R59c.EDF	R59	3
91	20930759	20930868	524463	524572	109	RIGHT	R59c.EDF	R59	3
91	20934222	20934307	527926	528011	85	RIGHT	R59c.EDF	R59	3
91	20934372	20934833	528076	528537	461	RIGHT	R59c.EDF	R59	3
91	20934915	20934924	528619	528628	9	RIGHT	R59c.EDF	R59	3
91	20935063	20935952	528767	529656	889	RIGHT	R59c.EDF	R59	3
91	20936058	20936062	529762	529766	4	RIGHT	R59c.EDF	R59	3
91	20936093	20936095	529797	529799	2	RIGHT	R59c.EDF	R59	3
91	20936482	20936530	530186	530234	48	RIGHT	R59c.EDF	R59	3
91	20936551	20936559	530255	530263	8	RIGHT	R59c.EDF	R59	3
91	20936586	20936587	530290	530291	1	RIGHT	R59c.EDF	R59	3
91	20936749	20937374	530453	531078	625	RIGHT	R59c.EDF	R59	3
91	20937439	20937449	531143	531153	10	RIGHT	R59c.EDF	R59	3
91	20940731	20940943	534435	534647	212	RIGHT	R59c.EDF	R59	3
91	20941426	20942462	535130	536166	1036	RIGHT	R59c.EDF	R59	3
91	20949342	20949533	543046	543237	191	RIGHT	R59c.EDF	R59	3
91	20952536	20952679	546240	546383	143	RIGHT	R59c.EDF	R59	3
91	20957082	20957259	550786	550963	177	RIGHT	R59c.EDF	R59	3
91	20960300	20960435	554004	554139	135	RIGHT	R59c.EDF	R59	3
91	20966141	20966287	559845	559991	146	RIGHT	R59c.EDF	R59	3
91	20968323	20968522	562027	562226	199	RIGHT	R59c.EDF	R59	3
91	20971220	20971358	564924	565062	138	RIGHT	R59c.EDF	R59	3
91	20978035	20978084	571739	571788	49	RIGHT	R59c.EDF	R59	3
91	20985048	20985225	578752	578929	177	RIGHT	R59c.EDF	R59	3
91	21000254	21000482	593958	594186	228	RIGHT	R59c.EDF	R59	3
91	21006696	21006864	600400	600568	168	RIGHT	R59c.EDF	R59	3
91	21012799	21012948	606503	606652	149	RIGHT	R59c.EDF	R59	3
91	21016033	21016204	609737	609908	171	RIGHT	R59c.EDF	R59	3
91	21026613	21026764	620317	620468	151	RIGHT	R59c.EDF	R59	3
91	21032035	21032244	625739	625948	209	RIGHT	R59c.EDF	R59	3
91	21039659	21039833	633363	633537	174	RIGHT	R59c.EDF	R59	3
91	21044553	21044706	638257	638410	153	RIGHT	R59c.EDF	R59	3
91	21052664	21052839	646368	646543	175	RIGHT	R59c.EDF	R59	3
91	21061420	21061597	655124	655301	177	RIGHT	R59c.EDF	R59	3
91	21063911	21064110	657615	657814	199	RIGHT	R59c.EDF	R59	3
91	21065821	21066249	659525	659953	428	RIGHT	R59c.EDF	R59	3
91	21068912	21069040	662616	662744	128	RIGHT	R59c.EDF	R59	3
91	21081095	21081250	674799	674954	155	RIGHT	R59c.EDF	R59	3
91	21087216	21087757	680920	681461	541	RIGHT	R59c.EDF	R59	3
91	21089104	21089986	682808	683690	882	RIGHT	R59c.EDF	R59	3
91	21090038	21122819	683742	716523	32781	RIGHT	R59c.EDF	R59	3
2	9591287	9591350	425	488	63	LEFT	R62a.EDF	R62	1
3	9600829	9600934	739	844	105	LEFT	R62a.EDF	R62	1
4	9609178	9609279	210	311	101	LEFT	R62a.EDF	R62	1
4	9611284	9611329	2316	2361	45	LEFT	R62a.EDF	R62	1
4	9613619	9613692	4651	4724	73	LEFT	R62a.EDF	R62	1
5	9618335	9618410	692	767	75	LEFT	R62a.EDF	R62	1
5	9618431	9618449	788	806	18	LEFT	R62a.EDF	R62	1
6	9632755	9632789	4426	4460	34	LEFT	R62a.EDF	R62	1
6	9632817	9632834	4488	4505	17	LEFT	R62a.EDF	R62	1
7	9637688	9637727	245	284	39	LEFT	R62a.EDF	R62	1
7	9637760	9637782	317	339	22	LEFT	R62a.EDF	R62	1
7	9639285	9639387	1842	1944	102	LEFT	R62a.EDF	R62	1
7	9643911	9644008	6468	6565	97	LEFT	R62a.EDF	R62	1
7	9644032	9644033	6589	6590	1	LEFT	R62a.EDF	R62	1
8	9647704	9647797	149	242	93	LEFT	R62a.EDF	R62	1
9	9656248	9656354	534	640	106	LEFT	R62a.EDF	R62	1
10	9664530	9664609	307	386	79	LEFT	R62a.EDF	R62	1
10	9667606	9667672	3383	3449	66	LEFT	R62a.EDF	R62	1
10	9667701	9667724	3478	3501	23	LEFT	R62a.EDF	R62	1
11	9675145	9675255	1187	1297	110	LEFT	R62a.EDF	R62	1
13	9690872	9690974	988	1090	102	LEFT	R62a.EDF	R62	1
13	9693578	9693690	3694	3806	112	LEFT	R62a.EDF	R62	1
14	9700452	9700571	201	320	119	LEFT	R62a.EDF	R62	1
14	9701718	9701849	1467	1598	131	LEFT	R62a.EDF	R62	1
15	9707272	9707353	72	153	81	LEFT	R62a.EDF	R62	1
15	9707375	9707394	175	194	19	LEFT	R62a.EDF	R62	1
16	9716213	9716307	676	770	94	LEFT	R62a.EDF	R62	1
17	9723929	9724025	548	644	96	LEFT	R62a.EDF	R62	1
17	9726677	9726688	3296	3307	11	LEFT	R62a.EDF	R62	1
17	9726710	9726728	3329	3347	18	LEFT	R62a.EDF	R62	1
18	9732918	9733019	559	660	101	LEFT	R62a.EDF	R62	1
18	9736032	9736186	3673	3827	154	LEFT	R62a.EDF	R62	1
18	9736221	9736265	3862	3906	44	LEFT	R62a.EDF	R62	1
19	9741907	9742004	80	177	97	LEFT	R62a.EDF	R62	1
19	9743054	9743172	1227	1345	118	LEFT	R62a.EDF	R62	1
22	9769395	9769505	236	346	110	LEFT	R62a.EDF	R62	1
22	9770790	9770939	1631	1780	149	LEFT	R62a.EDF	R62	1
23	9781182	9781231	71	120	49	LEFT	R62a.EDF	R62	1
23	9781254	9781279	143	168	25	LEFT	R62a.EDF	R62	1
23	9787272	9787364	6161	6253	92	LEFT	R62a.EDF	R62	1
24	9793652	9793747	1636	1731	95	LEFT	R62a.EDF	R62	1
26	9814797	9814881	3849	3933	84	LEFT	R62a.EDF	R62	1
27	9820778	9820918	844	984	140	LEFT	R62a.EDF	R62	1
29	9839997	9840125	724	852	128	LEFT	R62a.EDF	R62	1
29	9843566	9843657	4293	4384	91	LEFT	R62a.EDF	R62	1
30	9848180	9848272	564	656	92	LEFT	R62a.EDF	R62	1
33	9875916	9876015	178	277	99	LEFT	R62a.EDF	R62	1
33	9877584	9877591	1846	1853	7	LEFT	R62a.EDF	R62	1
33	9877612	9877642	1874	1904	30	LEFT	R62a.EDF	R62	1
33	9881886	9881984	6148	6246	98	LEFT	R62a.EDF	R62	1
34	9887089	9887154	58	123	65	LEFT	R62a.EDF	R62	1
34	9888213	9888216	1182	1185	3	LEFT	R62a.EDF	R62	1
34	9888237	9888308	1206	1277	71	LEFT	R62a.EDF	R62	1
35	9895340	9895458	525	643	118	LEFT	R62a.EDF	R62	1
37	9918709	9918822	5376	5489	113	LEFT	R62a.EDF	R62	1
41	9950041	9950144	1003	1106	103	LEFT	R62a.EDF	R62	1
41	9953642	9953757	4604	4719	115	LEFT	R62a.EDF	R62	1
43	9970044	9970147	1147	1250	103	LEFT	R62a.EDF	R62	1
44	9978564	9978735	561	732	171	LEFT	R62a.EDF	R62	1
45	9986897	9987024	756	883	127	LEFT	R62a.EDF	R62	1
46	9996330	9996441	162	273	111	LEFT	R62a.EDF	R62	1
49	10022219	10022283	116	180	64	LEFT	R62a.EDF	R62	1
49	10022692	10022819	589	716	127	LEFT	R62a.EDF	R62	1
50	10033728	10033896	571	739	168	LEFT	R62a.EDF	R62	1
51	10041334	10041423	101	190	89	LEFT	R62a.EDF	R62	1
52	10050990	10051125	233	368	135	LEFT	R62a.EDF	R62	1
53	10064798	10064874	4055	4131	76	LEFT	R62a.EDF	R62	1
54	10073909	10073974	58	123	65	LEFT	R62a.EDF	R62	1
54	10080518	10080588	6667	6737	70	LEFT	R62a.EDF	R62	1
55	10087563	10087656	4731	4824	93	LEFT	R62a.EDF	R62	1
60	10127243	10127339	92	188	96	LEFT	R62a.EDF	R62	1
60	10128119	10128207	968	1056	88	LEFT	R62a.EDF	R62	1
60	10133422	10133513	6271	6362	91	LEFT	R62a.EDF	R62	1
61	10136233	10136362	205	334	129	LEFT	R62a.EDF	R62	1
61	10141727	10141845	5699	5817	118	LEFT	R62a.EDF	R62	1
62	10148109	10148183	572	646	74	LEFT	R62a.EDF	R62	1
63	10157163	10157301	693	831	138	LEFT	R62a.EDF	R62	1
64	10165270	10165340	58	128	70	LEFT	R62a.EDF	R62	1
64	10166515	10166606	1303	1394	91	LEFT	R62a.EDF	R62	1
66	10185877	10185981	1247	1351	104	LEFT	R62a.EDF	R62	1
67	10192225	10192295	71	141	70	LEFT	R62a.EDF	R62	1
67	10198415	10198518	6261	6364	103	LEFT	R62a.EDF	R62	1
68	10201538	10201760	138	360	222	LEFT	R62a.EDF	R62	1
68	10206139	10206253	4739	4853	114	LEFT	R62a.EDF	R62	1
68	10206339	10206339	4939	4939	0	LEFT	R62a.EDF	R62	1
70	10221804	10221824	58	78	20	LEFT	R62a.EDF	R62	1
70	10225854	10225962	4108	4216	108	LEFT	R62a.EDF	R62	1
71	10229618	10229745	130	257	127	LEFT	R62a.EDF	R62	1
71	10231482	10231590	1994	2102	108	LEFT	R62a.EDF	R62	1
71	10231626	10231626	2138	2138	0	LEFT	R62a.EDF	R62	1
72	10238844	10238939	57	152	95	LEFT	R62a.EDF	R62	1
72	10240333	10240437	1546	1650	104	LEFT	R62a.EDF	R62	1
73	10248387	10248511	508	632	124	LEFT	R62a.EDF	R62	1
73	10253582	10253679	5703	5800	97	LEFT	R62a.EDF	R62	1
74	10257205	10257287	70	152	82	LEFT	R62a.EDF	R62	1
75	10265406	10265521	527	642	115	LEFT	R62a.EDF	R62	1
76	10274065	10274185	596	716	120	LEFT	R62a.EDF	R62	1
76	10275877	10275906	2408	2437	29	LEFT	R62a.EDF	R62	1
76	10275934	10275976	2465	2507	42	LEFT	R62a.EDF	R62	1
76	10276007	10276008	2538	2539	1	LEFT	R62a.EDF	R62	1
76	10278405	10278502	4936	5033	97	LEFT	R62a.EDF	R62	1
77	10285695	10285799	2506	2610	104	LEFT	R62a.EDF	R62	1
77	10285839	10285839	2650	2650	0	LEFT	R62a.EDF	R62	1
79	10300059	10300160	58	159	101	LEFT	R62a.EDF	R62	1
83	10335149	10335261	1023	1135	112	LEFT	R62a.EDF	R62	1
83	10335915	10335998	1789	1872	83	LEFT	R62a.EDF	R62	1
84	10343295	10343410	1215	1330	115	LEFT	R62a.EDF	R62	1
84	10349125	10349173	7045	7093	48	LEFT	R62a.EDF	R62	1
85	10352512	10352615	1192	1295	103	LEFT	R62a.EDF	R62	1
86	10358313	10358368	57	112	55	LEFT	R62a.EDF	R62	1
86	10359687	10359784	1431	1528	97	LEFT	R62a.EDF	R62	1
87	10366913	10367019	311	417	106	LEFT	R62a.EDF	R62	1
87	10368250	10368346	1648	1744	96	LEFT	R62a.EDF	R62	1
88	10377298	10377421	1057	1180	123	LEFT	R62a.EDF	R62	1
89	10386682	10386809	2504	2631	127	LEFT	R62a.EDF	R62	1
89	10386846	10386849	2668	2671	3	LEFT	R62a.EDF	R62	1
90	10394794	10394919	2127	2252	125	LEFT	R62a.EDF	R62	1
90	10394962	10394964	2295	2297	2	LEFT	R62a.EDF	R62	1
91	10400398	10400517	536	655	119	LEFT	R62a.EDF	R62	1
91	10402241	10402344	2379	2482	103	LEFT	R62a.EDF	R62	1
91	10402368	10402373	2506	2511	5	LEFT	R62a.EDF	R62	1
92	10411890	10411949	4040	4099	59	LEFT	R62a.EDF	R62	1
92	10414590	10414696	6740	6846	106	LEFT	R62a.EDF	R62	1
93	10418955	10419106	57	208	151	LEFT	R62a.EDF	R62	1
93	10421167	10421258	2269	2360	91	LEFT	R62a.EDF	R62	1
93	10423916	10424075	5018	5177	159	LEFT	R62a.EDF	R62	1
94	10429297	10429412	1570	1685	115	LEFT	R62a.EDF	R62	1
94	10429976	10430079	2249	2352	103	LEFT	R62a.EDF	R62	1
94	10431340	10431445	3613	3718	105	LEFT	R62a.EDF	R62	1
95	10439742	10439864	2885	3007	122	LEFT	R62a.EDF	R62	1
96	10446407	10446529	133	255	122	LEFT	R62a.EDF	R62	1
96	10448186	10448278	1912	2004	92	LEFT	R62a.EDF	R62	1
97	10455444	10455566	195	317	122	LEFT	R62a.EDF	R62	1
97	10457340	10457434	2091	2185	94	LEFT	R62a.EDF	R62	1
97	10461604	10461713	6355	6464	109	LEFT	R62a.EDF	R62	1
98	10466877	10466990	2200	2313	113	LEFT	R62a.EDF	R62	1
98	10467488	10467581	2811	2904	93	LEFT	R62a.EDF	R62	1
99	10475954	10476061	2581	2688	107	LEFT	R62a.EDF	R62	1
99	10476093	10476095	2720	2722	2	LEFT	R62a.EDF	R62	1
101	10492658	10492753	2205	2300	95	LEFT	R62a.EDF	R62	1
101	10495232	10495347	4779	4894	115	LEFT	R62a.EDF	R62	1
102	10501053	10501153	1940	2040	100	LEFT	R62a.EDF	R62	1
102	10504116	10504211	5003	5098	95	LEFT	R62a.EDF	R62	1
103	10509769	10509806	1560	1597	37	LEFT	R62a.EDF	R62	1
103	10510317	10510413	2108	2204	96	LEFT	R62a.EDF	R62	1
104	10521747	10521865	4484	4602	118	LEFT	R62a.EDF	R62	1
105	10529146	10529253	3345	3452	107	LEFT	R62a.EDF	R62	1
107	10543283	10543358	57	132	75	LEFT	R62a.EDF	R62	1
108	10551818	10551943	582	707	125	LEFT	R62a.EDF	R62	1
109	10559439	10559561	579	701	122	LEFT	R62a.EDF	R62	1
110	10568987	10569109	701	823	122	LEFT	R62a.EDF	R62	1
110	10573747	10573855	5461	5569	108	LEFT	R62a.EDF	R62	1
111	10577759	10577841	57	139	82	LEFT	R62a.EDF	R62	1
111	10580006	10580118	2304	2416	112	LEFT	R62a.EDF	R62	1
111	10583232	10583336	5530	5634	104	LEFT	R62a.EDF	R62	1
112	10590123	10590233	2752	2862	110	LEFT	R62a.EDF	R62	1
113	10599136	10599253	2113	2230	117	LEFT	R62a.EDF	R62	1
113	10601307	10601407	4284	4384	100	LEFT	R62a.EDF	R62	1
114	10606964	10607025	1747	1808	61	LEFT	R62a.EDF	R62	1
115	10613737	10613842	533	638	105	LEFT	R62a.EDF	R62	1
115	10614709	10614796	1505	1592	87	LEFT	R62a.EDF	R62	1
115	10615576	10615687	2372	2483	111	LEFT	R62a.EDF	R62	1
115	10615722	10615722	2518	2518	0	LEFT	R62a.EDF	R62	1
116	10625407	10625477	4025	4095	70	LEFT	R62a.EDF	R62	1
118	10637747	10637857	849	959	110	LEFT	R62a.EDF	R62	1
118	10640364	10640457	3466	3559	93	LEFT	R62a.EDF	R62	1
119	10651763	10651869	5845	5951	106	LEFT	R62a.EDF	R62	1
120	10661326	10661429	6873	6976	103	LEFT	R62a.EDF	R62	1
1	11427945	11427984	58	97	39	LEFT	R62b.EDF	R62	2
1	11429132	11429144	1245	1257	12	LEFT	R62b.EDF	R62	2
1	11429165	11429193	1278	1306	28	LEFT	R62b.EDF	R62	2
1	11429216	11429239	1329	1352	23	LEFT	R62b.EDF	R62	2
1	11429964	11430061	2077	2174	97	LEFT	R62b.EDF	R62	2
2	11437500	11437545	57	102	45	LEFT	R62b.EDF	R62	2
2	11437571	11437634	128	191	63	LEFT	R62b.EDF	R62	2
2	11438109	11438180	666	737	71	LEFT	R62b.EDF	R62	2
2	11441474	11441567	4031	4124	93	LEFT	R62b.EDF	R62	2
3	11445543	11445635	287	379	92	LEFT	R62b.EDF	R62	2
4	11455656	11455733	1217	1294	77	LEFT	R62b.EDF	R62	2
4	11456984	11457070	2545	2631	86	LEFT	R62b.EDF	R62	2
5	11463230	11463272	58	100	42	LEFT	R62b.EDF	R62	2
5	11465702	11465786	2530	2614	84	LEFT	R62b.EDF	R62	2
6	11470703	11470807	96	200	104	LEFT	R62b.EDF	R62	2
6	11472645	11472741	2038	2134	96	LEFT	R62b.EDF	R62	2
7	11480350	11480447	2359	2456	97	LEFT	R62b.EDF	R62	2
7	11484178	11484279	6187	6288	101	LEFT	R62b.EDF	R62	2
8	11488248	11488343	1214	1309	95	LEFT	R62b.EDF	R62	2
8	11489080	11489173	2046	2139	93	LEFT	R62b.EDF	R62	2
8	11491524	11491604	4490	4570	80	LEFT	R62b.EDF	R62	2
9	11497473	11497573	2135	2235	100	LEFT	R62b.EDF	R62	2
9	11502007	11502072	6669	6734	65	LEFT	R62b.EDF	R62	2
10	11505955	11506064	1340	1449	109	LEFT	R62b.EDF	R62	2
10	11506667	11506772	2052	2157	105	LEFT	R62b.EDF	R62	2
10	11507131	11507216	2516	2601	85	LEFT	R62b.EDF	R62	2
11	11515438	11515534	1836	1932	96	LEFT	R62b.EDF	R62	2
11	11515721	11515806	2119	2204	85	LEFT	R62b.EDF	R62	2
12	11522333	11522453	79	199	120	LEFT	R62b.EDF	R62	2
12	11524216	11524329	1962	2075	113	LEFT	R62b.EDF	R62	2
13	11531921	11532032	541	652	111	LEFT	R62b.EDF	R62	2
13	11532958	11533067	1578	1687	109	LEFT	R62b.EDF	R62	2
13	11533614	11533714	2234	2334	100	LEFT	R62b.EDF	R62	2
14	11542775	11542884	2329	2438	109	LEFT	R62b.EDF	R62	2
14	11546562	11546638	6116	6192	76	LEFT	R62b.EDF	R62	2
15	11550206	11550231	65	90	25	LEFT	R62b.EDF	R62	2
16	11559200	11559355	1570	1725	155	LEFT	R62b.EDF	R62	2
16	11560435	11560562	2805	2932	127	LEFT	R62b.EDF	R62	2
16	11563244	11563302	5614	5672	58	LEFT	R62b.EDF	R62	2
17	11568326	11568423	2545	2642	97	LEFT	R62b.EDF	R62	2
18	11575590	11575759	58	227	169	LEFT	R62b.EDF	R62	2
18	11578248	11578338	2716	2806	90	LEFT	R62b.EDF	R62	2
18	11581203	11581294	5671	5762	91	LEFT	R62b.EDF	R62	2
19	11587005	11587112	1969	2076	107	LEFT	R62b.EDF	R62	2
20	11594112	11594224	819	931	112	LEFT	R62b.EDF	R62	2
20	11595231	11595353	1938	2060	122	LEFT	R62b.EDF	R62	2
20	11596691	11596801	3398	3508	110	LEFT	R62b.EDF	R62	2
21	11604716	11604813	2293	2390	97	LEFT	R62b.EDF	R62	2
21	11607325	11607424	4902	5001	99	LEFT	R62b.EDF	R62	2
22	11612330	11612370	57	97	40	LEFT	R62b.EDF	R62	2
22	11614331	11614449	2058	2176	118	LEFT	R62b.EDF	R62	2
23	11621930	11622054	855	979	124	LEFT	R62b.EDF	R62	2
23	11623465	11623569	2390	2494	104	LEFT	R62b.EDF	R62	2
24	11630417	11630542	637	762	125	LEFT	R62b.EDF	R62	2
25	11638068	11638170	684	786	102	LEFT	R62b.EDF	R62	2
25	11642753	11642861	5369	5477	108	LEFT	R62b.EDF	R62	2
27	11654649	11654735	1774	1860	86	LEFT	R62b.EDF	R62	2
27	11657334	11657415	4459	4540	81	LEFT	R62b.EDF	R62	2
28	11663838	11663966	2075	2203	128	LEFT	R62b.EDF	R62	2
28	11665471	11665554	3708	3791	83	LEFT	R62b.EDF	R62	2
29	11671083	11671166	2085	2168	83	LEFT	R62b.EDF	R62	2
30	11678572	11678680	616	724	108	LEFT	R62b.EDF	R62	2
30	11678837	11679011	881	1055	174	LEFT	R62b.EDF	R62	2
30	11681760	11681859	3804	3903	99	LEFT	R62b.EDF	R62	2
30	11683983	11684106	6027	6150	123	LEFT	R62b.EDF	R62	2
31	11692238	11692328	5094	5184	90	LEFT	R62b.EDF	R62	2
32	11698998	11699110	2283	2395	112	LEFT	R62b.EDF	R62	2
33	11704252	11704383	57	188	131	LEFT	R62b.EDF	R62	2
33	11706396	11706515	2201	2320	119	LEFT	R62b.EDF	R62	2
34	11713950	11714077	2440	2567	127	LEFT	R62b.EDF	R62	2
35	11720338	11720481	77	220	143	LEFT	R62b.EDF	R62	2
35	11722212	11722327	1951	2066	115	LEFT	R62b.EDF	R62	2
35	11724220	11724324	3959	4063	104	LEFT	R62b.EDF	R62	2
36	11729835	11729954	2144	2263	119	LEFT	R62b.EDF	R62	2
37	11736624	11736683	1502	1561	59	LEFT	R62b.EDF	R62	2
37	11737135	11737242	2013	2120	107	LEFT	R62b.EDF	R62	2
37	11738633	11738745	3511	3623	112	LEFT	R62b.EDF	R62	2
39	11752784	11752825	58	99	41	LEFT	R62b.EDF	R62	2
39	11755006	11755107	2280	2381	101	LEFT	R62b.EDF	R62	2
40	11761900	11762003	1404	1507	103	LEFT	R62b.EDF	R62	2
40	11762891	11763005	2395	2509	114	LEFT	R62b.EDF	R62	2
41	11774198	11774298	5712	5812	100	LEFT	R62b.EDF	R62	2
42	11778055	11778142	1083	1170	87	LEFT	R62b.EDF	R62	2
43	11783703	11783765	58	120	62	LEFT	R62b.EDF	R62	2
43	11785772	11785897	2127	2252	125	LEFT	R62b.EDF	R62	2
44	11793356	11793454	1957	2055	98	LEFT	R62b.EDF	R62	2
46	11810590	11810744	1088	1242	154	LEFT	R62b.EDF	R62	2
48	11828575	11828673	1282	1380	98	LEFT	R62b.EDF	R62	2
49	11837907	11837999	739	831	92	LEFT	R62b.EDF	R62	2
50	11845146	11845208	58	120	62	LEFT	R62b.EDF	R62	2
50	11847188	11847292	2100	2204	104	LEFT	R62b.EDF	R62	2
51	11859289	11859404	5680	5795	115	LEFT	R62b.EDF	R62	2
53	11874402	11874514	1252	1364	112	LEFT	R62b.EDF	R62	2
54	11883784	11883879	1839	1934	95	LEFT	R62b.EDF	R62	2
54	11886465	11886572	4520	4627	107	LEFT	R62b.EDF	R62	2
55	11890777	11890909	687	819	132	LEFT	R62b.EDF	R62	2
55	11892421	11892520	2331	2430	99	LEFT	R62b.EDF	R62	2
55	11894371	11894495	4281	4405	124	LEFT	R62b.EDF	R62	2
56	11903567	11903787	58	278	220	LEFT	R62b.EDF	R62	2
56	11905169	11905273	1660	1764	104	LEFT	R62b.EDF	R62	2
56	11905737	11905848	2228	2339	111	LEFT	R62b.EDF	R62	2
57	11912490	11912527	59	96	37	LEFT	R62b.EDF	R62	2
57	11914810	11914888	2379	2457	78	LEFT	R62b.EDF	R62	2
57	11919779	11919885	7348	7454	106	LEFT	R62b.EDF	R62	2
58	11923878	11923962	1534	1618	84	LEFT	R62b.EDF	R62	2
58	11924510	11924600	2166	2256	90	LEFT	R62b.EDF	R62	2
59	11931016	11931153	1056	1193	137	LEFT	R62b.EDF	R62	2
60	11941490	11941616	1909	2035	126	LEFT	R62b.EDF	R62	2
61	11947881	11948007	726	852	126	LEFT	R62b.EDF	R62	2
61	11949150	11949244	1995	2089	94	LEFT	R62b.EDF	R62	2
63	11965231	11965337	2015	2121	106	LEFT	R62b.EDF	R62	2
63	11967255	11967360	4039	4144	105	LEFT	R62b.EDF	R62	2
63	11969369	11969495	6153	6279	126	LEFT	R62b.EDF	R62	2
64	11975193	11975305	2486	2598	112	LEFT	R62b.EDF	R62	2
65	11982615	11982795	57	237	180	LEFT	R62b.EDF	R62	2
65	11985057	11985186	2499	2628	129	LEFT	R62b.EDF	R62	2
66	11991835	11991982	624	771	147	LEFT	R62b.EDF	R62	2
69	12018274	12018378	2287	2391	104	LEFT	R62b.EDF	R62	2
71	12038014	12038124	2473	2583	110	LEFT	R62b.EDF	R62	2
72	12044435	12044577	1729	1871	142	LEFT	R62b.EDF	R62	2
72	12045094	12045230	2388	2524	136	LEFT	R62b.EDF	R62	2
75	12070465	12070591	314	440	126	LEFT	R62b.EDF	R62	2
75	12074545	12074648	4394	4497	103	LEFT	R62b.EDF	R62	2
76	12084032	12084133	4930	5031	101	LEFT	R62b.EDF	R62	2
77	12094441	12094548	6929	7036	107	LEFT	R62b.EDF	R62	2
80	12117944	12118043	1504	1603	99	LEFT	R62b.EDF	R62	2
80	12121126	12121239	4686	4799	113	LEFT	R62b.EDF	R62	2
81	12126898	12127027	1082	1211	129	LEFT	R62b.EDF	R62	2
82	12138152	12138244	4922	5014	92	LEFT	R62b.EDF	R62	2
83	12144102	12144211	2043	2152	109	LEFT	R62b.EDF	R62	2
83	12147710	12147815	5651	5756	105	LEFT	R62b.EDF	R62	2
84	12152389	12152535	752	898	146	LEFT	R62b.EDF	R62	2
84	12153709	12153802	2072	2165	93	LEFT	R62b.EDF	R62	2
84	12156977	12157083	5340	5446	106	LEFT	R62b.EDF	R62	2
85	12161617	12161712	1455	1550	95	LEFT	R62b.EDF	R62	2
85	12162625	12162729	2463	2567	104	LEFT	R62b.EDF	R62	2
86	12169864	12169982	2253	2371	118	LEFT	R62b.EDF	R62	2
87	12178477	12178583	2001	2107	106	LEFT	R62b.EDF	R62	2
87	12181476	12181587	5000	5111	111	LEFT	R62b.EDF	R62	2
88	12186522	12186609	1209	1296	87	LEFT	R62b.EDF	R62	2
88	12187661	12187776	2348	2463	115	LEFT	R62b.EDF	R62	2
88	12187806	12187806	2493	2493	0	LEFT	R62b.EDF	R62	2
88	12189728	12189819	4415	4506	91	LEFT	R62b.EDF	R62	2
89	12195615	12195717	2148	2250	102	LEFT	R62b.EDF	R62	2
90	12203627	12203733	1845	1951	106	LEFT	R62b.EDF	R62	2
90	12204372	12204479	2590	2697	107	LEFT	R62b.EDF	R62	2
90	12206175	12206274	4393	4492	99	LEFT	R62b.EDF	R62	2
91	12213050	12213167	2059	2176	117	LEFT	R62b.EDF	R62	2
91	12216600	12216720	5609	5729	120	LEFT	R62b.EDF	R62	2
92	12221070	12221207	1117	1254	137	LEFT	R62b.EDF	R62	2
92	12222326	12222433	2373	2480	107	LEFT	R62b.EDF	R62	2
93	12229287	12229408	1888	2009	121	LEFT	R62b.EDF	R62	2
94	12237437	12237551	1100	1214	114	LEFT	R62b.EDF	R62	2
94	12238563	12238672	2226	2335	109	LEFT	R62b.EDF	R62	2
95	12247608	12247691	2184	2267	83	LEFT	R62b.EDF	R62	2
96	12255695	12255785	1840	1930	90	LEFT	R62b.EDF	R62	2
96	12259041	12259145	5186	5290	104	LEFT	R62b.EDF	R62	2
97	12264546	12264649	2447	2550	103	LEFT	R62b.EDF	R62	2
98	12271742	12271868	773	899	126	LEFT	R62b.EDF	R62	2
98	12273129	12273228	2160	2259	99	LEFT	R62b.EDF	R62	2
98	12277655	12277767	6686	6798	112	LEFT	R62b.EDF	R62	2
99	12280274	12280364	57	147	90	LEFT	R62b.EDF	R62	2
99	12282382	12282490	2165	2273	108	LEFT	R62b.EDF	R62	2
99	12285156	12285252	4939	5035	96	LEFT	R62b.EDF	R62	2
100	12289029	12289157	689	817	128	LEFT	R62b.EDF	R62	2
100	12290258	12290357	1918	2017	99	LEFT	R62b.EDF	R62	2
101	12298913	12299048	1887	2022	135	LEFT	R62b.EDF	R62	2
101	12302204	12302327	5178	5301	123	LEFT	R62b.EDF	R62	2
102	12307808	12307915	1962	2069	107	LEFT	R62b.EDF	R62	2
103	12314523	12314572	58	107	49	LEFT	R62b.EDF	R62	2
103	12316383	12316489	1918	2024	106	LEFT	R62b.EDF	R62	2
104	12323528	12323660	1411	1543	132	LEFT	R62b.EDF	R62	2
105	12331793	12331807	63	77	14	LEFT	R62b.EDF	R62	2
105	12332641	12332759	911	1029	118	LEFT	R62b.EDF	R62	2
106	12341338	12341423	2000	2085	85	LEFT	R62b.EDF	R62	2
106	12345071	12345212	5733	5874	141	LEFT	R62b.EDF	R62	2
107	12349355	12349414	57	116	59	LEFT	R62b.EDF	R62	2
107	12354497	12354592	5199	5294	95	LEFT	R62b.EDF	R62	2
107	12355915	12355970	6617	6672	55	LEFT	R62b.EDF	R62	2
108	12359349	12359526	56	233	177	LEFT	R62b.EDF	R62	2
108	12364628	12364714	5335	5421	86	LEFT	R62b.EDF	R62	2
109	12369506	12369586	90	170	80	LEFT	R62b.EDF	R62	2
109	12371423	12371507	2007	2091	84	LEFT	R62b.EDF	R62	2
110	12381275	12381386	2123	2234	111	LEFT	R62b.EDF	R62	2
110	12384001	12384103	4849	4951	102	LEFT	R62b.EDF	R62	2
111	12390460	12390576	2512	2628	116	LEFT	R62b.EDF	R62	2
112	12399852	12399963	1694	1805	111	LEFT	R62b.EDF	R62	2
112	12402049	12402147	3891	3989	98	LEFT	R62b.EDF	R62	2
113	12411793	12411877	5105	5189	84	LEFT	R62b.EDF	R62	2
113	12411983	12412076	5295	5388	93	LEFT	R62b.EDF	R62	2
114	12416978	12417062	1959	2043	84	LEFT	R62b.EDF	R62	2
115	12425424	12425560	1411	1547	136	LEFT	R62b.EDF	R62	2
115	12426215	12426323	2202	2310	108	LEFT	R62b.EDF	R62	2
116	12431207	12431307	64	164	100	LEFT	R62b.EDF	R62	2
116	12435115	12435220	3972	4077	105	LEFT	R62b.EDF	R62	2
117	12442263	12442366	1824	1927	103	LEFT	R62b.EDF	R62	2
118	12450427	12450560	963	1096	133	LEFT	R62b.EDF	R62	2
118	12453062	12453135	3598	3671	73	LEFT	R62b.EDF	R62	2
120	12472881	12472984	4024	4127	103	LEFT	R62b.EDF	R62	2
1	13336154	13336244	308	398	90	LEFT	R62c.EDF	R62	3
1	13337445	13337559	1599	1713	114	LEFT	R62c.EDF	R62	3
1	13339217	13339321	3371	3475	104	LEFT	R62c.EDF	R62	3
2	13346713	13346819	986	1092	106	LEFT	R62c.EDF	R62	3
2	13347568	13347673	1841	1946	105	LEFT	R62c.EDF	R62	3
2	13348055	13348156	2328	2429	101	LEFT	R62c.EDF	R62	3
2	13349390	13349476	3663	3749	86	LEFT	R62c.EDF	R62	3
3	13355623	13355718	2042	2137	95	LEFT	R62c.EDF	R62	3
4	13364615	13364706	2122	2213	91	LEFT	R62c.EDF	R62	3
5	13370787	13370918	997	1128	131	LEFT	R62c.EDF	R62	3
5	13371726	13371822	1936	2032	96	LEFT	R62c.EDF	R62	3
5	13375169	13375276	5379	5486	107	LEFT	R62c.EDF	R62	3
6	13380107	13380221	677	791	114	LEFT	R62c.EDF	R62	3
6	13381350	13381447	1920	2017	97	LEFT	R62c.EDF	R62	3
7	13387632	13387742	575	685	110	LEFT	R62c.EDF	R62	3
7	13393055	13393127	5998	6070	72	LEFT	R62c.EDF	R62	3
8	13397487	13397594	1800	1907	107	LEFT	R62c.EDF	R62	3
9	13406382	13406468	2073	2159	86	LEFT	R62c.EDF	R62	3
10	13413877	13413980	1830	1933	103	LEFT	R62c.EDF	R62	3
11	13419939	13420032	306	399	93	LEFT	R62c.EDF	R62	3
11	13420537	13420644	904	1011	107	LEFT	R62c.EDF	R62	3
11	13421669	13421760	2036	2127	91	LEFT	R62c.EDF	R62	3
11	13423776	13423877	4143	4244	101	LEFT	R62c.EDF	R62	3
12	13431685	13431824	1097	1236	139	LEFT	R62c.EDF	R62	3
12	13432595	13432707	2007	2119	112	LEFT	R62c.EDF	R62	3
13	13439422	13439546	605	729	124	LEFT	R62c.EDF	R62	3
14	13448560	13448659	2203	2302	99	LEFT	R62c.EDF	R62	3
15	13456732	13456836	1935	2039	104	LEFT	R62c.EDF	R62	3
16	13463762	13463892	1109	1239	130	LEFT	R62c.EDF	R62	3
16	13464662	13464769	2009	2116	107	LEFT	R62c.EDF	R62	3
18	13478945	13479056	827	938	111	LEFT	R62c.EDF	R62	3
18	13480478	13480577	2360	2459	99	LEFT	R62c.EDF	R62	3
19	13489559	13489685	2222	2348	126	LEFT	R62c.EDF	R62	3
20	13497646	13497772	2268	2394	126	LEFT	R62c.EDF	R62	3
21	13505819	13505928	2076	2185	109	LEFT	R62c.EDF	R62	3
22	13514028	13514135	2157	2264	107	LEFT	R62c.EDF	R62	3
24	13529197	13529308	1763	1874	111	LEFT	R62c.EDF	R62	3
24	13529641	13529753	2207	2319	112	LEFT	R62c.EDF	R62	3
25	13537961	13538086	1824	1949	125	LEFT	R62c.EDF	R62	3
25	13538498	13538614	2361	2477	116	LEFT	R62c.EDF	R62	3
26	13545995	13546102	1833	1940	107	LEFT	R62c.EDF	R62	3
27	13555388	13555503	2411	2526	115	LEFT	R62c.EDF	R62	3
28	13561736	13561826	1674	1764	90	LEFT	R62c.EDF	R62	3
28	13561942	13562053	1880	1991	111	LEFT	R62c.EDF	R62	3
29	13573716	13573822	6061	6167	106	LEFT	R62c.EDF	R62	3
30	13579049	13579152	2004	2107	103	LEFT	R62c.EDF	R62	3
30	13582656	13582780	5611	5735	124	LEFT	R62c.EDF	R62	3
32	13596605	13596778	1484	1657	173	LEFT	R62c.EDF	R62	3
33	13604533	13604717	298	482	184	LEFT	R62c.EDF	R62	3
33	13606367	13606513	2132	2278	146	LEFT	R62c.EDF	R62	3
35	13622922	13623030	141	249	108	LEFT	R62c.EDF	R62	3
35	13625152	13625277	2371	2496	125	LEFT	R62c.EDF	R62	3
35	13629043	13629147	6262	6366	104	LEFT	R62c.EDF	R62	3
36	13634970	13635087	2404	2521	117	LEFT	R62c.EDF	R62	3
37	13640742	13640887	845	990	145	LEFT	R62c.EDF	R62	3
37	13643999	13644110	4102	4213	111	LEFT	R62c.EDF	R62	3
37	13644170	13644170	4273	4273	0	LEFT	R62c.EDF	R62	3
38	13649788	13649892	1415	1519	104	LEFT	R62c.EDF	R62	3
38	13650459	13650590	2086	2217	131	LEFT	R62c.EDF	R62	3
39	13658712	13658805	2355	2448	93	LEFT	R62c.EDF	R62	3
40	13664284	13664306	60	82	22	LEFT	R62c.EDF	R62	3
40	13664924	13665069	700	845	145	LEFT	R62c.EDF	R62	3
40	13665443	13665535	1219	1311	92	LEFT	R62c.EDF	R62	3
40	13665597	13665604	1373	1380	7	LEFT	R62c.EDF	R62	3
40	13665628	13665658	1404	1434	30	LEFT	R62c.EDF	R62	3
40	13665870	13665871	1646	1647	1	LEFT	R62c.EDF	R62	3
40	13667240	13667637	3016	3413	397	LEFT	R62c.EDF	R62	3
41	13673292	13673425	1296	1429	133	LEFT	R62c.EDF	R62	3
42	13683433	13683511	2280	2358	78	LEFT	R62c.EDF	R62	3
42	13685691	13685797	4538	4644	106	LEFT	R62c.EDF	R62	3
42	13687294	13687417	6141	6264	123	LEFT	R62c.EDF	R62	3
43	13691322	13691455	604	737	133	LEFT	R62c.EDF	R62	3
43	13696422	13696529	5704	5811	107	LEFT	R62c.EDF	R62	3
45	13711437	13711567	2598	2728	130	LEFT	R62c.EDF	R62	3
45	13711597	13711599	2758	2760	2	LEFT	R62c.EDF	R62	3
46	13718732	13718836	2078	2182	104	LEFT	R62c.EDF	R62	3
47	13726752	13726856	2227	2331	104	LEFT	R62c.EDF	R62	3
47	13726892	13726892	2367	2367	0	LEFT	R62c.EDF	R62	3
47	13730097	13730231	5572	5706	134	LEFT	R62c.EDF	R62	3
48	13737908	13738009	2171	2272	101	LEFT	R62c.EDF	R62	3
48	13740224	13740339	4487	4602	115	LEFT	R62c.EDF	R62	3
49	13746207	13746358	725	876	151	LEFT	R62c.EDF	R62	3
49	13747659	13747771	2177	2289	112	LEFT	R62c.EDF	R62	3
50	13756331	13756443	1767	1879	112	LEFT	R62c.EDF	R62	3
51	13765676	13765798	3353	3475	122	LEFT	R62c.EDF	R62	3
52	13773462	13773562	2189	2289	100	LEFT	R62c.EDF	R62	3
53	13781094	13781203	1483	1592	109	LEFT	R62c.EDF	R62	3
53	13784848	13784965	5237	5354	117	LEFT	R62c.EDF	R62	3
54	13788667	13788730	57	120	63	LEFT	R62c.EDF	R62	3
54	13789232	13789379	622	769	147	LEFT	R62c.EDF	R62	3
54	13792372	13792484	3762	3874	112	LEFT	R62c.EDF	R62	3
55	13798011	13798187	561	737	176	LEFT	R62c.EDF	R62	3
55	13799891	13799997	2441	2547	106	LEFT	R62c.EDF	R62	3
55	13800027	13800028	2577	2578	1	LEFT	R62c.EDF	R62	3
56	13804994	13805080	57	143	86	LEFT	R62c.EDF	R62	3
56	13807650	13807768	2713	2831	118	LEFT	R62c.EDF	R62	3
56	13807803	13807806	2866	2869	3	LEFT	R62c.EDF	R62	3
57	13818010	13818050	5186	5226	40	LEFT	R62c.EDF	R62	3
58	13822149	13822301	279	431	152	LEFT	R62c.EDF	R62	3
58	13825566	13825674	3696	3804	108	LEFT	R62c.EDF	R62	3
60	13838942	13839068	742	868	126	LEFT	R62c.EDF	R62	3
60	13840012	13840125	1812	1925	113	LEFT	R62c.EDF	R62	3
61	13850688	13850790	2067	2169	102	LEFT	R62c.EDF	R62	3
61	13850823	13850823	2202	2202	0	LEFT	R62c.EDF	R62	3
62	13856942	13857065	531	654	123	LEFT	R62c.EDF	R62	3
62	13861134	13861198	4723	4787	64	LEFT	R62c.EDF	R62	3
63	13866256	13866369	972	1085	113	LEFT	R62c.EDF	R62	3
63	13867573	13867705	2289	2421	132	LEFT	R62c.EDF	R62	3
63	13867740	13867740	2456	2456	0	LEFT	R62c.EDF	R62	3
64	13875553	13875666	2106	2219	113	LEFT	R62c.EDF	R62	3
65	13882379	13882538	629	788	159	LEFT	R62c.EDF	R62	3
65	13884758	13884847	3008	3097	89	LEFT	R62c.EDF	R62	3
66	13890534	13890659	613	738	125	LEFT	R62c.EDF	R62	3
66	13895321	13895433	5400	5512	112	LEFT	R62c.EDF	R62	3
67	13901229	13901330	2315	2416	101	LEFT	R62c.EDF	R62	3
67	13904469	13904571	5555	5657	102	LEFT	R62c.EDF	R62	3
68	13908906	13909027	1232	1353	121	LEFT	R62c.EDF	R62	3
69	13919519	13919636	4382	4499	117	LEFT	R62c.EDF	R62	3
70	13924740	13924773	63	96	33	LEFT	R62c.EDF	R62	3
70	13926629	13926746	1952	2069	117	LEFT	R62c.EDF	R62	3
71	13937286	13937406	2067	2187	120	LEFT	R62c.EDF	R62	3
71	13937454	13937454	2235	2235	0	LEFT	R62c.EDF	R62	3
72	13946400	13946554	1730	1884	154	LEFT	R62c.EDF	R62	3
72	13947108	13947239	2438	2569	131	LEFT	R62c.EDF	R62	3
72	13947295	13947296	2625	2626	1	LEFT	R62c.EDF	R62	3
73	13954507	13954641	1177	1311	134	LEFT	R62c.EDF	R62	3
73	13955378	13955502	2048	2172	124	LEFT	R62c.EDF	R62	3
73	13955547	13955548	2217	2218	1	LEFT	R62c.EDF	R62	3
74	13962411	13962569	596	754	158	LEFT	R62c.EDF	R62	3
74	13964153	13964288	2338	2473	135	LEFT	R62c.EDF	R62	3
75	13973231	13973344	3646	3759	113	LEFT	R62c.EDF	R62	3
76	13979544	13979627	1945	2028	83	LEFT	R62c.EDF	R62	3
76	13979776	13979897	2177	2298	121	LEFT	R62c.EDF	R62	3
77	13987711	13987828	210	327	117	LEFT	R62c.EDF	R62	3
77	13988163	13988277	662	776	114	LEFT	R62c.EDF	R62	3
77	13990859	13990953	3358	3452	94	LEFT	R62c.EDF	R62	3
78	13996565	13996679	1976	2090	114	LEFT	R62c.EDF	R62	3
78	13997595	13997595	3006	3006	0	LEFT	R62c.EDF	R62	3
79	14004262	14004262	1100	1100	0	LEFT	R62c.EDF	R62	3
79	14004296	14004301	1134	1139	5	LEFT	R62c.EDF	R62	3
79	14004324	14004365	1162	1203	41	LEFT	R62c.EDF	R62	3
79	14004387	14004405	1225	1243	18	LEFT	R62c.EDF	R62	3
79	14004432	14004449	1270	1287	17	LEFT	R62c.EDF	R62	3
79	14004497	14004525	1335	1363	28	LEFT	R62c.EDF	R62	3
79	14004575	14004597	1413	1435	22	LEFT	R62c.EDF	R62	3
79	14004619	14004806	1457	1644	187	LEFT	R62c.EDF	R62	3
79	14004834	14004835	1672	1673	1	LEFT	R62c.EDF	R62	3
79	14004931	14005064	1769	1902	133	LEFT	R62c.EDF	R62	3
79	14007091	14007091	3929	3929	0	LEFT	R62c.EDF	R62	3
79	14007264	14007265	4102	4103	1	LEFT	R62c.EDF	R62	3
79	14007317	14007319	4155	4157	2	LEFT	R62c.EDF	R62	3
79	14007349	14007363	4187	4201	14	LEFT	R62c.EDF	R62	3
79	14007435	14007445	4273	4283	10	LEFT	R62c.EDF	R62	3
79	14007481	14007481	4319	4319	0	LEFT	R62c.EDF	R62	3
79	14007512	14007550	4350	4388	38	LEFT	R62c.EDF	R62	3
79	14007608	14007610	4446	4448	2	LEFT	R62c.EDF	R62	3
79	14007647	14007660	4485	4498	13	LEFT	R62c.EDF	R62	3
79	14007710	14007710	4548	4548	0	LEFT	R62c.EDF	R62	3
79	14007751	14007799	4589	4637	48	LEFT	R62c.EDF	R62	3
79	14007853	14007921	4691	4759	68	LEFT	R62c.EDF	R62	3
79	14007947	14007948	4785	4786	1	LEFT	R62c.EDF	R62	3
79	14008030	14008030	4868	4868	0	LEFT	R62c.EDF	R62	3
79	14008065	14008080	4903	4918	15	LEFT	R62c.EDF	R62	3
79	14008160	14008160	4998	4998	0	LEFT	R62c.EDF	R62	3
79	14008184	14008204	5022	5042	20	LEFT	R62c.EDF	R62	3
79	14008235	14008235	5073	5073	0	LEFT	R62c.EDF	R62	3
79	14008263	14008263	5101	5101	0	LEFT	R62c.EDF	R62	3
79	14008290	14008300	5128	5138	10	LEFT	R62c.EDF	R62	3
79	14008344	14008346	5182	5184	2	LEFT	R62c.EDF	R62	3
79	14008377	14008464	5215	5302	87	LEFT	R62c.EDF	R62	3
79	14008518	14008578	5356	5416	60	LEFT	R62c.EDF	R62	3
79	14008607	14008733	5445	5571	126	LEFT	R62c.EDF	R62	3
79	14008754	14008867	5592	5705	113	LEFT	R62c.EDF	R62	3
79	14008891	14009137	5729	5975	246	LEFT	R62c.EDF	R62	3
80	14011484	14011485	157	158	1	LEFT	R62c.EDF	R62	3
80	14011511	14011512	184	185	1	LEFT	R62c.EDF	R62	3
80	14011544	14013005	217	1678	1461	LEFT	R62c.EDF	R62	3
80	14013039	14013122	1712	1795	83	LEFT	R62c.EDF	R62	3
80	14014033	14014033	2706	2706	0	LEFT	R62c.EDF	R62	3
80	14014150	14014189	2823	2862	39	LEFT	R62c.EDF	R62	3
80	14014226	14014226	2899	2899	0	LEFT	R62c.EDF	R62	3
80	14014256	14014259	2929	2932	3	LEFT	R62c.EDF	R62	3
80	14014347	14014347	3020	3020	0	LEFT	R62c.EDF	R62	3
80	14014376	14014758	3049	3431	382	LEFT	R62c.EDF	R62	3
80	14014795	14014868	3468	3541	73	LEFT	R62c.EDF	R62	3
80	14014899	14014909	3572	3582	10	LEFT	R62c.EDF	R62	3
80	14014935	14014958	3608	3631	23	LEFT	R62c.EDF	R62	3
80	14015022	14015026	3695	3699	4	LEFT	R62c.EDF	R62	3
80	14015072	14015072	3745	3745	0	LEFT	R62c.EDF	R62	3
80	14015406	14015407	4079	4080	1	LEFT	R62c.EDF	R62	3
80	14015469	14015470	4142	4143	1	LEFT	R62c.EDF	R62	3
80	14015660	14015672	4333	4345	12	LEFT	R62c.EDF	R62	3
80	14015707	14015732	4380	4405	25	LEFT	R62c.EDF	R62	3
80	14015770	14015958	4443	4631	188	LEFT	R62c.EDF	R62	3
80	14015979	14016135	4652	4808	156	LEFT	R62c.EDF	R62	3
80	14016169	14016249	4842	4922	80	LEFT	R62c.EDF	R62	3
80	14016275	14016389	4948	5062	114	LEFT	R62c.EDF	R62	3
80	14016414	14016523	5087	5196	109	LEFT	R62c.EDF	R62	3
81	14019924	14019943	181	200	19	LEFT	R62c.EDF	R62	3
81	14019996	14019998	253	255	2	LEFT	R62c.EDF	R62	3
81	14020025	14020042	282	299	17	LEFT	R62c.EDF	R62	3
81	14020120	14020123	377	380	3	LEFT	R62c.EDF	R62	3
81	14020154	14020163	411	420	9	LEFT	R62c.EDF	R62	3
81	14021028	14021156	1285	1413	128	LEFT	R62c.EDF	R62	3
81	14024385	14024483	4642	4740	98	LEFT	R62c.EDF	R62	3
82	14029573	14029676	1862	1965	103	LEFT	R62c.EDF	R62	3
83	14037122	14037238	1586	1702	116	LEFT	R62c.EDF	R62	3
83	14038222	14038337	2686	2801	115	LEFT	R62c.EDF	R62	3
83	14042658	14042748	7122	7212	90	LEFT	R62c.EDF	R62	3
84	14045948	14045971	386	409	23	LEFT	R62c.EDF	R62	3
84	14046087	14046207	525	645	120	LEFT	R62c.EDF	R62	3
84	14047895	14048002	2333	2440	107	LEFT	R62c.EDF	R62	3
84	14048038	14048039	2476	2477	1	LEFT	R62c.EDF	R62	3
84	14051908	14052036	6346	6474	128	LEFT	R62c.EDF	R62	3
84	14052104	14052104	6542	6542	0	LEFT	R62c.EDF	R62	3
86	14063375	14063515	467	607	140	LEFT	R62c.EDF	R62	3
86	14063577	14063581	669	673	4	LEFT	R62c.EDF	R62	3
86	14064092	14064240	1184	1332	148	LEFT	R62c.EDF	R62	3
87	14072205	14072326	550	671	121	LEFT	R62c.EDF	R62	3
87	14073587	14073681	1932	2026	94	LEFT	R62c.EDF	R62	3
88	14079776	14079905	624	753	129	LEFT	R62c.EDF	R62	3
88	14081219	14081331	2067	2179	112	LEFT	R62c.EDF	R62	3
89	14089491	14089616	2234	2359	125	LEFT	R62c.EDF	R62	3
89	14089652	14089653	2395	2396	1	LEFT	R62c.EDF	R62	3
91	14105289	14105406	1886	2003	117	LEFT	R62c.EDF	R62	3
91	14105436	14105436	2033	2033	0	LEFT	R62c.EDF	R62	3
92	14112876	14113038	477	639	162	LEFT	R62c.EDF	R62	3
92	14114384	14114475	1985	2076	91	LEFT	R62c.EDF	R62	3
92	14118434	14118547	6035	6148	113	LEFT	R62c.EDF	R62	3
93	14122315	14122429	791	905	114	LEFT	R62c.EDF	R62	3
93	14123406	14123545	1882	2021	139	LEFT	R62c.EDF	R62	3
93	14123589	14123590	2065	2066	1	LEFT	R62c.EDF	R62	3
94	14131641	14131770	2045	2174	129	LEFT	R62c.EDF	R62	3
94	14131812	14131815	2216	2219	3	LEFT	R62c.EDF	R62	3
95	14138034	14138160	996	1122	126	LEFT	R62c.EDF	R62	3
95	14139524	14139658	2486	2620	134	LEFT	R62c.EDF	R62	3
95	14139702	14139703	2664	2665	1	LEFT	R62c.EDF	R62	3
97	14156240	14156358	1886	2004	118	LEFT	R62c.EDF	R62	3
97	14160302	14160414	5948	6060	112	LEFT	R62c.EDF	R62	3
98	14164494	14164605	913	1024	111	LEFT	R62c.EDF	R62	3
98	14168169	14168267	4588	4686	98	LEFT	R62c.EDF	R62	3
99	14175121	14175244	1745	1868	123	LEFT	R62c.EDF	R62	3
99	14175559	14175652	2183	2276	93	LEFT	R62c.EDF	R62	3
99	14175679	14175680	2303	2304	1	LEFT	R62c.EDF	R62	3
100	14183036	14183150	2105	2219	114	LEFT	R62c.EDF	R62	3
101	14190805	14190914	2197	2306	109	LEFT	R62c.EDF	R62	3
102	14198593	14198714	1982	2103	121	LEFT	R62c.EDF	R62	3
102	14202397	14202471	5786	5860	74	LEFT	R62c.EDF	R62	3
103	14205285	14205407	79	201	122	LEFT	R62c.EDF	R62	3
103	14207235	14207350	2029	2144	115	LEFT	R62c.EDF	R62	3
104	14216452	14216554	1800	1902	102	LEFT	R62c.EDF	R62	3
105	14224902	14225007	1994	2099	105	LEFT	R62c.EDF	R62	3
106	14234123	14234226	2169	2272	103	LEFT	R62c.EDF	R62	3
106	14234253	14234256	2299	2302	3	LEFT	R62c.EDF	R62	3
106	14236911	14237024	4957	5070	113	LEFT	R62c.EDF	R62	3
107	14241838	14242310	306	778	472	LEFT	R62c.EDF	R62	3
107	14243788	14243926	2256	2394	138	LEFT	R62c.EDF	R62	3
107	14243965	14243968	2433	2436	3	LEFT	R62c.EDF	R62	3
108	14249009	14249018	256	265	9	LEFT	R62c.EDF	R62	3
108	14250919	14251026	2166	2273	107	LEFT	R62c.EDF	R62	3
108	14251068	14251071	2315	2318	3	LEFT	R62c.EDF	R62	3
109	14257605	14257709	57	161	104	LEFT	R62c.EDF	R62	3
109	14259966	14260079	2418	2531	113	LEFT	R62c.EDF	R62	3
110	14265273	14265395	570	692	122	LEFT	R62c.EDF	R62	3
110	14266729	14266822	2026	2119	93	LEFT	R62c.EDF	R62	3
110	14266864	14266864	2161	2161	0	LEFT	R62c.EDF	R62	3
111	14273815	14273966	808	959	151	LEFT	R62c.EDF	R62	3
111	14275097	14275202	2090	2195	105	LEFT	R62c.EDF	R62	3
112	14283383	14283527	665	809	144	LEFT	R62c.EDF	R62	3
112	14285013	14285133	2295	2415	120	LEFT	R62c.EDF	R62	3
112	14285158	14285158	2440	2440	0	LEFT	R62c.EDF	R62	3
113	14293343	14293441	1793	1891	98	LEFT	R62c.EDF	R62	3
113	14296397	14296516	4847	4966	119	LEFT	R62c.EDF	R62	3
114	14303106	14303242	2028	2164	136	LEFT	R62c.EDF	R62	3
115	14313648	14313771	4899	5022	123	LEFT	R62c.EDF	R62	3
116	14318070	14318176	1705	1811	106	LEFT	R62c.EDF	R62	3
116	14320645	14320772	4280	4407	127	LEFT	R62c.EDF	R62	3
117	14327522	14327854	1538	1870	332	LEFT	R62c.EDF	R62	3
117	14331077	14331190	5093	5206	113	LEFT	R62c.EDF	R62	3
118	14335398	14335545	851	998	147	LEFT	R62c.EDF	R62	3
118	14336571	14336676	2024	2129	105	LEFT	R62c.EDF	R62	3
118	14341327	14341452	6780	6905	125	LEFT	R62c.EDF	R62	3
119	14346566	14346691	2178	2303	125	LEFT	R62c.EDF	R62	3
119	14349417	14349561	5029	5173	144	LEFT	R62c.EDF	R62	3
120	14354791	14354926	2224	2359	135	LEFT	R62c.EDF	R62	3
120	14358345	14358456	5778	5889	111	LEFT	R62c.EDF	R62	3
121	14738938	14739085	450	597	147	LEFT	R62c.EDF	R62	3
121	14741646	14741804	3158	3316	158	LEFT	R62c.EDF	R62	3
121	14743699	14743875	5211	5387	176	LEFT	R62c.EDF	R62	3
121	14748390	14748539	9902	10051	149	LEFT	R62c.EDF	R62	3
121	14751312	14751605	12824	13117	293	LEFT	R62c.EDF	R62	3
121	14756065	14756195	17577	17707	130	LEFT	R62c.EDF	R62	3
121	14757363	14757546	18875	19058	183	LEFT	R62c.EDF	R62	3
121	14761316	14761451	22828	22963	135	LEFT	R62c.EDF	R62	3
121	14762579	14762788	24091	24300	209	LEFT	R62c.EDF	R62	3
121	14763507	14763934	25019	25446	427	LEFT	R62c.EDF	R62	3
121	14765664	14765820	27176	27332	156	LEFT	R62c.EDF	R62	3
121	14767090	14767376	28602	28888	286	LEFT	R62c.EDF	R62	3
121	14770583	14770821	32095	32333	238	LEFT	R62c.EDF	R62	3
121	14771424	14771596	32936	33108	172	LEFT	R62c.EDF	R62	3
121	14773306	14773445	34818	34957	139	LEFT	R62c.EDF	R62	3
121	14777536	14777666	39048	39178	130	LEFT	R62c.EDF	R62	3
121	14778799	14778990	40311	40502	191	LEFT	R62c.EDF	R62	3
121	14780689	14780837	42201	42349	148	LEFT	R62c.EDF	R62	3
121	14782190	14782333	43702	43845	143	LEFT	R62c.EDF	R62	3
121	14786344	14786454	47856	47966	110	LEFT	R62c.EDF	R62	3
121	14791359	14791487	52871	52999	128	LEFT	R62c.EDF	R62	3
121	14796650	14796767	58162	58279	117	LEFT	R62c.EDF	R62	3
121	14798019	14798201	59531	59713	182	LEFT	R62c.EDF	R62	3
121	14801557	14801681	63069	63193	124	LEFT	R62c.EDF	R62	3
121	14804579	14804722	66091	66234	143	LEFT	R62c.EDF	R62	3
121	14812917	14813074	74429	74586	157	LEFT	R62c.EDF	R62	3
121	14814388	14814532	75900	76044	144	LEFT	R62c.EDF	R62	3
121	14815847	14815986	77359	77498	139	LEFT	R62c.EDF	R62	3
121	14817417	14817541	78929	79053	124	LEFT	R62c.EDF	R62	3
121	14819515	14819667	81027	81179	152	LEFT	R62c.EDF	R62	3
121	14826841	14826967	88353	88479	126	LEFT	R62c.EDF	R62	3
121	14831072	14831289	92584	92801	217	LEFT	R62c.EDF	R62	3
121	14837122	14837378	98634	98890	256	LEFT	R62c.EDF	R62	3
121	14838427	14838640	99939	100152	213	LEFT	R62c.EDF	R62	3
121	14846859	14847020	108371	108532	161	LEFT	R62c.EDF	R62	3
121	14855765	14856009	117277	117521	244	LEFT	R62c.EDF	R62	3
121	14856398	14856584	117910	118096	186	LEFT	R62c.EDF	R62	3
121	14870867	14871097	132379	132609	230	LEFT	R62c.EDF	R62	3
121	14874043	14874208	135555	135720	165	LEFT	R62c.EDF	R62	3
121	14885366	14885556	146878	147068	190	LEFT	R62c.EDF	R62	3
121	14894342	14894499	155854	156011	157	LEFT	R62c.EDF	R62	3
121	14897177	14897358	158689	158870	181	LEFT	R62c.EDF	R62	3
121	14907173	14907351	168685	168863	178	LEFT	R62c.EDF	R62	3
121	14913424	14913556	174936	175068	132	LEFT	R62c.EDF	R62	3
121	14916318	14916445	177830	177957	127	LEFT	R62c.EDF	R62	3
121	14916713	14916876	178225	178388	163	LEFT	R62c.EDF	R62	3
121	14917731	14917942	179243	179454	211	LEFT	R62c.EDF	R62	3
121	14918665	14918977	180177	180489	312	LEFT	R62c.EDF	R62	3
121	14920965	14921165	182477	182677	200	LEFT	R62c.EDF	R62	3
121	14923118	14923430	184630	184942	312	LEFT	R62c.EDF	R62	3
121	14923831	14924260	185343	185772	429	LEFT	R62c.EDF	R62	3
121	14924490	14924500	186002	186012	10	LEFT	R62c.EDF	R62	3
121	14924685	14933253	186197	194765	8568	LEFT	R62c.EDF	R62	3
121	14933279	14933361	194791	194873	82	LEFT	R62c.EDF	R62	3
121	14935384	14935483	196896	196995	99	LEFT	R62c.EDF	R62	3
121	14936483	14936562	197995	198074	79	LEFT	R62c.EDF	R62	3
122	15021272	15021402	508	638	130	LEFT	R62c.EDF	R62	3
122	15023594	15023741	2830	2977	147	LEFT	R62c.EDF	R62	3
122	15024374	15024555	3610	3791	181	LEFT	R62c.EDF	R62	3
122	15025817	15025948	5053	5184	131	LEFT	R62c.EDF	R62	3
122	15025979	15025981	5215	5217	2	LEFT	R62c.EDF	R62	3
122	15027303	15027406	6539	6642	103	LEFT	R62c.EDF	R62	3
122	15028886	15029000	8122	8236	114	LEFT	R62c.EDF	R62	3
122	15032089	15032215	11325	11451	126	LEFT	R62c.EDF	R62	3
122	15034261	15034396	13497	13632	135	LEFT	R62c.EDF	R62	3
122	15034423	15034427	13659	13663	4	LEFT	R62c.EDF	R62	3
122	15035243	15035405	14479	14641	162	LEFT	R62c.EDF	R62	3
122	15037620	15037732	16856	16968	112	LEFT	R62c.EDF	R62	3
122	15039370	15039478	18606	18714	108	LEFT	R62c.EDF	R62	3
122	15041296	15041418	20532	20654	122	LEFT	R62c.EDF	R62	3
122	15042360	15042481	21596	21717	121	LEFT	R62c.EDF	R62	3
122	15043175	15043487	22411	22723	312	LEFT	R62c.EDF	R62	3
122	15044226	15044378	23462	23614	152	LEFT	R62c.EDF	R62	3
122	15046954	15047103	26190	26339	149	LEFT	R62c.EDF	R62	3
122	15050299	15050439	29535	29675	140	LEFT	R62c.EDF	R62	3
122	15055504	15055641	34740	34877	137	LEFT	R62c.EDF	R62	3
122	15055663	15055674	34899	34910	11	LEFT	R62c.EDF	R62	3
122	15057564	15057727	36800	36963	163	LEFT	R62c.EDF	R62	3
122	15060980	15061145	40216	40381	165	LEFT	R62c.EDF	R62	3
122	15065216	15065366	44452	44602	150	LEFT	R62c.EDF	R62	3
122	15065977	15065977	45213	45213	0	LEFT	R62c.EDF	R62	3
122	15066375	15066508	45611	45744	133	LEFT	R62c.EDF	R62	3
122	15069693	15069830	48929	49066	137	LEFT	R62c.EDF	R62	3
122	15069853	15069854	49089	49090	1	LEFT	R62c.EDF	R62	3
122	15071585	15071897	50821	51133	312	LEFT	R62c.EDF	R62	3
122	15074341	15074495	53577	53731	154	LEFT	R62c.EDF	R62	3
122	15076983	15077155	56219	56391	172	LEFT	R62c.EDF	R62	3
122	15081007	15081152	60243	60388	145	LEFT	R62c.EDF	R62	3
122	15082571	15082702	61807	61938	131	LEFT	R62c.EDF	R62	3
122	15084512	15084683	63748	63919	171	LEFT	R62c.EDF	R62	3
122	15085647	15085791	64883	65027	144	LEFT	R62c.EDF	R62	3
122	15087359	15087525	66595	66761	166	LEFT	R62c.EDF	R62	3
122	15088654	15088773	67890	68009	119	LEFT	R62c.EDF	R62	3
122	15089819	15089953	69055	69189	134	LEFT	R62c.EDF	R62	3
122	15091141	15091257	70377	70493	116	LEFT	R62c.EDF	R62	3
122	15094410	15094536	73646	73772	126	LEFT	R62c.EDF	R62	3
122	15096508	15096649	75744	75885	141	LEFT	R62c.EDF	R62	3
122	15098101	15098219	77337	77455	118	LEFT	R62c.EDF	R62	3
122	15099673	15099809	78909	79045	136	LEFT	R62c.EDF	R62	3
122	15101690	15101807	80926	81043	117	LEFT	R62c.EDF	R62	3
122	15104504	15104664	83740	83900	160	LEFT	R62c.EDF	R62	3
122	15105888	15106019	85124	85255	131	LEFT	R62c.EDF	R62	3
122	15109334	15109556	88570	88792	222	LEFT	R62c.EDF	R62	3
122	15110501	15110663	89737	89899	162	LEFT	R62c.EDF	R62	3
122	15110684	15110697	89920	89933	13	LEFT	R62c.EDF	R62	3
122	15113333	15113445	92569	92681	112	LEFT	R62c.EDF	R62	3
122	15116174	15116269	95410	95505	95	LEFT	R62c.EDF	R62	3
122	15118121	15118303	97357	97539	182	LEFT	R62c.EDF	R62	3
122	15119520	15119675	98756	98911	155	LEFT	R62c.EDF	R62	3
122	15121638	15121803	100874	101039	165	LEFT	R62c.EDF	R62	3
122	15122833	15122976	102069	102212	143	LEFT	R62c.EDF	R62	3
122	15124008	15124139	103244	103375	131	LEFT	R62c.EDF	R62	3
122	15126587	15126724	105823	105960	137	LEFT	R62c.EDF	R62	3
122	15127919	15128053	107155	107289	134	LEFT	R62c.EDF	R62	3
122	15129888	15130029	109124	109265	141	LEFT	R62c.EDF	R62	3
122	15131782	15131933	111018	111169	151	LEFT	R62c.EDF	R62	3
122	15132992	15133171	112228	112407	179	LEFT	R62c.EDF	R62	3
122	15135135	15135255	114371	114491	120	LEFT	R62c.EDF	R62	3
122	15137466	15137613	116702	116849	147	LEFT	R62c.EDF	R62	3
122	15139347	15139514	118583	118750	167	LEFT	R62c.EDF	R62	3
122	15142145	15142273	121381	121509	128	LEFT	R62c.EDF	R62	3
122	15145044	15145209	124280	124445	165	LEFT	R62c.EDF	R62	3
122	15148922	15149088	128158	128324	166	LEFT	R62c.EDF	R62	3
122	15150500	15150648	129736	129884	148	LEFT	R62c.EDF	R62	3
122	15151923	15152044	131159	131280	121	LEFT	R62c.EDF	R62	3
122	15154290	15154421	133526	133657	131	LEFT	R62c.EDF	R62	3
122	15155671	15155793	134907	135029	122	LEFT	R62c.EDF	R62	3
122	15158671	15158815	137907	138051	144	LEFT	R62c.EDF	R62	3
122	15160088	15160213	139324	139449	125	LEFT	R62c.EDF	R62	3
122	15161414	15161543	140650	140779	129	LEFT	R62c.EDF	R62	3
122	15163461	15163597	142697	142833	136	LEFT	R62c.EDF	R62	3
122	15165640	15165777	144876	145013	137	LEFT	R62c.EDF	R62	3
122	15168395	15168533	147631	147769	138	LEFT	R62c.EDF	R62	3
122	15170507	15170625	149743	149861	118	LEFT	R62c.EDF	R62	3
122	15172812	15172923	152048	152159	111	LEFT	R62c.EDF	R62	3
122	15174130	15174249	153366	153485	119	LEFT	R62c.EDF	R62	3
122	15176096	15176248	155332	155484	152	LEFT	R62c.EDF	R62	3
122	15179324	15179521	158560	158757	197	LEFT	R62c.EDF	R62	3
122	15182060	15182198	161296	161434	138	LEFT	R62c.EDF	R62	3
122	15182219	15182222	161455	161458	3	LEFT	R62c.EDF	R62	3
122	15186031	15186159	165267	165395	128	LEFT	R62c.EDF	R62	3
122	15187195	15187347	166431	166583	152	LEFT	R62c.EDF	R62	3
122	15187868	15188147	167104	167383	279	LEFT	R62c.EDF	R62	3
122	15189692	15190004	168928	169240	312	LEFT	R62c.EDF	R62	3
122	15193466	15193698	172702	172934	232	LEFT	R62c.EDF	R62	3
122	15195002	15195127	174238	174363	125	LEFT	R62c.EDF	R62	3
122	15197760	15197894	176996	177130	134	LEFT	R62c.EDF	R62	3
122	15200015	15200155	179251	179391	140	LEFT	R62c.EDF	R62	3
122	15204102	15204248	183338	183484	146	LEFT	R62c.EDF	R62	3
122	15206276	15206427	185512	185663	151	LEFT	R62c.EDF	R62	3
122	15207453	15207765	186689	187001	312	LEFT	R62c.EDF	R62	3
122	15209576	15209716	188812	188952	140	LEFT	R62c.EDF	R62	3
122	15211181	15211322	190417	190558	141	LEFT	R62c.EDF	R62	3
122	15212842	15212979	192078	192215	137	LEFT	R62c.EDF	R62	3
122	15215555	15215710	194791	194946	155	LEFT	R62c.EDF	R62	3
122	15218416	15218569	197652	197805	153	LEFT	R62c.EDF	R62	3
122	15221455	15221767	200691	201003	312	LEFT	R62c.EDF	R62	3
122	15223328	15223494	202564	202730	166	LEFT	R62c.EDF	R62	3
122	15225808	15225962	205044	205198	154	LEFT	R62c.EDF	R62	3
122	15227565	15227718	206801	206954	153	LEFT	R62c.EDF	R62	3
122	15228500	15228812	207736	208048	312	LEFT	R62c.EDF	R62	3
122	15229301	15229348	208537	208584	47	LEFT	R62c.EDF	R62	3
122	15229402	15318397	208638	297633	88995	LEFT	R62c.EDF	R62	3
2	3318404	3318494	66	156	90	RIGHT	R66a.EDF	R66	1
2	3319512	3319615	1174	1277	103	RIGHT	R66a.EDF	R66	1
2	3319641	3319656	1303	1318	15	RIGHT	R66a.EDF	R66	1
2	3321140	3321242	2802	2904	102	RIGHT	R66a.EDF	R66	1
3	3330021	3330110	869	958	89	RIGHT	R66a.EDF	R66	1
3	3330136	3330154	984	1002	18	RIGHT	R66a.EDF	R66	1
5	3347987	3348111	741	865	124	RIGHT	R66a.EDF	R66	1
6	3357047	3357103	243	299	56	RIGHT	R66a.EDF	R66	1
6	3357129	3357149	325	345	20	RIGHT	R66a.EDF	R66	1
6	3357338	3357451	534	647	113	RIGHT	R66a.EDF	R66	1
6	3357474	3357492	670	688	18	RIGHT	R66a.EDF	R66	1
8	3374939	3375049	562	672	110	RIGHT	R66a.EDF	R66	1
8	3375070	3375092	693	715	22	RIGHT	R66a.EDF	R66	1
9	3383692	3383833	374	515	141	RIGHT	R66a.EDF	R66	1
9	3384067	3384196	749	878	129	RIGHT	R66a.EDF	R66	1
9	3384218	3384235	900	917	17	RIGHT	R66a.EDF	R66	1
10	3392412	3392433	69	90	21	RIGHT	R66a.EDF	R66	1
10	3394740	3394762	2397	2419	22	RIGHT	R66a.EDF	R66	1
11	3401207	3401333	85	211	126	RIGHT	R66a.EDF	R66	1
11	3401456	3401558	334	436	102	RIGHT	R66a.EDF	R66	1
11	3401605	3401732	483	610	127	RIGHT	R66a.EDF	R66	1
12	3409958	3410074	263	379	116	RIGHT	R66a.EDF	R66	1
12	3410095	3410110	400	415	15	RIGHT	R66a.EDF	R66	1
13	3417529	3417636	572	679	107	RIGHT	R66a.EDF	R66	1
13	3417659	3417675	702	718	16	RIGHT	R66a.EDF	R66	1
13	3417915	3418004	958	1047	89	RIGHT	R66a.EDF	R66	1
13	3418028	3418045	1071	1088	17	RIGHT	R66a.EDF	R66	1
13	3418270	3418371	1313	1414	101	RIGHT	R66a.EDF	R66	1
13	3418402	3418423	1445	1466	21	RIGHT	R66a.EDF	R66	1
14	3426013	3426060	321	368	47	RIGHT	R66a.EDF	R66	1
14	3426085	3426105	393	413	20	RIGHT	R66a.EDF	R66	1
14	3426190	3426316	498	624	126	RIGHT	R66a.EDF	R66	1
15	3434508	3434639	306	437	131	RIGHT	R66a.EDF	R66	1
16	3441665	3441737	213	285	72	RIGHT	R66a.EDF	R66	1
16	3441759	3441772	307	320	13	RIGHT	R66a.EDF	R66	1
16	3444002	3444110	2550	2658	108	RIGHT	R66a.EDF	R66	1
17	3448579	3448640	57	118	61	RIGHT	R66a.EDF	R66	1
17	3448663	3448682	141	160	19	RIGHT	R66a.EDF	R66	1
17	3448845	3448928	323	406	83	RIGHT	R66a.EDF	R66	1
17	3448949	3448965	427	443	16	RIGHT	R66a.EDF	R66	1
17	3451010	3451120	2488	2598	110	RIGHT	R66a.EDF	R66	1
18	3456612	3456667	66	121	55	RIGHT	R66a.EDF	R66	1
18	3456690	3456715	144	169	25	RIGHT	R66a.EDF	R66	1
18	3457427	3457520	881	974	93	RIGHT	R66a.EDF	R66	1
18	3457546	3457568	1000	1022	22	RIGHT	R66a.EDF	R66	1
18	3458998	3459120	2452	2574	122	RIGHT	R66a.EDF	R66	1
19	3466130	3466264	69	203	134	RIGHT	R66a.EDF	R66	1
19	3466608	3466708	547	647	100	RIGHT	R66a.EDF	R66	1
19	3466736	3466754	675	693	18	RIGHT	R66a.EDF	R66	1
19	3468402	3468497	2341	2436	95	RIGHT	R66a.EDF	R66	1
19	3472156	3472200	6095	6139	44	RIGHT	R66a.EDF	R66	1
19	3472228	3472244	6167	6183	16	RIGHT	R66a.EDF	R66	1
19	3472468	3472588	6407	6527	120	RIGHT	R66a.EDF	R66	1
20	3475673	3475779	649	755	106	RIGHT	R66a.EDF	R66	1
20	3475803	3475822	779	798	19	RIGHT	R66a.EDF	R66	1
20	3476412	3476519	1388	1495	107	RIGHT	R66a.EDF	R66	1
20	3476546	3476566	1522	1542	20	RIGHT	R66a.EDF	R66	1
21	3483291	3483319	88	116	28	RIGHT	R66a.EDF	R66	1
21	3484145	3484244	942	1041	99	RIGHT	R66a.EDF	R66	1
21	3484270	3484292	1067	1089	22	RIGHT	R66a.EDF	R66	1
21	3485377	3485505	2174	2302	128	RIGHT	R66a.EDF	R66	1
21	3487502	3487581	4299	4378	79	RIGHT	R66a.EDF	R66	1
21	3487608	3487623	4405	4420	15	RIGHT	R66a.EDF	R66	1
22	3491296	3491420	223	347	124	RIGHT	R66a.EDF	R66	1
22	3491445	3491467	372	394	22	RIGHT	R66a.EDF	R66	1
22	3491764	3491918	691	845	154	RIGHT	R66a.EDF	R66	1
22	3491948	3491970	875	897	22	RIGHT	R66a.EDF	R66	1
22	3493729	3493832	2656	2759	103	RIGHT	R66a.EDF	R66	1
23	3499078	3499135	58	115	57	RIGHT	R66a.EDF	R66	1
23	3499160	3499176	140	156	16	RIGHT	R66a.EDF	R66	1
23	3499961	3500060	941	1040	99	RIGHT	R66a.EDF	R66	1
23	3500082	3500098	1062	1078	16	RIGHT	R66a.EDF	R66	1
23	3501139	3501267	2119	2247	128	RIGHT	R66a.EDF	R66	1
23	3502254	3502343	3234	3323	89	RIGHT	R66a.EDF	R66	1
24	3505810	3505934	225	349	124	RIGHT	R66a.EDF	R66	1
24	3506287	3506411	702	826	124	RIGHT	R66a.EDF	R66	1
24	3508210	3508303	2625	2718	93	RIGHT	R66a.EDF	R66	1
25	3513633	3513777	222	366	144	RIGHT	R66a.EDF	R66	1
25	3514510	3514613	1099	1202	103	RIGHT	R66a.EDF	R66	1
25	3514637	3514657	1226	1246	20	RIGHT	R66a.EDF	R66	1
25	3516128	3516249	2717	2838	121	RIGHT	R66a.EDF	R66	1
25	3516934	3517060	3523	3649	126	RIGHT	R66a.EDF	R66	1
25	3517851	3517964	4440	4553	113	RIGHT	R66a.EDF	R66	1
25	3518004	3518030	4593	4619	26	RIGHT	R66a.EDF	R66	1
26	3523200	3523325	333	458	125	RIGHT	R66a.EDF	R66	1
26	3525157	3525266	2290	2399	109	RIGHT	R66a.EDF	R66	1
26	3528226	3528341	5359	5474	115	RIGHT	R66a.EDF	R66	1
27	3531136	3531300	58	222	164	RIGHT	R66a.EDF	R66	1
27	3531324	3531347	246	269	23	RIGHT	R66a.EDF	R66	1
27	3532019	3532133	941	1055	114	RIGHT	R66a.EDF	R66	1
27	3532161	3532181	1083	1103	20	RIGHT	R66a.EDF	R66	1
27	3532579	3532679	1501	1601	100	RIGHT	R66a.EDF	R66	1
27	3532706	3532730	1628	1652	24	RIGHT	R66a.EDF	R66	1
27	3533733	3533868	2655	2790	135	RIGHT	R66a.EDF	R66	1
28	3540378	3540449	58	129	71	RIGHT	R66a.EDF	R66	1
28	3540473	3540493	153	173	20	RIGHT	R66a.EDF	R66	1
28	3541180	3541302	860	982	122	RIGHT	R66a.EDF	R66	1
28	3541323	3541345	1003	1025	22	RIGHT	R66a.EDF	R66	1
28	3541997	3542082	1677	1762	85	RIGHT	R66a.EDF	R66	1
28	3542107	3542122	1787	1802	15	RIGHT	R66a.EDF	R66	1
28	3542819	3542930	2499	2610	111	RIGHT	R66a.EDF	R66	1
28	3543751	3543837	3431	3517	86	RIGHT	R66a.EDF	R66	1
28	3543860	3543874	3540	3554	14	RIGHT	R66a.EDF	R66	1
28	3545153	3545233	4833	4913	80	RIGHT	R66a.EDF	R66	1
28	3545256	3545273	4936	4953	17	RIGHT	R66a.EDF	R66	1
28	3545985	3546104	5665	5784	119	RIGHT	R66a.EDF	R66	1
29	3548546	3548682	487	623	136	RIGHT	R66a.EDF	R66	1
29	3548706	3548725	647	666	19	RIGHT	R66a.EDF	R66	1
29	3549935	3550066	1876	2007	131	RIGHT	R66a.EDF	R66	1
29	3550726	3550845	2667	2786	119	RIGHT	R66a.EDF	R66	1
30	3556071	3556198	175	302	127	RIGHT	R66a.EDF	R66	1
30	3556219	3556237	323	341	18	RIGHT	R66a.EDF	R66	1
30	3558072	3558179	2176	2283	107	RIGHT	R66a.EDF	R66	1
31	3565375	3565474	514	613	99	RIGHT	R66a.EDF	R66	1
31	3565503	3565517	642	656	14	RIGHT	R66a.EDF	R66	1
31	3566339	3566420	1478	1559	81	RIGHT	R66a.EDF	R66	1
31	3566441	3566460	1580	1599	19	RIGHT	R66a.EDF	R66	1
31	3567068	3567188	2207	2327	120	RIGHT	R66a.EDF	R66	1
31	3567704	3567837	2843	2976	133	RIGHT	R66a.EDF	R66	1
31	3568865	3568992	4004	4131	127	RIGHT	R66a.EDF	R66	1
31	3569784	3569919	4923	5058	135	RIGHT	R66a.EDF	R66	1
32	3573038	3573162	162	286	124	RIGHT	R66a.EDF	R66	1
32	3573184	3573195	308	319	11	RIGHT	R66a.EDF	R66	1
32	3574459	3574519	1583	1643	60	RIGHT	R66a.EDF	R66	1
32	3574544	3574557	1668	1681	13	RIGHT	R66a.EDF	R66	1
33	3580737	3580757	64	84	20	RIGHT	R66a.EDF	R66	1
33	3580902	3581047	229	374	145	RIGHT	R66a.EDF	R66	1
33	3581553	3581672	880	999	119	RIGHT	R66a.EDF	R66	1
33	3581702	3581725	1029	1052	23	RIGHT	R66a.EDF	R66	1
33	3582379	3582474	1706	1801	95	RIGHT	R66a.EDF	R66	1
33	3582497	3582516	1824	1843	19	RIGHT	R66a.EDF	R66	1
33	3583507	3583585	2834	2912	78	RIGHT	R66a.EDF	R66	1
33	3583704	3583837	3031	3164	133	RIGHT	R66a.EDF	R66	1
34	3590431	3590532	304	405	101	RIGHT	R66a.EDF	R66	1
34	3590554	3590571	427	444	17	RIGHT	R66a.EDF	R66	1
34	3592661	3592764	2534	2637	103	RIGHT	R66a.EDF	R66	1
34	3593514	3593639	3387	3512	125	RIGHT	R66a.EDF	R66	1
35	3597736	3597834	76	174	98	RIGHT	R66a.EDF	R66	1
35	3597855	3597867	195	207	12	RIGHT	R66a.EDF	R66	1
35	3598373	3598464	713	804	91	RIGHT	R66a.EDF	R66	1
35	3598490	3598504	830	844	14	RIGHT	R66a.EDF	R66	1
35	3599789	3599880	2129	2220	91	RIGHT	R66a.EDF	R66	1
35	3600222	3600355	2562	2695	133	RIGHT	R66a.EDF	R66	1
36	3605728	3605823	132	227	95	RIGHT	R66a.EDF	R66	1
36	3605844	3605854	248	258	10	RIGHT	R66a.EDF	R66	1
36	3606432	3606564	836	968	132	RIGHT	R66a.EDF	R66	1
36	3606589	3606609	993	1013	20	RIGHT	R66a.EDF	R66	1
36	3606873	3606974	1277	1378	101	RIGHT	R66a.EDF	R66	1
36	3607006	3607023	1410	1427	17	RIGHT	R66a.EDF	R66	1
36	3607951	3608068	2355	2472	117	RIGHT	R66a.EDF	R66	1
37	3614624	3614637	91	104	13	RIGHT	R66a.EDF	R66	1
37	3615512	3615659	979	1126	147	RIGHT	R66a.EDF	R66	1
37	3616616	3616731	2083	2198	115	RIGHT	R66a.EDF	R66	1
38	3622843	3622984	86	227	141	RIGHT	R66a.EDF	R66	1
38	3623691	3623826	934	1069	135	RIGHT	R66a.EDF	R66	1
38	3623849	3623867	1092	1110	18	RIGHT	R66a.EDF	R66	1
38	3624163	3624290	1406	1533	127	RIGHT	R66a.EDF	R66	1
38	3624319	3624337	1562	1580	18	RIGHT	R66a.EDF	R66	1
38	3625334	3625454	2577	2697	120	RIGHT	R66a.EDF	R66	1
38	3626171	3626301	3414	3544	130	RIGHT	R66a.EDF	R66	1
39	3631254	3631361	198	305	107	RIGHT	R66a.EDF	R66	1
39	3631382	3631395	326	339	13	RIGHT	R66a.EDF	R66	1
39	3631907	3632022	851	966	115	RIGHT	R66a.EDF	R66	1
39	3632046	3632063	990	1007	17	RIGHT	R66a.EDF	R66	1
39	3632520	3632618	1464	1562	98	RIGHT	R66a.EDF	R66	1
39	3632645	3632665	1589	1609	20	RIGHT	R66a.EDF	R66	1
39	3633723	3633848	2667	2792	125	RIGHT	R66a.EDF	R66	1
39	3635276	3635320	4220	4264	44	RIGHT	R66a.EDF	R66	1
39	3635347	3635365	4291	4309	18	RIGHT	R66a.EDF	R66	1
40	3640076	3640184	301	409	108	RIGHT	R66a.EDF	R66	1
40	3640208	3640224	433	449	16	RIGHT	R66a.EDF	R66	1
40	3641218	3641331	1443	1556	113	RIGHT	R66a.EDF	R66	1
40	3641355	3641374	1580	1599	19	RIGHT	R66a.EDF	R66	1
41	3648592	3648712	119	239	120	RIGHT	R66a.EDF	R66	1
41	3648736	3648757	263	284	21	RIGHT	R66a.EDF	R66	1
41	3649254	3649403	781	930	149	RIGHT	R66a.EDF	R66	1
41	3649428	3649446	955	973	18	RIGHT	R66a.EDF	R66	1
41	3649618	3649742	1145	1269	124	RIGHT	R66a.EDF	R66	1
41	3649776	3649794	1303	1321	18	RIGHT	R66a.EDF	R66	1
41	3651782	3651894	3309	3421	112	RIGHT	R66a.EDF	R66	1
42	3655531	3655615	57	141	84	RIGHT	R66a.EDF	R66	1
42	3655636	3655653	162	179	17	RIGHT	R66a.EDF	R66	1
42	3658264	3658348	2790	2874	84	RIGHT	R66a.EDF	R66	1
42	3658877	3659014	3403	3540	137	RIGHT	R66a.EDF	R66	1
43	3664410	3664522	429	541	112	RIGHT	R66a.EDF	R66	1
43	3664543	3664554	562	573	11	RIGHT	R66a.EDF	R66	1
43	3665020	3665118	1039	1137	98	RIGHT	R66a.EDF	R66	1
43	3665147	3665162	1166	1181	15	RIGHT	R66a.EDF	R66	1
43	3666101	3666237	2120	2256	136	RIGHT	R66a.EDF	R66	1
44	3671512	3671534	58	80	22	RIGHT	R66a.EDF	R66	1
44	3672510	3672642	1056	1188	132	RIGHT	R66a.EDF	R66	1
44	3672670	3672688	1216	1234	18	RIGHT	R66a.EDF	R66	1
44	3674076	3674174	2622	2720	98	RIGHT	R66a.EDF	R66	1
45	3679334	3679430	131	227	96	RIGHT	R66a.EDF	R66	1
45	3679451	3679463	248	260	12	RIGHT	R66a.EDF	R66	1
45	3683414	3683505	4211	4302	91	RIGHT	R66a.EDF	R66	1
46	3687225	3687356	481	612	131	RIGHT	R66a.EDF	R66	1
46	3687382	3687402	638	658	20	RIGHT	R66a.EDF	R66	1
46	3688195	3688299	1451	1555	104	RIGHT	R66a.EDF	R66	1
46	3688324	3688339	1580	1595	15	RIGHT	R66a.EDF	R66	1
46	3689761	3689877	3017	3133	116	RIGHT	R66a.EDF	R66	1
47	3693770	3693882	131	243	112	RIGHT	R66a.EDF	R66	1
47	3693909	3693925	270	286	16	RIGHT	R66a.EDF	R66	1
48	3701783	3701899	452	568	116	RIGHT	R66a.EDF	R66	1
48	3701926	3701948	595	617	22	RIGHT	R66a.EDF	R66	1
48	3702137	3702231	806	900	94	RIGHT	R66a.EDF	R66	1
48	3702253	3702271	922	940	18	RIGHT	R66a.EDF	R66	1
48	3703773	3703890	2442	2559	117	RIGHT	R66a.EDF	R66	1
49	3709839	3709945	302	408	106	RIGHT	R66a.EDF	R66	1
49	3709966	3709984	429	447	18	RIGHT	R66a.EDF	R66	1
49	3711945	3712061	2408	2524	116	RIGHT	R66a.EDF	R66	1
49	3714270	3714393	4733	4856	123	RIGHT	R66a.EDF	R66	1
50	3717395	3717556	390	551	161	RIGHT	R66a.EDF	R66	1
50	3718315	3718414	1310	1409	99	RIGHT	R66a.EDF	R66	1
50	3718435	3718448	1430	1443	13	RIGHT	R66a.EDF	R66	1
51	3724754	3724883	130	259	129	RIGHT	R66a.EDF	R66	1
51	3725387	3725518	763	894	131	RIGHT	R66a.EDF	R66	1
51	3725542	3725560	918	936	18	RIGHT	R66a.EDF	R66	1
51	3727123	3727259	2499	2635	136	RIGHT	R66a.EDF	R66	1
51	3728450	3728584	3826	3960	134	RIGHT	R66a.EDF	R66	1
52	3732255	3732300	59	104	45	RIGHT	R66a.EDF	R66	1
52	3732321	3732346	125	150	25	RIGHT	R66a.EDF	R66	1
52	3733279	3733375	1083	1179	96	RIGHT	R66a.EDF	R66	1
52	3733401	3733418	1205	1222	17	RIGHT	R66a.EDF	R66	1
53	3740263	3740407	59	203	144	RIGHT	R66a.EDF	R66	1
53	3740745	3740852	541	648	107	RIGHT	R66a.EDF	R66	1
53	3740878	3740894	674	690	16	RIGHT	R66a.EDF	R66	1
53	3741296	3741396	1092	1192	100	RIGHT	R66a.EDF	R66	1
53	3741423	3741443	1219	1239	20	RIGHT	R66a.EDF	R66	1
54	3748260	3748414	415	569	154	RIGHT	R66a.EDF	R66	1
55	3756646	3756743	1088	1185	97	RIGHT	R66a.EDF	R66	1
55	3756764	3756782	1206	1224	18	RIGHT	R66a.EDF	R66	1
55	3758177	3758313	2619	2755	136	RIGHT	R66a.EDF	R66	1
55	3759642	3759770	4084	4212	128	RIGHT	R66a.EDF	R66	1
55	3760277	3760414	4719	4856	137	RIGHT	R66a.EDF	R66	1
55	3760993	3761021	5435	5463	28	RIGHT	R66a.EDF	R66	1
56	3763000	3763034	58	92	34	RIGHT	R66a.EDF	R66	1
56	3763925	3764038	983	1096	113	RIGHT	R66a.EDF	R66	1
56	3764060	3764077	1118	1135	17	RIGHT	R66a.EDF	R66	1
57	3772012	3772169	247	404	157	RIGHT	R66a.EDF	R66	1
57	3772194	3772208	429	443	14	RIGHT	R66a.EDF	R66	1
57	3772431	3772524	666	759	93	RIGHT	R66a.EDF	R66	1
57	3772553	3772570	788	805	17	RIGHT	R66a.EDF	R66	1
57	3773245	3773328	1480	1563	83	RIGHT	R66a.EDF	R66	1
57	3773353	3773367	1588	1602	14	RIGHT	R66a.EDF	R66	1
58	3779241	3779406	448	613	165	RIGHT	R66a.EDF	R66	1
58	3781777	3781890	2984	3097	113	RIGHT	R66a.EDF	R66	1
59	3787344	3787370	58	84	26	RIGHT	R66a.EDF	R66	1
59	3787398	3787431	112	145	33	RIGHT	R66a.EDF	R66	1
59	3787839	3787944	553	658	105	RIGHT	R66a.EDF	R66	1
59	3787966	3787984	680	698	18	RIGHT	R66a.EDF	R66	1
59	3789799	3789927	2513	2641	128	RIGHT	R66a.EDF	R66	1
60	3798292	3798417	3631	3756	125	RIGHT	R66a.EDF	R66	1
60	3798443	3798468	3782	3807	25	RIGHT	R66a.EDF	R66	1
60	3799050	3799184	4389	4523	134	RIGHT	R66a.EDF	R66	1
60	3799215	3799235	4554	4574	20	RIGHT	R66a.EDF	R66	1
61	3803814	3803940	834	960	126	RIGHT	R66a.EDF	R66	1
61	3803964	3803985	984	1005	21	RIGHT	R66a.EDF	R66	1
62	3810873	3811016	310	453	143	RIGHT	R66a.EDF	R66	1
62	3811514	3811650	951	1087	136	RIGHT	R66a.EDF	R66	1
62	3811676	3811694	1113	1131	18	RIGHT	R66a.EDF	R66	1
62	3812798	3812928	2235	2365	130	RIGHT	R66a.EDF	R66	1
63	3818911	3819020	739	848	109	RIGHT	R66a.EDF	R66	1
63	3819044	3819064	872	892	20	RIGHT	R66a.EDF	R66	1
63	3819542	3819641	1370	1469	99	RIGHT	R66a.EDF	R66	1
63	3819665	3819682	1493	1510	17	RIGHT	R66a.EDF	R66	1
63	3820507	3820619	2335	2447	112	RIGHT	R66a.EDF	R66	1
63	3822598	3822679	4426	4507	81	RIGHT	R66a.EDF	R66	1
63	3822701	3822712	4529	4540	11	RIGHT	R66a.EDF	R66	1
64	3827241	3827386	228	373	145	RIGHT	R66a.EDF	R66	1
64	3827409	3827428	396	415	19	RIGHT	R66a.EDF	R66	1
64	3828369	3828447	1356	1434	78	RIGHT	R66a.EDF	R66	1
64	3828470	3828485	1457	1472	15	RIGHT	R66a.EDF	R66	1
65	3834429	3834531	57	159	102	RIGHT	R66a.EDF	R66	1
65	3834553	3834569	181	197	16	RIGHT	R66a.EDF	R66	1
65	3834924	3835031	552	659	107	RIGHT	R66a.EDF	R66	1
65	3835057	3835071	685	699	14	RIGHT	R66a.EDF	R66	1
65	3835743	3835853	1371	1481	110	RIGHT	R66a.EDF	R66	1
65	3835875	3835890	1503	1518	15	RIGHT	R66a.EDF	R66	1
65	3836802	3836933	2430	2561	131	RIGHT	R66a.EDF	R66	1
65	3837824	3837953	3452	3581	129	RIGHT	R66a.EDF	R66	1
66	3842722	3842875	270	423	153	RIGHT	R66a.EDF	R66	1
66	3843468	3843602	1016	1150	134	RIGHT	R66a.EDF	R66	1
66	3843628	3843645	1176	1193	17	RIGHT	R66a.EDF	R66	1
67	3850348	3850497	275	424	149	RIGHT	R66a.EDF	R66	1
67	3852261	3852364	2188	2291	103	RIGHT	R66a.EDF	R66	1
67	3856430	3856554	6357	6481	124	RIGHT	R66a.EDF	R66	1
67	3856719	3856842	6646	6769	123	RIGHT	R66a.EDF	R66	1
68	3859692	3859799	749	856	107	RIGHT	R66a.EDF	R66	1
68	3859823	3859838	880	895	15	RIGHT	R66a.EDF	R66	1
68	3862657	3862768	3714	3825	111	RIGHT	R66a.EDF	R66	1
68	3862803	3862821	3860	3878	18	RIGHT	R66a.EDF	R66	1
68	3863771	3863877	4828	4934	106	RIGHT	R66a.EDF	R66	1
68	3863912	3863940	4969	4997	28	RIGHT	R66a.EDF	R66	1
68	3864378	3864498	5435	5555	120	RIGHT	R66a.EDF	R66	1
68	3864530	3864556	5587	5613	26	RIGHT	R66a.EDF	R66	1
69	3866865	3866892	87	114	27	RIGHT	R66a.EDF	R66	1
69	3867911	3868039	1133	1261	128	RIGHT	R66a.EDF	R66	1
69	3868068	3868091	1290	1313	23	RIGHT	R66a.EDF	R66	1
69	3868885	3869013	2107	2235	128	RIGHT	R66a.EDF	R66	1
69	3872041	3872156	5263	5378	115	RIGHT	R66a.EDF	R66	1
69	3872183	3872204	5405	5426	21	RIGHT	R66a.EDF	R66	1
70	3876545	3876686	682	823	141	RIGHT	R66a.EDF	R66	1
70	3876713	3876737	850	874	24	RIGHT	R66a.EDF	R66	1
70	3877375	3877470	1512	1607	95	RIGHT	R66a.EDF	R66	1
70	3877503	3877520	1640	1657	17	RIGHT	R66a.EDF	R66	1
71	3884330	3884440	156	266	110	RIGHT	R66a.EDF	R66	1
71	3884467	3884489	293	315	22	RIGHT	R66a.EDF	R66	1
71	3884539	3884678	365	504	139	RIGHT	R66a.EDF	R66	1
71	3886431	3886543	2257	2369	112	RIGHT	R66a.EDF	R66	1
72	3891957	3892134	58	235	177	RIGHT	R66a.EDF	R66	1
72	3892805	3892953	906	1054	148	RIGHT	R66a.EDF	R66	1
72	3892976	3892992	1077	1093	16	RIGHT	R66a.EDF	R66	1
72	3894238	3894374	2339	2475	136	RIGHT	R66a.EDF	R66	1
73	3899905	3899978	59	132	73	RIGHT	R66a.EDF	R66	1
73	3899999	3900011	153	165	12	RIGHT	R66a.EDF	R66	1
73	3901223	3901314	1377	1468	91	RIGHT	R66a.EDF	R66	1
73	3901335	3901350	1489	1504	15	RIGHT	R66a.EDF	R66	1
74	3908739	3908756	70	87	17	RIGHT	R66a.EDF	R66	1
74	3908936	3909075	267	406	139	RIGHT	R66a.EDF	R66	1
74	3910685	3910818	2016	2149	133	RIGHT	R66a.EDF	R66	1
75	3917262	3917408	424	570	146	RIGHT	R66a.EDF	R66	1
75	3917540	3917645	702	807	105	RIGHT	R66a.EDF	R66	1
75	3917668	3917681	830	843	13	RIGHT	R66a.EDF	R66	1
75	3918247	3918330	1409	1492	83	RIGHT	R66a.EDF	R66	1
75	3918357	3918371	1519	1533	14	RIGHT	R66a.EDF	R66	1
75	3922704	3922780	5866	5942	76	RIGHT	R66a.EDF	R66	1
75	3922804	3922818	5966	5980	14	RIGHT	R66a.EDF	R66	1
75	3923421	3923511	6583	6673	90	RIGHT	R66a.EDF	R66	1
75	3923534	3923546	6696	6708	12	RIGHT	R66a.EDF	R66	1
76	3925409	3925483	58	132	74	RIGHT	R66a.EDF	R66	1
76	3927908	3928024	2557	2673	116	RIGHT	R66a.EDF	R66	1
76	3928726	3928834	3375	3483	108	RIGHT	R66a.EDF	R66	1
77	3934193	3934279	1199	1285	86	RIGHT	R66a.EDF	R66	1
77	3934301	3934319	1307	1325	18	RIGHT	R66a.EDF	R66	1
77	3935403	3935512	2409	2518	109	RIGHT	R66a.EDF	R66	1
78	3940382	3940509	91	218	127	RIGHT	R66a.EDF	R66	1
78	3940531	3940544	240	253	13	RIGHT	R66a.EDF	R66	1
78	3941646	3941768	1355	1477	122	RIGHT	R66a.EDF	R66	1
78	3942594	3942716	2303	2425	122	RIGHT	R66a.EDF	R66	1
79	3947521	3947573	58	110	52	RIGHT	R66a.EDF	R66	1
79	3947596	3947613	133	150	17	RIGHT	R66a.EDF	R66	1
79	3948570	3948676	1107	1213	106	RIGHT	R66a.EDF	R66	1
79	3948702	3948717	1239	1254	15	RIGHT	R66a.EDF	R66	1
79	3949904	3950024	2441	2561	120	RIGHT	R66a.EDF	R66	1
79	3953866	3953948	6403	6485	82	RIGHT	R66a.EDF	R66	1
79	3953971	3953986	6508	6523	15	RIGHT	R66a.EDF	R66	1
79	3954197	3954209	6734	6746	12	RIGHT	R66a.EDF	R66	1
80	3958008	3958114	58	164	106	RIGHT	R66a.EDF	R66	1
80	3958592	3958650	642	700	58	RIGHT	R66a.EDF	R66	1
80	3958685	3958701	735	751	16	RIGHT	R66a.EDF	R66	1
80	3958879	3958968	929	1018	89	RIGHT	R66a.EDF	R66	1
80	3958991	3959002	1041	1052	11	RIGHT	R66a.EDF	R66	1
80	3959968	3960103	2018	2153	135	RIGHT	R66a.EDF	R66	1
81	3964725	3964746	80	101	21	RIGHT	R66a.EDF	R66	1
81	3967300	3967415	2655	2770	115	RIGHT	R66a.EDF	R66	1
82	3972582	3972719	89	226	137	RIGHT	R66a.EDF	R66	1
82	3972741	3972753	248	260	12	RIGHT	R66a.EDF	R66	1
82	3973460	3973571	967	1078	111	RIGHT	R66a.EDF	R66	1
82	3973599	3973618	1106	1125	19	RIGHT	R66a.EDF	R66	1
82	3974659	3974797	2166	2304	138	RIGHT	R66a.EDF	R66	1
82	3975671	3975795	3178	3302	124	RIGHT	R66a.EDF	R66	1
83	3981466	3981578	920	1032	112	RIGHT	R66a.EDF	R66	1
83	3981600	3981615	1054	1069	15	RIGHT	R66a.EDF	R66	1
83	3983172	3983280	2626	2734	108	RIGHT	R66a.EDF	R66	1
84	3988439	3988552	1117	1230	113	RIGHT	R66a.EDF	R66	1
84	3988577	3988604	1255	1282	27	RIGHT	R66a.EDF	R66	1
84	3989492	3989633	2170	2311	141	RIGHT	R66a.EDF	R66	1
85	3996691	3996785	374	468	94	RIGHT	R66a.EDF	R66	1
85	3996809	3996818	492	501	9	RIGHT	R66a.EDF	R66	1
85	3998093	3998188	1776	1871	95	RIGHT	R66a.EDF	R66	1
85	3998213	3998234	1896	1917	21	RIGHT	R66a.EDF	R66	1
85	3998873	3999033	2556	2716	160	RIGHT	R66a.EDF	R66	1
86	4004585	4004690	102	207	105	RIGHT	R66a.EDF	R66	1
86	4004716	4004729	233	246	13	RIGHT	R66a.EDF	R66	1
86	4005397	4005512	914	1029	115	RIGHT	R66a.EDF	R66	1
86	4005543	4005563	1060	1080	20	RIGHT	R66a.EDF	R66	1
86	4005769	4005879	1286	1396	110	RIGHT	R66a.EDF	R66	1
86	4005908	4005925	1425	1442	17	RIGHT	R66a.EDF	R66	1
86	4006866	4006963	2383	2480	97	RIGHT	R66a.EDF	R66	1
86	4006984	4006996	2501	2513	12	RIGHT	R66a.EDF	R66	1
87	4013626	4013758	148	280	132	RIGHT	R66a.EDF	R66	1
87	4014326	4014465	848	987	139	RIGHT	R66a.EDF	R66	1
87	4014499	4014523	1021	1045	24	RIGHT	R66a.EDF	R66	1
87	4015740	4015878	2262	2400	138	RIGHT	R66a.EDF	R66	1
88	4021143	4021252	130	239	109	RIGHT	R66a.EDF	R66	1
88	4021278	4021297	265	284	19	RIGHT	R66a.EDF	R66	1
88	4022028	4022143	1015	1130	115	RIGHT	R66a.EDF	R66	1
88	4022170	4022189	1157	1176	19	RIGHT	R66a.EDF	R66	1
88	4023093	4023239	2080	2226	146	RIGHT	R66a.EDF	R66	1
88	4024910	4024962	3897	3949	52	RIGHT	R66a.EDF	R66	1
88	4024990	4025016	3977	4003	26	RIGHT	R66a.EDF	R66	1
89	4029068	4029173	863	968	105	RIGHT	R66a.EDF	R66	1
89	4029198	4029219	993	1014	21	RIGHT	R66a.EDF	R66	1
89	4030184	4030326	1979	2121	142	RIGHT	R66a.EDF	R66	1
90	4037664	4037806	58	200	142	RIGHT	R66a.EDF	R66	1
90	4038590	4038699	984	1093	109	RIGHT	R66a.EDF	R66	1
90	4038727	4038746	1121	1140	19	RIGHT	R66a.EDF	R66	1
90	4039325	4039418	1719	1812	93	RIGHT	R66a.EDF	R66	1
90	4039447	4039475	1841	1869	28	RIGHT	R66a.EDF	R66	1
90	4040176	4040284	2570	2678	108	RIGHT	R66a.EDF	R66	1
90	4040307	4040323	2701	2717	16	RIGHT	R66a.EDF	R66	1
90	4042075	4042203	4469	4597	128	RIGHT	R66a.EDF	R66	1
90	4042926	4043037	5320	5431	111	RIGHT	R66a.EDF	R66	1
90	4043060	4043079	5454	5473	19	RIGHT	R66a.EDF	R66	1
91	4046573	4046680	295	402	107	RIGHT	R66a.EDF	R66	1
91	4046703	4046721	425	443	18	RIGHT	R66a.EDF	R66	1
92	4054786	4054910	77	201	124	RIGHT	R66a.EDF	R66	1
92	4054935	4054956	226	247	21	RIGHT	R66a.EDF	R66	1
92	4055719	4055835	1010	1126	116	RIGHT	R66a.EDF	R66	1
92	4055861	4055882	1152	1173	21	RIGHT	R66a.EDF	R66	1
92	4056924	4057066	2215	2357	142	RIGHT	R66a.EDF	R66	1
93	4064598	4064743	369	514	145	RIGHT	R66a.EDF	R66	1
93	4065921	4065952	1692	1723	31	RIGHT	R66a.EDF	R66	1
93	4065986	4066011	1757	1782	25	RIGHT	R66a.EDF	R66	1
93	4066820	4066943	2591	2714	123	RIGHT	R66a.EDF	R66	1
94	4072747	4072765	93	111	18	RIGHT	R66a.EDF	R66	1
94	4074608	4074746	1954	2092	138	RIGHT	R66a.EDF	R66	1
95	4080186	4080203	74	91	17	RIGHT	R66a.EDF	R66	1
95	4080367	4080495	255	383	128	RIGHT	R66a.EDF	R66	1
95	4080520	4080542	408	430	22	RIGHT	R66a.EDF	R66	1
95	4081150	4081274	1038	1162	124	RIGHT	R66a.EDF	R66	1
95	4081296	4081323	1184	1211	27	RIGHT	R66a.EDF	R66	1
96	4087473	4087532	58	117	59	RIGHT	R66a.EDF	R66	1
96	4087556	4087577	141	162	21	RIGHT	R66a.EDF	R66	1
96	4088042	4088143	627	728	101	RIGHT	R66a.EDF	R66	1
96	4088169	4088189	754	774	20	RIGHT	R66a.EDF	R66	1
96	4088839	4088920	1424	1505	81	RIGHT	R66a.EDF	R66	1
96	4088943	4088957	1528	1542	14	RIGHT	R66a.EDF	R66	1
97	4094462	4094581	537	656	119	RIGHT	R66a.EDF	R66	1
97	4094610	4094626	685	701	16	RIGHT	R66a.EDF	R66	1
97	4095979	4096135	2054	2210	156	RIGHT	R66a.EDF	R66	1
98	4101089	4101201	115	227	112	RIGHT	R66a.EDF	R66	1
98	4101227	4101239	253	265	12	RIGHT	R66a.EDF	R66	1
98	4101679	4101793	705	819	114	RIGHT	R66a.EDF	R66	1
98	4101817	4101832	843	858	15	RIGHT	R66a.EDF	R66	1
98	4103268	4103385	2294	2411	117	RIGHT	R66a.EDF	R66	1
99	4107833	4107867	58	92	34	RIGHT	R66a.EDF	R66	1
99	4107889	4107905	114	130	16	RIGHT	R66a.EDF	R66	1
99	4108704	4108799	929	1024	95	RIGHT	R66a.EDF	R66	1
99	4108825	4108845	1050	1070	20	RIGHT	R66a.EDF	R66	1
99	4109795	4109929	2020	2154	134	RIGHT	R66a.EDF	R66	1
100	4117119	4117236	787	904	117	RIGHT	R66a.EDF	R66	1
100	4117257	4117280	925	948	23	RIGHT	R66a.EDF	R66	1
100	4118549	4118678	2217	2346	129	RIGHT	R66a.EDF	R66	1
101	4125273	4125384	77	188	111	RIGHT	R66a.EDF	R66	1
101	4125406	4125427	210	231	21	RIGHT	R66a.EDF	R66	1
101	4126182	4126317	986	1121	135	RIGHT	R66a.EDF	R66	1
101	4126343	4126369	1147	1173	26	RIGHT	R66a.EDF	R66	1
101	4127709	4127813	2513	2617	104	RIGHT	R66a.EDF	R66	1
102	4132800	4132902	58	160	102	RIGHT	R66a.EDF	R66	1
102	4132925	4132943	183	201	18	RIGHT	R66a.EDF	R66	1
102	4133715	4133830	973	1088	115	RIGHT	R66a.EDF	R66	1
102	4133859	4133880	1117	1138	21	RIGHT	R66a.EDF	R66	1
102	4134724	4134863	1982	2121	139	RIGHT	R66a.EDF	R66	1
103	4141379	4141520	134	275	141	RIGHT	R66a.EDF	R66	1
103	4142884	4142974	1639	1729	90	RIGHT	R66a.EDF	R66	1
103	4143001	4143022	1756	1777	21	RIGHT	R66a.EDF	R66	1
103	4143561	4143691	2316	2446	130	RIGHT	R66a.EDF	R66	1
103	4143714	4143731	2469	2486	17	RIGHT	R66a.EDF	R66	1
104	4150397	4150496	144	243	99	RIGHT	R66a.EDF	R66	1
104	4150524	4150542	271	289	18	RIGHT	R66a.EDF	R66	1
104	4151176	4151294	923	1041	118	RIGHT	R66a.EDF	R66	1
104	4151321	4151344	1068	1091	23	RIGHT	R66a.EDF	R66	1
104	4152383	4152513	2130	2260	130	RIGHT	R66a.EDF	R66	1
104	4154901	4154985	4648	4732	84	RIGHT	R66a.EDF	R66	1
104	4155016	4155041	4763	4788	25	RIGHT	R66a.EDF	R66	1
105	4159045	4159170	57	182	125	RIGHT	R66a.EDF	R66	1
105	4159736	4159834	748	846	98	RIGHT	R66a.EDF	R66	1
105	4159858	4159877	870	889	19	RIGHT	R66a.EDF	R66	1
105	4161031	4161153	2043	2165	122	RIGHT	R66a.EDF	R66	1
105	4161807	4161920	2819	2932	113	RIGHT	R66a.EDF	R66	1
105	4162424	4162557	3436	3569	133	RIGHT	R66a.EDF	R66	1
106	4167427	4167537	384	494	110	RIGHT	R66a.EDF	R66	1
106	4167558	4167572	515	529	14	RIGHT	R66a.EDF	R66	1
106	4168313	4168427	1270	1384	114	RIGHT	R66a.EDF	R66	1
106	4168452	4168473	1409	1430	21	RIGHT	R66a.EDF	R66	1
106	4169253	4169364	2210	2321	111	RIGHT	R66a.EDF	R66	1
106	4169386	4169401	2343	2358	15	RIGHT	R66a.EDF	R66	1
106	4170419	4170529	3376	3486	110	RIGHT	R66a.EDF	R66	1
106	4170553	4170569	3510	3526	16	RIGHT	R66a.EDF	R66	1
107	4174834	4174947	779	892	113	RIGHT	R66a.EDF	R66	1
107	4174977	4175000	922	945	23	RIGHT	R66a.EDF	R66	1
107	4176123	4176274	2068	2219	151	RIGHT	R66a.EDF	R66	1
107	4176749	4176882	2694	2827	133	RIGHT	R66a.EDF	R66	1
107	4177470	4177569	3415	3514	99	RIGHT	R66a.EDF	R66	1
107	4177593	4177608	3538	3553	15	RIGHT	R66a.EDF	R66	1
108	4183558	4183675	87	204	117	RIGHT	R66a.EDF	R66	1
108	4183709	4183736	238	265	27	RIGHT	R66a.EDF	R66	1
108	4183993	4184123	522	652	130	RIGHT	R66a.EDF	R66	1
108	4184158	4184180	687	709	22	RIGHT	R66a.EDF	R66	1
108	4184874	4184963	1403	1492	89	RIGHT	R66a.EDF	R66	1
108	4184995	4185011	1524	1540	16	RIGHT	R66a.EDF	R66	1
108	4185642	4185785	2171	2314	143	RIGHT	R66a.EDF	R66	1
108	4186964	4187053	3493	3582	89	RIGHT	R66a.EDF	R66	1
108	4187083	4187109	3612	3638	26	RIGHT	R66a.EDF	R66	1
108	4187754	4187858	4283	4387	104	RIGHT	R66a.EDF	R66	1
108	4187885	4187916	4414	4445	31	RIGHT	R66a.EDF	R66	1
108	4188647	4188744	5176	5273	97	RIGHT	R66a.EDF	R66	1
108	4188788	4188833	5317	5362	45	RIGHT	R66a.EDF	R66	1
109	4192180	4192280	894	994	100	RIGHT	R66a.EDF	R66	1
109	4192307	4192328	1021	1042	21	RIGHT	R66a.EDF	R66	1
109	4193507	4193634	2221	2348	127	RIGHT	R66a.EDF	R66	1
110	4199993	4200126	450	583	133	RIGHT	R66a.EDF	R66	1
110	4200149	4200167	606	624	18	RIGHT	R66a.EDF	R66	1
110	4201676	4201811	2133	2268	135	RIGHT	R66a.EDF	R66	1
111	4207643	4207795	276	428	152	RIGHT	R66a.EDF	R66	1
111	4207952	4208067	585	700	115	RIGHT	R66a.EDF	R66	1
111	4208091	4208106	724	739	15	RIGHT	R66a.EDF	R66	1
111	4209442	4209591	2075	2224	149	RIGHT	R66a.EDF	R66	1
111	4210322	4210421	2955	3054	99	RIGHT	R66a.EDF	R66	1
111	4210448	4210466	3081	3099	18	RIGHT	R66a.EDF	R66	1
111	4210902	4211005	3535	3638	103	RIGHT	R66a.EDF	R66	1
111	4211031	4211053	3664	3686	22	RIGHT	R66a.EDF	R66	1
111	4211624	4211739	4257	4372	115	RIGHT	R66a.EDF	R66	1
111	4211766	4211786	4399	4419	20	RIGHT	R66a.EDF	R66	1
111	4212220	4212260	4853	4893	40	RIGHT	R66a.EDF	R66	1
112	4214560	4214677	258	375	117	RIGHT	R66a.EDF	R66	1
112	4214711	4214741	409	439	30	RIGHT	R66a.EDF	R66	1
112	4214994	4215152	692	850	158	RIGHT	R66a.EDF	R66	1
112	4215182	4215201	880	899	19	RIGHT	R66a.EDF	R66	1
112	4215875	4215978	1573	1676	103	RIGHT	R66a.EDF	R66	1
112	4216005	4216021	1703	1719	16	RIGHT	R66a.EDF	R66	1
112	4216722	4216863	2420	2561	141	RIGHT	R66a.EDF	R66	1
113	4223065	4223088	58	81	23	RIGHT	R66a.EDF	R66	1
113	4223549	4223666	542	659	117	RIGHT	R66a.EDF	R66	1
113	4223695	4223716	688	709	21	RIGHT	R66a.EDF	R66	1
113	4224305	4224418	1298	1411	113	RIGHT	R66a.EDF	R66	1
113	4224442	4224467	1435	1460	25	RIGHT	R66a.EDF	R66	1
113	4226693	4226751	3686	3744	58	RIGHT	R66a.EDF	R66	1
113	4226774	4226790	3767	3783	16	RIGHT	R66a.EDF	R66	1
114	4231967	4232072	376	481	105	RIGHT	R66a.EDF	R66	1
114	4232096	4232111	505	520	15	RIGHT	R66a.EDF	R66	1
114	4233451	4233576	1860	1985	125	RIGHT	R66a.EDF	R66	1
115	4238942	4239071	75	204	129	RIGHT	R66a.EDF	R66	1
115	4239093	4239118	226	251	25	RIGHT	R66a.EDF	R66	1
115	4241029	4241172	2162	2305	143	RIGHT	R66a.EDF	R66	1
116	4246010	4246078	59	127	68	RIGHT	R66a.EDF	R66	1
116	4246099	4246119	148	168	20	RIGHT	R66a.EDF	R66	1
116	4248087	4248208	2136	2257	121	RIGHT	R66a.EDF	R66	1
116	4249111	4249204	3160	3253	93	RIGHT	R66a.EDF	R66	1
116	4249228	4249243	3277	3292	15	RIGHT	R66a.EDF	R66	1
116	4250693	4250762	4742	4811	69	RIGHT	R66a.EDF	R66	1
117	4253340	4253420	619	699	80	RIGHT	R66a.EDF	R66	1
117	4253452	4253473	731	752	21	RIGHT	R66a.EDF	R66	1
117	4255306	4255439	2585	2718	133	RIGHT	R66a.EDF	R66	1
118	4260769	4260886	362	479	117	RIGHT	R66a.EDF	R66	1
118	4260909	4260931	502	524	22	RIGHT	R66a.EDF	R66	1
118	4262595	4262726	2188	2319	131	RIGHT	R66a.EDF	R66	1
118	4266750	4266850	6343	6443	100	RIGHT	R66a.EDF	R66	1
118	4266872	4266888	6465	6481	16	RIGHT	R66a.EDF	R66	1
119	4269099	4269212	327	440	113	RIGHT	R66a.EDF	R66	1
119	4269242	4269267	470	495	25	RIGHT	R66a.EDF	R66	1
119	4269991	4270132	1219	1360	141	RIGHT	R66a.EDF	R66	1
119	4270162	4270190	1390	1418	28	RIGHT	R66a.EDF	R66	1
119	4271085	4271185	2313	2413	100	RIGHT	R66a.EDF	R66	1
119	4271208	4271233	2436	2461	25	RIGHT	R66a.EDF	R66	1
119	4271647	4271746	2875	2974	99	RIGHT	R66a.EDF	R66	1
119	4271770	4271788	2998	3016	18	RIGHT	R66a.EDF	R66	1
119	4273894	4273961	5122	5189	67	RIGHT	R66a.EDF	R66	1
119	4273992	4274017	5220	5245	25	RIGHT	R66a.EDF	R66	1
119	4274384	4274485	5612	5713	101	RIGHT	R66a.EDF	R66	1
119	4274515	4274533	5743	5761	18	RIGHT	R66a.EDF	R66	1
120	4277638	4277776	58	196	138	RIGHT	R66a.EDF	R66	1
120	4277807	4277834	227	254	27	RIGHT	R66a.EDF	R66	1
120	4278725	4278846	1145	1266	121	RIGHT	R66a.EDF	R66	1
120	4278872	4278892	1292	1312	20	RIGHT	R66a.EDF	R66	1
120	4279559	4279705	1979	2125	146	RIGHT	R66a.EDF	R66	1
120	4283099	4283201	5519	5621	102	RIGHT	R66a.EDF	R66	1
120	4283228	4283249	5648	5669	21	RIGHT	R66a.EDF	R66	1
1	5329244	5329338	810	904	94	RIGHT	R66b.EDF	R66	2
2	5337374	5337503	181	310	129	RIGHT	R66b.EDF	R66	2
2	5338266	5338370	1073	1177	104	RIGHT	R66b.EDF	R66	2
2	5338395	5338412	1202	1219	17	RIGHT	R66b.EDF	R66	2
2	5338625	5338757	1432	1564	132	RIGHT	R66b.EDF	R66	2
4	5352058	5352210	68	220	152	RIGHT	R66b.EDF	R66	2
6	5369454	5369511	57	114	57	RIGHT	R66b.EDF	R66	2
6	5369538	5369563	141	166	25	RIGHT	R66b.EDF	R66	2
8	5384062	5384082	57	77	20	RIGHT	R66b.EDF	R66	2
8	5384118	5384151	113	146	33	RIGHT	R66b.EDF	R66	2
8	5385770	5385916	1765	1911	146	RIGHT	R66b.EDF	R66	2
9	5393104	5393269	751	916	165	RIGHT	R66b.EDF	R66	2
9	5397008	5397106	4655	4753	98	RIGHT	R66b.EDF	R66	2
9	5397134	5397156	4781	4803	22	RIGHT	R66b.EDF	R66	2
10	5401746	5401897	128	279	151	RIGHT	R66b.EDF	R66	2
10	5406625	5406702	5007	5084	77	RIGHT	R66b.EDF	R66	2
11	5409173	5409300	131	258	127	RIGHT	R66b.EDF	R66	2
11	5409327	5409356	285	314	29	RIGHT	R66b.EDF	R66	2
12	5417026	5417044	71	89	18	RIGHT	R66b.EDF	R66	2
12	5417228	5417373	273	418	145	RIGHT	R66b.EDF	R66	2
12	5417875	5417951	920	996	76	RIGHT	R66b.EDF	R66	2
12	5417977	5417994	1022	1039	17	RIGHT	R66b.EDF	R66	2
13	5425316	5425475	133	292	159	RIGHT	R66b.EDF	R66	2
14	5432955	5433108	195	348	153	RIGHT	R66b.EDF	R66	2
14	5433136	5433158	376	398	22	RIGHT	R66b.EDF	R66	2
14	5433340	5433472	580	712	132	RIGHT	R66b.EDF	R66	2
14	5433496	5433519	736	759	23	RIGHT	R66b.EDF	R66	2
15	5441144	5441291	417	564	147	RIGHT	R66b.EDF	R66	2
15	5444836	5444983	4109	4256	147	RIGHT	R66b.EDF	R66	2
16	5449041	5449078	58	95	37	RIGHT	R66b.EDF	R66	2
16	5449104	5449141	121	158	37	RIGHT	R66b.EDF	R66	2
17	5458041	5458178	110	247	137	RIGHT	R66b.EDF	R66	2
18	5466754	5466806	58	110	52	RIGHT	R66b.EDF	R66	2
19	5476277	5476379	889	991	102	RIGHT	R66b.EDF	R66	2
19	5476403	5476424	1015	1036	21	RIGHT	R66b.EDF	R66	2
20	5484107	5484297	1195	1385	190	RIGHT	R66b.EDF	R66	2
20	5485188	5485315	2276	2403	127	RIGHT	R66b.EDF	R66	2
21	5491982	5492127	362	507	145	RIGHT	R66b.EDF	R66	2
21	5492314	5492432	694	812	118	RIGHT	R66b.EDF	R66	2
21	5492458	5492473	838	853	15	RIGHT	R66b.EDF	R66	2
21	5493926	5494020	2306	2400	94	RIGHT	R66b.EDF	R66	2
22	5498702	5498848	289	435	146	RIGHT	R66b.EDF	R66	2
23	5507261	5507362	103	204	101	RIGHT	R66b.EDF	R66	2
23	5507383	5507402	225	244	19	RIGHT	R66b.EDF	R66	2
23	5508073	5508200	915	1042	127	RIGHT	R66b.EDF	R66	2
24	5515181	5515344	243	406	163	RIGHT	R66b.EDF	R66	2
24	5517094	5517215	2156	2277	121	RIGHT	R66b.EDF	R66	2
25	5522255	5522373	88	206	118	RIGHT	R66b.EDF	R66	2
25	5522406	5522427	239	260	21	RIGHT	R66b.EDF	R66	2
25	5522612	5522735	445	568	123	RIGHT	R66b.EDF	R66	2
25	5524651	5524728	2484	2561	77	RIGHT	R66b.EDF	R66	2
26	5531858	5531986	712	840	128	RIGHT	R66b.EDF	R66	2
26	5532009	5532028	863	882	19	RIGHT	R66b.EDF	R66	2
26	5533122	5533258	1976	2112	136	RIGHT	R66b.EDF	R66	2
26	5534260	5534403	3114	3257	143	RIGHT	R66b.EDF	R66	2
26	5535193	5535352	4047	4206	159	RIGHT	R66b.EDF	R66	2
26	5535920	5536029	4774	4883	109	RIGHT	R66b.EDF	R66	2
26	5536055	5536077	4909	4931	22	RIGHT	R66b.EDF	R66	2
26	5537226	5537278	6080	6132	52	RIGHT	R66b.EDF	R66	2
26	5537301	5537317	6155	6171	16	RIGHT	R66b.EDF	R66	2
26	5537585	5537666	6439	6520	81	RIGHT	R66b.EDF	R66	2
26	5537693	5537708	6547	6562	15	RIGHT	R66b.EDF	R66	2
27	5540473	5540601	978	1106	128	RIGHT	R66b.EDF	R66	2
27	5540624	5540641	1129	1146	17	RIGHT	R66b.EDF	R66	2
28	5548020	5548154	146	280	134	RIGHT	R66b.EDF	R66	2
28	5550136	5550240	2262	2366	104	RIGHT	R66b.EDF	R66	2
29	5555446	5555587	189	330	141	RIGHT	R66b.EDF	R66	2
29	5556550	5556663	1293	1406	113	RIGHT	R66b.EDF	R66	2
29	5556688	5556702	1431	1445	14	RIGHT	R66b.EDF	R66	2
29	5557419	5557556	2162	2299	137	RIGHT	R66b.EDF	R66	2
30	5563350	5563464	58	172	114	RIGHT	R66b.EDF	R66	2
30	5564108	5564188	816	896	80	RIGHT	R66b.EDF	R66	2
30	5564209	5564225	917	933	16	RIGHT	R66b.EDF	R66	2
30	5565645	5565761	2353	2469	116	RIGHT	R66b.EDF	R66	2
30	5566727	5566843	3435	3551	116	RIGHT	R66b.EDF	R66	2
31	5570635	5570771	124	260	136	RIGHT	R66b.EDF	R66	2
31	5572287	5572365	1776	1854	78	RIGHT	R66b.EDF	R66	2
31	5572386	5572406	1875	1895	20	RIGHT	R66b.EDF	R66	2
31	5573259	5573327	2748	2816	68	RIGHT	R66b.EDF	R66	2
32	5577706	5577865	529	688	159	RIGHT	R66b.EDF	R66	2
32	5577890	5577921	713	744	31	RIGHT	R66b.EDF	R66	2
32	5579419	5579539	2242	2362	120	RIGHT	R66b.EDF	R66	2
32	5580984	5581103	3807	3926	119	RIGHT	R66b.EDF	R66	2
33	5585097	5585191	57	151	94	RIGHT	R66b.EDF	R66	2
33	5585215	5585236	175	196	21	RIGHT	R66b.EDF	R66	2
33	5585392	5585518	352	478	126	RIGHT	R66b.EDF	R66	2
33	5585542	5585561	502	521	19	RIGHT	R66b.EDF	R66	2
33	5587190	5587334	2150	2294	144	RIGHT	R66b.EDF	R66	2
34	5593977	5594068	241	332	91	RIGHT	R66b.EDF	R66	2
34	5594103	5594125	367	389	22	RIGHT	R66b.EDF	R66	2
34	5594296	5594433	560	697	137	RIGHT	R66b.EDF	R66	2
34	5594469	5594496	733	760	27	RIGHT	R66b.EDF	R66	2
34	5596156	5596278	2420	2542	122	RIGHT	R66b.EDF	R66	2
35	5600849	5600978	587	716	129	RIGHT	R66b.EDF	R66	2
35	5601000	5601016	738	754	16	RIGHT	R66b.EDF	R66	2
35	5601827	5601917	1565	1655	90	RIGHT	R66b.EDF	R66	2
35	5601941	5601960	1679	1698	19	RIGHT	R66b.EDF	R66	2
35	5602593	5602741	2331	2479	148	RIGHT	R66b.EDF	R66	2
35	5603524	5603641	3262	3379	117	RIGHT	R66b.EDF	R66	2
35	5603662	5603674	3400	3412	12	RIGHT	R66b.EDF	R66	2
35	5605536	5605660	5274	5398	124	RIGHT	R66b.EDF	R66	2
36	5609757	5609929	237	409	172	RIGHT	R66b.EDF	R66	2
36	5610793	5610896	1273	1376	103	RIGHT	R66b.EDF	R66	2
36	5610918	5610931	1398	1411	13	RIGHT	R66b.EDF	R66	2
36	5611729	5611843	2209	2323	114	RIGHT	R66b.EDF	R66	2
36	5612710	5612846	3190	3326	136	RIGHT	R66b.EDF	R66	2
37	5618315	5618452	58	195	137	RIGHT	R66b.EDF	R66	2
37	5619948	5620053	1691	1796	105	RIGHT	R66b.EDF	R66	2
37	5620075	5620094	1818	1837	19	RIGHT	R66b.EDF	R66	2
37	5620662	5620786	2405	2529	124	RIGHT	R66b.EDF	R66	2
37	5622209	5622336	3952	4079	127	RIGHT	R66b.EDF	R66	2
37	5622989	5623108	4732	4851	119	RIGHT	R66b.EDF	R66	2
37	5623524	5623658	5267	5401	134	RIGHT	R66b.EDF	R66	2
38	5626091	5626239	114	262	148	RIGHT	R66b.EDF	R66	2
38	5626565	5626695	588	718	130	RIGHT	R66b.EDF	R66	2
38	5626717	5626733	740	756	16	RIGHT	R66b.EDF	R66	2
38	5627568	5627674	1591	1697	106	RIGHT	R66b.EDF	R66	2
38	5627700	5627717	1723	1740	17	RIGHT	R66b.EDF	R66	2
38	5628408	5628524	2431	2547	116	RIGHT	R66b.EDF	R66	2
38	5630397	5630501	4420	4524	104	RIGHT	R66b.EDF	R66	2
39	5633679	5633773	339	433	94	RIGHT	R66b.EDF	R66	2
39	5633794	5633813	454	473	19	RIGHT	R66b.EDF	R66	2
39	5633961	5634075	621	735	114	RIGHT	R66b.EDF	R66	2
39	5634096	5634111	756	771	15	RIGHT	R66b.EDF	R66	2
39	5634948	5635041	1608	1701	93	RIGHT	R66b.EDF	R66	2
39	5635065	5635086	1725	1746	21	RIGHT	R66b.EDF	R66	2
39	5635672	5635784	2332	2444	112	RIGHT	R66b.EDF	R66	2
40	5640929	5641031	58	160	102	RIGHT	R66b.EDF	R66	2
40	5641648	5641780	777	909	132	RIGHT	R66b.EDF	R66	2
40	5641803	5641822	932	951	19	RIGHT	R66b.EDF	R66	2
40	5643134	5643255	2263	2384	121	RIGHT	R66b.EDF	R66	2
40	5644134	5644149	3263	3278	15	RIGHT	R66b.EDF	R66	2
40	5644377	5644489	3506	3618	112	RIGHT	R66b.EDF	R66	2
41	5649124	5649299	254	429	175	RIGHT	R66b.EDF	R66	2
41	5651001	5651132	2131	2262	131	RIGHT	R66b.EDF	R66	2
42	5657008	5657130	57	179	122	RIGHT	R66b.EDF	R66	2
42	5657778	5657929	827	978	151	RIGHT	R66b.EDF	R66	2
42	5657954	5657983	1003	1032	29	RIGHT	R66b.EDF	R66	2
42	5658619	5658775	1668	1824	156	RIGHT	R66b.EDF	R66	2
42	5658797	5658808	1846	1857	11	RIGHT	R66b.EDF	R66	2
42	5659318	5659462	2367	2511	144	RIGHT	R66b.EDF	R66	2
43	5664896	5665000	57	161	104	RIGHT	R66b.EDF	R66	2
43	5667061	5667195	2222	2356	134	RIGHT	R66b.EDF	R66	2
44	5673395	5673536	544	685	141	RIGHT	R66b.EDF	R66	2
44	5673707	5673818	856	967	111	RIGHT	R66b.EDF	R66	2
44	5673840	5673857	989	1006	17	RIGHT	R66b.EDF	R66	2
44	5674227	5674341	1376	1490	114	RIGHT	R66b.EDF	R66	2
44	5674362	5674373	1511	1522	11	RIGHT	R66b.EDF	R66	2
44	5675000	5675149	2149	2298	149	RIGHT	R66b.EDF	R66	2
45	5682721	5682831	1996	2106	110	RIGHT	R66b.EDF	R66	2
45	5686334	5686449	5609	5724	115	RIGHT	R66b.EDF	R66	2
46	5689006	5689173	383	550	167	RIGHT	R66b.EDF	R66	2
46	5689337	5689484	714	861	147	RIGHT	R66b.EDF	R66	2
46	5689509	5689527	886	904	18	RIGHT	R66b.EDF	R66	2
46	5689786	5689909	1163	1286	123	RIGHT	R66b.EDF	R66	2
46	5689932	5689948	1309	1325	16	RIGHT	R66b.EDF	R66	2
46	5690827	5690961	2204	2338	134	RIGHT	R66b.EDF	R66	2
47	5697318	5697418	957	1057	100	RIGHT	R66b.EDF	R66	2
47	5697439	5697453	1078	1092	14	RIGHT	R66b.EDF	R66	2
47	5698323	5698451	1962	2090	128	RIGHT	R66b.EDF	R66	2
48	5703515	5703610	57	152	95	RIGHT	R66b.EDF	R66	2
48	5704293	5704444	835	986	151	RIGHT	R66b.EDF	R66	2
48	5705655	5705767	2197	2309	112	RIGHT	R66b.EDF	R66	2
49	5711628	5711792	507	671	164	RIGHT	R66b.EDF	R66	2
49	5713221	5713369	2100	2248	148	RIGHT	R66b.EDF	R66	2
50	5720176	5720255	57	136	79	RIGHT	R66b.EDF	R66	2
50	5720280	5720303	161	184	23	RIGHT	R66b.EDF	R66	2
50	5720902	5721040	783	921	138	RIGHT	R66b.EDF	R66	2
50	5721063	5721080	944	961	17	RIGHT	R66b.EDF	R66	2
50	5722799	5722915	2680	2796	116	RIGHT	R66b.EDF	R66	2
51	5729382	5729523	73	214	141	RIGHT	R66b.EDF	R66	2
51	5730209	5730385	900	1076	176	RIGHT	R66b.EDF	R66	2
51	5731385	5731521	2076	2212	136	RIGHT	R66b.EDF	R66	2
52	5739015	5739137	513	635	122	RIGHT	R66b.EDF	R66	2
52	5739160	5739182	658	680	22	RIGHT	R66b.EDF	R66	2
52	5739948	5740058	1446	1556	110	RIGHT	R66b.EDF	R66	2
52	5740079	5740098	1577	1596	19	RIGHT	R66b.EDF	R66	2
52	5740715	5740849	2213	2347	134	RIGHT	R66b.EDF	R66	2
53	5747592	5747758	223	389	166	RIGHT	R66b.EDF	R66	2
53	5749515	5749653	2146	2284	138	RIGHT	R66b.EDF	R66	2
54	5755480	5755586	103	209	106	RIGHT	R66b.EDF	R66	2
54	5755609	5755633	232	256	24	RIGHT	R66b.EDF	R66	2
54	5756204	5756388	827	1011	184	RIGHT	R66b.EDF	R66	2
55	5762218	5762349	113	244	131	RIGHT	R66b.EDF	R66	2
55	5762371	5762388	266	283	17	RIGHT	R66b.EDF	R66	2
55	5763032	5763185	927	1080	153	RIGHT	R66b.EDF	R66	2
55	5763208	5763225	1103	1120	17	RIGHT	R66b.EDF	R66	2
55	5764660	5764799	2555	2694	139	RIGHT	R66b.EDF	R66	2
55	5766441	5766575	4336	4470	134	RIGHT	R66b.EDF	R66	2
55	5767190	5767324	5085	5219	134	RIGHT	R66b.EDF	R66	2
55	5768436	5768583	6331	6478	147	RIGHT	R66b.EDF	R66	2
56	5771221	5771342	317	438	121	RIGHT	R66b.EDF	R66	2
56	5771370	5771392	466	488	22	RIGHT	R66b.EDF	R66	2
57	5779348	5779482	339	473	134	RIGHT	R66b.EDF	R66	2
57	5779506	5779522	497	513	16	RIGHT	R66b.EDF	R66	2
57	5780878	5781008	1869	1999	130	RIGHT	R66b.EDF	R66	2
57	5781569	5781715	2560	2706	146	RIGHT	R66b.EDF	R66	2
58	5786733	5786824	57	148	91	RIGHT	R66b.EDF	R66	2
58	5786845	5786876	169	200	31	RIGHT	R66b.EDF	R66	2
58	5788806	5788948	2130	2272	142	RIGHT	R66b.EDF	R66	2
59	5796198	5796358	117	277	160	RIGHT	R66b.EDF	R66	2
59	5797088	5797206	1007	1125	118	RIGHT	R66b.EDF	R66	2
59	5797227	5797249	1146	1168	22	RIGHT	R66b.EDF	R66	2
59	5798392	5798525	2311	2444	133	RIGHT	R66b.EDF	R66	2
59	5802101	5802196	6020	6115	95	RIGHT	R66b.EDF	R66	2
59	5802221	5802244	6140	6163	23	RIGHT	R66b.EDF	R66	2
59	5802425	5802543	6344	6462	118	RIGHT	R66b.EDF	R66	2
60	5804483	5804698	105	320	215	RIGHT	R66b.EDF	R66	2
60	5806545	5806682	2167	2304	137	RIGHT	R66b.EDF	R66	2
61	5811837	5811964	58	185	127	RIGHT	R66b.EDF	R66	2
61	5812962	5813128	1183	1349	166	RIGHT	R66b.EDF	R66	2
61	5814111	5814260	2332	2481	149	RIGHT	R66b.EDF	R66	2
61	5815620	5815773	3841	3994	153	RIGHT	R66b.EDF	R66	2
62	5819814	5819925	420	531	111	RIGHT	R66b.EDF	R66	2
62	5819951	5819965	557	571	14	RIGHT	R66b.EDF	R66	2
62	5820822	5820978	1428	1584	156	RIGHT	R66b.EDF	R66	2
62	5821582	5821735	2188	2341	153	RIGHT	R66b.EDF	R66	2
63	5827632	5827781	623	772	149	RIGHT	R66b.EDF	R66	2
63	5827805	5827829	796	820	24	RIGHT	R66b.EDF	R66	2
63	5828726	5828866	1717	1857	140	RIGHT	R66b.EDF	R66	2
63	5833610	5833692	6601	6683	82	RIGHT	R66b.EDF	R66	2
64	5835844	5835994	372	522	150	RIGHT	R66b.EDF	R66	2
65	5843865	5844011	57	203	146	RIGHT	R66b.EDF	R66	2
65	5844756	5844905	948	1097	149	RIGHT	R66b.EDF	R66	2
65	5846121	5846261	2313	2453	140	RIGHT	R66b.EDF	R66	2
66	5850555	5850712	58	215	157	RIGHT	R66b.EDF	R66	2
66	5852701	5852828	2204	2331	127	RIGHT	R66b.EDF	R66	2
67	5858568	5858727	479	638	159	RIGHT	R66b.EDF	R66	2
68	5867395	5867553	819	977	158	RIGHT	R66b.EDF	R66	2
68	5867705	5867845	1129	1269	140	RIGHT	R66b.EDF	R66	2
68	5867868	5867888	1292	1312	20	RIGHT	R66b.EDF	R66	2
68	5868608	5868788	2032	2212	180	RIGHT	R66b.EDF	R66	2
69	5873484	5873564	57	137	80	RIGHT	R66b.EDF	R66	2
69	5875671	5875796	2244	2369	125	RIGHT	R66b.EDF	R66	2
70	5882121	5882250	262	391	129	RIGHT	R66b.EDF	R66	2
70	5882279	5882303	420	444	24	RIGHT	R66b.EDF	R66	2
70	5882794	5882953	935	1094	159	RIGHT	R66b.EDF	R66	2
70	5882979	5883004	1120	1145	25	RIGHT	R66b.EDF	R66	2
71	5890559	5890693	321	455	134	RIGHT	R66b.EDF	R66	2
71	5890721	5890748	483	510	27	RIGHT	R66b.EDF	R66	2
71	5892403	5892553	2165	2315	150	RIGHT	R66b.EDF	R66	2
72	5899594	5899747	401	554	153	RIGHT	R66b.EDF	R66	2
72	5899776	5899806	583	613	30	RIGHT	R66b.EDF	R66	2
72	5900010	5900114	817	921	104	RIGHT	R66b.EDF	R66	2
72	5900139	5900160	946	967	21	RIGHT	R66b.EDF	R66	2
72	5901559	5901637	2366	2444	78	RIGHT	R66b.EDF	R66	2
72	5901660	5901676	2467	2483	16	RIGHT	R66b.EDF	R66	2
73	5906375	5906496	1021	1142	121	RIGHT	R66b.EDF	R66	2
73	5906517	5906534	1163	1180	17	RIGHT	R66b.EDF	R66	2
74	5914673	5914777	70	174	104	RIGHT	R66b.EDF	R66	2
74	5914801	5914819	198	216	18	RIGHT	R66b.EDF	R66	2
74	5916743	5916877	2140	2274	134	RIGHT	R66b.EDF	R66	2
75	5926395	5926519	4577	4701	124	RIGHT	R66b.EDF	R66	2
75	5926540	5926568	4722	4750	28	RIGHT	R66b.EDF	R66	2
75	5927286	5927443	5468	5625	157	RIGHT	R66b.EDF	R66	2
76	5929507	5929659	57	209	152	RIGHT	R66b.EDF	R66	2
76	5929684	5929708	234	258	24	RIGHT	R66b.EDF	R66	2
76	5930111	5930220	661	770	109	RIGHT	R66b.EDF	R66	2
76	5930243	5930256	793	806	13	RIGHT	R66b.EDF	R66	2
76	5930664	5930766	1214	1316	102	RIGHT	R66b.EDF	R66	2
76	5930794	5930805	1344	1355	11	RIGHT	R66b.EDF	R66	2
76	5932157	5932280	2707	2830	123	RIGHT	R66b.EDF	R66	2
76	5933355	5933489	3905	4039	134	RIGHT	R66b.EDF	R66	2
77	5938472	5938607	513	648	135	RIGHT	R66b.EDF	R66	2
77	5938629	5938648	670	689	19	RIGHT	R66b.EDF	R66	2
78	5944915	5945058	214	357	143	RIGHT	R66b.EDF	R66	2
78	5947884	5948029	3183	3328	145	RIGHT	R66b.EDF	R66	2
79	5954446	5954605	800	959	159	RIGHT	R66b.EDF	R66	2
79	5955232	5955339	1586	1693	107	RIGHT	R66b.EDF	R66	2
79	5955367	5955385	1721	1739	18	RIGHT	R66b.EDF	R66	2
79	5956001	5956138	2355	2492	137	RIGHT	R66b.EDF	R66	2
80	5961323	5961462	295	434	139	RIGHT	R66b.EDF	R66	2
80	5962155	5962270	1127	1242	115	RIGHT	R66b.EDF	R66	2
80	5962292	5962309	1264	1281	17	RIGHT	R66b.EDF	R66	2
80	5963478	5963600	2450	2572	122	RIGHT	R66b.EDF	R66	2
81	5970998	5971156	945	1103	158	RIGHT	R66b.EDF	R66	2
81	5972251	5972362	2198	2309	111	RIGHT	R66b.EDF	R66	2
82	5977856	5977966	82	192	110	RIGHT	R66b.EDF	R66	2
83	5985356	5985527	87	258	171	RIGHT	R66b.EDF	R66	2
83	5986327	5986512	1058	1243	185	RIGHT	R66b.EDF	R66	2
85	5999708	5999822	212	326	114	RIGHT	R66b.EDF	R66	2
85	5999851	5999877	355	381	26	RIGHT	R66b.EDF	R66	2
85	6000564	6000683	1068	1187	119	RIGHT	R66b.EDF	R66	2
85	6000706	6000724	1210	1228	18	RIGHT	R66b.EDF	R66	2
86	6009104	6009255	808	959	151	RIGHT	R66b.EDF	R66	2
86	6010839	6010980	2543	2684	141	RIGHT	R66b.EDF	R66	2
86	6012245	6012389	3949	4093	144	RIGHT	R66b.EDF	R66	2
86	6013123	6013245	4827	4949	122	RIGHT	R66b.EDF	R66	2
86	6013776	6013914	5480	5618	138	RIGHT	R66b.EDF	R66	2
87	6017626	6017790	896	1060	164	RIGHT	R66b.EDF	R66	2
87	6021548	6021661	4818	4931	113	RIGHT	R66b.EDF	R66	2
88	6025179	6025355	412	588	176	RIGHT	R66b.EDF	R66	2
88	6027202	6027340	2435	2573	138	RIGHT	R66b.EDF	R66	2
89	6033510	6033668	953	1111	158	RIGHT	R66b.EDF	R66	2
90	6040167	6040275	356	464	108	RIGHT	R66b.EDF	R66	2
90	6040296	6040316	485	505	20	RIGHT	R66b.EDF	R66	2
90	6041264	6041411	1453	1600	147	RIGHT	R66b.EDF	R66	2
90	6042333	6042342	2522	2531	9	RIGHT	R66b.EDF	R66	2
90	6042370	6042396	2559	2585	26	RIGHT	R66b.EDF	R66	2
90	6042510	6042633	2699	2822	123	RIGHT	R66b.EDF	R66	2
91	6047033	6047180	178	325	147	RIGHT	R66b.EDF	R66	2
91	6047482	6047654	627	799	172	RIGHT	R66b.EDF	R66	2
91	6047681	6047705	826	850	24	RIGHT	R66b.EDF	R66	2
92	6055872	6056028	269	425	156	RIGHT	R66b.EDF	R66	2
92	6056051	6056079	448	476	28	RIGHT	R66b.EDF	R66	2
92	6057165	6057303	1562	1700	138	RIGHT	R66b.EDF	R66	2
93	6063965	6064072	247	354	107	RIGHT	R66b.EDF	R66	2
93	6064094	6064114	376	396	20	RIGHT	R66b.EDF	R66	2
93	6066752	6066879	3034	3161	127	RIGHT	R66b.EDF	R66	2
94	6071827	6071936	58	167	109	RIGHT	R66b.EDF	R66	2
94	6074990	6075129	3221	3360	139	RIGHT	R66b.EDF	R66	2
95	6079793	6079825	67	99	32	RIGHT	R66b.EDF	R66	2
95	6079859	6079899	133	173	40	RIGHT	R66b.EDF	R66	2
95	6079967	6080112	241	386	145	RIGHT	R66b.EDF	R66	2
95	6080785	6080906	1059	1180	121	RIGHT	R66b.EDF	R66	2
95	6081848	6081993	2122	2267	145	RIGHT	R66b.EDF	R66	2
96	6089352	6089414	1543	1605	62	RIGHT	R66b.EDF	R66	2
96	6089438	6089468	1629	1659	30	RIGHT	R66b.EDF	R66	2
97	6097844	6097938	2345	2439	94	RIGHT	R66b.EDF	R66	2
98	6104008	6104157	159	308	149	RIGHT	R66b.EDF	R66	2
98	6105832	6105977	1983	2128	145	RIGHT	R66b.EDF	R66	2
98	6108398	6108520	4549	4671	122	RIGHT	R66b.EDF	R66	2
99	6112465	6112498	95	128	33	RIGHT	R66b.EDF	R66	2
99	6114752	6114877	2382	2507	125	RIGHT	R66b.EDF	R66	2
99	6116176	6116309	3806	3939	133	RIGHT	R66b.EDF	R66	2
100	6121589	6121733	2410	2554	144	RIGHT	R66b.EDF	R66	2
101	6127480	6127593	1106	1219	113	RIGHT	R66b.EDF	R66	2
101	6127616	6127641	1242	1267	25	RIGHT	R66b.EDF	R66	2
101	6128724	6128839	2350	2465	115	RIGHT	R66b.EDF	R66	2
102	6135100	6135131	57	88	31	RIGHT	R66b.EDF	R66	2
102	6135152	6135185	109	142	33	RIGHT	R66b.EDF	R66	2
102	6137500	6137630	2457	2587	130	RIGHT	R66b.EDF	R66	2
103	6143695	6143807	300	412	112	RIGHT	R66b.EDF	R66	2
103	6143829	6143849	434	454	20	RIGHT	R66b.EDF	R66	2
103	6144729	6144842	1334	1447	113	RIGHT	R66b.EDF	R66	2
103	6144865	6144882	1470	1487	17	RIGHT	R66b.EDF	R66	2
103	6145561	6145720	2166	2325	159	RIGHT	R66b.EDF	R66	2
103	6149852	6150019	6457	6624	167	RIGHT	R66b.EDF	R66	2
104	6153219	6153373	638	792	154	RIGHT	R66b.EDF	R66	2
104	6154184	6154266	1603	1685	82	RIGHT	R66b.EDF	R66	2
104	6154287	6154305	1706	1724	18	RIGHT	R66b.EDF	R66	2
105	6161074	6161191	177	294	117	RIGHT	R66b.EDF	R66	2
105	6161214	6161236	317	339	22	RIGHT	R66b.EDF	R66	2
105	6161408	6161537	511	640	129	RIGHT	R66b.EDF	R66	2
105	6161573	6161596	676	699	23	RIGHT	R66b.EDF	R66	2
105	6162157	6162273	1260	1376	116	RIGHT	R66b.EDF	R66	2
105	6162298	6162324	1401	1427	26	RIGHT	R66b.EDF	R66	2
106	6167906	6167970	58	122	64	RIGHT	R66b.EDF	R66	2
106	6168568	6168650	720	802	82	RIGHT	R66b.EDF	R66	2
106	6168672	6168694	824	846	22	RIGHT	R66b.EDF	R66	2
107	6178268	6178403	2427	2562	135	RIGHT	R66b.EDF	R66	2
109	6191555	6191695	1301	1441	140	RIGHT	R66b.EDF	R66	2
109	6191718	6191735	1464	1481	17	RIGHT	R66b.EDF	R66	2
109	6192754	6192882	2500	2628	128	RIGHT	R66b.EDF	R66	2
109	6196203	6196355	5949	6101	152	RIGHT	R66b.EDF	R66	2
110	6200740	6200843	2442	2545	103	RIGHT	R66b.EDF	R66	2
110	6202156	6202269	3858	3971	113	RIGHT	R66b.EDF	R66	2
111	6207062	6207229	250	417	167	RIGHT	R66b.EDF	R66	2
111	6207444	6207609	632	797	165	RIGHT	R66b.EDF	R66	2
111	6207632	6207656	820	844	24	RIGHT	R66b.EDF	R66	2
112	6214788	6214917	863	992	129	RIGHT	R66b.EDF	R66	2
112	6214938	6214957	1013	1032	19	RIGHT	R66b.EDF	R66	2
112	6216208	6216326	2283	2401	118	RIGHT	R66b.EDF	R66	2
113	6221804	6221903	1063	1162	99	RIGHT	R66b.EDF	R66	2
113	6221926	6221946	1185	1205	20	RIGHT	R66b.EDF	R66	2
114	6227961	6228114	266	419	153	RIGHT	R66b.EDF	R66	2
114	6228395	6228535	700	840	140	RIGHT	R66b.EDF	R66	2
114	6228935	6229051	1240	1356	116	RIGHT	R66b.EDF	R66	2
114	6229074	6229090	1379	1395	16	RIGHT	R66b.EDF	R66	2
115	6236293	6236429	353	489	136	RIGHT	R66b.EDF	R66	2
115	6238473	6238605	2533	2665	132	RIGHT	R66b.EDF	R66	2
116	6246094	6246246	2018	2170	152	RIGHT	R66b.EDF	R66	2
116	6247309	6247464	3233	3388	155	RIGHT	R66b.EDF	R66	2
116	6247956	6248099	3880	4023	143	RIGHT	R66b.EDF	R66	2
117	6250999	6251140	379	520	141	RIGHT	R66b.EDF	R66	2
117	6253074	6253216	2454	2596	142	RIGHT	R66b.EDF	R66	2
118	6259237	6259389	111	263	152	RIGHT	R66b.EDF	R66	2
118	6259410	6259442	284	316	32	RIGHT	R66b.EDF	R66	2
118	6261201	6261339	2075	2213	138	RIGHT	R66b.EDF	R66	2
119	6270132	6270238	2279	2385	106	RIGHT	R66b.EDF	R66	2
119	6271174	6271307	3321	3454	133	RIGHT	R66b.EDF	R66	2
120	6277718	6277843	2344	2469	125	RIGHT	R66b.EDF	R66	2
1	6914306	6914447	57	198	141	RIGHT	R66c.EDF	R66	3
1	6915982	6916068	1733	1819	86	RIGHT	R66c.EDF	R66	3
2	6922391	6922508	271	388	117	RIGHT	R66c.EDF	R66	3
2	6923187	6923323	1067	1203	136	RIGHT	R66c.EDF	R66	3
3	6931854	6931995	787	928	141	RIGHT	R66c.EDF	R66	3
3	6932016	6932040	949	973	24	RIGHT	R66c.EDF	R66	3
4	6940682	6940866	75	259	184	RIGHT	R66c.EDF	R66	3
4	6941968	6942095	1361	1488	127	RIGHT	R66c.EDF	R66	3
4	6942864	6942991	2257	2384	127	RIGHT	R66c.EDF	R66	3
5	6949821	6949970	62	211	149	RIGHT	R66c.EDF	R66	3
5	6950798	6950921	1039	1162	123	RIGHT	R66c.EDF	R66	3
5	6950943	6950966	1184	1207	23	RIGHT	R66c.EDF	R66	3
6	6956557	6956710	76	229	153	RIGHT	R66c.EDF	R66	3
8	6973234	6973339	797	902	105	RIGHT	R66c.EDF	R66	3
8	6973360	6973385	923	948	25	RIGHT	R66c.EDF	R66	3
8	6977117	6977328	4680	4891	211	RIGHT	R66c.EDF	R66	3
8	6977360	6977400	4923	4963	40	RIGHT	R66c.EDF	R66	3
10	6989471	6989609	155	293	138	RIGHT	R66c.EDF	R66	3
11	6996738	6996892	129	283	154	RIGHT	R66c.EDF	R66	3
12	7005719	7005833	1500	1614	114	RIGHT	R66c.EDF	R66	3
12	7005854	7005873	1635	1654	19	RIGHT	R66c.EDF	R66	3
12	7008561	7008670	4342	4451	109	RIGHT	R66c.EDF	R66	3
12	7008704	7008737	4485	4518	33	RIGHT	R66c.EDF	R66	3
13	7011844	7011970	153	279	126	RIGHT	R66c.EDF	R66	3
13	7012589	7012694	898	1003	105	RIGHT	R66c.EDF	R66	3
13	7012721	7012751	1030	1060	30	RIGHT	R66c.EDF	R66	3
13	7015878	7016030	4187	4339	152	RIGHT	R66c.EDF	R66	3
14	7020179	7020295	1169	1285	116	RIGHT	R66c.EDF	R66	3
14	7020316	7020341	1306	1331	25	RIGHT	R66c.EDF	R66	3
15	7031443	7031599	4811	4967	156	RIGHT	R66c.EDF	R66	3
15	7031642	7031685	5010	5053	43	RIGHT	R66c.EDF	R66	3
16	7035504	7035602	1872	1970	98	RIGHT	R66c.EDF	R66	3
16	7035628	7035653	1996	2021	25	RIGHT	R66c.EDF	R66	3
16	7036337	7036460	2705	2828	123	RIGHT	R66c.EDF	R66	3
16	7040568	7040645	6936	7013	77	RIGHT	R66c.EDF	R66	3
17	7045424	7045545	2494	2615	121	RIGHT	R66c.EDF	R66	3
18	7051414	7051568	815	969	154	RIGHT	R66c.EDF	R66	3
19	7058695	7058840	58	203	145	RIGHT	R66c.EDF	R66	3
19	7059424	7059537	787	900	113	RIGHT	R66c.EDF	R66	3
19	7059558	7059578	921	941	20	RIGHT	R66c.EDF	R66	3
19	7061075	7061169	2438	2532	94	RIGHT	R66c.EDF	R66	3
20	7069437	7069557	2856	2976	120	RIGHT	R66c.EDF	R66	3
21	7076497	7076637	1349	1489	140	RIGHT	R66c.EDF	R66	3
21	7079734	7079880	4586	4732	146	RIGHT	R66c.EDF	R66	3
22	7082986	7083164	199	377	178	RIGHT	R66c.EDF	R66	3
22	7083306	7083492	519	705	186	RIGHT	R66c.EDF	R66	3
22	7083520	7083560	733	773	40	RIGHT	R66c.EDF	R66	3
22	7085322	7085408	2535	2621	86	RIGHT	R66c.EDF	R66	3
23	7089750	7089770	57	77	20	RIGHT	R66c.EDF	R66	3
24	7096870	7097007	148	285	137	RIGHT	R66c.EDF	R66	3
25	7105782	7105886	237	341	104	RIGHT	R66c.EDF	R66	3
25	7105914	7105937	369	392	23	RIGHT	R66c.EDF	R66	3
26	7112759	7112918	57	216	159	RIGHT	R66c.EDF	R66	3
26	7115966	7116122	3264	3420	156	RIGHT	R66c.EDF	R66	3
27	7121176	7121312	789	925	136	RIGHT	R66c.EDF	R66	3
27	7122640	7122776	2253	2389	136	RIGHT	R66c.EDF	R66	3
28	7130318	7130434	606	722	116	RIGHT	R66c.EDF	R66	3
28	7130457	7130481	745	769	24	RIGHT	R66c.EDF	R66	3
28	7132157	7132273	2445	2561	116	RIGHT	R66c.EDF	R66	3
29	7138485	7138724	554	793	239	RIGHT	R66c.EDF	R66	3
29	7138745	7138771	814	840	26	RIGHT	R66c.EDF	R66	3
29	7138981	7139140	1050	1209	159	RIGHT	R66c.EDF	R66	3
29	7139170	7139205	1239	1274	35	RIGHT	R66c.EDF	R66	3
29	7139996	7140123	2065	2192	127	RIGHT	R66c.EDF	R66	3
30	7146048	7146173	218	343	125	RIGHT	R66c.EDF	R66	3
31	7155685	7155792	2385	2492	107	RIGHT	R66c.EDF	R66	3
32	7162145	7162367	168	390	222	RIGHT	R66c.EDF	R66	3
32	7163043	7163184	1066	1207	141	RIGHT	R66c.EDF	R66	3
32	7163206	7163230	1229	1253	24	RIGHT	R66c.EDF	R66	3
32	7164314	7164447	2337	2470	133	RIGHT	R66c.EDF	R66	3
33	7171165	7171339	164	338	174	RIGHT	R66c.EDF	R66	3
33	7171864	7172022	863	1021	158	RIGHT	R66c.EDF	R66	3
33	7173047	7173190	2046	2189	143	RIGHT	R66c.EDF	R66	3
34	7177960	7178147	63	250	187	RIGHT	R66c.EDF	R66	3
35	7185540	7185673	57	190	133	RIGHT	R66c.EDF	R66	3
36	7193042	7193194	274	426	152	RIGHT	R66c.EDF	R66	3
36	7193218	7193248	450	480	30	RIGHT	R66c.EDF	R66	3
36	7194926	7195047	2158	2279	121	RIGHT	R66c.EDF	R66	3
37	7200140	7200297	361	518	157	RIGHT	R66c.EDF	R66	3
37	7201794	7201907	2015	2128	113	RIGHT	R66c.EDF	R66	3
37	7203178	7203287	3399	3508	109	RIGHT	R66c.EDF	R66	3
38	7207659	7207836	111	288	177	RIGHT	R66c.EDF	R66	3
38	7208127	7208294	579	746	167	RIGHT	R66c.EDF	R66	3
38	7208318	7208348	770	800	30	RIGHT	R66c.EDF	R66	3
38	7213681	7213811	6133	6263	130	RIGHT	R66c.EDF	R66	3
38	7214274	7214432	6726	6884	158	RIGHT	R66c.EDF	R66	3
39	7216259	7216426	134	301	167	RIGHT	R66c.EDF	R66	3
39	7218144	7218261	2019	2136	117	RIGHT	R66c.EDF	R66	3
40	7223355	7223536	99	280	181	RIGHT	R66c.EDF	R66	3
40	7224388	7224547	1132	1291	159	RIGHT	R66c.EDF	R66	3
40	7225341	7225469	2085	2213	128	RIGHT	R66c.EDF	R66	3
41	7230246	7230425	94	273	179	RIGHT	R66c.EDF	R66	3
41	7231932	7232077	1780	1925	145	RIGHT	R66c.EDF	R66	3
41	7235352	7235529	5200	5377	177	RIGHT	R66c.EDF	R66	3
42	7238944	7239109	176	341	165	RIGHT	R66c.EDF	R66	3
42	7239590	7239723	822	955	133	RIGHT	R66c.EDF	R66	3
42	7239745	7239769	977	1001	24	RIGHT	R66c.EDF	R66	3
42	7241376	7241503	2608	2735	127	RIGHT	R66c.EDF	R66	3
42	7243323	7243445	4555	4677	122	RIGHT	R66c.EDF	R66	3
42	7244269	7244387	5501	5619	118	RIGHT	R66c.EDF	R66	3
43	7248444	7248597	110	263	153	RIGHT	R66c.EDF	R66	3
43	7251013	7251135	2679	2801	122	RIGHT	R66c.EDF	R66	3
44	7255778	7255912	320	454	134	RIGHT	R66c.EDF	R66	3
44	7257735	7257867	2277	2409	132	RIGHT	R66c.EDF	R66	3
44	7262270	7262379	6812	6921	109	RIGHT	R66c.EDF	R66	3
45	7264661	7264678	157	174	17	RIGHT	R66c.EDF	R66	3
45	7264809	7264965	305	461	156	RIGHT	R66c.EDF	R66	3
45	7265814	7265969	1310	1465	155	RIGHT	R66c.EDF	R66	3
45	7267010	7267150	2506	2646	140	RIGHT	R66c.EDF	R66	3
45	7267175	7267201	2671	2697	26	RIGHT	R66c.EDF	R66	3
45	7267833	7267953	3329	3449	120	RIGHT	R66c.EDF	R66	3
46	7272521	7272729	516	724	208	RIGHT	R66c.EDF	R66	3
46	7276405	7276549	4400	4544	144	RIGHT	R66c.EDF	R66	3
47	7281060	7281269	78	287	209	RIGHT	R66c.EDF	R66	3
47	7282057	7282245	1075	1263	188	RIGHT	R66c.EDF	R66	3
47	7283287	7283437	2305	2455	150	RIGHT	R66c.EDF	R66	3
47	7284167	7284292	3185	3310	125	RIGHT	R66c.EDF	R66	3
48	7289554	7289740	516	702	186	RIGHT	R66c.EDF	R66	3
48	7291210	7291325	2172	2287	115	RIGHT	R66c.EDF	R66	3
48	7291558	7291721	2520	2683	163	RIGHT	R66c.EDF	R66	3
48	7295142	7295287	6104	6249	145	RIGHT	R66c.EDF	R66	3
49	7297939	7298124	166	351	185	RIGHT	R66c.EDF	R66	3
49	7300036	7300159	2263	2386	123	RIGHT	R66c.EDF	R66	3
49	7302271	7302393	4498	4620	122	RIGHT	R66c.EDF	R66	3
50	7307782	7307921	2269	2408	139	RIGHT	R66c.EDF	R66	3
50	7311921	7312044	6408	6531	123	RIGHT	R66c.EDF	R66	3
51	7314233	7314388	57	212	155	RIGHT	R66c.EDF	R66	3
51	7314880	7315002	704	826	122	RIGHT	R66c.EDF	R66	3
51	7315524	7315642	1348	1466	118	RIGHT	R66c.EDF	R66	3
51	7316276	7316417	2100	2241	141	RIGHT	R66c.EDF	R66	3
52	7323625	7323799	58	232	174	RIGHT	R66c.EDF	R66	3
52	7325992	7326121	2425	2554	129	RIGHT	R66c.EDF	R66	3
52	7327529	7327647	3962	4080	118	RIGHT	R66c.EDF	R66	3
52	7329391	7329504	5824	5937	113	RIGHT	R66c.EDF	R66	3
52	7329526	7329546	5959	5979	20	RIGHT	R66c.EDF	R66	3
53	7332206	7332361	342	497	155	RIGHT	R66c.EDF	R66	3
53	7332387	7332416	523	552	29	RIGHT	R66c.EDF	R66	3
53	7333967	7334107	2103	2243	140	RIGHT	R66c.EDF	R66	3
53	7335455	7335589	3591	3725	134	RIGHT	R66c.EDF	R66	3
54	7340219	7340396	518	695	177	RIGHT	R66c.EDF	R66	3
54	7341663	7341809	1962	2108	146	RIGHT	R66c.EDF	R66	3
55	7348735	7348929	390	584	194	RIGHT	R66c.EDF	R66	3
55	7353071	7353240	4726	4895	169	RIGHT	R66c.EDF	R66	3
55	7353912	7354090	5567	5745	178	RIGHT	R66c.EDF	R66	3
56	7358624	7358763	1526	1665	139	RIGHT	R66c.EDF	R66	3
56	7358784	7358811	1686	1713	27	RIGHT	R66c.EDF	R66	3
56	7359334	7359453	2236	2355	119	RIGHT	R66c.EDF	R66	3
57	7364230	7364384	337	491	154	RIGHT	R66c.EDF	R66	3
57	7364982	7365176	1089	1283	194	RIGHT	R66c.EDF	R66	3
57	7366122	7366273	2229	2380	151	RIGHT	R66c.EDF	R66	3
57	7369130	7369298	5237	5405	168	RIGHT	R66c.EDF	R66	3
58	7373150	7373315	1211	1376	165	RIGHT	R66c.EDF	R66	3
58	7373883	7374027	1944	2088	144	RIGHT	R66c.EDF	R66	3
59	7378789	7378956	257	424	167	RIGHT	R66c.EDF	R66	3
59	7380764	7380889	2232	2357	125	RIGHT	R66c.EDF	R66	3
60	7388053	7388222	404	573	169	RIGHT	R66c.EDF	R66	3
60	7389935	7390089	2286	2440	154	RIGHT	R66c.EDF	R66	3
60	7393211	7393331	5562	5682	120	RIGHT	R66c.EDF	R66	3
60	7393352	7393378	5703	5729	26	RIGHT	R66c.EDF	R66	3
62	7403446	7403659	196	409	213	RIGHT	R66c.EDF	R66	3
62	7404833	7404935	1583	1685	102	RIGHT	R66c.EDF	R66	3
62	7405794	7405904	2544	2654	110	RIGHT	R66c.EDF	R66	3
63	7411948	7412139	731	922	191	RIGHT	R66c.EDF	R66	3
63	7413636	7413770	2419	2553	134	RIGHT	R66c.EDF	R66	3
63	7414365	7414505	3148	3288	140	RIGHT	R66c.EDF	R66	3
63	7415541	7415688	4324	4471	147	RIGHT	R66c.EDF	R66	3
63	7416916	7417036	5699	5819	120	RIGHT	R66c.EDF	R66	3
64	7419662	7419830	765	933	168	RIGHT	R66c.EDF	R66	3
64	7421343	7421480	2446	2583	137	RIGHT	R66c.EDF	R66	3
65	7428876	7429072	594	790	196	RIGHT	R66c.EDF	R66	3
65	7430610	7430773	2328	2491	163	RIGHT	R66c.EDF	R66	3
65	7432215	7432360	3933	4078	145	RIGHT	R66c.EDF	R66	3
65	7433247	7433412	4965	5130	165	RIGHT	R66c.EDF	R66	3
66	7438430	7438606	672	848	176	RIGHT	R66c.EDF	R66	3
66	7439922	7440057	2164	2299	135	RIGHT	R66c.EDF	R66	3
66	7440743	7440869	2985	3111	126	RIGHT	R66c.EDF	R66	3
67	7446715	7446899	1090	1274	184	RIGHT	R66c.EDF	R66	3
67	7448070	7448196	2445	2571	126	RIGHT	R66c.EDF	R66	3
67	7448973	7449120	3348	3495	147	RIGHT	R66c.EDF	R66	3
67	7450270	7450422	4645	4797	152	RIGHT	R66c.EDF	R66	3
68	7453581	7453787	519	725	206	RIGHT	R66c.EDF	R66	3
68	7454996	7455137	1934	2075	141	RIGHT	R66c.EDF	R66	3
68	7456939	7457070	3877	4008	131	RIGHT	R66c.EDF	R66	3
68	7458366	7458485	5304	5423	119	RIGHT	R66c.EDF	R66	3
69	7460867	7461051	406	590	184	RIGHT	R66c.EDF	R66	3
70	7468690	7468883	164	357	193	RIGHT	R66c.EDF	R66	3
70	7468915	7468945	389	419	30	RIGHT	R66c.EDF	R66	3
70	7469633	7469825	1107	1299	192	RIGHT	R66c.EDF	R66	3
70	7470807	7470956	2281	2430	149	RIGHT	R66c.EDF	R66	3
70	7471667	7471809	3141	3283	142	RIGHT	R66c.EDF	R66	3
71	7475923	7476125	239	441	202	RIGHT	R66c.EDF	R66	3
71	7476690	7476877	1006	1193	187	RIGHT	R66c.EDF	R66	3
71	7477761	7477923	2077	2239	162	RIGHT	R66c.EDF	R66	3
71	7479144	7479316	3460	3632	172	RIGHT	R66c.EDF	R66	3
72	7483302	7483508	613	819	206	RIGHT	R66c.EDF	R66	3
72	7485870	7486034	3181	3345	164	RIGHT	R66c.EDF	R66	3
72	7488586	7488744	5897	6055	158	RIGHT	R66c.EDF	R66	3
73	7491252	7491404	58	210	152	RIGHT	R66c.EDF	R66	3
73	7491425	7491453	231	259	28	RIGHT	R66c.EDF	R66	3
73	7492531	7492722	1337	1528	191	RIGHT	R66c.EDF	R66	3
73	7493775	7493918	2581	2724	143	RIGHT	R66c.EDF	R66	3
74	7499457	7499593	970	1106	136	RIGHT	R66c.EDF	R66	3
74	7500949	7501095	2462	2608	146	RIGHT	R66c.EDF	R66	3
75	7505390	7505560	148	318	170	RIGHT	R66c.EDF	R66	3
75	7505586	7505621	344	379	35	RIGHT	R66c.EDF	R66	3
75	7505742	7505948	500	706	206	RIGHT	R66c.EDF	R66	3
75	7506536	7506690	1294	1448	154	RIGHT	R66c.EDF	R66	3
75	7508062	7508191	2820	2949	129	RIGHT	R66c.EDF	R66	3
75	7510106	7510242	4864	5000	136	RIGHT	R66c.EDF	R66	3
76	7515135	7515282	480	627	147	RIGHT	R66c.EDF	R66	3
76	7515304	7515327	649	672	23	RIGHT	R66c.EDF	R66	3
76	7516256	7516442	1601	1787	186	RIGHT	R66c.EDF	R66	3
76	7517190	7517337	2535	2682	147	RIGHT	R66c.EDF	R66	3
76	7518711	7518870	4056	4215	159	RIGHT	R66c.EDF	R66	3
77	7521784	7521979	319	514	195	RIGHT	R66c.EDF	R66	3
77	7523834	7523977	2369	2512	143	RIGHT	R66c.EDF	R66	3
78	7530597	7530777	70	250	180	RIGHT	R66c.EDF	R66	3
79	7538282	7538467	128	313	185	RIGHT	R66c.EDF	R66	3
79	7539140	7539305	986	1151	165	RIGHT	R66c.EDF	R66	3
79	7540480	7540626	2326	2472	146	RIGHT	R66c.EDF	R66	3
80	7546040	7546185	154	299	145	RIGHT	R66c.EDF	R66	3
80	7546207	7546230	321	344	23	RIGHT	R66c.EDF	R66	3
80	7547908	7548044	2022	2158	136	RIGHT	R66c.EDF	R66	3
81	7554134	7554315	611	792	181	RIGHT	R66c.EDF	R66	3
81	7555701	7555854	2178	2331	153	RIGHT	R66c.EDF	R66	3
82	7561950	7562144	823	1017	194	RIGHT	R66c.EDF	R66	3
83	7569125	7569291	198	364	166	RIGHT	R66c.EDF	R66	3
83	7569429	7569635	502	708	206	RIGHT	R66c.EDF	R66	3
83	7570152	7570300	1225	1373	148	RIGHT	R66c.EDF	R66	3
84	7577096	7577278	969	1151	182	RIGHT	R66c.EDF	R66	3
84	7578518	7578652	2391	2525	134	RIGHT	R66c.EDF	R66	3
84	7582327	7582478	6200	6351	151	RIGHT	R66c.EDF	R66	3
85	7584303	7584494	111	302	191	RIGHT	R66c.EDF	R66	3
85	7585342	7585527	1150	1335	185	RIGHT	R66c.EDF	R66	3
85	7586691	7586804	2499	2612	113	RIGHT	R66c.EDF	R66	3
86	7591568	7591727	72	231	159	RIGHT	R66c.EDF	R66	3
86	7593733	7593874	2237	2378	141	RIGHT	R66c.EDF	R66	3
87	7600681	7600870	130	319	189	RIGHT	R66c.EDF	R66	3
87	7602049	7602201	1498	1650	152	RIGHT	R66c.EDF	R66	3
87	7602930	7603080	2379	2529	150	RIGHT	R66c.EDF	R66	3
88	7608562	7608655	58	151	93	RIGHT	R66c.EDF	R66	3
88	7609473	7609683	969	1179	210	RIGHT	R66c.EDF	R66	3
88	7610574	7610720	2070	2216	146	RIGHT	R66c.EDF	R66	3
89	7616810	7616924	57	171	114	RIGHT	R66c.EDF	R66	3
89	7618820	7618929	2067	2176	109	RIGHT	R66c.EDF	R66	3
90	7624112	7624307	126	321	195	RIGHT	R66c.EDF	R66	3
90	7625264	7625374	1278	1388	110	RIGHT	R66c.EDF	R66	3
90	7625636	7625675	1650	1689	39	RIGHT	R66c.EDF	R66	3
90	7626180	7626334	2194	2348	154	RIGHT	R66c.EDF	R66	3
91	7632558	7632754	187	383	196	RIGHT	R66c.EDF	R66	3
91	7634748	7634877	2377	2506	129	RIGHT	R66c.EDF	R66	3
91	7635243	7635390	2872	3019	147	RIGHT	R66c.EDF	R66	3
91	7635871	7636005	3500	3634	134	RIGHT	R66c.EDF	R66	3
91	7637961	7638053	5590	5682	92	RIGHT	R66c.EDF	R66	3
93	7650309	7650469	908	1068	160	RIGHT	R66c.EDF	R66	3
93	7651748	7651885	2347	2484	137	RIGHT	R66c.EDF	R66	3
93	7652776	7652905	3375	3504	129	RIGHT	R66c.EDF	R66	3
94	7657736	7657926	578	768	190	RIGHT	R66c.EDF	R66	3
94	7659493	7659619	2335	2461	126	RIGHT	R66c.EDF	R66	3
95	7665931	7666143	453	665	212	RIGHT	R66c.EDF	R66	3
95	7667630	7667756	2152	2278	126	RIGHT	R66c.EDF	R66	3
96	7674201	7674385	345	529	184	RIGHT	R66c.EDF	R66	3
96	7675991	7676167	2135	2311	176	RIGHT	R66c.EDF	R66	3
96	7679285	7679455	5429	5599	170	RIGHT	R66c.EDF	R66	3
97	7682864	7683124	107	367	260	RIGHT	R66c.EDF	R66	3
97	7683292	7683512	535	755	220	RIGHT	R66c.EDF	R66	3
97	7684421	7684594	1664	1837	173	RIGHT	R66c.EDF	R66	3
97	7685260	7685413	2503	2656	153	RIGHT	R66c.EDF	R66	3
98	7692319	7692457	2184	2322	138	RIGHT	R66c.EDF	R66	3
98	7695014	7695154	4879	5019	140	RIGHT	R66c.EDF	R66	3
99	7697581	7697742	150	311	161	RIGHT	R66c.EDF	R66	3
99	7699548	7699700	2117	2269	152	RIGHT	R66c.EDF	R66	3
99	7700564	7700684	3133	3253	120	RIGHT	R66c.EDF	R66	3
99	7701836	7702003	4405	4572	167	RIGHT	R66c.EDF	R66	3
100	7704629	7704780	204	355	151	RIGHT	R66c.EDF	R66	3
101	7713159	7713372	572	785	213	RIGHT	R66c.EDF	R66	3
101	7714529	7714685	1942	2098	156	RIGHT	R66c.EDF	R66	3
101	7717550	7717690	4963	5103	140	RIGHT	R66c.EDF	R66	3
102	7723500	7723655	2034	2189	155	RIGHT	R66c.EDF	R66	3
103	7730622	7730766	2281	2425	144	RIGHT	R66c.EDF	R66	3
103	7732737	7732854	4396	4513	117	RIGHT	R66c.EDF	R66	3
104	7737598	7737794	324	520	196	RIGHT	R66c.EDF	R66	3
104	7739560	7739717	2286	2443	157	RIGHT	R66c.EDF	R66	3
104	7740260	7740390	2986	3116	130	RIGHT	R66c.EDF	R66	3
105	7745872	7746053	392	573	181	RIGHT	R66c.EDF	R66	3
105	7747519	7747654	2039	2174	135	RIGHT	R66c.EDF	R66	3
105	7748524	7748655	3044	3175	131	RIGHT	R66c.EDF	R66	3
105	7749309	7749465	3829	3985	156	RIGHT	R66c.EDF	R66	3
105	7749917	7750078	4437	4598	161	RIGHT	R66c.EDF	R66	3
106	7752644	7752712	59	127	68	RIGHT	R66c.EDF	R66	3
106	7753086	7753274	501	689	188	RIGHT	R66c.EDF	R66	3
107	7762009	7762189	421	601	180	RIGHT	R66c.EDF	R66	3
107	7763863	7764014	2275	2426	151	RIGHT	R66c.EDF	R66	3
107	7767262	7767431	5674	5843	169	RIGHT	R66c.EDF	R66	3
109	7777188	7777378	139	329	190	RIGHT	R66c.EDF	R66	3
109	7780688	7780842	3639	3793	154	RIGHT	R66c.EDF	R66	3
109	7782922	7783065	5873	6016	143	RIGHT	R66c.EDF	R66	3
109	7783988	7784163	6939	7114	175	RIGHT	R66c.EDF	R66	3
110	7786500	7786655	465	620	155	RIGHT	R66c.EDF	R66	3
110	7788478	7788609	2443	2574	131	RIGHT	R66c.EDF	R66	3
110	7789537	7789674	3502	3639	137	RIGHT	R66c.EDF	R66	3
111	7795257	7795440	206	389	183	RIGHT	R66c.EDF	R66	3
111	7797317	7797435	2266	2384	118	RIGHT	R66c.EDF	R66	3
112	7805214	7805342	2300	2428	128	RIGHT	R66c.EDF	R66	3
113	7812822	7812947	2641	2766	125	RIGHT	R66c.EDF	R66	3
113	7813927	7814090	3746	3909	163	RIGHT	R66c.EDF	R66	3
113	7816029	7816203	5848	6022	174	RIGHT	R66c.EDF	R66	3
114	7820108	7820282	1245	1419	174	RIGHT	R66c.EDF	R66	3
114	7820993	7821150	2130	2287	157	RIGHT	R66c.EDF	R66	3
115	7828365	7828550	874	1059	185	RIGHT	R66c.EDF	R66	3
115	7829899	7830041	2408	2550	142	RIGHT	R66c.EDF	R66	3
115	7833323	7833373	5832	5882	50	RIGHT	R66c.EDF	R66	3
117	7844547	7844702	175	330	155	RIGHT	R66c.EDF	R66	3
117	7846771	7846930	2399	2558	159	RIGHT	R66c.EDF	R66	3
118	7854751	7854927	1147	1323	176	RIGHT	R66c.EDF	R66	3
118	7855654	7855797	2050	2193	143	RIGHT	R66c.EDF	R66	3
119	7862743	7862967	852	1076	224	RIGHT	R66c.EDF	R66	3
119	7864273	7864413	2382	2522	140	RIGHT	R66c.EDF	R66	3
120	7871926	7872132	709	915	206	RIGHT	R66c.EDF	R66	3
120	7873398	7873516	2181	2299	118	RIGHT	R66c.EDF	R66	3
120	7875529	7875663	4312	4446	134	RIGHT	R66c.EDF	R66	3
1	6509096	6509203	307	414	107	RIGHT	S26.EDF	S26	.
1	6510015	6510100	1226	1311	85	RIGHT	S26.EDF	S26	.
6	6551461	6551552	5009	5100	91	RIGHT	S26.EDF	S26	.
6	6551577	6551584	5125	5132	7	RIGHT	S26.EDF	S26	.
7	6560576	6560595	5470	5489	19	RIGHT	S26.EDF	S26	.
7	6560623	6560628	5517	5522	5	RIGHT	S26.EDF	S26	.
8	6568140	6568215	5031	5106	75	RIGHT	S26.EDF	S26	.
9	6574027	6574117	2504	2594	90	RIGHT	S26.EDF	S26	.
9	6574142	6574150	2619	2627	8	RIGHT	S26.EDF	S26	.
11	6587448	6587537	563	652	89	RIGHT	S26.EDF	S26	.
12	6596846	6596932	501	587	86	RIGHT	S26.EDF	S26	.
12	6596955	6596959	610	614	4	RIGHT	S26.EDF	S26	.
12	6602763	6602769	6418	6424	6	RIGHT	S26.EDF	S26	.
14	6618240	6618369	3094	3223	129	RIGHT	S26.EDF	S26	.
14	6618396	6618406	3250	3260	10	RIGHT	S26.EDF	S26	.
17	6639255	6639410	2223	2378	155	RIGHT	S26.EDF	S26	.
18	6644711	6644855	865	1009	144	RIGHT	S26.EDF	S26	.
19	6651340	6651345	89	94	5	RIGHT	S26.EDF	S26	.
21	6669025	6669142	2476	2593	117	RIGHT	S26.EDF	S26	.
25	6700019	6700051	1574	1606	32	RIGHT	S26.EDF	S26	.
26	6706212	6706289	680	757	77	RIGHT	S26.EDF	S26	.
26	6706316	6706324	784	792	8	RIGHT	S26.EDF	S26	.
29	6730286	6730380	870	964	94	RIGHT	S26.EDF	S26	.
30	6737958	6738053	557	652	95	RIGHT	S26.EDF	S26	.
30	6738076	6738080	675	679	4	RIGHT	S26.EDF	S26	.
34	6769530	6769607	751	828	77	RIGHT	S26.EDF	S26	.
34	6769634	6769635	855	856	1	RIGHT	S26.EDF	S26	.
37	6794619	6794686	722	789	67	RIGHT	S26.EDF	S26	.
39	6810658	6810806	2420	2568	148	RIGHT	S26.EDF	S26	.
39	6810829	6810841	2591	2603	12	RIGHT	S26.EDF	S26	.
40	6818266	6818383	644	761	117	RIGHT	S26.EDF	S26	.
40	6818409	6818417	787	795	8	RIGHT	S26.EDF	S26	.
41	6826957	6827044	2101	2188	87	RIGHT	S26.EDF	S26	.
41	6827066	6827071	2210	2215	5	RIGHT	S26.EDF	S26	.
45	6860343	6860431	6177	6265	88	RIGHT	S26.EDF	S26	.
46	6863791	6863975	700	884	184	RIGHT	S26.EDF	S26	.
46	6864003	6864015	912	924	12	RIGHT	S26.EDF	S26	.
46	6865601	6865796	2510	2705	195	RIGHT	S26.EDF	S26	.
47	6872651	6872686	57	92	35	RIGHT	S26.EDF	S26	.
47	6872711	6872725	117	131	14	RIGHT	S26.EDF	S26	.
47	6877307	6877463	4713	4869	156	RIGHT	S26.EDF	S26	.
48	6885644	6885765	5844	5965	121	RIGHT	S26.EDF	S26	.
49	6887731	6887993	57	319	262	RIGHT	S26.EDF	S26	.
49	6888344	6888431	670	757	87	RIGHT	S26.EDF	S26	.
49	6888452	6888472	778	798	20	RIGHT	S26.EDF	S26	.
50	6898013	6898143	2366	2496	130	RIGHT	S26.EDF	S26	.
50	6898168	6898188	2521	2541	20	RIGHT	S26.EDF	S26	.
50	6900486	6900493	4839	4846	7	RIGHT	S26.EDF	S26	.
50	6900586	6900592	4939	4945	6	RIGHT	S26.EDF	S26	.
51	6902663	6902828	57	222	165	RIGHT	S26.EDF	S26	.
55	6939422	6939521	5670	5769	99	RIGHT	S26.EDF	S26	.
55	6939590	6939594	5838	5842	4	RIGHT	S26.EDF	S26	.
56	6944926	6945054	1253	1381	128	RIGHT	S26.EDF	S26	.
56	6945095	6945117	1422	1444	22	RIGHT	S26.EDF	S26	.
58	6962751	6962754	4870	4873	3	RIGHT	S26.EDF	S26	.
59	6967543	6967707	2701	2865	164	RIGHT	S26.EDF	S26	.
59	6967735	6967756	2893	2914	21	RIGHT	S26.EDF	S26	.
61	6982913	6983054	67	208	141	RIGHT	S26.EDF	S26	.
61	6983098	6983106	252	260	8	RIGHT	S26.EDF	S26	.
62	6991003	6991128	57	182	125	RIGHT	S26.EDF	S26	.
62	6991150	6991161	204	215	11	RIGHT	S26.EDF	S26	.
62	6991874	6992003	928	1057	129	RIGHT	S26.EDF	S26	.
62	6992034	6992049	1088	1103	15	RIGHT	S26.EDF	S26	.
62	6997680	6997753	6734	6807	73	RIGHT	S26.EDF	S26	.
63	7003862	7003977	3895	4010	115	RIGHT	S26.EDF	S26	.
63	7004031	7004040	4064	4073	9	RIGHT	S26.EDF	S26	.
64	7008342	7008354	75	87	12	RIGHT	S26.EDF	S26	.
65	7018544	7018688	2750	2894	144	RIGHT	S26.EDF	S26	.
66	7023578	7023775	806	1003	197	RIGHT	S26.EDF	S26	.
67	7032422	7032718	2289	2585	296	RIGHT	S26.EDF	S26	.
67	7033015	7033271	2882	3138	256	RIGHT	S26.EDF	S26	.
68	7039184	7039341	903	1060	157	RIGHT	S26.EDF	S26	.
68	7039378	7039405	1097	1124	27	RIGHT	S26.EDF	S26	.
68	7044910	7045103	6629	6822	193	RIGHT	S26.EDF	S26	.
68	7045132	7045153	6851	6872	21	RIGHT	S26.EDF	S26	.
69	7050823	7050936	3918	4031	113	RIGHT	S26.EDF	S26	.
69	7050992	7051001	4087	4096	9	RIGHT	S26.EDF	S26	.
70	7057015	7057162	1903	2050	147	RIGHT	S26.EDF	S26	.
70	7057322	7057497	2210	2385	175	RIGHT	S26.EDF	S26	.
71	7064629	7064790	2574	2735	161	RIGHT	S26.EDF	S26	.
71	7064812	7064832	2757	2777	20	RIGHT	S26.EDF	S26	.
71	7066812	7066971	4757	4916	159	RIGHT	S26.EDF	S26	.
71	7067003	7067029	4948	4974	26	RIGHT	S26.EDF	S26	.
72	7070638	7070683	72	117	45	RIGHT	S26.EDF	S26	.
72	7073092	7073200	2526	2634	108	RIGHT	S26.EDF	S26	.
72	7073233	7073246	2667	2680	13	RIGHT	S26.EDF	S26	.
73	7077180	7077213	57	90	33	RIGHT	S26.EDF	S26	.
73	7077291	7077366	168	243	75	RIGHT	S26.EDF	S26	.
73	7079163	7079367	2040	2244	204	RIGHT	S26.EDF	S26	.
73	7079388	7079413	2265	2290	25	RIGHT	S26.EDF	S26	.
74	7085708	7085901	643	836	193	RIGHT	S26.EDF	S26	.
74	7085939	7085963	874	898	24	RIGHT	S26.EDF	S26	.
74	7089523	7089732	4458	4667	209	RIGHT	S26.EDF	S26	.
74	7089791	7089831	4726	4766	40	RIGHT	S26.EDF	S26	.
75	7093493	7093651	1754	1912	158	RIGHT	S26.EDF	S26	.
75	7093676	7093690	1937	1951	14	RIGHT	S26.EDF	S26	.
75	7097686	7097696	5947	5957	10	RIGHT	S26.EDF	S26	.
76	7100752	7100946	797	991	194	RIGHT	S26.EDF	S26	.
76	7100994	7101015	1039	1060	21	RIGHT	S26.EDF	S26	.
76	7102328	7102610	2373	2655	282	RIGHT	S26.EDF	S26	.
77	7109528	7109721	65	258	193	RIGHT	S26.EDF	S26	.
77	7109742	7109766	279	303	24	RIGHT	S26.EDF	S26	.
77	7110957	7111127	1494	1664	170	RIGHT	S26.EDF	S26	.
77	7111157	7111176	1694	1713	19	RIGHT	S26.EDF	S26	.
77	7115274	7115426	5811	5963	152	RIGHT	S26.EDF	S26	.
77	7115479	7115507	6016	6044	28	RIGHT	S26.EDF	S26	.
78	7121892	7122016	3984	4108	124	RIGHT	S26.EDF	S26	.
78	7122052	7122064	4144	4156	12	RIGHT	S26.EDF	S26	.
79	7128336	7128460	74	198	124	RIGHT	S26.EDF	S26	.
79	7128501	7128512	239	250	11	RIGHT	S26.EDF	S26	.
79	7129141	7129266	879	1004	125	RIGHT	S26.EDF	S26	.
79	7129300	7129305	1038	1043	5	RIGHT	S26.EDF	S26	.
80	7136850	7137025	299	474	175	RIGHT	S26.EDF	S26	.
80	7138652	7138812	2101	2261	160	RIGHT	S26.EDF	S26	.
80	7138838	7138868	2287	2317	30	RIGHT	S26.EDF	S26	.
81	7146455	7146658	1952	2155	203	RIGHT	S26.EDF	S26	.
81	7149595	7149691	5092	5188	96	RIGHT	S26.EDF	S26	.
81	7149728	7149741	5225	5238	13	RIGHT	S26.EDF	S26	.
82	7153685	7153746	1285	1346	61	RIGHT	S26.EDF	S26	.
82	7153784	7153799	1384	1399	15	RIGHT	S26.EDF	S26	.
82	7158601	7158760	6201	6360	159	RIGHT	S26.EDF	S26	.
83	7165536	7165694	1953	2111	158	RIGHT	S26.EDF	S26	.
84	7171343	7171480	1341	1478	137	RIGHT	S26.EDF	S26	.
84	7171503	7171527	1501	1525	24	RIGHT	S26.EDF	S26	.
85	7177535	7177576	61	102	41	RIGHT	S26.EDF	S26	.
85	7179863	7180008	2389	2534	145	RIGHT	S26.EDF	S26	.
85	7180030	7180048	2556	2574	18	RIGHT	S26.EDF	S26	.
86	7184441	7184475	71	105	34	RIGHT	S26.EDF	S26	.
86	7186701	7186918	2331	2548	217	RIGHT	S26.EDF	S26	.
86	7188402	7188630	4032	4260	228	RIGHT	S26.EDF	S26	.
86	7188670	7188701	4300	4331	31	RIGHT	S26.EDF	S26	.
87	7195109	7195255	2676	2822	146	RIGHT	S26.EDF	S26	.
87	7195280	7195298	2847	2865	18	RIGHT	S26.EDF	S26	.
87	7196035	7196192	3602	3759	157	RIGHT	S26.EDF	S26	.
87	7196221	7196247	3788	3814	26	RIGHT	S26.EDF	S26	.
88	7200821	7200994	694	867	173	RIGHT	S26.EDF	S26	.
88	7201032	7201059	905	932	27	RIGHT	S26.EDF	S26	.
89	7210999	7211108	3286	3395	109	RIGHT	S26.EDF	S26	.
89	7211141	7211161	3428	3448	20	RIGHT	S26.EDF	S26	.
90	7218381	7218525	3954	4098	144	RIGHT	S26.EDF	S26	.
90	7218548	7218574	4121	4147	26	RIGHT	S26.EDF	S26	.
91	7223198	7223427	597	826	229	RIGHT	S26.EDF	S26	.
92	7230951	7231117	72	238	166	RIGHT	S26.EDF	S26	.
92	7231139	7231161	260	282	22	RIGHT	S26.EDF	S26	.
92	7232207	7232306	1328	1427	99	RIGHT	S26.EDF	S26	.
92	7232330	7232344	1451	1465	14	RIGHT	S26.EDF	S26	.
93	7243561	7243669	4383	4491	108	RIGHT	S26.EDF	S26	.
93	7243708	7243723	4530	4545	15	RIGHT	S26.EDF	S26	.
94	7250312	7250448	1532	1668	136	RIGHT	S26.EDF	S26	.
94	7250488	7250496	1708	1716	8	RIGHT	S26.EDF	S26	.
94	7254419	7254521	5639	5741	102	RIGHT	S26.EDF	S26	.
94	7254558	7254558	5778	5778	0	RIGHT	S26.EDF	S26	.
95	7258243	7258458	91	306	215	RIGHT	S26.EDF	S26	.
95	7258779	7259068	627	916	289	RIGHT	S26.EDF	S26	.
95	7260810	7261034	2658	2882	224	RIGHT	S26.EDF	S26	.
96	7265630	7265785	595	750	155	RIGHT	S26.EDF	S26	.
96	7267277	7267459	2242	2424	182	RIGHT	S26.EDF	S26	.
96	7271264	7271410	6229	6375	146	RIGHT	S26.EDF	S26	.
96	7271455	7271483	6420	6448	28	RIGHT	S26.EDF	S26	.
97	7274743	7274932	670	859	189	RIGHT	S26.EDF	S26	.
97	7275653	7275782	1580	1709	129	RIGHT	S26.EDF	S26	.
97	7278604	7278757	4531	4684	153	RIGHT	S26.EDF	S26	.
97	7278803	7278828	4730	4755	25	RIGHT	S26.EDF	S26	.
98	7281699	7281778	313	392	79	RIGHT	S26.EDF	S26	.
98	7281799	7281805	413	419	6	RIGHT	S26.EDF	S26	.
98	7282144	7282337	758	951	193	RIGHT	S26.EDF	S26	.
98	7285128	7285244	3742	3858	116	RIGHT	S26.EDF	S26	.
98	7285274	7285296	3888	3910	22	RIGHT	S26.EDF	S26	.
99	7290128	7290269	693	834	141	RIGHT	S26.EDF	S26	.
100	7301829	7302017	4210	4398	188	RIGHT	S26.EDF	S26	.
100	7302053	7302107	4434	4488	54	RIGHT	S26.EDF	S26	.
101	7308635	7308802	2895	3062	167	RIGHT	S26.EDF	S26	.
101	7308828	7308858	3088	3118	30	RIGHT	S26.EDF	S26	.
102	7316790	7316989	3978	4177	199	RIGHT	S26.EDF	S26	.
102	7317027	7317062	4215	4250	35	RIGHT	S26.EDF	S26	.
103	7324591	7324720	4637	4766	129	RIGHT	S26.EDF	S26	.
103	7324780	7324812	4826	4858	32	RIGHT	S26.EDF	S26	.
104	7326977	7327180	143	346	203	RIGHT	S26.EDF	S26	.
104	7327204	7327231	370	397	27	RIGHT	S26.EDF	S26	.
104	7327882	7328160	1048	1326	278	RIGHT	S26.EDF	S26	.
104	7328192	7328225	1358	1391	33	RIGHT	S26.EDF	S26	.
104	7328498	7328768	1664	1934	270	RIGHT	S26.EDF	S26	.
104	7331795	7331914	4961	5080	119	RIGHT	S26.EDF	S26	.
104	7331964	7331991	5130	5157	27	RIGHT	S26.EDF	S26	.
105	7334302	7334415	57	170	113	RIGHT	S26.EDF	S26	.
105	7334438	7334457	193	212	19	RIGHT	S26.EDF	S26	.
105	7335206	7335340	961	1095	134	RIGHT	S26.EDF	S26	.
105	7335378	7335401	1133	1156	23	RIGHT	S26.EDF	S26	.
105	7338686	7338819	4441	4574	133	RIGHT	S26.EDF	S26	.
105	7338865	7338897	4620	4652	32	RIGHT	S26.EDF	S26	.
106	7343304	7343525	57	278	221	RIGHT	S26.EDF	S26	.
106	7343745	7343922	498	675	177	RIGHT	S26.EDF	S26	.
107	7353031	7353226	2322	2517	195	RIGHT	S26.EDF	S26	.
108	7363849	7363978	5623	5752	129	RIGHT	S26.EDF	S26	.
108	7364028	7364053	5802	5827	25	RIGHT	S26.EDF	S26	.
109	7368379	7368525	690	836	146	RIGHT	S26.EDF	S26	.
109	7368569	7368590	880	901	21	RIGHT	S26.EDF	S26	.
109	7370167	7370378	2478	2689	211	RIGHT	S26.EDF	S26	.
109	7371864	7372117	4175	4428	253	RIGHT	S26.EDF	S26	.
109	7372191	7372318	4502	4629	127	RIGHT	S26.EDF	S26	.
110	7377055	7377253	57	255	198	RIGHT	S26.EDF	S26	.
110	7379663	7379858	2665	2860	195	RIGHT	S26.EDF	S26	.
110	7379898	7379968	2900	2970	70	RIGHT	S26.EDF	S26	.
110	7381455	7381780	4457	4782	325	RIGHT	S26.EDF	S26	.
110	7381838	7381965	4840	4967	127	RIGHT	S26.EDF	S26	.
110	7382638	7382903	5640	5905	265	RIGHT	S26.EDF	S26	.
111	7387343	7387564	2071	2292	221	RIGHT	S26.EDF	S26	.
111	7388281	7388448	3009	3176	167	RIGHT	S26.EDF	S26	.
112	7393717	7393853	297	433	136	RIGHT	S26.EDF	S26	.
113	7401736	7401817	575	656	81	RIGHT	S26.EDF	S26	.
113	7401855	7401869	694	708	14	RIGHT	S26.EDF	S26	.
113	7402822	7402967	1661	1806	145	RIGHT	S26.EDF	S26	.
113	7402989	7403011	1828	1850	22	RIGHT	S26.EDF	S26	.
113	7403347	7403524	2186	2363	177	RIGHT	S26.EDF	S26	.
114	7407964	7408228	57	321	264	RIGHT	S26.EDF	S26	.
114	7408261	7408301	354	394	40	RIGHT	S26.EDF	S26	.
114	7410170	7410408	2263	2501	238	RIGHT	S26.EDF	S26	.
115	7415723	7415895	82	254	172	RIGHT	S26.EDF	S26	.
115	7416640	7416818	999	1177	178	RIGHT	S26.EDF	S26	.
115	7421315	7421468	5674	5827	153	RIGHT	S26.EDF	S26	.
115	7421521	7421564	5880	5923	43	RIGHT	S26.EDF	S26	.
116	7427150	7427268	3675	3793	118	RIGHT	S26.EDF	S26	.
116	7427320	7427357	3845	3882	37	RIGHT	S26.EDF	S26	.
117	7434040	7434186	2353	2499	146	RIGHT	S26.EDF	S26	.
118	7439861	7440016	765	920	155	RIGHT	S26.EDF	S26	.
118	7440039	7440063	943	967	24	RIGHT	S26.EDF	S26	.
119	7448030	7448111	58	139	81	RIGHT	S26.EDF	S26	.
119	7448133	7448157	161	185	24	RIGHT	S26.EDF	S26	.
119	7448846	7449053	874	1081	207	RIGHT	S26.EDF	S26	.
119	7449095	7449121	1123	1149	26	RIGHT	S26.EDF	S26	.
3	9348277	9348431	584	738	154	RIGHT	S311.EDF	S31	1
8	9392187	9392357	121	291	170	RIGHT	S311.EDF	S31	1
9	9405770	9405895	4429	4554	125	RIGHT	S311.EDF	S31	1
11	9418437	9418562	1867	1992	125	RIGHT	S311.EDF	S31	1
12	9426326	9426467	783	924	141	RIGHT	S311.EDF	S31	1
13	9438162	9438345	3803	3986	183	RIGHT	S311.EDF	S31	1
15	9454540	9454759	2875	3094	219	RIGHT	S311.EDF	S31	1
16	9461472	9461564	58	150	92	RIGHT	S311.EDF	S31	1
17	9474563	9474784	4233	4454	221	RIGHT	S311.EDF	S31	1
18	9481510	9481735	1987	2212	225	RIGHT	S311.EDF	S31	1
19	9492599	9492807	5380	5588	208	RIGHT	S311.EDF	S31	1
20	9495395	9495427	57	89	32	RIGHT	S311.EDF	S31	1
20	9496060	9496353	722	1015	293	RIGHT	S311.EDF	S31	1
20	9497464	9497671	2126	2333	207	RIGHT	S311.EDF	S31	1
21	9504110	9504297	160	347	187	RIGHT	S311.EDF	S31	1
22	9513312	9513437	57	182	125	RIGHT	S311.EDF	S31	1
22	9513703	9513874	448	619	171	RIGHT	S311.EDF	S31	1
23	9522389	9522554	804	969	165	RIGHT	S311.EDF	S31	1
25	9536569	9536796	982	1209	227	RIGHT	S311.EDF	S31	1
26	9550414	9550493	5738	5817	79	RIGHT	S311.EDF	S31	1
27	9552560	9552692	57	189	132	RIGHT	S311.EDF	S31	1
28	9562321	9562575	560	814	254	RIGHT	S311.EDF	S31	1
29	9571180	9571341	457	618	161	RIGHT	S311.EDF	S31	1
30	9581921	9582085	2912	3076	164	RIGHT	S311.EDF	S31	1
32	9598091	9598307	2563	2779	216	RIGHT	S311.EDF	S31	1
34	9613172	9613208	58	94	36	RIGHT	S311.EDF	S31	1
34	9613569	9613757	455	643	188	RIGHT	S311.EDF	S31	1
35	9623143	9623367	2550	2774	224	RIGHT	S311.EDF	S31	1
36	9630854	9631059	1224	1429	205	RIGHT	S311.EDF	S31	1
37	9639424	9639599	981	1156	175	RIGHT	S311.EDF	S31	1
38	9646963	9647173	185	395	210	RIGHT	S311.EDF	S31	1
40	9661705	9661852	58	205	147	RIGHT	S311.EDF	S31	1
43	9690905	9691156	2942	3193	251	RIGHT	S311.EDF	S31	1
44	9699562	9699834	2804	3076	272	RIGHT	S311.EDF	S31	1
45	9705005	9705027	57	79	22	RIGHT	S311.EDF	S31	1
45	9707398	9707643	2450	2695	245	RIGHT	S311.EDF	S31	1
47	9723888	9723946	96	154	58	RIGHT	S311.EDF	S31	1
48	9731981	9732169	321	509	188	RIGHT	S311.EDF	S31	1
50	9750552	9750633	57	138	81	RIGHT	S311.EDF	S31	1
52	9770483	9770703	58	278	220	RIGHT	S311.EDF	S31	1
57	9810427	9810506	57	136	79	RIGHT	S311.EDF	S31	1
59	9827572	9827717	57	202	145	RIGHT	S311.EDF	S31	1
62	9851757	9851970	499	712	213	RIGHT	S311.EDF	S31	1
63	9859621	9859726	58	163	105	RIGHT	S311.EDF	S31	1
70	9918065	9918286	57	278	221	RIGHT	S311.EDF	S31	1
70	9921836	9921843	3828	3835	7	RIGHT	S311.EDF	S31	1
70	9921933	9921950	3925	3942	17	RIGHT	S311.EDF	S31	1
70	9921972	9922095	3964	4087	123	RIGHT	S311.EDF	S31	1
70	9922581	9923503	4573	5495	922	RIGHT	S311.EDF	S31	1
71	9930468	9930676	4926	5134	208	RIGHT	S311.EDF	S31	1
72	9934677	9934892	57	272	215	RIGHT	S311.EDF	S31	1
72	9939287	9939287	4667	4667	0	RIGHT	S311.EDF	S31	1
72	9939308	9941203	4688	6583	1895	RIGHT	S311.EDF	S31	1
73	9943751	9943896	57	202	145	RIGHT	S311.EDF	S31	1
74	9951648	9951879	510	741	231	RIGHT	S311.EDF	S31	1
74	9957320	9957353	6182	6215	33	RIGHT	S311.EDF	S31	1
75	9959392	9959721	58	387	329	RIGHT	S311.EDF	S31	1
75	9965738	9965739	6404	6405	1	RIGHT	S311.EDF	S31	1
75	9965761	9965778	6427	6444	17	RIGHT	S311.EDF	S31	1
76	9967709	9967950	473	714	241	RIGHT	S311.EDF	S31	1
77	9980469	9980478	5358	5367	9	RIGHT	S311.EDF	S31	1
77	9980501	9980583	5390	5472	82	RIGHT	S311.EDF	S31	1
77	9980680	9981208	5569	6097	528	RIGHT	S311.EDF	S31	1
81	10009882	10009901	1828	1847	19	RIGHT	S311.EDF	S31	1
81	10011317	10011935	3263	3881	618	RIGHT	S311.EDF	S31	1
82	10017213	10017240	57	84	27	RIGHT	S311.EDF	S31	1
82	10018581	10018588	1425	1432	7	RIGHT	S311.EDF	S31	1
82	10019015	10019117	1859	1961	102	RIGHT	S311.EDF	S31	1
82	10020959	10020971	3803	3815	12	RIGHT	S311.EDF	S31	1
82	10020993	10020999	3837	3843	6	RIGHT	S311.EDF	S31	1
82	10021021	10021530	3865	4374	509	RIGHT	S311.EDF	S31	1
82	10021668	10021668	4512	4512	0	RIGHT	S311.EDF	S31	1
82	10021945	10021945	4789	4789	0	RIGHT	S311.EDF	S31	1
82	10021974	10021974	4818	4818	0	RIGHT	S311.EDF	S31	1
82	10022014	10022014	4858	4858	0	RIGHT	S311.EDF	S31	1
82	10022515	10022624	5359	5468	109	RIGHT	S311.EDF	S31	1
83	10025546	10025750	345	549	204	RIGHT	S311.EDF	S31	1
86	10052696	10053073	2593	2970	377	RIGHT	S311.EDF	S31	1
88	10065483	10065517	57	91	34	RIGHT	S311.EDF	S31	1
89	10073337	10073361	57	81	24	RIGHT	S311.EDF	S31	1
92	10100706	10100806	1264	1364	100	RIGHT	S311.EDF	S31	1
93	10106534	10106651	57	174	117	RIGHT	S311.EDF	S31	1
93	10110065	10110380	3588	3903	315	RIGHT	S311.EDF	S31	1
94	10113858	10113910	57	109	52	RIGHT	S311.EDF	S31	1
97	10135512	10135634	58	180	122	RIGHT	S311.EDF	S31	1
100	10164275	10164296	4667	4688	21	RIGHT	S311.EDF	S31	1
100	10164323	10164349	4715	4741	26	RIGHT	S311.EDF	S31	1
100	10164897	10164897	5289	5289	0	RIGHT	S311.EDF	S31	1
100	10164920	10164995	5312	5387	75	RIGHT	S311.EDF	S31	1
100	10165018	10165020	5410	5412	2	RIGHT	S311.EDF	S31	1
100	10165049	10166292	5441	6684	1243	RIGHT	S311.EDF	S31	1
102	10176336	10176558	57	279	222	RIGHT	S311.EDF	S31	1
104	10192203	10192233	57	87	30	RIGHT	S311.EDF	S31	1
104	10197080	10197205	4934	5059	125	RIGHT	S311.EDF	S31	1
104	10197258	10198863	5112	6717	1605	RIGHT	S311.EDF	S31	1
105	10205617	10205618	4877	4878	1	RIGHT	S311.EDF	S31	1
105	10205672	10205796	4932	5056	124	RIGHT	S311.EDF	S31	1
106	10208916	10209247	1320	1651	331	RIGHT	S311.EDF	S31	1
107	10217766	10217842	1475	1551	76	RIGHT	S311.EDF	S31	1
107	10217915	10218036	1624	1745	121	RIGHT	S311.EDF	S31	1
107	10218651	10219362	2360	3071	711	RIGHT	S311.EDF	S31	1
107	10219914	10219914	3623	3623	0	RIGHT	S311.EDF	S31	1
108	10228756	10228879	4390	4513	123	RIGHT	S311.EDF	S31	1
108	10229144	10229244	4778	4878	100	RIGHT	S311.EDF	S31	1
108	10229579	10229603	5213	5237	24	RIGHT	S311.EDF	S31	1
108	10229629	10229723	5263	5357	94	RIGHT	S311.EDF	S31	1
108	10229795	10229858	5429	5492	63	RIGHT	S311.EDF	S31	1
108	10229903	10229912	5537	5546	9	RIGHT	S311.EDF	S31	1
108	10229942	10230108	5576	5742	166	RIGHT	S311.EDF	S31	1
108	10230215	10231332	5849	6966	1117	RIGHT	S311.EDF	S31	1
109	10233939	10233970	58	89	31	RIGHT	S311.EDF	S31	1
109	10238122	10238122	4241	4241	0	RIGHT	S311.EDF	S31	1
109	10238166	10239502	4285	5621	1336	RIGHT	S311.EDF	S31	1
109	10239721	10240037	5840	6156	316	RIGHT	S311.EDF	S31	1
110	10242167	10242204	79	116	37	RIGHT	S311.EDF	S31	1
110	10247244	10247444	5156	5356	200	RIGHT	S311.EDF	S31	1
112	10257699	10257943	457	701	244	RIGHT	S311.EDF	S31	1
113	10266238	10266292	58	112	54	RIGHT	S311.EDF	S31	1
113	10271755	10271831	5575	5651	76	RIGHT	S311.EDF	S31	1
113	10272165	10272788	5985	6608	623	RIGHT	S311.EDF	S31	1
114	10279575	10279626	3653	3704	51	RIGHT	S311.EDF	S31	1
114	10279779	10279842	3857	3920	63	RIGHT	S311.EDF	S31	1
115	10284811	10285103	1537	1829	292	RIGHT	S311.EDF	S31	1
115	10288054	10288054	4780	4780	0	RIGHT	S311.EDF	S31	1
115	10288078	10288775	4804	5501	697	RIGHT	S311.EDF	S31	1
116	10291352	10291953	57	658	601	RIGHT	S311.EDF	S31	1
116	10292833	10293354	1538	2059	521	RIGHT	S311.EDF	S31	1
116	10295905	10295905	4610	4610	0	RIGHT	S311.EDF	S31	1
116	10295944	10295944	4649	4649	0	RIGHT	S311.EDF	S31	1
116	10296099	10296203	4804	4908	104	RIGHT	S311.EDF	S31	1
116	10296516	10296913	5221	5618	397	RIGHT	S311.EDF	S31	1
116	10296992	10297326	5697	6031	334	RIGHT	S311.EDF	S31	1
116	10297381	10297833	6086	6538	452	RIGHT	S311.EDF	S31	1
117	10301481	10301556	1245	1320	75	RIGHT	S311.EDF	S31	1
117	10301585	10302301	1349	2065	716	RIGHT	S311.EDF	S31	1
117	10303508	10303689	3272	3453	181	RIGHT	S311.EDF	S31	1
117	10303762	10305818	3526	5582	2056	RIGHT	S311.EDF	S31	1
119	10315252	10315416	58	222	164	RIGHT	S311.EDF	S31	1
119	10316474	10316480	1280	1286	6	RIGHT	S311.EDF	S31	1
119	10316675	10316821	1481	1627	146	RIGHT	S311.EDF	S31	1
119	10318364	10318521	3170	3327	157	RIGHT	S311.EDF	S31	1
119	10318593	10318670	3399	3476	77	RIGHT	S311.EDF	S31	1
119	10319527	10320947	4333	5753	1420	RIGHT	S311.EDF	S31	1
120	10325253	10325569	1768	2084	316	RIGHT	S311.EDF	S31	1
120	10328017	10328080	4532	4595	63	RIGHT	S311.EDF	S31	1
120	10328145	10328162	4660	4677	17	RIGHT	S311.EDF	S31	1
120	10328201	10328601	4716	5116	400	RIGHT	S311.EDF	S31	1
6	11354479	11354605	57	183	126	RIGHT	S312.EDF	S31	2
10	11387677	11387772	58	153	95	RIGHT	S312.EDF	S31	2
13	11412285	11412312	58	85	27	RIGHT	S312.EDF	S31	2
14	11420417	11420533	58	174	116	RIGHT	S312.EDF	S31	2
17	11451268	11451517	2747	2996	249	RIGHT	S312.EDF	S31	2
18	11458876	11459145	2483	2752	269	RIGHT	S312.EDF	S31	2
21	11480284	11480354	57	127	70	RIGHT	S312.EDF	S31	2
23	11496423	11496455	68	100	32	RIGHT	S312.EDF	S31	2
23	11498787	11499025	2432	2670	238	RIGHT	S312.EDF	S31	2
25	11515672	11515931	1642	1901	259	RIGHT	S312.EDF	S31	2
28	11539734	11539903	561	730	169	RIGHT	S312.EDF	S31	2
28	11541865	11542099	2692	2926	234	RIGHT	S312.EDF	S31	2
29	11548408	11548620	2160	2372	212	RIGHT	S312.EDF	S31	2
33	11576803	11577050	2357	2604	247	RIGHT	S312.EDF	S31	2
36	11597367	11597436	57	126	69	RIGHT	S312.EDF	S31	2
37	11607282	11607597	3089	3404	315	RIGHT	S312.EDF	S31	2
38	11612697	11612725	57	85	28	RIGHT	S312.EDF	S31	2
39	11620862	11620906	58	102	44	RIGHT	S312.EDF	S31	2
41	11640142	11640362	2414	2634	220	RIGHT	S312.EDF	S31	2
42	11648727	11648935	2485	2693	208	RIGHT	S312.EDF	S31	2
44	11663850	11664075	2870	3095	225	RIGHT	S312.EDF	S31	2
45	11668833	11668937	58	162	104	RIGHT	S312.EDF	S31	2
46	11678749	11678999	2283	2533	250	RIGHT	S312.EDF	S31	2
50	11707983	11708077	57	151	94	RIGHT	S312.EDF	S31	2
50	11710113	11710331	2187	2405	218	RIGHT	S312.EDF	S31	2
51	11719954	11720174	3501	3721	220	RIGHT	S312.EDF	S31	2
53	11732850	11733016	57	223	166	RIGHT	S312.EDF	S31	2
54	11742138	11742234	57	153	96	RIGHT	S312.EDF	S31	2
55	11749368	11749402	57	91	34	RIGHT	S312.EDF	S31	2
56	11758490	11758582	57	149	92	RIGHT	S312.EDF	S31	2
56	11761275	11761580	2842	3147	305	RIGHT	S312.EDF	S31	2
57	11766981	11767034	57	110	53	RIGHT	S312.EDF	S31	2
58	11776237	11776408	57	228	171	RIGHT	S312.EDF	S31	2
59	11784191	11784393	58	260	202	RIGHT	S312.EDF	S31	2
62	11808247	11808326	57	136	79	RIGHT	S312.EDF	S31	2
62	11810390	11810650	2200	2460	260	RIGHT	S312.EDF	S31	2
63	11818806	11819048	3080	3322	242	RIGHT	S312.EDF	S31	2
66	11843789	11844105	2389	2705	316	RIGHT	S312.EDF	S31	2
67	11849795	11849945	57	207	150	RIGHT	S312.EDF	S31	2
68	11857438	11857654	57	273	216	RIGHT	S312.EDF	S31	2
69	11866230	11866255	57	82	25	RIGHT	S312.EDF	S31	2
70	11874736	11874871	57	192	135	RIGHT	S312.EDF	S31	2
72	11890477	11890504	57	84	27	RIGHT	S312.EDF	S31	2
74	11906107	11906272	57	222	165	RIGHT	S312.EDF	S31	2
76	11922489	11922696	258	465	207	RIGHT	S312.EDF	S31	2
77	11929572	11929784	58	270	212	RIGHT	S312.EDF	S31	2
77	11931804	11931940	2290	2426	136	RIGHT	S312.EDF	S31	2
79	11943520	11943567	57	104	47	RIGHT	S312.EDF	S31	2
81	11959119	11959218	57	156	99	RIGHT	S312.EDF	S31	2
82	11965794	11965888	58	152	94	RIGHT	S312.EDF	S31	2
83	11972936	11973155	57	276	219	RIGHT	S312.EDF	S31	2
85	11988318	11988379	57	118	61	RIGHT	S312.EDF	S31	2
85	11991396	11991712	3135	3451	316	RIGHT	S312.EDF	S31	2
86	11997303	11997520	57	274	217	RIGHT	S312.EDF	S31	2
87	12005532	12005588	57	113	56	RIGHT	S312.EDF	S31	2
88	12012384	12012415	57	88	31	RIGHT	S312.EDF	S31	2
91	12036474	12036513	58	97	39	RIGHT	S312.EDF	S31	2
92	12043987	12044058	57	128	71	RIGHT	S312.EDF	S31	2
93	12053863	12054198	923	1258	335	RIGHT	S312.EDF	S31	2
94	12059934	12060055	58	179	121	RIGHT	S312.EDF	S31	2
95	12067887	12067980	1048	1141	93	RIGHT	S312.EDF	S31	2
97	12084202	12084344	58	200	142	RIGHT	S312.EDF	S31	2
99	12101000	12101140	58	198	140	RIGHT	S312.EDF	S31	2
100	12108749	12108878	57	186	129	RIGHT	S312.EDF	S31	2
100	12110962	12111238	2270	2546	276	RIGHT	S312.EDF	S31	2
100	12113883	12113918	5191	5226	35	RIGHT	S312.EDF	S31	2
100	12113943	12114163	5251	5471	220	RIGHT	S312.EDF	S31	2
100	12114187	12114193	5495	5501	6	RIGHT	S312.EDF	S31	2
100	12114408	12115480	5716	6788	1072	RIGHT	S312.EDF	S31	2
101	12117349	12117482	57	190	133	RIGHT	S312.EDF	S31	2
101	12119511	12120015	2219	2723	504	RIGHT	S312.EDF	S31	2
102	12126236	12126310	58	132	74	RIGHT	S312.EDF	S31	2
102	12129150	12129582	2972	3404	432	RIGHT	S312.EDF	S31	2
103	12137928	12138182	2956	3210	254	RIGHT	S312.EDF	S31	2
104	12145072	12145152	2297	2377	80	RIGHT	S312.EDF	S31	2
104	12145531	12145846	2756	3071	315	RIGHT	S312.EDF	S31	2
105	12150891	12151070	489	668	179	RIGHT	S312.EDF	S31	2
109	12185991	12186359	2419	2787	368	RIGHT	S312.EDF	S31	2
109	12188189	12189966	4617	6394	1777	RIGHT	S312.EDF	S31	2
110	12191814	12192297	57	540	483	RIGHT	S312.EDF	S31	2
111	12198699	12199357	58	716	658	RIGHT	S312.EDF	S31	2
111	12203189	12203195	4548	4554	6	RIGHT	S312.EDF	S31	2
111	12203377	12203515	4736	4874	138	RIGHT	S312.EDF	S31	2
111	12203620	12203620	4979	4979	0	RIGHT	S312.EDF	S31	2
112	12208473	12208767	57	351	294	RIGHT	S312.EDF	S31	2
112	12209955	12209955	1539	1539	0	RIGHT	S312.EDF	S31	2
112	12209982	12210605	1566	2189	623	RIGHT	S312.EDF	S31	2
112	12211003	12211269	2587	2853	266	RIGHT	S312.EDF	S31	2
113	12215935	12216132	58	255	197	RIGHT	S312.EDF	S31	2
113	12216160	12216201	283	324	41	RIGHT	S312.EDF	S31	2
115	12235132	12235323	4440	4631	191	RIGHT	S312.EDF	S31	2
115	12235380	12235523	4688	4831	143	RIGHT	S312.EDF	S31	2
115	12235548	12235548	4856	4856	0	RIGHT	S312.EDF	S31	2
115	12235575	12235576	4883	4884	1	RIGHT	S312.EDF	S31	2
115	12235606	12235899	4914	5207	293	RIGHT	S312.EDF	S31	2
115	12236075	12236075	5383	5383	0	RIGHT	S312.EDF	S31	2
115	12236500	12236643	5808	5951	143	RIGHT	S312.EDF	S31	2
115	12236667	12236859	5975	6167	192	RIGHT	S312.EDF	S31	2
115	12236900	12237115	6208	6423	215	RIGHT	S312.EDF	S31	2
115	12237151	12237153	6459	6461	2	RIGHT	S312.EDF	S31	2
116	12239171	12239289	57	175	118	RIGHT	S312.EDF	S31	2
116	12243033	12243705	3919	4591	672	RIGHT	S312.EDF	S31	2
116	12243730	12243830	4616	4716	100	RIGHT	S312.EDF	S31	2
116	12243856	12243856	4742	4742	0	RIGHT	S312.EDF	S31	2
116	12243889	12243920	4775	4806	31	RIGHT	S312.EDF	S31	2
116	12243943	12243959	4829	4845	16	RIGHT	S312.EDF	S31	2
118	12254560	12254668	57	165	108	RIGHT	S312.EDF	S31	2
118	12258737	12258737	4234	4234	0	RIGHT	S312.EDF	S31	2
118	12258794	12261109	4291	6606	2315	RIGHT	S312.EDF	S31	2
119	12263221	12263336	58	173	115	RIGHT	S312.EDF	S31	2
119	12264559	12265307	1396	2144	748	RIGHT	S312.EDF	S31	2
119	12265732	12266224	2569	3061	492	RIGHT	S312.EDF	S31	2
119	12266261	12267215	3098	4052	954	RIGHT	S312.EDF	S31	2
119	12267404	12270235	4241	7072	2831	RIGHT	S312.EDF	S31	2
120	12271929	12272157	122	350	228	RIGHT	S312.EDF	S31	2
1	12791877	12792019	810	952	142	RIGHT	S313.EDF	S31	3
1	12792638	12792861	1571	1794	223	RIGHT	S313.EDF	S31	3
3	12806883	12806911	57	85	28	RIGHT	S313.EDF	S31	3
12	12883315	12883468	536	689	153	RIGHT	S313.EDF	S31	3
17	12921705	12921927	478	700	222	RIGHT	S313.EDF	S31	3
18	12930082	12930216	223	357	134	RIGHT	S313.EDF	S31	3
18	12933008	12933194	3149	3335	186	RIGHT	S313.EDF	S31	3
19	12938688	12938852	455	619	164	RIGHT	S313.EDF	S31	3
19	12940569	12940764	2336	2531	195	RIGHT	S313.EDF	S31	3
21	12953554	12953581	58	85	27	RIGHT	S313.EDF	S31	3
22	12961714	12961764	58	108	50	RIGHT	S313.EDF	S31	3
23	12968860	12969060	427	627	200	RIGHT	S313.EDF	S31	3
24	12975889	12975916	57	84	27	RIGHT	S313.EDF	S31	3
25	12984432	12984602	387	557	170	RIGHT	S313.EDF	S31	3
27	12998851	12998880	58	87	29	RIGHT	S313.EDF	S31	3
28	13005844	13005934	58	148	90	RIGHT	S313.EDF	S31	3
29	13013785	13014008	391	614	223	RIGHT	S313.EDF	S31	3
30	13024290	13024517	2773	3000	227	RIGHT	S313.EDF	S31	3
31	13029980	13030036	57	113	56	RIGHT	S313.EDF	S31	3
32	13038447	13038620	359	532	173	RIGHT	S313.EDF	S31	3
32	13040622	13040856	2534	2768	234	RIGHT	S313.EDF	S31	3
33	13046983	13047202	431	650	219	RIGHT	S313.EDF	S31	3
37	13079980	13080163	57	240	183	RIGHT	S313.EDF	S31	3
38	13087195	13087392	453	650	197	RIGHT	S313.EDF	S31	3
38	13089821	13090024	3079	3282	203	RIGHT	S313.EDF	S31	3
39	13094437	13094511	58	132	74	RIGHT	S313.EDF	S31	3
43	13129297	13129365	57	125	68	RIGHT	S313.EDF	S31	3
48	13170232	13170342	57	167	110	RIGHT	S313.EDF	S31	3
49	13178480	13178549	57	126	69	RIGHT	S313.EDF	S31	3
50	13186536	13186617	57	138	81	RIGHT	S313.EDF	S31	3
53	13209899	13210008	57	166	109	RIGHT	S313.EDF	S31	3
54	13217847	13217890	57	100	43	RIGHT	S313.EDF	S31	3
56	13234577	13234675	58	156	98	RIGHT	S313.EDF	S31	3
57	13243117	13243131	72	86	14	RIGHT	S313.EDF	S31	3
59	13261237	13261413	2642	2818	176	RIGHT	S313.EDF	S31	3
62	13288871	13289036	4472	4637	165	RIGHT	S313.EDF	S31	3
63	13296470	13296695	5268	5493	225	RIGHT	S313.EDF	S31	3
64	13299580	13299649	58	127	69	RIGHT	S313.EDF	S31	3
65	13306370	13306495	327	452	125	RIGHT	S313.EDF	S31	3
67	13322098	13322191	57	150	93	RIGHT	S313.EDF	S31	3
68	13331004	13331027	58	81	23	RIGHT	S313.EDF	S31	3
69	13339824	13340033	599	808	209	RIGHT	S313.EDF	S31	3
77	13403012	13403205	572	765	193	RIGHT	S313.EDF	S31	3
78	13411613	13411788	251	426	175	RIGHT	S313.EDF	S31	3
79	13420958	13421221	452	715	263	RIGHT	S313.EDF	S31	3
80	13430835	13430896	57	118	61	RIGHT	S313.EDF	S31	3
80	13431232	13431459	454	681	227	RIGHT	S313.EDF	S31	3
83	13454234	13454444	489	699	210	RIGHT	S313.EDF	S31	3
83	13457302	13457557	3557	3812	255	RIGHT	S313.EDF	S31	3
85	13468719	13468756	57	94	37	RIGHT	S313.EDF	S31	3
86	13476969	13477167	353	551	198	RIGHT	S313.EDF	S31	3
90	13510536	13510760	88	312	224	RIGHT	S313.EDF	S31	3
92	13527983	13528053	57	127	70	RIGHT	S313.EDF	S31	3
95	13551124	13551196	58	130	72	RIGHT	S313.EDF	S31	3
97	13566943	13567637	64	758	694	RIGHT	S313.EDF	S31	3
97	13567663	13569350	784	2471	1687	RIGHT	S313.EDF	S31	3
97	13571566	13571937	4687	5058	371	RIGHT	S313.EDF	S31	3
98	13576819	13577121	2493	2795	302	RIGHT	S313.EDF	S31	3
100	13594274	13594501	3073	3300	227	RIGHT	S313.EDF	S31	3
102	13609756	13609799	57	100	43	RIGHT	S313.EDF	S31	3
102	13609963	13610182	264	483	219	RIGHT	S313.EDF	S31	3
105	13636074	13636378	322	626	304	RIGHT	S313.EDF	S31	3
107	13653438	13653671	233	466	233	RIGHT	S313.EDF	S31	3
107	13656299	13656497	3094	3292	198	RIGHT	S313.EDF	S31	3
108	13661746	13662036	453	743	290	RIGHT	S313.EDF	S31	3
110	13676297	13676322	57	82	25	RIGHT	S313.EDF	S31	3
110	13676368	13676756	128	516	388	RIGHT	S313.EDF	S31	3
112	13689926	13690171	57	302	245	RIGHT	S313.EDF	S31	3
117	13728019	13728202	76	259	183	RIGHT	S313.EDF	S31	3
118	13736956	13737093	89	226	137	RIGHT	S313.EDF	S31	3
118	13739068	13739187	2201	2320	119	RIGHT	S313.EDF	S31	3
119	13743955	13744183	106	334	228	RIGHT	S313.EDF	S31	3
120	13751872	13752155	379	662	283	RIGHT	S313.EDF	S31	3
1	1962433	1962612	1238	1417	179	RIGHT	S381.EDF	S38	1
3	1980344	1980469	1030	1155	125	RIGHT	S381.EDF	S38	1
6	2009272	2009413	830	971	141	RIGHT	S381.EDF	S38	1
7	2019356	2019459	1103	1206	103	RIGHT	S381.EDF	S38	1
10	2045584	2045707	57	180	123	RIGHT	S381.EDF	S38	1
13	2070667	2070781	76	190	114	RIGHT	S381.EDF	S38	1
25	2183566	2183689	5573	5696	123	RIGHT	S381.EDF	S38	1
30	2228096	2228127	57	88	31	RIGHT	S381.EDF	S38	1
30	2228473	2228671	434	632	198	RIGHT	S381.EDF	S38	1
33	2261516	2261684	2752	2920	168	RIGHT	S381.EDF	S38	1
33	2264799	2264991	6035	6227	192	RIGHT	S381.EDF	S38	1
34	2268277	2268432	57	212	155	RIGHT	S381.EDF	S38	1
36	2289430	2289565	3115	3250	135	RIGHT	S381.EDF	S38	1
40	2325852	2326044	112	304	192	RIGHT	S381.EDF	S38	1
43	2356346	2356422	57	133	76	RIGHT	S381.EDF	S38	1
44	2369367	2369506	3945	4084	139	RIGHT	S381.EDF	S38	1
49	2414858	2415045	732	919	187	RIGHT	S381.EDF	S38	1
52	2442757	2442852	57	152	95	RIGHT	S381.EDF	S38	1
52	2449257	2449434	6557	6734	177	RIGHT	S381.EDF	S38	1
53	2453670	2453814	833	977	144	RIGHT	S381.EDF	S38	1
61	2525934	2525956	170	192	22	RIGHT	S381.EDF	S38	1
62	2534375	2534469	57	151	94	RIGHT	S381.EDF	S38	1
62	2534534	2534535	216	217	1	RIGHT	S381.EDF	S38	1
62	2534563	2534572	245	254	9	RIGHT	S381.EDF	S38	1
62	2534596	2534606	278	288	10	RIGHT	S381.EDF	S38	1
62	2534646	2534697	328	379	51	RIGHT	S381.EDF	S38	1
62	2537637	2537812	3319	3494	175	RIGHT	S381.EDF	S38	1
63	2546629	2546629	3416	3416	0	RIGHT	S381.EDF	S38	1
63	2546775	2546776	3562	3563	1	RIGHT	S381.EDF	S38	1
63	2546805	2546820	3592	3607	15	RIGHT	S381.EDF	S38	1
63	2546861	2546899	3648	3686	38	RIGHT	S381.EDF	S38	1
63	2546933	2549047	3720	5834	2114	RIGHT	S381.EDF	S38	1
64	2554265	2554265	529	529	0	RIGHT	S381.EDF	S38	1
64	2555050	2555050	1314	1314	0	RIGHT	S381.EDF	S38	1
64	2557068	2557068	3332	3332	0	RIGHT	S381.EDF	S38	1
64	2557155	2557156	3419	3420	1	RIGHT	S381.EDF	S38	1
64	2557369	2557370	3633	3634	1	RIGHT	S381.EDF	S38	1
64	2557608	2557609	3872	3873	1	RIGHT	S381.EDF	S38	1
64	2557688	2557692	3952	3956	4	RIGHT	S381.EDF	S38	1
64	2557996	2557996	4260	4260	0	RIGHT	S381.EDF	S38	1
64	2558226	2558226	4490	4490	0	RIGHT	S381.EDF	S38	1
64	2558292	2558292	4556	4556	0	RIGHT	S381.EDF	S38	1
64	2558424	2558466	4688	4730	42	RIGHT	S381.EDF	S38	1
64	2559014	2559014	5278	5278	0	RIGHT	S381.EDF	S38	1
64	2559130	2559145	5394	5409	15	RIGHT	S381.EDF	S38	1
64	2559642	2559642	5906	5906	0	RIGHT	S381.EDF	S38	1
64	2559665	2559666	5929	5930	1	RIGHT	S381.EDF	S38	1
64	2559699	2559699	5963	5963	0	RIGHT	S381.EDF	S38	1
64	2559777	2559782	6041	6046	5	RIGHT	S381.EDF	S38	1
64	2559948	2559948	6212	6212	0	RIGHT	S381.EDF	S38	1
64	2560033	2560034	6297	6298	1	RIGHT	S381.EDF	S38	1
64	2560101	2560142	6365	6406	41	RIGHT	S381.EDF	S38	1
64	2560179	2560229	6443	6493	50	RIGHT	S381.EDF	S38	1
64	2560338	2560344	6602	6608	6	RIGHT	S381.EDF	S38	1
64	2560391	2560391	6655	6655	0	RIGHT	S381.EDF	S38	1
69	2599561	2599774	536	749	213	RIGHT	S381.EDF	S38	1
72	2628097	2628235	1219	1357	138	RIGHT	S381.EDF	S38	1
74	2645147	2645270	561	684	123	RIGHT	S381.EDF	S38	1
79	2690844	2690937	58	151	93	RIGHT	S381.EDF	S38	1
88	2777594	2777763	4712	4881	169	RIGHT	S381.EDF	S38	1
89	2785965	2786126	2854	3015	161	RIGHT	S381.EDF	S38	1
105	2933515	2933572	58	115	57	RIGHT	S381.EDF	S38	1
105	2933945	2934075	488	618	130	RIGHT	S381.EDF	S38	1
108	2962941	2963097	900	1056	156	RIGHT	S381.EDF	S38	1
109	2971287	2971465	459	637	178	RIGHT	S381.EDF	S38	1
114	3020800	3020963	2975	3138	163	RIGHT	S381.EDF	S38	1
114	3020985	3020985	3160	3160	0	RIGHT	S381.EDF	S38	1
116	3042221	3042375	3677	3831	154	RIGHT	S381.EDF	S38	1
117	3049175	3049281	2634	2740	106	RIGHT	S381.EDF	S38	1
119	3065516	3065666	1523	1673	150	RIGHT	S381.EDF	S38	1
120	3072454	3072510	74	130	56	RIGHT	S381.EDF	S38	1
1	4096849	4096959	1148	1258	110	RIGHT	S382.EDF	S38	2
4	4123369	4123506	842	979	137	RIGHT	S382.EDF	S38	2
5	4136070	4136165	4678	4773	95	RIGHT	S382.EDF	S38	2
9	4169636	4169767	1493	1624	131	RIGHT	S382.EDF	S38	2
12	4194276	4194396	57	177	120	RIGHT	S382.EDF	S38	2
13	4204515	4205008	312	805	493	RIGHT	S382.EDF	S38	2
13	4207831	4207925	3628	3722	94	RIGHT	S382.EDF	S38	2
13	4208525	4208684	4322	4481	159	RIGHT	S382.EDF	S38	2
14	4214910	4215020	2603	2713	110	RIGHT	S382.EDF	S38	2
14	4216021	4216160	3714	3853	139	RIGHT	S382.EDF	S38	2
15	4221069	4221187	58	176	118	RIGHT	S382.EDF	S38	2
16	4233355	4233451	3745	3841	96	RIGHT	S382.EDF	S38	2
18	4246435	4246615	725	905	180	RIGHT	S382.EDF	S38	2
19	4254633	4254769	398	534	136	RIGHT	S382.EDF	S38	2
19	4255275	4255457	1040	1222	182	RIGHT	S382.EDF	S38	2
21	4274359	4274482	3012	3135	123	RIGHT	S382.EDF	S38	2
21	4274503	4274503	3156	3156	0	RIGHT	S382.EDF	S38	2
25	4307371	4307559	382	570	188	RIGHT	S382.EDF	S38	2
26	4317611	4317746	2729	2864	135	RIGHT	S382.EDF	S38	2
26	4318143	4318313	3261	3431	170	RIGHT	S382.EDF	S38	2
27	4325437	4325558	2501	2622	121	RIGHT	S382.EDF	S38	2
28	4334098	4334231	2816	2949	133	RIGHT	S382.EDF	S38	2
31	4360418	4360537	1752	1871	119	RIGHT	S382.EDF	S38	2
31	4364668	4364730	6002	6064	62	RIGHT	S382.EDF	S38	2
38	4423479	4423523	99	143	44	RIGHT	S382.EDF	S38	2
40	4442256	4442361	57	162	105	RIGHT	S382.EDF	S38	2
40	4447638	4447789	5439	5590	151	RIGHT	S382.EDF	S38	2
43	4473854	4474021	4305	4472	167	RIGHT	S382.EDF	S38	2
45	4490547	4490720	774	947	173	RIGHT	S382.EDF	S38	2
45	4492843	4493006	3070	3233	163	RIGHT	S382.EDF	S38	2
48	4522563	4522712	3825	3974	149	RIGHT	S382.EDF	S38	2
50	4541698	4541788	4760	4850	90	RIGHT	S382.EDF	S38	2
52	4560149	4560316	4070	4237	167	RIGHT	S382.EDF	S38	2
53	4566372	4566517	57	202	145	RIGHT	S382.EDF	S38	2
54	4577920	4578019	735	834	99	RIGHT	S382.EDF	S38	2
54	4580110	4580254	2925	3069	144	RIGHT	S382.EDF	S38	2
55	4588981	4589037	2241	2297	56	RIGHT	S382.EDF	S38	2
56	4600158	4600174	4112	4128	16	RIGHT	S382.EDF	S38	2
56	4600484	4600637	4438	4591	153	RIGHT	S382.EDF	S38	2
57	4607759	4607919	697	857	160	RIGHT	S382.EDF	S38	2
59	4625432	4625444	870	882	12	RIGHT	S382.EDF	S38	2
61	4645301	4645447	3617	3763	146	RIGHT	S382.EDF	S38	2
62	4657254	4657401	6625	6772	147	RIGHT	S382.EDF	S38	2
63	4660497	4660583	72	158	86	RIGHT	S382.EDF	S38	2
63	4663524	4663683	3099	3258	159	RIGHT	S382.EDF	S38	2
64	4669418	4669559	666	807	141	RIGHT	S382.EDF	S38	2
69	4713379	4713552	4328	4501	173	RIGHT	S382.EDF	S38	2
70	4717205	4717317	734	846	112	RIGHT	S382.EDF	S38	2
71	4727863	4727981	3357	3475	118	RIGHT	S382.EDF	S38	2
74	4753929	4754115	4622	4808	186	RIGHT	S382.EDF	S38	2
76	4770664	4770832	5352	5520	168	RIGHT	S382.EDF	S38	2
77	4776687	4776832	3541	3686	145	RIGHT	S382.EDF	S38	2
78	4783469	4783477	234	242	8	RIGHT	S382.EDF	S38	2
78	4783566	4783599	331	364	33	RIGHT	S382.EDF	S38	2
82	4815669	4815752	58	141	83	RIGHT	S382.EDF	S38	2
83	4829925	4830043	3949	4067	118	RIGHT	S382.EDF	S38	2
84	4835592	4835738	359	505	146	RIGHT	S382.EDF	S38	2
84	4837975	4838138	2742	2905	163	RIGHT	S382.EDF	S38	2
86	4856703	4856864	4560	4721	161	RIGHT	S382.EDF	S38	2
88	4870799	4870800	503	504	1	RIGHT	S382.EDF	S38	2
88	4873344	4873492	3048	3196	148	RIGHT	S382.EDF	S38	2
93	4913664	4913835	3223	3394	171	RIGHT	S382.EDF	S38	2
97	4947144	4947314	3333	3503	170	RIGHT	S382.EDF	S38	2
98	4955981	4956137	3115	3271	156	RIGHT	S382.EDF	S38	2
100	4972454	4972644	3220	3410	190	RIGHT	S382.EDF	S38	2
104	5003909	5004112	377	580	203	RIGHT	S382.EDF	S38	2
105	5015432	5015605	3720	3893	173	RIGHT	S382.EDF	S38	2
1	5914671	5914801	1006	1136	130	RIGHT	S383.EDF	S38	3
2	5922443	5922632	693	882	189	RIGHT	S383.EDF	S38	3
2	5924816	5924927	3066	3177	111	RIGHT	S383.EDF	S38	3
3	5930825	5930946	139	260	121	RIGHT	S383.EDF	S38	3
4	5939371	5939502	700	831	131	RIGHT	S383.EDF	S38	3
6	5956890	5957028	295	433	138	RIGHT	S383.EDF	S38	3
6	5959748	5959886	3153	3291	138	RIGHT	S383.EDF	S38	3
7	5966256	5966458	384	586	202	RIGHT	S383.EDF	S38	3
8	5975498	5975664	469	635	166	RIGHT	S383.EDF	S38	3
9	5983302	5983515	592	805	213	RIGHT	S383.EDF	S38	3
11	6000522	6000722	174	374	200	RIGHT	S383.EDF	S38	3
11	6006725	6006734	6377	6386	9	RIGHT	S383.EDF	S38	3
12	6012142	6012282	1866	2006	140	RIGHT	S383.EDF	S38	3
13	6020883	6021151	419	687	268	RIGHT	S383.EDF	S38	3
13	6021822	6021981	1358	1517	159	RIGHT	S383.EDF	S38	3
14	6030120	6030853	290	1023	733	RIGHT	S383.EDF	S38	3
15	6042503	6042629	3489	3615	126	RIGHT	S383.EDF	S38	3
19	6074364	6074386	57	79	22	RIGHT	S383.EDF	S38	3
20	6084459	6084521	950	1012	62	RIGHT	S383.EDF	S38	3
20	6087708	6087828	4199	4319	120	RIGHT	S383.EDF	S38	3
21	6091887	6092081	602	796	194	RIGHT	S383.EDF	S38	3
23	6109690	6109846	532	688	156	RIGHT	S383.EDF	S38	3
24	6118172	6118374	572	774	202	RIGHT	S383.EDF	S38	3
25	6125365	6125400	58	93	35	RIGHT	S383.EDF	S38	3
26	6139257	6139415	3465	3623	158	RIGHT	S383.EDF	S38	3
28	6154611	6154792	518	699	181	RIGHT	S383.EDF	S38	3
30	6171766	6171956	643	833	190	RIGHT	S383.EDF	S38	3
31	6179949	6180117	675	843	168	RIGHT	S383.EDF	S38	3
32	6188380	6188554	323	497	174	RIGHT	S383.EDF	S38	3
33	6197697	6197884	263	450	187	RIGHT	S383.EDF	S38	3
34	6206851	6207073	473	695	222	RIGHT	S383.EDF	S38	3
37	6234527	6234671	512	656	144	RIGHT	S383.EDF	S38	3
38	6244484	6244689	533	738	205	RIGHT	S383.EDF	S38	3
39	6253672	6253870	606	804	198	RIGHT	S383.EDF	S38	3
40	6263723	6263905	490	672	182	RIGHT	S383.EDF	S38	3
42	6281841	6282086	68	313	245	RIGHT	S383.EDF	S38	3
43	6290967	6291243	592	868	276	RIGHT	S383.EDF	S38	3
44	6300858	6301013	241	396	155	RIGHT	S383.EDF	S38	3
44	6304343	6304457	3726	3840	114	RIGHT	S383.EDF	S38	3
46	6319890	6319943	58	111	53	RIGHT	S383.EDF	S38	3
46	6320502	6320756	670	924	254	RIGHT	S383.EDF	S38	3
47	6328154	6328327	316	489	173	RIGHT	S383.EDF	S38	3
48	6336965	6337120	57	212	155	RIGHT	S383.EDF	S38	3
50	6354709	6354961	592	844	252	RIGHT	S383.EDF	S38	3
53	6380942	6381130	57	245	188	RIGHT	S383.EDF	S38	3
54	6389678	6389854	58	234	176	RIGHT	S383.EDF	S38	3
54	6389875	6389877	255	257	2	RIGHT	S383.EDF	S38	3
64	6482482	6482686	898	1102	204	RIGHT	S383.EDF	S38	3
65	6491953	6492142	1029	1218	189	RIGHT	S383.EDF	S38	3
66	6500949	6501132	521	704	183	RIGHT	S383.EDF	S38	3
66	6503347	6503506	2919	3078	159	RIGHT	S383.EDF	S38	3
67	6509038	6509238	58	258	200	RIGHT	S383.EDF	S38	3
68	6516733	6516903	193	363	170	RIGHT	S383.EDF	S38	3
68	6519499	6519639	2959	3099	140	RIGHT	S383.EDF	S38	3
70	6536125	6536366	147	388	241	RIGHT	S383.EDF	S38	3
70	6536976	6537155	998	1177	179	RIGHT	S383.EDF	S38	3
71	6545052	6545300	175	423	248	RIGHT	S383.EDF	S38	3
72	6554705	6554919	415	629	214	RIGHT	S383.EDF	S38	3
73	6564400	6564663	453	716	263	RIGHT	S383.EDF	S38	3
73	6566549	6566674	2602	2727	125	RIGHT	S383.EDF	S38	3
74	6571745	6572004	145	404	259	RIGHT	S383.EDF	S38	3
74	6572591	6572738	991	1138	147	RIGHT	S383.EDF	S38	3
75	6580187	6580462	263	538	275	RIGHT	S383.EDF	S38	3
75	6580495	6580495	571	571	0	RIGHT	S383.EDF	S38	3
76	6588348	6588352	266	270	4	RIGHT	S383.EDF	S38	3
76	6588376	6588536	294	454	160	RIGHT	S383.EDF	S38	3
76	6588613	6588827	531	745	214	RIGHT	S383.EDF	S38	3
76	6588849	6588856	767	774	7	RIGHT	S383.EDF	S38	3
77	6597004	6597359	57	412	355	RIGHT	S383.EDF	S38	3
77	6597491	6597705	544	758	214	RIGHT	S383.EDF	S38	3
78	6606671	6606849	57	235	178	RIGHT	S383.EDF	S38	3
78	6606888	6606903	274	289	15	RIGHT	S383.EDF	S38	3
78	6607097	6607339	483	725	242	RIGHT	S383.EDF	S38	3
79	6616566	6616837	57	328	271	RIGHT	S383.EDF	S38	3
79	6616869	6616872	360	363	3	RIGHT	S383.EDF	S38	3
79	6617005	6617199	496	690	194	RIGHT	S383.EDF	S38	3
80	6626035	6626260	168	393	225	RIGHT	S383.EDF	S38	3
80	6626960	6627183	1093	1316	223	RIGHT	S383.EDF	S38	3
81	6634323	6634651	103	431	328	RIGHT	S383.EDF	S38	3
82	6642994	6643283	478	767	289	RIGHT	S383.EDF	S38	3
82	6647244	6647409	4728	4893	165	RIGHT	S383.EDF	S38	3
83	6652090	6652513	57	480	423	RIGHT	S383.EDF	S38	3
84	6659743	6660440	58	755	697	RIGHT	S383.EDF	S38	3
85	6669140	6669603	58	521	463	RIGHT	S383.EDF	S38	3
85	6669863	6670112	781	1030	249	RIGHT	S383.EDF	S38	3
86	6682668	6682809	4589	4730	141	RIGHT	S383.EDF	S38	3
87	6686160	6686270	78	188	110	RIGHT	S383.EDF	S38	3
87	6686298	6686325	216	243	27	RIGHT	S383.EDF	S38	3
87	6686833	6687030	751	948	197	RIGHT	S383.EDF	S38	3
89	6705665	6705870	201	406	205	RIGHT	S383.EDF	S38	3
90	6715344	6715548	395	599	204	RIGHT	S383.EDF	S38	3
91	6724763	6724966	858	1061	203	RIGHT	S383.EDF	S38	3
92	6732958	6733651	58	751	693	RIGHT	S383.EDF	S38	3
93	6742585	6742733	507	655	148	RIGHT	S383.EDF	S38	3
94	6754531	6754666	2767	2902	135	RIGHT	S383.EDF	S38	3
96	6769192	6769433	57	298	241	RIGHT	S383.EDF	S38	3
96	6770190	6770352	1055	1217	162	RIGHT	S383.EDF	S38	3
96	6770387	6770402	1252	1267	15	RIGHT	S383.EDF	S38	3
96	6773045	6773191	3910	4056	146	RIGHT	S383.EDF	S38	3
96	6773212	6773216	4077	4081	4	RIGHT	S383.EDF	S38	3
97	6777975	6778143	66	234	168	RIGHT	S383.EDF	S38	3
97	6778197	6778216	288	307	19	RIGHT	S383.EDF	S38	3
97	6778380	6778541	471	632	161	RIGHT	S383.EDF	S38	3
97	6781906	6782037	3997	4128	131	RIGHT	S383.EDF	S38	3
98	6785689	6785894	115	320	205	RIGHT	S383.EDF	S38	3
98	6785916	6785932	342	358	16	RIGHT	S383.EDF	S38	3
99	6793856	6794054	57	255	198	RIGHT	S383.EDF	S38	3
99	6794075	6794080	276	281	5	RIGHT	S383.EDF	S38	3
100	6803651	6803919	199	467	268	RIGHT	S383.EDF	S38	3
102	6822234	6822700	57	523	466	RIGHT	S383.EDF	S38	3
103	6830729	6831322	57	650	593	RIGHT	S383.EDF	S38	3
104	6845522	6845643	5933	6054	121	RIGHT	S383.EDF	S38	3
105	6850064	6850239	532	707	175	RIGHT	S383.EDF	S38	3
107	6868097	6868251	650	804	154	RIGHT	S383.EDF	S38	3
108	6876702	6876816	291	405	114	RIGHT	S383.EDF	S38	3
108	6876871	6877071	460	660	200	RIGHT	S383.EDF	S38	3
109	6885766	6886008	160	402	242	RIGHT	S383.EDF	S38	3
109	6886157	6886320	551	714	163	RIGHT	S383.EDF	S38	3
111	6905596	6905841	386	631	245	RIGHT	S383.EDF	S38	3
112	6913807	6913864	57	114	57	RIGHT	S383.EDF	S38	3
113	6921874	6922015	57	198	141	RIGHT	S383.EDF	S38	3
115	6941192	6941344	703	855	152	RIGHT	S383.EDF	S38	3
116	6950103	6950155	58	110	52	RIGHT	S383.EDF	S38	3
117	6961365	6961494	2926	3055	129	RIGHT	S383.EDF	S38	3
1	9406135	9406199	314	378	64	RIGHT	S391.EDF	S39	1
1	9406934	9406998	1113	1177	64	RIGHT	S391.EDF	S39	1
1	9410007	9410145	4186	4324	138	RIGHT	S391.EDF	S39	1
2	9415847	9415971	1007	1131	124	RIGHT	S391.EDF	S39	1
2	9417537	9417850	2697	3010	313	RIGHT	S391.EDF	S39	1
3	9430389	9430514	6604	6729	125	RIGHT	S391.EDF	S39	1
4	9433910	9434102	95	287	192	RIGHT	S391.EDF	S39	1
4	9439161	9439292	5346	5477	131	RIGHT	S391.EDF	S39	1
5	9443438	9443550	57	169	112	RIGHT	S391.EDF	S39	1
5	9447826	9447974	4445	4593	148	RIGHT	S391.EDF	S39	1
5	9448836	9449000	5455	5619	164	RIGHT	S391.EDF	S39	1
6	9453847	9454035	1428	1616	188	RIGHT	S391.EDF	S39	1
6	9455811	9455975	3392	3556	164	RIGHT	S391.EDF	S39	1
7	9462733	9462868	1168	1303	135	RIGHT	S391.EDF	S39	1
8	9471661	9471705	57	101	44	RIGHT	S391.EDF	S39	1
8	9471965	9472123	361	519	158	RIGHT	S391.EDF	S39	1
8	9475354	9475441	3750	3837	87	RIGHT	S391.EDF	S39	1
9	9481243	9481285	57	99	42	RIGHT	S391.EDF	S39	1
9	9482096	9482220	910	1034	124	RIGHT	S391.EDF	S39	1
10	9489509	9489680	57	228	171	RIGHT	S391.EDF	S39	1
11	9497980	9498172	156	348	192	RIGHT	S391.EDF	S39	1
11	9499001	9499415	1177	1591	414	RIGHT	S391.EDF	S39	1
12	9507000	9507185	1179	1364	185	RIGHT	S391.EDF	S39	1
13	9516914	9517015	924	1025	101	RIGHT	S391.EDF	S39	1
14	9528025	9528182	4861	5018	157	RIGHT	S391.EDF	S39	1
15	9532536	9532697	928	1089	161	RIGHT	S391.EDF	S39	1
16	9538839	9538964	57	182	125	RIGHT	S391.EDF	S39	1
17	9547776	9547925	153	302	149	RIGHT	S391.EDF	S39	1
17	9552392	9552587	4769	4964	195	RIGHT	S391.EDF	S39	1
18	9554996	9555105	57	166	109	RIGHT	S391.EDF	S39	1
18	9555749	9555881	810	942	132	RIGHT	S391.EDF	S39	1
18	9559004	9559131	4065	4192	127	RIGHT	S391.EDF	S39	1
18	9559896	9560260	4957	5321	364	RIGHT	S391.EDF	S39	1
20	9571796	9572115	164	483	319	RIGHT	S391.EDF	S39	1
21	9580943	9581104	190	351	161	RIGHT	S391.EDF	S39	1
21	9584210	9584397	3457	3644	187	RIGHT	S391.EDF	S39	1
22	9591638	9591981	1027	1370	343	RIGHT	S391.EDF	S39	1
22	9593862	9593999	3251	3388	137	RIGHT	S391.EDF	S39	1
22	9596911	9597079	6300	6468	168	RIGHT	S391.EDF	S39	1
23	9601274	9601509	1576	1811	235	RIGHT	S391.EDF	S39	1
24	9609310	9609496	76	262	186	RIGHT	S391.EDF	S39	1
25	9618568	9618619	57	108	51	RIGHT	S391.EDF	S39	1
25	9618786	9619007	275	496	221	RIGHT	S391.EDF	S39	1
25	9619354	9619607	843	1096	253	RIGHT	S391.EDF	S39	1
25	9620145	9620208	1634	1697	63	RIGHT	S391.EDF	S39	1
26	9627330	9627511	107	288	181	RIGHT	S391.EDF	S39	1
27	9635072	9635247	405	580	175	RIGHT	S391.EDF	S39	1
28	9645142	9645316	1155	1329	174	RIGHT	S391.EDF	S39	1
30	9662354	9662545	198	389	191	RIGHT	S391.EDF	S39	1
30	9667609	9667711	5453	5555	102	RIGHT	S391.EDF	S39	1
30	9669374	9669391	7218	7235	17	RIGHT	S391.EDF	S39	1
31	9671960	9672156	129	325	196	RIGHT	S391.EDF	S39	1
31	9673046	9673513	1215	1682	467	RIGHT	S391.EDF	S39	1
31	9675581	9675755	3750	3924	174	RIGHT	S391.EDF	S39	1
32	9680776	9680825	57	106	49	RIGHT	S391.EDF	S39	1
33	9689274	9689448	64	238	174	RIGHT	S391.EDF	S39	1
33	9693306	9693478	4096	4268	172	RIGHT	S391.EDF	S39	1
34	9697894	9698048	756	910	154	RIGHT	S391.EDF	S39	1
34	9698240	9698375	1102	1237	135	RIGHT	S391.EDF	S39	1
34	9702565	9702685	5427	5547	120	RIGHT	S391.EDF	S39	1
36	9714031	9714241	1068	1278	210	RIGHT	S391.EDF	S39	1
36	9715746	9715925	2783	2962	179	RIGHT	S391.EDF	S39	1
37	9723673	9723862	2455	2644	189	RIGHT	S391.EDF	S39	1
37	9724829	9725003	3611	3785	174	RIGHT	S391.EDF	S39	1
38	9733227	9733393	4622	4788	166	RIGHT	S391.EDF	S39	1
39	9738137	9738369	884	1116	232	RIGHT	S391.EDF	S39	1
39	9740376	9740587	3123	3334	211	RIGHT	S391.EDF	S39	1
40	9747000	9747173	468	641	173	RIGHT	S391.EDF	S39	1
42	9765541	9765855	4217	4531	314	RIGHT	S391.EDF	S39	1
43	9768909	9769116	57	264	207	RIGHT	S391.EDF	S39	1
43	9771424	9771607	2572	2755	183	RIGHT	S391.EDF	S39	1
45	9786313	9786776	82	545	463	RIGHT	S391.EDF	S39	1
45	9786867	9787076	636	845	209	RIGHT	S391.EDF	S39	1
45	9787454	9787545	1223	1314	91	RIGHT	S391.EDF	S39	1
45	9790944	9791129	4713	4898	185	RIGHT	S391.EDF	S39	1
47	9802650	9802779	291	420	129	RIGHT	S391.EDF	S39	1
48	9810026	9810207	292	473	181	RIGHT	S391.EDF	S39	1
49	9816860	9816973	57	170	113	RIGHT	S391.EDF	S39	1
50	9827714	9828094	2376	2756	380	RIGHT	S391.EDF	S39	1
51	9833681	9833776	57	152	95	RIGHT	S391.EDF	S39	1
51	9834837	9835034	1213	1410	197	RIGHT	S391.EDF	S39	1
51	9837309	9837526	3685	3902	217	RIGHT	S391.EDF	S39	1
52	9840583	9840836	57	310	253	RIGHT	S391.EDF	S39	1
52	9841700	9841895	1174	1369	195	RIGHT	S391.EDF	S39	1
52	9844728	9844906	4202	4380	178	RIGHT	S391.EDF	S39	1
53	9849470	9849629	344	503	159	RIGHT	S391.EDF	S39	1
53	9850244	9850431	1118	1305	187	RIGHT	S391.EDF	S39	1
54	9857613	9857719	1157	1263	106	RIGHT	S391.EDF	S39	1
57	9879994	9880225	135	366	231	RIGHT	S391.EDF	S39	1
58	9888274	9888351	57	134	77	RIGHT	S391.EDF	S39	1
62	9920483	9920669	1147	1333	186	RIGHT	S391.EDF	S39	1
63	9932808	9932883	5064	5139	75	RIGHT	S391.EDF	S39	1
65	9944000	9944272	220	492	272	RIGHT	S391.EDF	S39	1
66	9954839	9954936	1713	1810	97	RIGHT	S391.EDF	S39	1
66	9955290	9955479	2164	2353	189	RIGHT	S391.EDF	S39	1
67	9961756	9962018	1134	1396	262	RIGHT	S391.EDF	S39	1
68	9967622	9967642	57	77	20	RIGHT	S391.EDF	S39	1
69	9974769	9974804	57	92	35	RIGHT	S391.EDF	S39	1
69	9975192	9975391	480	679	199	RIGHT	S391.EDF	S39	1
69	9978845	9978978	4133	4266	133	RIGHT	S391.EDF	S39	1
70	9981980	9982122	690	832	142	RIGHT	S391.EDF	S39	1
71	9987994	9988115	265	386	121	RIGHT	S391.EDF	S39	1
71	9988219	9988517	490	788	298	RIGHT	S391.EDF	S39	1
71	9988998	9989091	1269	1362	93	RIGHT	S391.EDF	S39	1
71	9989387	9989524	1658	1795	137	RIGHT	S391.EDF	S39	1
74	10015039	10015196	57	214	157	RIGHT	S391.EDF	S39	1
74	10018889	10019041	3907	4059	152	RIGHT	S391.EDF	S39	1
75	10022526	10022595	57	126	69	RIGHT	S391.EDF	S39	1
75	10023527	10023677	1058	1208	150	RIGHT	S391.EDF	S39	1
75	10026890	10026984	4421	4515	94	RIGHT	S391.EDF	S39	1
75	10027551	10027751	5082	5282	200	RIGHT	S391.EDF	S39	1
77	10041274	10041400	529	655	126	RIGHT	S391.EDF	S39	1
78	10048773	10048855	57	139	82	RIGHT	S391.EDF	S39	1
78	10049811	10049938	1095	1222	127	RIGHT	S391.EDF	S39	1
79	10057479	10057533	57	111	54	RIGHT	S391.EDF	S39	1
81	10074717	10074884	1257	1424	167	RIGHT	S391.EDF	S39	1
83	10088945	10089059	118	232	114	RIGHT	S391.EDF	S39	1
83	10089091	10089292	264	465	201	RIGHT	S391.EDF	S39	1
83	10089968	10090381	1141	1554	413	RIGHT	S391.EDF	S39	1
84	10097383	10097570	447	634	187	RIGHT	S391.EDF	S39	1
85	10104175	10104375	288	488	200	RIGHT	S391.EDF	S39	1
86	10111789	10112312	159	682	523	RIGHT	S391.EDF	S39	1
87	10119606	10119752	470	616	146	RIGHT	S391.EDF	S39	1
88	10127149	10127462	337	650	313	RIGHT	S391.EDF	S39	1
88	10129789	10129931	2977	3119	142	RIGHT	S391.EDF	S39	1
89	10136133	10136161	58	86	28	RIGHT	S391.EDF	S39	1
90	10143550	10143737	396	583	187	RIGHT	S391.EDF	S39	1
91	10151781	10151970	750	939	189	RIGHT	S391.EDF	S39	1
91	10157205	10157398	6174	6367	193	RIGHT	S391.EDF	S39	1
93	10168028	10168427	1570	1969	399	RIGHT	S391.EDF	S39	1
95	10182772	10182833	76	137	61	RIGHT	S391.EDF	S39	1
95	10183633	10183780	937	1084	147	RIGHT	S391.EDF	S39	1
96	10191469	10191638	564	733	169	RIGHT	S391.EDF	S39	1
96	10193963	10194120	3058	3215	157	RIGHT	S391.EDF	S39	1
96	10196835	10196971	5930	6066	136	RIGHT	S391.EDF	S39	1
97	10200830	10200933	451	554	103	RIGHT	S391.EDF	S39	1
97	10203100	10203276	2721	2897	176	RIGHT	S391.EDF	S39	1
98	10209889	10210112	325	548	223	RIGHT	S391.EDF	S39	1
99	10216533	10216946	126	539	413	RIGHT	S391.EDF	S39	1
100	10226210	10226415	860	1065	205	RIGHT	S391.EDF	S39	1
101	10235264	10235444	1433	1613	180	RIGHT	S391.EDF	S39	1
102	10241373	10241406	58	91	33	RIGHT	S391.EDF	S39	1
104	10258075	10258124	1234	1283	49	RIGHT	S391.EDF	S39	1
107	10279884	10280031	354	501	147	RIGHT	S391.EDF	S39	1
108	10286926	10287051	57	182	125	RIGHT	S391.EDF	S39	1
109	10297230	10297431	3675	3876	201	RIGHT	S391.EDF	S39	1
110	10306131	10306257	5041	5167	126	RIGHT	S391.EDF	S39	1
114	10335551	10335571	57	77	20	RIGHT	S391.EDF	S39	1
116	10356391	10356532	57	198	141	RIGHT	S391.EDF	S39	1
117	10365608	10365834	458	684	226	RIGHT	S391.EDF	S39	1
118	10375232	10375437	57	262	205	RIGHT	S391.EDF	S39	1
118	10378870	10379086	3695	3911	216	RIGHT	S391.EDF	S39	1
119	10383705	10383906	57	258	201	RIGHT	S391.EDF	S39	1
120	10396751	10396848	4004	4101	97	RIGHT	S391.EDF	S39	1
1	11334790	11334913	1055	1178	123	RIGHT	S392.EDF	S39	2
2	11344152	11344305	1066	1219	153	RIGHT	S392.EDF	S39	2
3	11352648	11352835	303	490	187	RIGHT	S392.EDF	S39	2
4	11361245	11361441	305	501	196	RIGHT	S392.EDF	S39	2
5	11369814	11370053	57	296	239	RIGHT	S392.EDF	S39	2
6	11378441	11378606	407	572	165	RIGHT	S392.EDF	S39	2
7	11387136	11387252	57	173	116	RIGHT	S392.EDF	S39	2
9	11403770	11404058	302	590	288	RIGHT	S392.EDF	S39	2
10	11410928	11411084	403	559	156	RIGHT	S392.EDF	S39	2
11	11418198	11418259	57	118	61	RIGHT	S392.EDF	S39	2
12	11427288	11427500	57	269	212	RIGHT	S392.EDF	S39	2
12	11428004	11428707	773	1476	703	RIGHT	S392.EDF	S39	2
13	11434904	11434934	57	87	30	RIGHT	S392.EDF	S39	2
14	11444240	11444419	128	307	179	RIGHT	S392.EDF	S39	2
15	11452884	11453037	558	711	153	RIGHT	S392.EDF	S39	2
15	11454898	11455056	2572	2730	158	RIGHT	S392.EDF	S39	2
16	11463886	11463996	3597	3707	110	RIGHT	S392.EDF	S39	2
17	11469564	11469683	56	175	119	RIGHT	S392.EDF	S39	2
17	11471709	11471927	2201	2419	218	RIGHT	S392.EDF	S39	2
18	11477060	11477150	57	147	90	RIGHT	S392.EDF	S39	2
20	11495634	11495826	280	472	192	RIGHT	S392.EDF	S39	2
21	11506175	11506300	1016	1141	125	RIGHT	S392.EDF	S39	2
21	11508585	11508734	3426	3575	149	RIGHT	S392.EDF	S39	2
22	11514645	11514697	57	109	52	RIGHT	S392.EDF	S39	2
22	11514937	11515079	349	491	142	RIGHT	S392.EDF	S39	2
23	11523289	11523492	100	303	203	RIGHT	S392.EDF	S39	2
23	11524220	11524355	1031	1166	135	RIGHT	S392.EDF	S39	2
25	11538093	11538283	264	454	190	RIGHT	S392.EDF	S39	2
27	11557227	11557254	5438	5465	27	RIGHT	S392.EDF	S39	2
28	11560938	11561037	57	156	99	RIGHT	S392.EDF	S39	2
29	11572908	11574103	57	1252	1195	RIGHT	S392.EDF	S39	2
32	11599023	11599148	1078	1203	125	RIGHT	S392.EDF	S39	2
32	11604668	11604847	6723	6902	179	RIGHT	S392.EDF	S39	2
34	11620093	11620134	4234	4275	41	RIGHT	S392.EDF	S39	2
34	11620214	11620363	4355	4504	149	RIGHT	S392.EDF	S39	2
35	11626864	11626887	2572	2595	23	RIGHT	S392.EDF	S39	2
35	11627008	11627146	2716	2854	138	RIGHT	S392.EDF	S39	2
38	11647313	11647343	64	94	30	RIGHT	S392.EDF	S39	2
38	11647564	11647760	315	511	196	RIGHT	S392.EDF	S39	2
39	11654359	11654378	57	76	19	RIGHT	S392.EDF	S39	2
40	11661160	11661188	57	85	28	RIGHT	S392.EDF	S39	2
41	11668277	11668358	57	138	81	RIGHT	S392.EDF	S39	2
41	11668938	11669067	718	847	129	RIGHT	S392.EDF	S39	2
42	11676953	11676981	57	85	28	RIGHT	S392.EDF	S39	2
43	11686641	11686709	57	125	68	RIGHT	S392.EDF	S39	2
43	11688594	11688702	2010	2118	108	RIGHT	S392.EDF	S39	2
46	11714549	11714641	3151	3243	92	RIGHT	S392.EDF	S39	2
46	11715791	11716104	4393	4706	313	RIGHT	S392.EDF	S39	2
49	11739903	11740014	57	168	111	RIGHT	S392.EDF	S39	2
49	11740946	11741114	1100	1268	168	RIGHT	S392.EDF	S39	2
49	11745894	11746098	6048	6252	204	RIGHT	S392.EDF	S39	2
50	11748469	11748811	57	399	342	RIGHT	S392.EDF	S39	2
50	11748929	11749020	517	608	91	RIGHT	S392.EDF	S39	2
50	11749490	11749586	1078	1174	96	RIGHT	S392.EDF	S39	2
51	11759270	11759384	1413	1527	114	RIGHT	S392.EDF	S39	2
54	11782483	11782771	172	460	288	RIGHT	S392.EDF	S39	2
54	11783169	11783169	858	858	0	RIGHT	S392.EDF	S39	2
54	11783197	11783210	886	899	13	RIGHT	S392.EDF	S39	2
54	11783238	11783254	927	943	16	RIGHT	S392.EDF	S39	2
54	11783514	11783684	1203	1373	170	RIGHT	S392.EDF	S39	2
54	11783725	11783733	1414	1422	8	RIGHT	S392.EDF	S39	2
55	11791196	11791232	61	97	36	RIGHT	S392.EDF	S39	2
55	11792814	11793067	1679	1932	253	RIGHT	S392.EDF	S39	2
55	11796771	11796848	5636	5713	77	RIGHT	S392.EDF	S39	2
56	11801405	11801478	1454	1527	73	RIGHT	S392.EDF	S39	2
56	11805343	11805545	5392	5594	202	RIGHT	S392.EDF	S39	2
57	11808329	11808465	93	229	136	RIGHT	S392.EDF	S39	2
59	11824699	11824720	57	78	21	RIGHT	S392.EDF	S39	2
59	11824751	11824955	109	313	204	RIGHT	S392.EDF	S39	2
61	11841354	11841512	316	474	158	RIGHT	S392.EDF	S39	2
63	11858185	11858445	57	317	260	RIGHT	S392.EDF	S39	2
64	11866768	11866868	56	156	100	RIGHT	S392.EDF	S39	2
64	11867757	11867866	1045	1154	109	RIGHT	S392.EDF	S39	2
65	11876517	11876640	2110	2233	123	RIGHT	S392.EDF	S39	2
67	11891803	11891960	715	872	157	RIGHT	S392.EDF	S39	2
68	11898171	11898332	410	571	161	RIGHT	S392.EDF	S39	2
69	11904861	11905054	56	249	193	RIGHT	S392.EDF	S39	2
70	11912484	11912548	76	140	64	RIGHT	S392.EDF	S39	2
70	11914645	11914748	2237	2340	103	RIGHT	S392.EDF	S39	2
73	11935092	11935302	397	607	210	RIGHT	S392.EDF	S39	2
73	11938503	11938729	3808	4034	226	RIGHT	S392.EDF	S39	2
73	11940133	11940347	5438	5652	214	RIGHT	S392.EDF	S39	2
74	11943554	11943686	445	577	132	RIGHT	S392.EDF	S39	2
75	11951322	11952895	57	1630	1573	RIGHT	S392.EDF	S39	2
75	11953665	11954128	2400	2863	463	RIGHT	S392.EDF	S39	2
76	11959015	11959198	377	560	183	RIGHT	S392.EDF	S39	2
77	11971443	11971587	4800	4944	144	RIGHT	S392.EDF	S39	2
78	11974220	11974369	470	619	149	RIGHT	S392.EDF	S39	2
79	11984397	11984555	2495	2653	158	RIGHT	S392.EDF	S39	2
79	11984642	11984792	2740	2890	150	RIGHT	S392.EDF	S39	2
80	11990466	11990491	57	82	25	RIGHT	S392.EDF	S39	2
81	11998418	11998551	1054	1187	133	RIGHT	S392.EDF	S39	2
82	12005047	12005236	999	1188	189	RIGHT	S392.EDF	S39	2
82	12008176	12008339	4128	4291	163	RIGHT	S392.EDF	S39	2
84	12019111	12019264	395	548	153	RIGHT	S392.EDF	S39	2
84	12021479	12021828	2763	3112	349	RIGHT	S392.EDF	S39	2
85	12027079	12027227	317	465	148	RIGHT	S392.EDF	S39	2
86	12034531	12034681	544	694	150	RIGHT	S392.EDF	S39	2
87	12042025	12042139	464	578	114	RIGHT	S392.EDF	S39	2
87	12046057	12046214	4496	4653	157	RIGHT	S392.EDF	S39	2
88	12050932	12051114	287	469	182	RIGHT	S392.EDF	S39	2
89	12059216	12059410	443	637	194	RIGHT	S392.EDF	S39	2
89	12061577	12061616	2804	2843	39	RIGHT	S392.EDF	S39	2
89	12061663	12061824	2890	3051	161	RIGHT	S392.EDF	S39	2
90	12067196	12067391	431	626	195	RIGHT	S392.EDF	S39	2
90	12070918	12071162	4153	4397	244	RIGHT	S392.EDF	S39	2
91	12073297	12073579	95	377	282	RIGHT	S392.EDF	S39	2
92	12082201	12082330	425	554	129	RIGHT	S392.EDF	S39	2
93	12090582	12090663	341	422	81	RIGHT	S392.EDF	S39	2
94	12098114	12098320	56	262	206	RIGHT	S392.EDF	S39	2
94	12099770	12099857	1712	1799	87	RIGHT	S392.EDF	S39	2
94	12100128	12100249	2070	2191	121	RIGHT	S392.EDF	S39	2
96	12116036	12116245	170	379	209	RIGHT	S392.EDF	S39	2
97	12123670	12123801	730	861	131	RIGHT	S392.EDF	S39	2
99	12137951	12137959	573	581	8	RIGHT	S392.EDF	S39	2
99	12138257	12138861	879	1483	604	RIGHT	S392.EDF	S39	2
100	12144944	12145096	434	586	152	RIGHT	S392.EDF	S39	2
100	12148573	12148744	4063	4234	171	RIGHT	S392.EDF	S39	2
101	12153768	12153911	590	733	143	RIGHT	S392.EDF	S39	2
102	12162778	12162922	422	566	144	RIGHT	S392.EDF	S39	2
102	12167415	12167582	5059	5226	167	RIGHT	S392.EDF	S39	2
103	12171630	12171734	587	691	104	RIGHT	S392.EDF	S39	2
105	12186100	12186309	370	579	209	RIGHT	S392.EDF	S39	2
105	12188294	12188412	2564	2682	118	RIGHT	S392.EDF	S39	2
108	12211630	12211794	614	778	164	RIGHT	S392.EDF	S39	2
108	12215979	12216076	4963	5060	97	RIGHT	S392.EDF	S39	2
109	12222213	12222397	2652	2836	184	RIGHT	S392.EDF	S39	2
110	12227405	12227518	488	601	113	RIGHT	S392.EDF	S39	2
110	12232722	12232881	5805	5964	159	RIGHT	S392.EDF	S39	2
111	12236677	12236871	448	642	194	RIGHT	S392.EDF	S39	2
114	12259105	12259203	118	216	98	RIGHT	S392.EDF	S39	2
114	12260353	12260469	1366	1482	116	RIGHT	S392.EDF	S39	2
115	12267975	12268285	213	523	310	RIGHT	S392.EDF	S39	2
116	12274452	12274535	57	140	83	RIGHT	S392.EDF	S39	2
116	12274844	12275024	449	629	180	RIGHT	S392.EDF	S39	2
116	12275422	12275479	1027	1084	57	RIGHT	S392.EDF	S39	2
116	12275526	12275638	1131	1243	112	RIGHT	S392.EDF	S39	2
117	12283009	12283250	219	460	241	RIGHT	S392.EDF	S39	2
117	12287916	12288210	5126	5420	294	RIGHT	S392.EDF	S39	2
117	12289853	12289883	7063	7093	30	RIGHT	S392.EDF	S39	2
118	12291982	12292415	267	700	433	RIGHT	S392.EDF	S39	2
118	12292537	12292655	822	940	118	RIGHT	S392.EDF	S39	2
118	12295920	12296094	4205	4379	174	RIGHT	S392.EDF	S39	2
119	12300744	12300917	307	480	173	RIGHT	S392.EDF	S39	2
1	4365855	4365911	1318	1374	56	RIGHT	S451.EDF	S45	1
2	4375299	4375356	62	119	57	RIGHT	S451.EDF	S45	1
2	4376179	4376274	942	1037	95	RIGHT	S451.EDF	S45	1
3	4384268	4384399	934	1065	131	RIGHT	S451.EDF	S45	1
4	4394511	4394553	977	1019	42	RIGHT	S451.EDF	S45	1
5	4402312	4402423	585	696	111	RIGHT	S451.EDF	S45	1
5	4403017	4403189	1290	1462	172	RIGHT	S451.EDF	S45	1
6	4412587	4412665	864	942	78	RIGHT	S451.EDF	S45	1
7	4420951	4421045	1098	1192	94	RIGHT	S451.EDF	S45	1
7	4421718	4421846	1865	1993	128	RIGHT	S451.EDF	S45	1
8	4428551	4428622	57	128	71	RIGHT	S451.EDF	S45	1
8	4429461	4429567	967	1073	106	RIGHT	S451.EDF	S45	1
8	4431137	4431267	2643	2773	130	RIGHT	S451.EDF	S45	1
9	4439388	4439470	1068	1150	82	RIGHT	S451.EDF	S45	1
10	4448501	4448582	684	765	81	RIGHT	S451.EDF	S45	1
11	4461753	4461845	703	795	92	RIGHT	S451.EDF	S45	1
12	4470349	4470392	472	515	43	RIGHT	S451.EDF	S45	1
12	4471200	4471351	1323	1474	151	RIGHT	S451.EDF	S45	1
13	4482472	4482574	2802	2904	102	RIGHT	S451.EDF	S45	1
15	4499503	4499565	727	789	62	RIGHT	S451.EDF	S45	1
16	4509379	4509387	486	494	8	RIGHT	S451.EDF	S45	1
16	4510200	4510316	1307	1423	116	RIGHT	S451.EDF	S45	1
17	4522679	4522771	441	533	92	RIGHT	S451.EDF	S45	1
17	4523645	4523797	1407	1559	152	RIGHT	S451.EDF	S45	1
18	4532462	4532622	437	597	160	RIGHT	S451.EDF	S45	1
18	4533080	4533247	1055	1222	167	RIGHT	S451.EDF	S45	1
18	4533717	4533840	1692	1815	123	RIGHT	S451.EDF	S45	1
18	4537169	4537251	5144	5226	82	RIGHT	S451.EDF	S45	1
19	4542938	4542972	715	749	34	RIGHT	S451.EDF	S45	1
20	4552754	4552807	115	168	53	RIGHT	S451.EDF	S45	1
21	4562492	4562584	479	571	92	RIGHT	S451.EDF	S45	1
22	4570781	4570791	672	682	10	RIGHT	S451.EDF	S45	1
22	4572987	4573016	2878	2907	29	RIGHT	S451.EDF	S45	1
22	4573037	4573039	2928	2930	2	RIGHT	S451.EDF	S45	1
24	4589785	4589877	628	720	92	RIGHT	S451.EDF	S45	1
24	4592115	4592150	2958	2993	35	RIGHT	S451.EDF	S45	1
27	4617986	4618071	620	705	85	RIGHT	S451.EDF	S45	1
27	4618776	4618909	1410	1543	133	RIGHT	S451.EDF	S45	1
28	4627044	4627152	271	379	108	RIGHT	S451.EDF	S45	1
29	4636951	4636987	58	94	36	RIGHT	S451.EDF	S45	1
29	4637541	4637656	648	763	115	RIGHT	S451.EDF	S45	1
29	4639711	4639778	2818	2885	67	RIGHT	S451.EDF	S45	1
29	4640468	4640613	3575	3720	145	RIGHT	S451.EDF	S45	1
32	4666867	4666997	962	1092	130	RIGHT	S451.EDF	S45	1
33	4675996	4676100	940	1044	104	RIGHT	S451.EDF	S45	1
33	4678167	4678172	3111	3116	5	RIGHT	S451.EDF	S45	1
33	4678208	4678212	3152	3156	4	RIGHT	S451.EDF	S45	1
35	4693442	4693581	1080	1219	139	RIGHT	S451.EDF	S45	1
36	4702807	4702986	467	646	179	RIGHT	S451.EDF	S45	1
36	4704900	4704962	2560	2622	62	RIGHT	S451.EDF	S45	1
37	4711487	4711513	297	323	26	RIGHT	S451.EDF	S45	1
37	4712497	4712611	1307	1421	114	RIGHT	S451.EDF	S45	1
38	4721206	4721226	505	525	20	RIGHT	S451.EDF	S45	1
39	4729150	4729268	463	581	118	RIGHT	S451.EDF	S45	1
39	4730097	4730262	1410	1575	165	RIGHT	S451.EDF	S45	1
40	4739014	4739123	1715	1824	109	RIGHT	S451.EDF	S45	1
41	4747800	4747839	470	509	39	RIGHT	S451.EDF	S45	1
42	4757338	4757396	282	340	58	RIGHT	S451.EDF	S45	1
42	4758022	4758206	966	1150	184	RIGHT	S451.EDF	S45	1
43	4767454	4767531	249	326	77	RIGHT	S451.EDF	S45	1
43	4768170	4768325	965	1120	155	RIGHT	S451.EDF	S45	1
44	4778747	4778856	668	777	109	RIGHT	S451.EDF	S45	1
44	4782394	4782473	4315	4394	79	RIGHT	S451.EDF	S45	1
45	4788520	4788553	867	900	33	RIGHT	S451.EDF	S45	1
46	4797269	4797338	880	949	69	RIGHT	S451.EDF	S45	1
48	4813007	4813167	488	648	160	RIGHT	S451.EDF	S45	1
48	4813740	4813882	1221	1363	142	RIGHT	S451.EDF	S45	1
49	4823360	4823553	905	1098	193	RIGHT	S451.EDF	S45	1
49	4825471	4825526	3016	3071	55	RIGHT	S451.EDF	S45	1
50	4832742	4832812	260	330	70	RIGHT	S451.EDF	S45	1
50	4833582	4833725	1100	1243	143	RIGHT	S451.EDF	S45	1
51	4840588	4840711	303	426	123	RIGHT	S451.EDF	S45	1
51	4841371	4841583	1086	1298	212	RIGHT	S451.EDF	S45	1
52	4850718	4850804	234	320	86	RIGHT	S451.EDF	S45	1
53	4860623	4860693	1489	1559	70	RIGHT	S451.EDF	S45	1
54	4869628	4869763	779	914	135	RIGHT	S451.EDF	S45	1
54	4870300	4870454	1451	1605	154	RIGHT	S451.EDF	S45	1
57	4895116	4895242	275	401	126	RIGHT	S451.EDF	S45	1
58	4904505	4904596	924	1015	91	RIGHT	S451.EDF	S45	1
59	4913678	4913761	167	250	83	RIGHT	S451.EDF	S45	1
59	4915023	4915153	1512	1642	130	RIGHT	S451.EDF	S45	1
60	4923207	4923335	760	888	128	RIGHT	S451.EDF	S45	1
61	4930451	4930504	214	267	53	RIGHT	S451.EDF	S45	1
61	4931285	4931420	1048	1183	135	RIGHT	S451.EDF	S45	1
63	4953100	4953162	725	787	62	RIGHT	S451.EDF	S45	1
63	4953746	4953863	1371	1488	117	RIGHT	S451.EDF	S45	1
66	4974506	4974608	58	160	102	RIGHT	S451.EDF	S45	1
67	4983674	4983720	249	295	46	RIGHT	S451.EDF	S45	1
73	5037242	5037296	1420	1474	54	RIGHT	S451.EDF	S45	1
74	5045636	5045726	1746	1836	90	RIGHT	S451.EDF	S45	1
75	5052452	5052457	700	705	5	RIGHT	S451.EDF	S45	1
76	5059560	5059657	608	705	97	RIGHT	S451.EDF	S45	1
76	5060394	5060536	1442	1584	142	RIGHT	S451.EDF	S45	1
77	5066574	5066640	221	287	66	RIGHT	S451.EDF	S45	1
78	5075140	5075185	57	102	45	RIGHT	S451.EDF	S45	1
78	5076066	5076179	983	1096	113	RIGHT	S451.EDF	S45	1
79	5085902	5086041	984	1123	139	RIGHT	S451.EDF	S45	1
80	5092943	5093041	109	207	98	RIGHT	S451.EDF	S45	1
81	5102670	5102750	173	253	80	RIGHT	S451.EDF	S45	1
81	5103303	5103396	806	899	93	RIGHT	S451.EDF	S45	1
82	5109880	5109966	938	1024	86	RIGHT	S451.EDF	S45	1
82	5111881	5111958	2939	3016	77	RIGHT	S451.EDF	S45	1
83	5116314	5116414	221	321	100	RIGHT	S451.EDF	S45	1
86	5142854	5142929	322	397	75	RIGHT	S451.EDF	S45	1
86	5143795	5143897	1263	1365	102	RIGHT	S451.EDF	S45	1
87	5151676	5151742	119	185	66	RIGHT	S451.EDF	S45	1
87	5153748	5153845	2191	2288	97	RIGHT	S451.EDF	S45	1
88	5162008	5162109	966	1067	101	RIGHT	S451.EDF	S45	1
89	5169529	5169623	694	788	94	RIGHT	S451.EDF	S45	1
90	5179144	5179266	1110	1232	122	RIGHT	S451.EDF	S45	1
91	5185895	5185922	1102	1129	27	RIGHT	S451.EDF	S45	1
91	5186264	5186266	1471	1473	2	RIGHT	S451.EDF	S45	1
92	5193614	5193718	813	917	104	RIGHT	S451.EDF	S45	1
93	5204294	5204428	402	536	134	RIGHT	S451.EDF	S45	1
95	5220178	5220204	248	274	26	RIGHT	S451.EDF	S45	1
95	5220910	5221058	980	1128	148	RIGHT	S451.EDF	S45	1
99	5255194	5255243	1266	1315	49	RIGHT	S451.EDF	S45	1
101	5270131	5270180	113	162	49	RIGHT	S451.EDF	S45	1
102	5278536	5278621	1351	1436	85	RIGHT	S451.EDF	S45	1
103	5288415	5288469	1036	1090	54	RIGHT	S451.EDF	S45	1
104	5295718	5295748	334	364	30	RIGHT	S451.EDF	S45	1
106	5311997	5312094	561	658	97	RIGHT	S451.EDF	S45	1
107	5319258	5319364	548	654	106	RIGHT	S451.EDF	S45	1
108	5327374	5327492	221	339	118	RIGHT	S451.EDF	S45	1
108	5328042	5328152	889	999	110	RIGHT	S451.EDF	S45	1
109	5337006	5337041	1174	1209	35	RIGHT	S451.EDF	S45	1
110	5342862	5342951	266	355	89	RIGHT	S451.EDF	S45	1
111	5351880	5351991	1133	1244	111	RIGHT	S451.EDF	S45	1
112	5359564	5359604	57	97	40	RIGHT	S451.EDF	S45	1
113	5368039	5368143	918	1022	104	RIGHT	S451.EDF	S45	1
115	5385051	5385157	835	941	106	RIGHT	S451.EDF	S45	1
115	5387434	5387467	3218	3251	33	RIGHT	S451.EDF	S45	1
117	5400023	5400108	802	887	85	RIGHT	S451.EDF	S45	1
118	5407961	5408020	339	398	59	RIGHT	S451.EDF	S45	1
118	5408516	5408595	894	973	79	RIGHT	S451.EDF	S45	1
119	5415273	5415353	291	371	80	RIGHT	S451.EDF	S45	1
120	5422905	5423007	96	198	102	RIGHT	S451.EDF	S45	1
4	6579270	6579375	57	162	105	RIGHT	S452.EDF	S45	2
5	6587175	6587329	303	457	154	RIGHT	S452.EDF	S45	2
6	6595193	6595229	71	107	36	RIGHT	S452.EDF	S45	2
9	6618269	6618308	57	96	39	RIGHT	S452.EDF	S45	2
9	6619816	6619885	1604	1673	69	RIGHT	S452.EDF	S45	2
11	6634588	6634682	118	212	94	RIGHT	S452.EDF	S45	2
11	6635862	6635982	1392	1512	120	RIGHT	S452.EDF	S45	2
12	6643941	6644056	1127	1242	115	RIGHT	S452.EDF	S45	2
13	6652482	6652608	569	695	126	RIGHT	S452.EDF	S45	2
14	6661170	6661291	302	423	121	RIGHT	S452.EDF	S45	2
14	6662284	6662404	1416	1536	120	RIGHT	S452.EDF	S45	2
16	6677496	6677534	112	150	38	RIGHT	S452.EDF	S45	2
18	6694138	6694182	73	117	44	RIGHT	S452.EDF	S45	2
18	6695274	6695331	1209	1266	57	RIGHT	S452.EDF	S45	2
19	6704422	6704484	1136	1198	62	RIGHT	S452.EDF	S45	2
19	6705731	6705740	2445	2454	9	RIGHT	S452.EDF	S45	2
19	6706477	6706481	3191	3195	4	RIGHT	S452.EDF	S45	2
21	6719658	6719664	404	410	6	RIGHT	S452.EDF	S45	2
22	6727344	6727461	851	968	117	RIGHT	S452.EDF	S45	2
23	6735292	6735353	82	143	61	RIGHT	S452.EDF	S45	2
24	6743030	6743043	361	374	13	RIGHT	S452.EDF	S45	2
24	6745449	6745480	2780	2811	31	RIGHT	S452.EDF	S45	2
25	6751814	6751873	509	568	59	RIGHT	S452.EDF	S45	2
26	6760377	6760457	856	936	80	RIGHT	S452.EDF	S45	2
29	6785694	6785828	943	1077	134	RIGHT	S452.EDF	S45	2
32	6811014	6811081	1212	1279	67	RIGHT	S452.EDF	S45	2
34	6825027	6825074	58	105	47	RIGHT	S452.EDF	S45	2
35	6836879	6836974	2898	2993	95	RIGHT	S452.EDF	S45	2
39	6871182	6871237	1582	1637	55	RIGHT	S452.EDF	S45	2
40	6882218	6882276	1065	1123	58	RIGHT	S452.EDF	S45	2
41	6888215	6888244	58	87	29	RIGHT	S452.EDF	S45	2
43	6906509	6906552	272	315	43	RIGHT	S452.EDF	S45	2
47	6939505	6939564	57	116	59	RIGHT	S452.EDF	S45	2
48	6947950	6948034	835	919	84	RIGHT	S452.EDF	S45	2
49	6955663	6955759	128	224	96	RIGHT	S452.EDF	S45	2
50	6964460	6964508	114	162	48	RIGHT	S452.EDF	S45	2
52	6982970	6983094	682	806	124	RIGHT	S452.EDF	S45	2
52	6983602	6983727	1314	1439	125	RIGHT	S452.EDF	S45	2
52	6985008	6985071	2720	2783	63	RIGHT	S452.EDF	S45	2
52	6986180	6986232	3892	3944	52	RIGHT	S452.EDF	S45	2
52	6986844	6986909	4556	4621	65	RIGHT	S452.EDF	S45	2
52	6988806	6988871	6518	6583	65	RIGHT	S452.EDF	S45	2
53	6992381	6992439	1143	1201	58	RIGHT	S452.EDF	S45	2
54	6998981	6999057	117	193	76	RIGHT	S452.EDF	S45	2
54	7000360	7000441	1496	1577	81	RIGHT	S452.EDF	S45	2
56	7016308	7016355	521	568	47	RIGHT	S452.EDF	S45	2
59	7040931	7041031	423	523	100	RIGHT	S452.EDF	S45	2
59	7041544	7041616	1036	1108	72	RIGHT	S452.EDF	S45	2
62	7068043	7068116	1029	1102	73	RIGHT	S452.EDF	S45	2
63	7077706	7077795	1138	1227	89	RIGHT	S452.EDF	S45	2
64	7086670	7086812	958	1100	142	RIGHT	S452.EDF	S45	2
66	7104119	7104189	983	1053	70	RIGHT	S452.EDF	S45	2
69	7128595	7128632	1098	1135	37	RIGHT	S452.EDF	S45	2
70	7137190	7137283	1012	1105	93	RIGHT	S452.EDF	S45	2
71	7146349	7146496	1037	1184	147	RIGHT	S452.EDF	S45	2
73	7165288	7165350	1620	1682	62	RIGHT	S452.EDF	S45	2
76	7189889	7189912	446	469	23	RIGHT	S452.EDF	S45	2
83	7245910	7245961	1270	1321	51	RIGHT	S452.EDF	S45	2
83	7248209	7248280	3569	3640	71	RIGHT	S452.EDF	S45	2
83	7249079	7249120	4439	4480	41	RIGHT	S452.EDF	S45	2
84	7253802	7253844	274	316	42	RIGHT	S452.EDF	S45	2
86	7269776	7269818	129	171	42	RIGHT	S452.EDF	S45	2
86	7273277	7273330	3630	3683	53	RIGHT	S452.EDF	S45	2
88	7285762	7285799	57	94	37	RIGHT	S452.EDF	S45	2
88	7287259	7287277	1554	1572	18	RIGHT	S452.EDF	S45	2
88	7288900	7288980	3195	3275	80	RIGHT	S452.EDF	S45	2
90	7303765	7303832	970	1037	67	RIGHT	S452.EDF	S45	2
90	7304433	7304557	1638	1762	124	RIGHT	S452.EDF	S45	2
91	7311956	7311990	175	209	34	RIGHT	S452.EDF	S45	2
95	7343355	7343447	974	1066	92	RIGHT	S452.EDF	S45	2
96	7352032	7352072	307	347	40	RIGHT	S452.EDF	S45	2
96	7352456	7352590	731	865	134	RIGHT	S452.EDF	S45	2
99	7376725	7376750	766	791	25	RIGHT	S452.EDF	S45	2
99	7377403	7377490	1444	1531	87	RIGHT	S452.EDF	S45	2
99	7378369	7378379	2410	2420	10	RIGHT	S452.EDF	S45	2
99	7379267	7379315	3308	3356	48	RIGHT	S452.EDF	S45	2
102	7401911	7401976	294	359	65	RIGHT	S452.EDF	S45	2
108	7449699	7449804	851	956	105	RIGHT	S452.EDF	S45	2
111	7476470	7476487	275	292	17	RIGHT	S452.EDF	S45	2
111	7477761	7477815	1566	1620	54	RIGHT	S452.EDF	S45	2
112	7486292	7486334	761	803	42	RIGHT	S452.EDF	S45	2
112	7486835	7486954	1304	1423	119	RIGHT	S452.EDF	S45	2
113	7493899	7493948	216	265	49	RIGHT	S452.EDF	S45	2
117	7528316	7528355	439	478	39	RIGHT	S452.EDF	S45	2
120	7553960	7553969	932	941	9	RIGHT	S452.EDF	S45	2
120	7553990	7553992	962	964	2	RIGHT	S452.EDF	S45	2
2	8002985	8003025	1590	1630	40	RIGHT	S453.EDF	S45	3
4	8016193	8016281	883	971	88	RIGHT	S453.EDF	S45	3
5	8024863	8024949	1318	1404	86	RIGHT	S453.EDF	S45	3
11	8076901	8076926	165	190	25	RIGHT	S453.EDF	S45	3
12	8087089	8087124	1107	1142	35	RIGHT	S453.EDF	S45	3
18	8138066	8138068	331	333	2	RIGHT	S453.EDF	S45	3
18	8138089	8138110	354	375	21	RIGHT	S453.EDF	S45	3
18	8138131	8138142	396	407	11	RIGHT	S453.EDF	S45	3
18	8139047	8139144	1312	1409	97	RIGHT	S453.EDF	S45	3
20	8153042	8153056	1214	1228	14	RIGHT	S453.EDF	S45	3
20	8153078	8153078	1250	1250	0	RIGHT	S453.EDF	S45	3
24	8185575	8185656	824	905	81	RIGHT	S453.EDF	S45	3
26	8201356	8201428	509	581	72	RIGHT	S453.EDF	S45	3
26	8201746	8201851	899	1004	105	RIGHT	S453.EDF	S45	3
26	8202240	8202328	1393	1481	88	RIGHT	S453.EDF	S45	3
31	8242854	8242863	224	233	9	RIGHT	S453.EDF	S45	3
31	8242886	8242906	256	276	20	RIGHT	S453.EDF	S45	3
31	8242929	8242941	299	311	12	RIGHT	S453.EDF	S45	3
33	8259319	8259455	296	432	136	RIGHT	S453.EDF	S45	3
34	8267181	8267300	276	395	119	RIGHT	S453.EDF	S45	3
35	8277802	8277896	1734	1828	94	RIGHT	S453.EDF	S45	3
40	8318653	8318780	1140	1267	127	RIGHT	S453.EDF	S45	3
45	8360151	8360163	286	298	12	RIGHT	S453.EDF	S45	3
45	8361755	8361761	1890	1896	6	RIGHT	S453.EDF	S45	3
46	8367973	8367975	221	223	2	RIGHT	S453.EDF	S45	3
46	8368011	8368011	259	259	0	RIGHT	S453.EDF	S45	3
46	8368918	8369072	1166	1320	154	RIGHT	S453.EDF	S45	3
49	8392352	8392403	57	108	51	RIGHT	S453.EDF	S45	3
50	8400542	8400600	251	309	58	RIGHT	S453.EDF	S45	3
51	8409432	8409541	407	516	109	RIGHT	S453.EDF	S45	3
52	8416308	8416356	123	171	48	RIGHT	S453.EDF	S45	3
52	8417454	8417483	1269	1298	29	RIGHT	S453.EDF	S45	3
55	8441765	8441799	835	869	34	RIGHT	S453.EDF	S45	3
57	8456462	8456512	57	107	50	RIGHT	S453.EDF	S45	3
57	8457704	8457760	1299	1355	56	RIGHT	S453.EDF	S45	3
58	8467780	8467888	309	417	108	RIGHT	S453.EDF	S45	3
59	8475258	8475350	57	149	92	RIGHT	S453.EDF	S45	3
59	8476549	8476622	1348	1421	73	RIGHT	S453.EDF	S45	3
61	8490724	8490786	899	961	62	RIGHT	S453.EDF	S45	3
62	8498192	8498243	268	319	51	RIGHT	S453.EDF	S45	3
62	8498264	8498294	340	370	30	RIGHT	S453.EDF	S45	3
65	8522991	8523089	494	592	98	RIGHT	S453.EDF	S45	3
65	8523506	8523628	1009	1131	122	RIGHT	S453.EDF	S45	3
65	8525081	8525163	2584	2666	82	RIGHT	S453.EDF	S45	3
70	8567452	8567595	535	678	143	RIGHT	S453.EDF	S45	3
75	8615753	8615834	178	259	81	RIGHT	S453.EDF	S45	3
78	8641680	8641844	575	739	164	RIGHT	S453.EDF	S45	3
79	8649835	8649918	523	606	83	RIGHT	S453.EDF	S45	3
79	8651082	8651137	1770	1825	55	RIGHT	S453.EDF	S45	3
82	8675702	8675734	319	351	32	RIGHT	S453.EDF	S45	3
82	8676173	8676231	790	848	58	RIGHT	S453.EDF	S45	3
87	8716787	8716870	212	295	83	RIGHT	S453.EDF	S45	3
90	8743366	8743382	94	110	16	RIGHT	S453.EDF	S45	3
91	8751959	8752089	463	593	130	RIGHT	S453.EDF	S45	3
100	8829590	8829669	95	174	79	RIGHT	S453.EDF	S45	3
105	8869578	8869618	159	199	40	RIGHT	S453.EDF	S45	3
113	8935942	8936038	823	919	96	RIGHT	S453.EDF	S45	3
113	8939151	8939184	4032	4065	33	RIGHT	S453.EDF	S45	3
114	8943501	8943565	397	461	64	RIGHT	S453.EDF	S45	3
114	8943928	8944037	824	933	109	RIGHT	S453.EDF	S45	3
117	8966604	8966610	551	557	6	RIGHT	S453.EDF	S45	3
118	8978757	8978765	3364	3372	8	RIGHT	S453.EDF	S45	3
118	8978790	8978792	3397	3399	2	RIGHT	S453.EDF	S45	3
120	8991645	8991686	57	98	41	RIGHT	S453.EDF	S45	3
120	8995031	8995039	3443	3451	8	RIGHT	S453.EDF	S45	3
120	8995070	8995080	3482	3492	10	RIGHT	S453.EDF	S45	3
8	3010298	3010387	584	673	89	RIGHT	T411.EDF	T41	1
13	3055384	3055387	94	97	3	RIGHT	T411.EDF	T41	1
13	3055611	3055636	321	346	25	RIGHT	T411.EDF	T41	1
13	3055659	3055666	369	376	7	RIGHT	T411.EDF	T41	1
13	3055737	3055855	447	565	118	RIGHT	T411.EDF	T41	1
13	3055877	3055895	587	605	18	RIGHT	T411.EDF	T41	1
18	3101368	3101499	578	709	131	RIGHT	T411.EDF	T41	1
20	3121084	3121116	496	528	32	RIGHT	T411.EDF	T41	1
20	3121138	3121147	550	559	9	RIGHT	T411.EDF	T41	1
23	3149600	3150122	143	665	522	RIGHT	T411.EDF	T41	1
23	3150171	3150390	714	933	219	RIGHT	T411.EDF	T41	1
26	3180517	3181012	57	552	495	RIGHT	T411.EDF	T41	1
28	3196207	3196209	80	82	2	RIGHT	T411.EDF	T41	1
28	3196401	3196602	274	475	201	RIGHT	T411.EDF	T41	1
30	3214163	3214232	475	544	69	RIGHT	T411.EDF	T41	1
34	3249490	3249520	489	519	30	RIGHT	T411.EDF	T41	1
35	3256529	3259524	57	3052	2995	RIGHT	T411.EDF	T41	1
43	3329423	3329528	58	163	105	RIGHT	T411.EDF	T41	1
43	3329555	3329574	190	209	19	RIGHT	T411.EDF	T41	1
45	3346189	3346294	304	409	105	RIGHT	T411.EDF	T41	1
45	3346490	3346543	605	658	53	RIGHT	T411.EDF	T41	1
45	3346569	3346576	684	691	7	RIGHT	T411.EDF	T41	1
54	3426010	3426131	792	913	121	RIGHT	T411.EDF	T41	1
56	3441623	3441678	224	279	55	RIGHT	T411.EDF	T41	1
66	3528231	3528293	58	120	62	RIGHT	T411.EDF	T41	1
66	3528393	3528916	220	743	523	RIGHT	T411.EDF	T41	1
80	3651555	3651704	839	988	149	RIGHT	T411.EDF	T41	1
80	3651732	3651737	1016	1021	5	RIGHT	T411.EDF	T41	1
90	3739087	3739218	96	227	131	RIGHT	T411.EDF	T41	1
93	3765259	3765269	99	109	10	RIGHT	T411.EDF	T41	1
93	3765291	3765408	131	248	117	RIGHT	T411.EDF	T41	1
98	3810528	3810561	58	91	33	RIGHT	T411.EDF	T41	1
98	3810856	3810860	386	390	4	RIGHT	T411.EDF	T41	1
102	3846316	3846955	849	1488	639	RIGHT	T411.EDF	T41	1
102	3848040	3848062	2573	2595	22	RIGHT	T411.EDF	T41	1
102	3848593	3848619	3126	3152	26	RIGHT	T411.EDF	T41	1
110	3916485	3916660	771	946	175	RIGHT	T411.EDF	T41	1
119	3993535	3993571	184	220	36	RIGHT	T411.EDF	T41	1
119	3993665	3993704	314	353	39	RIGHT	T411.EDF	T41	1
7	4846586	4847058	471	943	472	RIGHT	T412.EDF	T41	2
7	4847142	4847239	1027	1124	97	RIGHT	T412.EDF	T41	2
12	4888069	4888131	57	119	62	RIGHT	T412.EDF	T41	2
13	4895776	4895808	186	218	32	RIGHT	T412.EDF	T41	2
13	4895830	4895833	240	243	3	RIGHT	T412.EDF	T41	2
13	4896042	4896272	452	682	230	RIGHT	T412.EDF	T41	2
13	4896303	4896310	713	720	7	RIGHT	T412.EDF	T41	2
17	4929609	4929717	467	575	108	RIGHT	T412.EDF	T41	2
17	4929745	4929746	603	604	1	RIGHT	T412.EDF	T41	2
18	4938040	4938117	140	217	77	RIGHT	T412.EDF	T41	2
18	4938378	4938536	478	636	158	RIGHT	T412.EDF	T41	2
26	5004242	5004242	187	187	0	RIGHT	T412.EDF	T41	2
26	5004517	5004840	462	785	323	RIGHT	T412.EDF	T41	2
34	5070060	5070206	140	286	146	RIGHT	T412.EDF	T41	2
34	5070231	5070231	311	311	0	RIGHT	T412.EDF	T41	2
34	5070332	5070575	412	655	243	RIGHT	T412.EDF	T41	2
34	5070615	5070616	695	696	1	RIGHT	T412.EDF	T41	2
38	5103056	5103136	60	140	80	RIGHT	T412.EDF	T41	2
40	5121589	5121701	58	170	112	RIGHT	T412.EDF	T41	2
43	5146852	5146972	497	617	120	RIGHT	T412.EDF	T41	2
48	5186718	5187002	57	341	284	RIGHT	T412.EDF	T41	2
57	5261206	5261373	58	225	167	RIGHT	T412.EDF	T41	2
61	5294287	5294425	57	195	138	RIGHT	T412.EDF	T41	2
64	5319809	5319901	58	150	92	RIGHT	T412.EDF	T41	2
64	5320645	5320753	894	1002	108	RIGHT	T412.EDF	T41	2
67	5348520	5348670	119	269	150	RIGHT	T412.EDF	T41	2
68	5358116	5358308	92	284	192	RIGHT	T412.EDF	T41	2
69	5366858	5367073	441	656	215	RIGHT	T412.EDF	T41	2
69	5367106	5367111	689	694	5	RIGHT	T412.EDF	T41	2
76	5426743	5426763	58	78	20	RIGHT	T412.EDF	T41	2
82	5477567	5477602	58	93	35	RIGHT	T412.EDF	T41	2
84	5496212	5496343	185	316	131	RIGHT	T412.EDF	T41	2
84	5496555	5496555	528	528	0	RIGHT	T412.EDF	T41	2
84	5496577	5496589	550	562	12	RIGHT	T412.EDF	T41	2
92	5560684	5560694	417	427	10	RIGHT	T412.EDF	T41	2
92	5560734	5560743	467	476	9	RIGHT	T412.EDF	T41	2
92	5561102	5561258	835	991	156	RIGHT	T412.EDF	T41	2
98	5612222	5612251	57	86	29	RIGHT	T412.EDF	T41	2
98	5612585	5612616	420	451	31	RIGHT	T412.EDF	T41	2
98	5612772	5613176	607	1011	404	RIGHT	T412.EDF	T41	2
105	5670826	5670864	57	95	38	RIGHT	T412.EDF	T41	2
2	6528396	6528806	57	467	410	RIGHT	T413.EDF	T41	3
5	6555745	6555770	5447	5472	25	RIGHT	T413.EDF	T41	3
8	6574756	6574978	465	687	222	RIGHT	T413.EDF	T41	3
8	6575081	6575244	790	953	163	RIGHT	T413.EDF	T41	3
8	6575266	6575268	975	977	2	RIGHT	T413.EDF	T41	3
17	6648297	6648326	57	86	29	RIGHT	T413.EDF	T41	3
19	6662079	6662176	58	155	97	RIGHT	T413.EDF	T41	3
20	6671847	6671908	1444	1505	61	RIGHT	T413.EDF	T41	3
23	6694446	6694540	173	267	94	RIGHT	T413.EDF	T41	3
36	6802877	6803082	57	262	205	RIGHT	T413.EDF	T41	3
36	6803369	6803527	549	707	158	RIGHT	T413.EDF	T41	3
38	6818249	6818282	58	91	33	RIGHT	T413.EDF	T41	3
38	6818310	6818319	119	128	9	RIGHT	T413.EDF	T41	3
40	6834516	6834631	57	172	115	RIGHT	T413.EDF	T41	3
44	6868366	6868372	274	280	6	RIGHT	T413.EDF	T41	3
44	6868446	6868446	354	354	0	RIGHT	T413.EDF	T41	3
44	6869322	6869375	1230	1283	53	RIGHT	T413.EDF	T41	3
45	6875574	6875621	57	104	47	RIGHT	T413.EDF	T41	3
51	6928278	6928954	58	734	676	RIGHT	T413.EDF	T41	3
51	6928981	6928981	761	761	0	RIGHT	T413.EDF	T41	3
54	6950981	6951060	57	136	79	RIGHT	T413.EDF	T41	3
55	6959221	6959272	57	108	51	RIGHT	T413.EDF	T41	3
64	7031012	7031032	83	103	20	RIGHT	T413.EDF	T41	3
65	7040690	7040700	134	144	10	RIGHT	T413.EDF	T41	3
65	7040841	7041099	285	543	258	RIGHT	T413.EDF	T41	3
65	7041151	7041165	595	609	14	RIGHT	T413.EDF	T41	3
68	7063961	7064551	57	647	590	RIGHT	T413.EDF	T41	3
69	7072617	7072720	57	160	103	RIGHT	T413.EDF	T41	3
69	7072744	7072746	184	186	2	RIGHT	T413.EDF	T41	3
72	7095607	7095706	185	284	99	RIGHT	T413.EDF	T41	3
74	7110629	7110678	58	107	49	RIGHT	T413.EDF	T41	3
76	7128396	7128595	814	1013	199	RIGHT	T413.EDF	T41	3
84	7192390	7192481	1510	1601	91	RIGHT	T413.EDF	T41	3
84	7195758	7197556	4878	6676	1798	RIGHT	T413.EDF	T41	3
90	7243807	7243959	2360	2512	152	RIGHT	T413.EDF	T41	3
91	7249598	7250364	57	823	766	RIGHT	T413.EDF	T41	3
94	7275813	7275822	615	624	9	RIGHT	T413.EDF	T41	3
94	7275850	7276613	652	1415	763	RIGHT	T413.EDF	T41	3
99	7317004	7317123	912	1031	119	RIGHT	T413.EDF	T41	3
100	7324292	7324537	182	427	245	RIGHT	T413.EDF	T41	3
103	7351092	7351359	313	580	267	RIGHT	T413.EDF	T41	3
103	7351545	7351583	766	804	38	RIGHT	T413.EDF	T41	3
104	7360142	7362188	57	2103	2046	RIGHT	T413.EDF	T41	3
105	7368100	7368167	57	124	67	RIGHT	T413.EDF	T41	3
106	7377044	7377099	58	113	55	RIGHT	T413.EDF	T41	3
108	7395484	7395753	846	1115	269	RIGHT	T413.EDF	T41	3
109	7403725	7403876	964	1115	151	RIGHT	T413.EDF	T41	3
110	7411223	7411360	58	195	137	RIGHT	T413.EDF	T41	3
113	7438963	7439164	741	942	201	RIGHT	T413.EDF	T41	3
115	7453197	7453289	58	150	92	RIGHT	T413.EDF	T41	3
116	7463166	7463264	959	1057	98	RIGHT	T413.EDF	T41	3
117	7471653	7471706	57	110	53	RIGHT	T413.EDF	T41	3
117	7474143	7474195	2547	2599	52	RIGHT	T413.EDF	T41	3
118	7481680	7482561	1832	2713	881	RIGHT	T413.EDF	T41	3
118	7482585	7482593	2737	2745	8	RIGHT	T413.EDF	T41	3
118	7482615	7482622	2767	2774	7	RIGHT	T413.EDF	T41	3
118	7482648	7482660	2800	2812	12	RIGHT	T413.EDF	T41	3
1	443133	443225	1018	1110	92	RIGHT	Y481.EDF	Y48	1
2	451521	451645	1276	1400	124	RIGHT	Y481.EDF	Y48	1
3	457823	457899	434	510	76	RIGHT	Y481.EDF	Y48	1
4	465962	466115	1416	1569	153	RIGHT	Y481.EDF	Y48	1
4	470400	470660	5854	6114	260	RIGHT	Y481.EDF	Y48	1
5	474209	474322	1227	1340	113	RIGHT	Y481.EDF	Y48	1
6	479783	480090	58	365	307	RIGHT	Y481.EDF	Y48	1
6	481128	481242	1403	1517	114	RIGHT	Y481.EDF	Y48	1
6	484080	484452	4355	4727	372	RIGHT	Y481.EDF	Y48	1
6	485777	485902	6052	6177	125	RIGHT	Y481.EDF	Y48	1
6	486893	487231	7168	7506	338	RIGHT	Y481.EDF	Y48	1
7	488811	488912	167	268	101	RIGHT	Y481.EDF	Y48	1
7	490141	490293	1497	1649	152	RIGHT	Y481.EDF	Y48	1
8	498154	498287	1597	1730	133	RIGHT	Y481.EDF	Y48	1
9	504597	504705	495	603	108	RIGHT	Y481.EDF	Y48	1
9	506379	506488	2277	2386	109	RIGHT	Y481.EDF	Y48	1
9	508274	508397	4172	4295	123	RIGHT	Y481.EDF	Y48	1
9	508790	508931	4688	4829	141	RIGHT	Y481.EDF	Y48	1
10	512777	512897	490	610	120	RIGHT	Y481.EDF	Y48	1
10	514556	514716	2269	2429	160	RIGHT	Y481.EDF	Y48	1
10	516925	517078	4638	4791	153	RIGHT	Y481.EDF	Y48	1
11	519970	520118	543	691	148	RIGHT	Y481.EDF	Y48	1
12	527052	527423	57	428	371	RIGHT	Y481.EDF	Y48	1
13	536142	536303	981	1142	161	RIGHT	Y481.EDF	Y48	1
13	537611	537783	2450	2622	172	RIGHT	Y481.EDF	Y48	1
14	543722	543872	477	627	150	RIGHT	Y481.EDF	Y48	1
15	551337	551386	57	106	49	RIGHT	Y481.EDF	Y48	1
15	553590	553718	2310	2438	128	RIGHT	Y481.EDF	Y48	1
16	559104	559285	801	982	181	RIGHT	Y481.EDF	Y48	1
17	567777	567905	1227	1355	128	RIGHT	Y481.EDF	Y48	1
18	574554	574675	1251	1372	121	RIGHT	Y481.EDF	Y48	1
19	581089	581224	881	1016	135	RIGHT	Y481.EDF	Y48	1
20	587412	587536	490	614	124	RIGHT	Y481.EDF	Y48	1
20	588933	589059	2011	2137	126	RIGHT	Y481.EDF	Y48	1
21	596018	596136	485	603	118	RIGHT	Y481.EDF	Y48	1
21	601717	601769	6184	6236	52	RIGHT	Y481.EDF	Y48	1
22	604978	605103	1497	1622	125	RIGHT	Y481.EDF	Y48	1
22	606398	606512	2917	3031	114	RIGHT	Y481.EDF	Y48	1
23	610956	611099	553	696	143	RIGHT	Y481.EDF	Y48	1
24	618459	618553	57	151	94	RIGHT	Y481.EDF	Y48	1
24	624403	624516	6001	6114	113	RIGHT	Y481.EDF	Y48	1
25	627022	627158	97	233	136	RIGHT	Y481.EDF	Y48	1
25	629130	629261	2205	2336	131	RIGHT	Y481.EDF	Y48	1
25	631575	632150	4650	5225	575	RIGHT	Y481.EDF	Y48	1
26	636317	636434	1724	1841	117	RIGHT	Y481.EDF	Y48	1
26	639185	639449	4592	4856	264	RIGHT	Y481.EDF	Y48	1
26	640305	640434	5712	5841	129	RIGHT	Y481.EDF	Y48	1
27	646730	646891	4094	4255	161	RIGHT	Y481.EDF	Y48	1
29	658533	658627	1847	1941	94	RIGHT	Y481.EDF	Y48	1
30	665420	665575	1140	1295	155	RIGHT	Y481.EDF	Y48	1
31	673304	673429	600	725	125	RIGHT	Y481.EDF	Y48	1
32	681283	681369	1348	1434	86	RIGHT	Y481.EDF	Y48	1
33	688652	688764	908	1020	112	RIGHT	Y481.EDF	Y48	1
34	696390	696486	2103	2199	96	RIGHT	Y481.EDF	Y48	1
36	711857	711946	1729	1818	89	RIGHT	Y481.EDF	Y48	1
38	726255	726382	1289	1416	127	RIGHT	Y481.EDF	Y48	1
39	733257	733284	57	84	27	RIGHT	Y481.EDF	Y48	1
40	740364	740486	148	270	122	RIGHT	Y481.EDF	Y48	1
41	748583	748749	1131	1297	166	RIGHT	Y481.EDF	Y48	1
41	750154	750270	2702	2818	116	RIGHT	Y481.EDF	Y48	1
42	755599	755728	463	592	129	RIGHT	Y481.EDF	Y48	1
42	756260	756266	1124	1130	6	RIGHT	Y481.EDF	Y48	1
42	756298	757398	1162	2262	1100	RIGHT	Y481.EDF	Y48	1
42	757419	757471	2283	2335	52	RIGHT	Y481.EDF	Y48	1
43	764469	764606	1387	1524	137	RIGHT	Y481.EDF	Y48	1
44	773375	773523	2898	3046	148	RIGHT	Y481.EDF	Y48	1
44	775287	775421	4810	4944	134	RIGHT	Y481.EDF	Y48	1
45	778058	778143	58	143	85	RIGHT	Y481.EDF	Y48	1
45	779411	779584	1411	1584	173	RIGHT	Y481.EDF	Y48	1
47	792954	793105	670	821	151	RIGHT	Y481.EDF	Y48	1
47	794099	794276	1815	1992	177	RIGHT	Y481.EDF	Y48	1
48	801665	801823	1311	1469	158	RIGHT	Y481.EDF	Y48	1
49	809244	809358	1305	1419	114	RIGHT	Y481.EDF	Y48	1
50	819020	819131	2986	3097	111	RIGHT	Y481.EDF	Y48	1
53	839415	839529	2373	2487	114	RIGHT	Y481.EDF	Y48	1
53	841004	841099	3962	4057	95	RIGHT	Y481.EDF	Y48	1
55	853213	853379	547	713	166	RIGHT	Y481.EDF	Y48	1
55	853480	853632	814	966	152	RIGHT	Y481.EDF	Y48	1
56	862798	862905	2687	2794	107	RIGHT	Y481.EDF	Y48	1
56	865544	865669	5433	5558	125	RIGHT	Y481.EDF	Y48	1
57	868609	868767	502	660	158	RIGHT	Y481.EDF	Y48	1
57	868921	869108	814	1001	187	RIGHT	Y481.EDF	Y48	1
57	872898	873073	4791	4966	175	RIGHT	Y481.EDF	Y48	1
57	874506	874576	6399	6469	70	RIGHT	Y481.EDF	Y48	1
57	874599	874605	6492	6498	6	RIGHT	Y481.EDF	Y48	1
57	874632	874636	6525	6529	4	RIGHT	Y481.EDF	Y48	1
57	874659	874691	6552	6584	32	RIGHT	Y481.EDF	Y48	1
57	874748	874750	6641	6643	2	RIGHT	Y481.EDF	Y48	1
58	876437	877589	57	1209	1152	RIGHT	Y481.EDF	Y48	1
58	877615	877637	1235	1257	22	RIGHT	Y481.EDF	Y48	1
58	877704	877704	1324	1324	0	RIGHT	Y481.EDF	Y48	1
58	877763	877862	1383	1482	99	RIGHT	Y481.EDF	Y48	1
58	878524	879562	2144	3182	1038	RIGHT	Y481.EDF	Y48	1
58	879712	879739	3332	3359	27	RIGHT	Y481.EDF	Y48	1
58	879761	879793	3381	3413	32	RIGHT	Y481.EDF	Y48	1
58	879817	879845	3437	3465	28	RIGHT	Y481.EDF	Y48	1
58	880003	880004	3623	3624	1	RIGHT	Y481.EDF	Y48	1
58	880025	880103	3645	3723	78	RIGHT	Y481.EDF	Y48	1
58	880144	880175	3764	3795	31	RIGHT	Y481.EDF	Y48	1
58	880251	880272	3871	3892	21	RIGHT	Y481.EDF	Y48	1
58	880299	881712	3919	5332	1413	RIGHT	Y481.EDF	Y48	1
58	881739	881804	5359	5424	65	RIGHT	Y481.EDF	Y48	1
58	881916	882623	5536	6243	707	RIGHT	Y481.EDF	Y48	1
58	882652	882655	6272	6275	3	RIGHT	Y481.EDF	Y48	1
58	883027	883313	6647	6933	286	RIGHT	Y481.EDF	Y48	1
58	883357	883366	6977	6986	9	RIGHT	Y481.EDF	Y48	1
58	883411	883411	7031	7031	0	RIGHT	Y481.EDF	Y48	1
58	883503	883793	7123	7413	290	RIGHT	Y481.EDF	Y48	1
58	883830	883886	7450	7506	56	RIGHT	Y481.EDF	Y48	1
59	885430	885481	57	108	51	RIGHT	Y481.EDF	Y48	1
59	886250	886301	877	928	51	RIGHT	Y481.EDF	Y48	1
59	886334	886334	961	961	0	RIGHT	Y481.EDF	Y48	1
59	886765	886765	1392	1392	0	RIGHT	Y481.EDF	Y48	1
59	888059	888341	2686	2968	282	RIGHT	Y481.EDF	Y48	1
59	888365	888446	2992	3073	81	RIGHT	Y481.EDF	Y48	1
59	888484	888484	3111	3111	0	RIGHT	Y481.EDF	Y48	1
59	888526	888748	3153	3375	222	RIGHT	Y481.EDF	Y48	1
59	889472	889631	4099	4258	159	RIGHT	Y481.EDF	Y48	1
59	889652	889680	4279	4307	28	RIGHT	Y481.EDF	Y48	1
59	889807	890070	4434	4697	263	RIGHT	Y481.EDF	Y48	1
59	890110	890167	4737	4794	57	RIGHT	Y481.EDF	Y48	1
59	890223	890244	4850	4871	21	RIGHT	Y481.EDF	Y48	1
59	890313	890318	4940	4945	5	RIGHT	Y481.EDF	Y48	1
59	890461	890473	5088	5100	12	RIGHT	Y481.EDF	Y48	1
59	890589	890703	5216	5330	114	RIGHT	Y481.EDF	Y48	1
59	890735	890735	5362	5362	0	RIGHT	Y481.EDF	Y48	1
59	890837	890922	5464	5549	85	RIGHT	Y481.EDF	Y48	1
59	890996	890998	5623	5625	2	RIGHT	Y481.EDF	Y48	1
59	891023	891222	5650	5849	199	RIGHT	Y481.EDF	Y48	1
59	891281	891325	5908	5952	44	RIGHT	Y481.EDF	Y48	1
59	891392	891425	6019	6052	33	RIGHT	Y481.EDF	Y48	1
59	892590	892850	7217	7477	260	RIGHT	Y481.EDF	Y48	1
60	895089	895089	517	517	0	RIGHT	Y481.EDF	Y48	1
60	895138	895374	566	802	236	RIGHT	Y481.EDF	Y48	1
60	895416	895461	844	889	45	RIGHT	Y481.EDF	Y48	1
60	895675	895706	1103	1134	31	RIGHT	Y481.EDF	Y48	1
60	895746	895859	1174	1287	113	RIGHT	Y481.EDF	Y48	1
60	896366	896374	1794	1802	8	RIGHT	Y481.EDF	Y48	1
60	896530	896802	1958	2230	272	RIGHT	Y481.EDF	Y48	1
60	896838	896884	2266	2312	46	RIGHT	Y481.EDF	Y48	1
60	897112	897227	2540	2655	115	RIGHT	Y481.EDF	Y48	1
60	897276	897302	2704	2730	26	RIGHT	Y481.EDF	Y48	1
60	898362	898362	3790	3790	0	RIGHT	Y481.EDF	Y48	1
60	898404	898461	3832	3889	57	RIGHT	Y481.EDF	Y48	1
60	898537	898575	3965	4003	38	RIGHT	Y481.EDF	Y48	1
60	898862	898862	4290	4290	0	RIGHT	Y481.EDF	Y48	1
60	899266	899291	4694	4719	25	RIGHT	Y481.EDF	Y48	1
60	899741	899763	5169	5191	22	RIGHT	Y481.EDF	Y48	1
60	899795	899801	5223	5229	6	RIGHT	Y481.EDF	Y48	1
60	899852	899910	5280	5338	58	RIGHT	Y481.EDF	Y48	1
61	901843	902018	57	232	175	RIGHT	Y481.EDF	Y48	1
61	902058	902178	272	392	120	RIGHT	Y481.EDF	Y48	1
61	902444	902473	658	687	29	RIGHT	Y481.EDF	Y48	1
61	902699	902854	913	1068	155	RIGHT	Y481.EDF	Y48	1
61	904365	904505	2579	2719	140	RIGHT	Y481.EDF	Y48	1
61	904620	904722	2834	2936	102	RIGHT	Y481.EDF	Y48	1
62	908916	909029	57	170	113	RIGHT	Y481.EDF	Y48	1
62	911166	911321	2307	2462	155	RIGHT	Y481.EDF	Y48	1
62	913568	913860	4709	5001	292	RIGHT	Y481.EDF	Y48	1
62	914055	914057	5196	5198	2	RIGHT	Y481.EDF	Y48	1
62	914091	914683	5232	5824	592	RIGHT	Y481.EDF	Y48	1
62	914830	914942	5971	6083	112	RIGHT	Y481.EDF	Y48	1
63	917084	917084	529	529	0	RIGHT	Y481.EDF	Y48	1
63	917287	917370	732	815	83	RIGHT	Y481.EDF	Y48	1
64	926719	927205	1177	1663	486	RIGHT	Y481.EDF	Y48	1
64	927259	927324	1717	1782	65	RIGHT	Y481.EDF	Y48	1
64	928516	928617	2974	3075	101	RIGHT	Y481.EDF	Y48	1
64	930076	930076	4534	4534	0	RIGHT	Y481.EDF	Y48	1
64	930097	930214	4555	4672	117	RIGHT	Y481.EDF	Y48	1
64	930358	930485	4816	4943	127	RIGHT	Y481.EDF	Y48	1
64	932519	932545	6977	7003	26	RIGHT	Y481.EDF	Y48	1
65	935071	935220	609	758	149	RIGHT	Y481.EDF	Y48	1
66	941818	941961	87	230	143	RIGHT	Y481.EDF	Y48	1
66	943669	943748	1938	2017	79	RIGHT	Y481.EDF	Y48	1
67	949904	950074	869	1039	170	RIGHT	Y481.EDF	Y48	1
67	950804	950877	1769	1842	73	RIGHT	Y481.EDF	Y48	1
67	953269	953392	4234	4357	123	RIGHT	Y481.EDF	Y48	1
67	954173	954328	5138	5293	155	RIGHT	Y481.EDF	Y48	1
67	954718	954817	5683	5782	99	RIGHT	Y481.EDF	Y48	1
69	966117	966274	1144	1301	157	RIGHT	Y481.EDF	Y48	1
70	974627	974799	1160	1332	172	RIGHT	Y481.EDF	Y48	1
70	975062	975207	1595	1740	145	RIGHT	Y481.EDF	Y48	1
71	988515	988646	6629	6760	131	RIGHT	Y481.EDF	Y48	1
72	990358	990392	57	91	34	RIGHT	Y481.EDF	Y48	1
72	990551	990708	250	407	157	RIGHT	Y481.EDF	Y48	1
72	992171	992289	1870	1988	118	RIGHT	Y481.EDF	Y48	1
73	997240	997413	525	698	173	RIGHT	Y481.EDF	Y48	1
73	999283	999428	2568	2713	145	RIGHT	Y481.EDF	Y48	1
73	1002288	1002429	5573	5714	141	RIGHT	Y481.EDF	Y48	1
74	1006132	1006338	523	729	206	RIGHT	Y481.EDF	Y48	1
75	1013007	1013158	494	645	151	RIGHT	Y481.EDF	Y48	1
76	1020710	1020929	514	733	219	RIGHT	Y481.EDF	Y48	1
76	1021011	1021186	815	990	175	RIGHT	Y481.EDF	Y48	1
77	1028216	1028221	1180	1185	5	RIGHT	Y481.EDF	Y48	1
77	1028251	1029267	1215	2231	1016	RIGHT	Y481.EDF	Y48	1
77	1029300	1029369	2264	2333	69	RIGHT	Y481.EDF	Y48	1
78	1036204	1036208	698	702	4	RIGHT	Y481.EDF	Y48	1
78	1036232	1036364	726	858	132	RIGHT	Y481.EDF	Y48	1
78	1036409	1036428	903	922	19	RIGHT	Y481.EDF	Y48	1
78	1036468	1036468	962	962	0	RIGHT	Y481.EDF	Y48	1
78	1036499	1036500	993	994	1	RIGHT	Y481.EDF	Y48	1
78	1036522	1036522	1016	1016	0	RIGHT	Y481.EDF	Y48	1
78	1036568	1036579	1062	1073	11	RIGHT	Y481.EDF	Y48	1
78	1036608	1036636	1102	1130	28	RIGHT	Y481.EDF	Y48	1
78	1036667	1036873	1161	1367	206	RIGHT	Y481.EDF	Y48	1
78	1036968	1037284	1462	1778	316	RIGHT	Y481.EDF	Y48	1
78	1037350	1037425	1844	1919	75	RIGHT	Y481.EDF	Y48	1
78	1037620	1037749	2114	2243	129	RIGHT	Y481.EDF	Y48	1
78	1037994	1038120	2488	2614	126	RIGHT	Y481.EDF	Y48	1
78	1038314	1038325	2808	2819	11	RIGHT	Y481.EDF	Y48	1
78	1038532	1038532	3026	3026	0	RIGHT	Y481.EDF	Y48	1
78	1038563	1038563	3057	3057	0	RIGHT	Y481.EDF	Y48	1
78	1038648	1038650	3142	3144	2	RIGHT	Y481.EDF	Y48	1
78	1038692	1038692	3186	3186	0	RIGHT	Y481.EDF	Y48	1
78	1039188	1039270	3682	3764	82	RIGHT	Y481.EDF	Y48	1
78	1040563	1040563	5057	5057	0	RIGHT	Y481.EDF	Y48	1
78	1040605	1040996	5099	5490	391	RIGHT	Y481.EDF	Y48	1
79	1043141	1043177	67	103	36	RIGHT	Y481.EDF	Y48	1
79	1043563	1043581	489	507	18	RIGHT	Y481.EDF	Y48	1
79	1044470	1044541	1396	1467	71	RIGHT	Y481.EDF	Y48	1
80	1050792	1050918	764	890	126	RIGHT	Y481.EDF	Y48	1
81	1057625	1057763	101	239	138	RIGHT	Y481.EDF	Y48	1
82	1065127	1065278	541	692	151	RIGHT	Y481.EDF	Y48	1
83	1073631	1073771	57	197	140	RIGHT	Y481.EDF	Y48	1
83	1073970	1074513	396	939	543	RIGHT	Y481.EDF	Y48	1
83	1074557	1074737	983	1163	180	RIGHT	Y481.EDF	Y48	1
83	1074977	1075616	1403	2042	639	RIGHT	Y481.EDF	Y48	1
83	1075897	1075948	2323	2374	51	RIGHT	Y481.EDF	Y48	1
83	1077131	1077241	3557	3667	110	RIGHT	Y481.EDF	Y48	1
83	1078004	1078242	4430	4668	238	RIGHT	Y481.EDF	Y48	1
84	1081136	1081293	750	907	157	RIGHT	Y481.EDF	Y48	1
84	1082898	1083518	2512	3132	620	RIGHT	Y481.EDF	Y48	1
84	1085398	1085551	5012	5165	153	RIGHT	Y481.EDF	Y48	1
85	1087437	1089649	58	2270	2212	RIGHT	Y481.EDF	Y48	1
85	1089806	1089808	2427	2429	2	RIGHT	Y481.EDF	Y48	1
85	1090109	1093614	2730	6235	3505	RIGHT	Y481.EDF	Y48	1
86	1094983	1096656	58	1731	1673	RIGHT	Y481.EDF	Y48	1
86	1096889	1096988	1964	2063	99	RIGHT	Y481.EDF	Y48	1
86	1098155	1098199	3230	3274	44	RIGHT	Y481.EDF	Y48	1
86	1099687	1099779	4762	4854	92	RIGHT	Y481.EDF	Y48	1
87	1102975	1102981	548	554	6	RIGHT	Y481.EDF	Y48	1
87	1103015	1103576	588	1149	561	RIGHT	Y481.EDF	Y48	1
87	1108543	1108677	6116	6250	134	RIGHT	Y481.EDF	Y48	1
88	1112827	1112899	2046	2118	72	RIGHT	Y481.EDF	Y48	1
88	1114780	1114923	3999	4142	143	RIGHT	Y481.EDF	Y48	1
89	1119326	1119502	185	361	176	RIGHT	Y481.EDF	Y48	1
89	1119597	1119748	456	607	151	RIGHT	Y481.EDF	Y48	1
89	1119858	1119935	717	794	77	RIGHT	Y481.EDF	Y48	1
89	1120428	1120533	1287	1392	105	RIGHT	Y481.EDF	Y48	1
89	1122774	1122874	3633	3733	100	RIGHT	Y481.EDF	Y48	1
89	1124848	1124962	5707	5821	114	RIGHT	Y481.EDF	Y48	1
90	1130643	1130743	2588	2688	100	RIGHT	Y481.EDF	Y48	1
90	1131576	1131720	3521	3665	144	RIGHT	Y481.EDF	Y48	1
90	1133186	1133274	5131	5219	88	RIGHT	Y481.EDF	Y48	1
91	1135328	1135328	388	388	0	RIGHT	Y481.EDF	Y48	1
91	1135371	1135819	431	879	448	RIGHT	Y481.EDF	Y48	1
91	1135852	1135968	912	1028	116	RIGHT	Y481.EDF	Y48	1
91	1136893	1137011	1953	2071	118	RIGHT	Y481.EDF	Y48	1
92	1144776	1144933	1131	1288	157	RIGHT	Y481.EDF	Y48	1
93	1151686	1151758	57	129	72	RIGHT	Y481.EDF	Y48	1
93	1152065	1152225	436	596	160	RIGHT	Y481.EDF	Y48	1
93	1152437	1152568	808	939	131	RIGHT	Y481.EDF	Y48	1
93	1153176	1153287	1547	1658	111	RIGHT	Y481.EDF	Y48	1
94	1159782	1159851	57	126	69	RIGHT	Y481.EDF	Y48	1
94	1160229	1160753	504	1028	524	RIGHT	Y481.EDF	Y48	1
94	1161174	1161243	1449	1518	69	RIGHT	Y481.EDF	Y48	1
94	1164031	1164129	4306	4404	98	RIGHT	Y481.EDF	Y48	1
94	1165442	1165442	5717	5717	0	RIGHT	Y481.EDF	Y48	1
95	1167710	1168025	583	898	315	RIGHT	Y481.EDF	Y48	1
96	1177361	1177414	2005	2058	53	RIGHT	Y481.EDF	Y48	1
97	1185309	1185414	3089	3194	105	RIGHT	Y481.EDF	Y48	1
97	1186506	1186684	4286	4464	178	RIGHT	Y481.EDF	Y48	1
98	1189818	1189990	637	809	172	RIGHT	Y481.EDF	Y48	1
99	1197552	1197630	57	135	78	RIGHT	Y481.EDF	Y48	1
99	1199020	1199164	1525	1669	144	RIGHT	Y481.EDF	Y48	1
99	1200435	1200540	2940	3045	105	RIGHT	Y481.EDF	Y48	1
100	1204632	1204769	488	625	137	RIGHT	Y481.EDF	Y48	1
100	1204800	1205789	656	1645	989	RIGHT	Y481.EDF	Y48	1
101	1211921	1212069	645	793	148	RIGHT	Y481.EDF	Y48	1
101	1213065	1213143	1789	1867	78	RIGHT	Y481.EDF	Y48	1
102	1219380	1219399	57	76	19	RIGHT	Y481.EDF	Y48	1
102	1219854	1219981	531	658	127	RIGHT	Y481.EDF	Y48	1
102	1220095	1220171	772	848	76	RIGHT	Y481.EDF	Y48	1
102	1220845	1220963	1522	1640	118	RIGHT	Y481.EDF	Y48	1
102	1221347	1221768	2024	2445	421	RIGHT	Y481.EDF	Y48	1
102	1222325	1222533	3002	3210	208	RIGHT	Y481.EDF	Y48	1
102	1222930	1223076	3607	3753	146	RIGHT	Y481.EDF	Y48	1
102	1223124	1223145	3801	3822	21	RIGHT	Y481.EDF	Y48	1
102	1223220	1224585	3897	5262	1365	RIGHT	Y481.EDF	Y48	1
103	1227492	1227979	58	545	487	RIGHT	Y481.EDF	Y48	1
103	1228018	1228150	584	716	132	RIGHT	Y481.EDF	Y48	1
103	1228499	1229518	1065	2084	1019	RIGHT	Y481.EDF	Y48	1
103	1229545	1229636	2111	2202	91	RIGHT	Y481.EDF	Y48	1
104	1235215	1235549	495	829	334	RIGHT	Y481.EDF	Y48	1
104	1236255	1236391	1535	1671	136	RIGHT	Y481.EDF	Y48	1
104	1236719	1236794	1999	2074	75	RIGHT	Y481.EDF	Y48	1
105	1244276	1244404	490	618	128	RIGHT	Y481.EDF	Y48	1
105	1244629	1246022	843	2236	1393	RIGHT	Y481.EDF	Y48	1
105	1246043	1246108	2257	2322	65	RIGHT	Y481.EDF	Y48	1
105	1247850	1247968	4064	4182	118	RIGHT	Y481.EDF	Y48	1
105	1249306	1249448	5520	5662	142	RIGHT	Y481.EDF	Y48	1
106	1251998	1252033	58	93	35	RIGHT	Y481.EDF	Y48	1
106	1252848	1252985	908	1045	137	RIGHT	Y481.EDF	Y48	1
106	1253056	1255138	1116	3198	2082	RIGHT	Y481.EDF	Y48	1
107	1259110	1259136	57	83	26	RIGHT	Y481.EDF	Y48	1
107	1259330	1259451	277	398	121	RIGHT	Y481.EDF	Y48	1
107	1259699	1259718	646	665	19	RIGHT	Y481.EDF	Y48	1
107	1259984	1264995	931	5942	5011	RIGHT	Y481.EDF	Y48	1
107	1265060	1265184	6007	6131	124	RIGHT	Y481.EDF	Y48	1
108	1268989	1269063	755	829	74	RIGHT	Y481.EDF	Y48	1
108	1273914	1273946	5680	5712	32	RIGHT	Y481.EDF	Y48	1
109	1275880	1275925	364	409	45	RIGHT	Y481.EDF	Y48	1
109	1275973	1275982	457	466	9	RIGHT	Y481.EDF	Y48	1
109	1276017	1278022	501	2506	2005	RIGHT	Y481.EDF	Y48	1
109	1279307	1279448	3791	3932	141	RIGHT	Y481.EDF	Y48	1
110	1283668	1283792	407	531	124	RIGHT	Y481.EDF	Y48	1
111	1291436	1291581	182	327	145	RIGHT	Y481.EDF	Y48	1
111	1293768	1293883	2514	2629	115	RIGHT	Y481.EDF	Y48	1
112	1298153	1298326	497	670	173	RIGHT	Y481.EDF	Y48	1
115	1318697	1318823	265	391	126	RIGHT	Y481.EDF	Y48	1
116	1325860	1327173	985	2298	1313	RIGHT	Y481.EDF	Y48	1
116	1327194	1327286	2319	2411	92	RIGHT	Y481.EDF	Y48	1
116	1327664	1327670	2789	2795	6	RIGHT	Y481.EDF	Y48	1
116	1328010	1328951	3135	4076	941	RIGHT	Y481.EDF	Y48	1
117	1332037	1332502	91	556	465	RIGHT	Y481.EDF	Y48	1
118	1342248	1342371	2652	2775	123	RIGHT	Y481.EDF	Y48	1
118	1342574	1342643	2978	3047	69	RIGHT	Y481.EDF	Y48	1
118	1342677	1342694	3081	3098	17	RIGHT	Y481.EDF	Y48	1
118	1345086	1345200	5490	5604	114	RIGHT	Y481.EDF	Y48	1
119	1348229	1348361	640	772	132	RIGHT	Y481.EDF	Y48	1
120	1356290	1357805	604	2119	1515	RIGHT	Y481.EDF	Y48	1
120	1361108	1361263	5422	5577	155	RIGHT	Y481.EDF	Y48	1
1	2231949	2232507	57	615	558	RIGHT	Y482.EDF	Y48	2
1	2232671	2232984	779	1092	313	RIGHT	Y482.EDF	Y48	2
1	2233566	2234367	1674	2475	801	RIGHT	Y482.EDF	Y48	2
2	2240062	2240293	1194	1425	231	RIGHT	Y482.EDF	Y48	2
4	2253668	2254471	878	1681	803	RIGHT	Y482.EDF	Y48	2
4	2254512	2255562	1722	2772	1050	RIGHT	Y482.EDF	Y48	2
4	2255891	2257018	3101	4228	1127	RIGHT	Y482.EDF	Y48	2
4	2257667	2258026	4877	5236	359	RIGHT	Y482.EDF	Y48	2
5	2259746	2260590	57	901	844	RIGHT	Y482.EDF	Y48	2
5	2262794	2265399	3105	5710	2605	RIGHT	Y482.EDF	Y48	2
6	2266677	2272844	57	6224	6167	RIGHT	Y482.EDF	Y48	2
7	2274452	2279518	57	5123	5066	RIGHT	Y482.EDF	Y48	2
8	2281437	2281826	58	447	389	RIGHT	Y482.EDF	Y48	2
8	2282206	2282412	827	1033	206	RIGHT	Y482.EDF	Y48	2
8	2282499	2282616	1120	1237	117	RIGHT	Y482.EDF	Y48	2
9	2292171	2292284	2523	2636	113	RIGHT	Y482.EDF	Y48	2
12	2311113	2311207	58	152	94	RIGHT	Y482.EDF	Y48	2
12	2312339	2313250	1284	2195	911	RIGHT	Y482.EDF	Y48	2
13	2318832	2321270	519	2957	2438	RIGHT	Y482.EDF	Y48	2
13	2321308	2322776	2995	4463	1468	RIGHT	Y482.EDF	Y48	2
13	2323810	2324225	5497	5912	415	RIGHT	Y482.EDF	Y48	2
13	2324606	2325717	6293	7404	1111	RIGHT	Y482.EDF	Y48	2
14	2328286	2334212	58	5984	5926	RIGHT	Y482.EDF	Y48	2
15	2335822	2341436	58	5672	5614	RIGHT	Y482.EDF	Y48	2
16	2343122	2349901	57	6836	6779	RIGHT	Y482.EDF	Y48	2
17	2352211	2358496	57	6342	6285	RIGHT	Y482.EDF	Y48	2
18	2360225	2360498	57	330	273	RIGHT	Y482.EDF	Y48	2
18	2360587	2361015	419	847	428	RIGHT	Y482.EDF	Y48	2
20	2379440	2379592	5304	5456	152	RIGHT	Y482.EDF	Y48	2
21	2382944	2383515	756	1327	571	RIGHT	Y482.EDF	Y48	2
21	2383539	2383640	1351	1452	101	RIGHT	Y482.EDF	Y48	2
21	2383688	2383911	1500	1723	223	RIGHT	Y482.EDF	Y48	2
22	2390913	2391135	2065	2287	222	RIGHT	Y482.EDF	Y48	2
23	2395584	2396820	58	1294	1236	RIGHT	Y482.EDF	Y48	2
24	2409894	2410025	5507	5638	131	RIGHT	Y482.EDF	Y48	2
25	2411888	2411914	58	84	26	RIGHT	Y482.EDF	Y48	2
25	2412437	2412611	607	781	174	RIGHT	Y482.EDF	Y48	2
26	2420888	2422997	594	2703	2109	RIGHT	Y482.EDF	Y48	2
26	2424133	2426058	3839	5764	1925	RIGHT	Y482.EDF	Y48	2
27	2428235	2428265	57	87	30	RIGHT	Y482.EDF	Y48	2
27	2430256	2430331	2078	2153	75	RIGHT	Y482.EDF	Y48	2
27	2431956	2432111	3778	3933	155	RIGHT	Y482.EDF	Y48	2
27	2432215	2432398	4037	4220	183	RIGHT	Y482.EDF	Y48	2
27	2433144	2433573	4966	5395	429	RIGHT	Y482.EDF	Y48	2
28	2434888	2436163	58	1333	1275	RIGHT	Y482.EDF	Y48	2
28	2436236	2441428	1406	6598	5192	RIGHT	Y482.EDF	Y48	2
29	2442766	2449643	58	6935	6877	RIGHT	Y482.EDF	Y48	2
30	2451159	2456707	57	5605	5548	RIGHT	Y482.EDF	Y48	2
31	2458455	2460493	57	2095	2038	RIGHT	Y482.EDF	Y48	2
31	2460697	2461112	2299	2714	415	RIGHT	Y482.EDF	Y48	2
31	2463302	2463544	4904	5146	242	RIGHT	Y482.EDF	Y48	2
32	2469229	2469399	1168	1338	170	RIGHT	Y482.EDF	Y48	2
33	2480481	2480707	5933	6159	226	RIGHT	Y482.EDF	Y48	2
34	2482411	2482502	57	148	91	RIGHT	Y482.EDF	Y48	2
34	2488639	2488804	6285	6450	165	RIGHT	Y482.EDF	Y48	2
35	2490688	2490940	103	355	252	RIGHT	Y482.EDF	Y48	2
35	2493168	2493351	2583	2766	183	RIGHT	Y482.EDF	Y48	2
35	2496424	2496658	5839	6073	234	RIGHT	Y482.EDF	Y48	2
36	2499770	2499771	707	708	1	RIGHT	Y482.EDF	Y48	2
36	2499792	2500813	729	1750	1021	RIGHT	Y482.EDF	Y48	2
37	2509244	2509952	2297	3005	708	RIGHT	Y482.EDF	Y48	2
37	2511141	2511608	4194	4661	467	RIGHT	Y482.EDF	Y48	2
38	2514440	2514745	549	854	305	RIGHT	Y482.EDF	Y48	2
38	2518641	2518876	4750	4985	235	RIGHT	Y482.EDF	Y48	2
39	2523063	2523259	2260	2456	196	RIGHT	Y482.EDF	Y48	2
40	2528366	2528961	577	1172	595	RIGHT	Y482.EDF	Y48	2
40	2529440	2529716	1651	1927	276	RIGHT	Y482.EDF	Y48	2
40	2532010	2532278	4221	4489	268	RIGHT	Y482.EDF	Y48	2
41	2535575	2536048	690	1163	473	RIGHT	Y482.EDF	Y48	2
41	2539589	2539689	4704	4804	100	RIGHT	Y482.EDF	Y48	2
42	2547015	2547285	4377	4647	270	RIGHT	Y482.EDF	Y48	2
42	2547307	2547348	4669	4710	41	RIGHT	Y482.EDF	Y48	2
42	2547385	2547485	4747	4847	100	RIGHT	Y482.EDF	Y48	2
42	2547515	2547515	4877	4877	0	RIGHT	Y482.EDF	Y48	2
42	2547634	2547662	4996	5024	28	RIGHT	Y482.EDF	Y48	2
42	2547771	2547897	5133	5259	126	RIGHT	Y482.EDF	Y48	2
42	2547923	2548126	5285	5488	203	RIGHT	Y482.EDF	Y48	2
42	2548892	2548894	6254	6256	2	RIGHT	Y482.EDF	Y48	2
43	2551152	2557849	57	6754	6697	RIGHT	Y482.EDF	Y48	2
44	2559356	2560516	57	1217	1160	RIGHT	Y482.EDF	Y48	2
44	2561060	2561318	1761	2019	258	RIGHT	Y482.EDF	Y48	2
45	2567379	2573939	333	6893	6560	RIGHT	Y482.EDF	Y48	2
46	2575758	2580513	58	4813	4755	RIGHT	Y482.EDF	Y48	2
47	2581829	2588788	58	7017	6959	RIGHT	Y482.EDF	Y48	2
48	2590327	2595192	58	4923	4865	RIGHT	Y482.EDF	Y48	2
49	2597127	2603327	57	6257	6200	RIGHT	Y482.EDF	Y48	2
50	2605086	2606066	57	1037	980	RIGHT	Y482.EDF	Y48	2
50	2606494	2606847	1465	1818	353	RIGHT	Y482.EDF	Y48	2
50	2607168	2607229	2139	2200	61	RIGHT	Y482.EDF	Y48	2
50	2610597	2610808	5568	5779	211	RIGHT	Y482.EDF	Y48	2
51	2613732	2614012	529	809	280	RIGHT	Y482.EDF	Y48	2
51	2614036	2614436	833	1233	400	RIGHT	Y482.EDF	Y48	2
51	2614730	2618667	1527	5464	3937	RIGHT	Y482.EDF	Y48	2
52	2620173	2622368	57	2252	2195	RIGHT	Y482.EDF	Y48	2
52	2622440	2622625	2324	2509	185	RIGHT	Y482.EDF	Y48	2
52	2622773	2626542	2657	6426	3769	RIGHT	Y482.EDF	Y48	2
53	2627971	2635167	57	7253	7196	RIGHT	Y482.EDF	Y48	2
54	2637505	2639035	57	1587	1530	RIGHT	Y482.EDF	Y48	2
54	2641420	2641420	3972	3972	0	RIGHT	Y482.EDF	Y48	2
54	2641454	2643472	4006	6024	2018	RIGHT	Y482.EDF	Y48	2
55	2645164	2651807	57	6700	6643	RIGHT	Y482.EDF	Y48	2
56	2653607	2660412	58	6863	6805	RIGHT	Y482.EDF	Y48	2
57	2662051	2668538	58	6545	6487	RIGHT	Y482.EDF	Y48	2
58	2669997	2677083	58	7144	7086	RIGHT	Y482.EDF	Y48	2
59	2679039	2680668	57	1686	1629	RIGHT	Y482.EDF	Y48	2
60	2686536	2687374	57	895	838	RIGHT	Y482.EDF	Y48	2
61	2694641	2694727	57	143	86	RIGHT	Y482.EDF	Y48	2
61	2694756	2694861	172	277	105	RIGHT	Y482.EDF	Y48	2
61	2695362	2695768	778	1184	406	RIGHT	Y482.EDF	Y48	2
61	2695931	2696057	1347	1473	126	RIGHT	Y482.EDF	Y48	2
61	2696778	2697002	2194	2418	224	RIGHT	Y482.EDF	Y48	2
61	2698683	2698900	4099	4316	217	RIGHT	Y482.EDF	Y48	2
61	2700458	2700517	5874	5933	59	RIGHT	Y482.EDF	Y48	2
62	2704310	2704542	2186	2418	232	RIGHT	Y482.EDF	Y48	2
63	2710410	2710438	58	86	28	RIGHT	Y482.EDF	Y48	2
63	2713435	2713603	3083	3251	168	RIGHT	Y482.EDF	Y48	2
64	2722914	2723431	5378	5895	517	RIGHT	Y482.EDF	Y48	2
65	2725057	2725303	164	410	246	RIGHT	Y482.EDF	Y48	2
65	2727367	2727620	2474	2727	253	RIGHT	Y482.EDF	Y48	2
66	2733076	2733293	57	274	217	RIGHT	Y482.EDF	Y48	2
66	2733946	2734271	927	1252	325	RIGHT	Y482.EDF	Y48	2
66	2736564	2737341	3545	4322	777	RIGHT	Y482.EDF	Y48	2
67	2741636	2741740	1795	1899	104	RIGHT	Y482.EDF	Y48	2
67	2741761	2741908	1920	2067	147	RIGHT	Y482.EDF	Y48	2
68	2749416	2749534	58	176	118	RIGHT	Y482.EDF	Y48	2
68	2750859	2751177	1501	1819	318	RIGHT	Y482.EDF	Y48	2
68	2751333	2751519	1975	2161	186	RIGHT	Y482.EDF	Y48	2
69	2757942	2758654	980	1692	712	RIGHT	Y482.EDF	Y48	2
69	2759470	2759833	2508	2871	363	RIGHT	Y482.EDF	Y48	2
69	2760903	2761155	3941	4193	252	RIGHT	Y482.EDF	Y48	2
69	2761456	2762796	4494	5834	1340	RIGHT	Y482.EDF	Y48	2
70	2765422	2771471	58	6107	6049	RIGHT	Y482.EDF	Y48	2
71	2773041	2774092	58	1109	1051	RIGHT	Y482.EDF	Y48	2
71	2774495	2774578	1512	1595	83	RIGHT	Y482.EDF	Y48	2
72	2780596	2780715	73	192	119	RIGHT	Y482.EDF	Y48	2
72	2781034	2781670	511	1147	636	RIGHT	Y482.EDF	Y48	2
72	2781892	2782029	1369	1506	137	RIGHT	Y482.EDF	Y48	2
72	2783021	2783177	2498	2654	156	RIGHT	Y482.EDF	Y48	2
72	2785336	2785514	4813	4991	178	RIGHT	Y482.EDF	Y48	2
72	2786534	2786744	6011	6221	210	RIGHT	Y482.EDF	Y48	2
73	2789571	2789908	620	957	337	RIGHT	Y482.EDF	Y48	2
74	2796024	2796374	648	998	350	RIGHT	Y482.EDF	Y48	2
74	2797703	2797972	2327	2596	269	RIGHT	Y482.EDF	Y48	2
74	2798985	2799413	3609	4037	428	RIGHT	Y482.EDF	Y48	2
74	2800152	2800542	4776	5166	390	RIGHT	Y482.EDF	Y48	2
75	2802623	2802911	58	346	288	RIGHT	Y482.EDF	Y48	2
76	2811925	2812207	583	865	282	RIGHT	Y482.EDF	Y48	2
76	2816185	2816629	4843	5287	444	RIGHT	Y482.EDF	Y48	2
77	2819218	2819268	57	107	50	RIGHT	Y482.EDF	Y48	2
77	2819785	2820091	624	930	306	RIGHT	Y482.EDF	Y48	2
79	2835540	2835771	2201	2432	231	RIGHT	Y482.EDF	Y48	2
79	2836041	2836690	2702	3351	649	RIGHT	Y482.EDF	Y48	2
79	2836927	2837050	3588	3711	123	RIGHT	Y482.EDF	Y48	2
79	2837589	2837762	4250	4423	173	RIGHT	Y482.EDF	Y48	2
80	2842202	2842408	599	805	206	RIGHT	Y482.EDF	Y48	2
81	2849073	2849314	617	858	241	RIGHT	Y482.EDF	Y48	2
82	2856660	2857004	306	650	344	RIGHT	Y482.EDF	Y48	2
82	2857038	2857313	684	959	275	RIGHT	Y482.EDF	Y48	2
83	2866845	2866967	1639	1761	122	RIGHT	Y482.EDF	Y48	2
83	2866995	2867108	1789	1902	113	RIGHT	Y482.EDF	Y48	2
84	2873714	2874878	57	1221	1164	RIGHT	Y482.EDF	Y48	2
84	2875388	2875507	1731	1850	119	RIGHT	Y482.EDF	Y48	2
85	2882077	2882376	649	948	299	RIGHT	Y482.EDF	Y48	2
85	2883827	2883917	2399	2489	90	RIGHT	Y482.EDF	Y48	2
87	2896637	2897910	710	1983	1273	RIGHT	Y482.EDF	Y48	2
88	2909748	2909806	6348	6406	58	RIGHT	Y482.EDF	Y48	2
89	2911795	2911967	624	796	172	RIGHT	Y482.EDF	Y48	2
90	2919073	2919237	291	455	164	RIGHT	Y482.EDF	Y48	2
90	2919606	2919724	824	942	118	RIGHT	Y482.EDF	Y48	2
91	2924948	2926702	92	1846	1754	RIGHT	Y482.EDF	Y48	2
91	2926995	2927282	2139	2426	287	RIGHT	Y482.EDF	Y48	2
91	2927366	2927463	2510	2607	97	RIGHT	Y482.EDF	Y48	2
93	2940973	2941144	528	699	171	RIGHT	Y482.EDF	Y48	2
94	2947953	2947967	63	77	14	RIGHT	Y482.EDF	Y48	2
94	2950276	2950415	2386	2525	139	RIGHT	Y482.EDF	Y48	2
94	2954215	2954364	6325	6474	149	RIGHT	Y482.EDF	Y48	2
95	2956654	2956701	58	105	47	RIGHT	Y482.EDF	Y48	2
95	2959041	2959209	2445	2613	168	RIGHT	Y482.EDF	Y48	2
95	2959887	2960055	3291	3459	168	RIGHT	Y482.EDF	Y48	2
95	2961331	2961591	4735	4995	260	RIGHT	Y482.EDF	Y48	2
96	2964870	2966754	80	1964	1884	RIGHT	Y482.EDF	Y48	2
96	2967262	2967305	2472	2515	43	RIGHT	Y482.EDF	Y48	2
96	2969128	2969307	4338	4517	179	RIGHT	Y482.EDF	Y48	2
96	2969501	2970764	4711	5974	1263	RIGHT	Y482.EDF	Y48	2
97	2971943	2977568	58	5683	5625	RIGHT	Y482.EDF	Y48	2
98	2979297	2985973	58	6734	6676	RIGHT	Y482.EDF	Y48	2
99	2987602	2993418	58	5874	5816	RIGHT	Y482.EDF	Y48	2
100	2994978	3001202	57	6281	6224	RIGHT	Y482.EDF	Y48	2
101	3003169	3009147	58	6036	5978	RIGHT	Y482.EDF	Y48	2
102	3010796	3017543	58	6805	6747	RIGHT	Y482.EDF	Y48	2
103	3019090	3025668	57	6635	6578	RIGHT	Y482.EDF	Y48	2
104	3027867	3034353	58	6544	6486	RIGHT	Y482.EDF	Y48	2
105	3035987	3042898	57	6968	6911	RIGHT	Y482.EDF	Y48	2
106	3044836	3051944	58	7166	7108	RIGHT	Y482.EDF	Y48	2
107	3053750	3055307	58	1615	1557	RIGHT	Y482.EDF	Y48	2
108	3064037	3064220	3098	3281	183	RIGHT	Y482.EDF	Y48	2
109	3069134	3069587	58	511	453	RIGHT	Y482.EDF	Y48	2
109	3069738	3070153	662	1077	415	RIGHT	Y482.EDF	Y48	2
109	3070927	3076138	1851	7062	5211	RIGHT	Y482.EDF	Y48	2
110	3078855	3085985	57	7187	7130	RIGHT	Y482.EDF	Y48	2
111	3087463	3093219	57	5813	5756	RIGHT	Y482.EDF	Y48	2
112	3095186	3101075	57	5946	5889	RIGHT	Y482.EDF	Y48	2
113	3102813	3108078	57	5322	5265	RIGHT	Y482.EDF	Y48	2
114	3110217	3116363	57	6203	6146	RIGHT	Y482.EDF	Y48	2
115	3117972	3124819	57	6904	6847	RIGHT	Y482.EDF	Y48	2
116	3126506	3131563	57	5114	5057	RIGHT	Y482.EDF	Y48	2
117	3133333	3138707	58	5432	5374	RIGHT	Y482.EDF	Y48	2
118	3140607	3145892	57	5342	5285	RIGHT	Y482.EDF	Y48	2
119	3147858	3154397	57	6596	6539	RIGHT	Y482.EDF	Y48	2
120	3156323	3162293	58	6028	5970	RIGHT	Y482.EDF	Y48	2
1	3545750	3546958	582	1790	1208	RIGHT	Y483.EDF	Y48	3
2	3552512	3552728	204	420	216	RIGHT	Y483.EDF	Y48	3
2	3553248	3553446	940	1138	198	RIGHT	Y483.EDF	Y48	3
2	3553507	3553735	1199	1427	228	RIGHT	Y483.EDF	Y48	3
2	3554837	3555019	2529	2711	182	RIGHT	Y483.EDF	Y48	3
2	3555117	3555352	2809	3044	235	RIGHT	Y483.EDF	Y48	3
3	3561105	3561358	408	661	253	RIGHT	Y483.EDF	Y48	3
4	3570327	3570745	1757	2175	418	RIGHT	Y483.EDF	Y48	3
4	3570867	3571014	2297	2444	147	RIGHT	Y483.EDF	Y48	3
5	3578381	3578634	1634	1887	253	RIGHT	Y483.EDF	Y48	3
7	3591453	3591489	57	93	36	RIGHT	Y483.EDF	Y48	3
7	3591623	3591738	227	342	115	RIGHT	Y483.EDF	Y48	3
7	3591997	3592155	601	759	158	RIGHT	Y483.EDF	Y48	3
7	3592787	3592895	1391	1499	108	RIGHT	Y483.EDF	Y48	3
7	3593160	3593315	1764	1919	155	RIGHT	Y483.EDF	Y48	3
8	3598668	3598670	597	599	2	RIGHT	Y483.EDF	Y48	3
8	3598696	3599731	625	1660	1035	RIGHT	Y483.EDF	Y48	3
9	3604479	3604729	545	795	250	RIGHT	Y483.EDF	Y48	3
9	3608821	3609007	4887	5073	186	RIGHT	Y483.EDF	Y48	3
10	3610450	3610674	63	287	224	RIGHT	Y483.EDF	Y48	3
10	3616188	3616486	5801	6099	298	RIGHT	Y483.EDF	Y48	3
11	3618687	3624776	57	6146	6089	RIGHT	Y483.EDF	Y48	3
12	3626400	3626708	57	365	308	RIGHT	Y483.EDF	Y48	3
12	3630288	3630521	3945	4178	233	RIGHT	Y483.EDF	Y48	3
12	3631368	3631380	5025	5037	12	RIGHT	Y483.EDF	Y48	3
12	3631562	3631583	5219	5240	21	RIGHT	Y483.EDF	Y48	3
13	3634516	3635638	574	1696	1122	RIGHT	Y483.EDF	Y48	3
13	3637300	3637336	3358	3394	36	RIGHT	Y483.EDF	Y48	3
13	3637428	3637430	3486	3488	2	RIGHT	Y483.EDF	Y48	3
13	3637509	3637651	3567	3709	142	RIGHT	Y483.EDF	Y48	3
13	3637678	3637678	3736	3736	0	RIGHT	Y483.EDF	Y48	3
13	3637704	3638399	3762	4457	695	RIGHT	Y483.EDF	Y48	3
13	3638907	3638989	4965	5047	82	RIGHT	Y483.EDF	Y48	3
13	3639211	3639218	5269	5276	7	RIGHT	Y483.EDF	Y48	3
13	3639247	3639247	5305	5305	0	RIGHT	Y483.EDF	Y48	3
13	3639292	3639476	5350	5534	184	RIGHT	Y483.EDF	Y48	3
14	3642068	3642256	460	648	188	RIGHT	Y483.EDF	Y48	3
15	3648507	3648599	57	149	92	RIGHT	Y483.EDF	Y48	3
15	3655322	3655464	6872	7014	142	RIGHT	Y483.EDF	Y48	3
16	3657101	3657375	166	440	274	RIGHT	Y483.EDF	Y48	3
16	3659682	3659924	2747	2989	242	RIGHT	Y483.EDF	Y48	3
16	3661921	3662054	4986	5119	133	RIGHT	Y483.EDF	Y48	3
16	3662134	3662926	5199	5991	792	RIGHT	Y483.EDF	Y48	3
16	3663050	3663060	6115	6125	10	RIGHT	Y483.EDF	Y48	3
17	3665812	3666041	270	499	229	RIGHT	Y483.EDF	Y48	3
18	3672564	3672841	468	745	277	RIGHT	Y483.EDF	Y48	3
19	3680905	3681555	234	884	650	RIGHT	Y483.EDF	Y48	3
19	3682942	3683227	2271	2556	285	RIGHT	Y483.EDF	Y48	3
21	3697017	3697627	516	1126	610	RIGHT	Y483.EDF	Y48	3
22	3705581	3705818	527	764	237	RIGHT	Y483.EDF	Y48	3
23	3712203	3712455	496	748	252	RIGHT	Y483.EDF	Y48	3
24	3722516	3722645	2152	2281	129	RIGHT	Y483.EDF	Y48	3
24	3724865	3724952	4501	4588	87	RIGHT	Y483.EDF	Y48	3
25	3732867	3732985	4193	4311	118	RIGHT	Y483.EDF	Y48	3
26	3737488	3737629	312	453	141	RIGHT	Y483.EDF	Y48	3
26	3737817	3737962	641	786	145	RIGHT	Y483.EDF	Y48	3
26	3739410	3739563	2234	2387	153	RIGHT	Y483.EDF	Y48	3
26	3739956	3740118	2780	2942	162	RIGHT	Y483.EDF	Y48	3
26	3741483	3741714	4307	4538	231	RIGHT	Y483.EDF	Y48	3
27	3745256	3745286	256	286	30	RIGHT	Y483.EDF	Y48	3
27	3745336	3746764	336	1764	1428	RIGHT	Y483.EDF	Y48	3
27	3749048	3749061	4048	4061	13	RIGHT	Y483.EDF	Y48	3
29	3759917	3760108	58	249	191	RIGHT	Y483.EDF	Y48	3
29	3760461	3760733	602	874	272	RIGHT	Y483.EDF	Y48	3
29	3761823	3761987	1964	2128	164	RIGHT	Y483.EDF	Y48	3
32	3784899	3785147	2636	2884	248	RIGHT	Y483.EDF	Y48	3
33	3791530	3791907	1403	1780	377	RIGHT	Y483.EDF	Y48	3
33	3794939	3794967	4812	4840	28	RIGHT	Y483.EDF	Y48	3
34	3798629	3798966	84	421	337	RIGHT	Y483.EDF	Y48	3
34	3803099	3803131	4554	4586	32	RIGHT	Y483.EDF	Y48	3
34	3805221	3805230	6676	6685	9	RIGHT	Y483.EDF	Y48	3
35	3807725	3807983	315	573	258	RIGHT	Y483.EDF	Y48	3
36	3816319	3816547	1776	2004	228	RIGHT	Y483.EDF	Y48	3
37	3822452	3822747	664	959	295	RIGHT	Y483.EDF	Y48	3
37	3828467	3828532	6679	6744	65	RIGHT	Y483.EDF	Y48	3
38	3830414	3830933	220	739	519	RIGHT	Y483.EDF	Y48	3
38	3831091	3831236	897	1042	145	RIGHT	Y483.EDF	Y48	3
39	3836925	3837199	57	331	274	RIGHT	Y483.EDF	Y48	3
40	3846398	3846536	2960	3098	138	RIGHT	Y483.EDF	Y48	3
41	3857563	3857780	5526	5743	217	RIGHT	Y483.EDF	Y48	3
42	3861160	3861740	1008	1588	580	RIGHT	Y483.EDF	Y48	3
43	3871132	3871315	3052	3235	183	RIGHT	Y483.EDF	Y48	3
44	3875899	3876276	500	877	377	RIGHT	Y483.EDF	Y48	3
44	3881242	3881364	5843	5965	122	RIGHT	Y483.EDF	Y48	3
44	3881437	3881640	6038	6241	203	RIGHT	Y483.EDF	Y48	3
45	3884349	3884900	103	654	551	RIGHT	Y483.EDF	Y48	3
45	3885262	3885455	1016	1209	193	RIGHT	Y483.EDF	Y48	3
45	3886672	3886890	2426	2644	218	RIGHT	Y483.EDF	Y48	3
45	3888757	3889107	4511	4861	350	RIGHT	Y483.EDF	Y48	3
46	3892064	3892193	57	186	129	RIGHT	Y483.EDF	Y48	3
46	3893499	3893633	1492	1626	134	RIGHT	Y483.EDF	Y48	3
47	3899387	3899535	231	379	148	RIGHT	Y483.EDF	Y48	3
47	3905582	3905705	6426	6549	123	RIGHT	Y483.EDF	Y48	3
48	3907429	3907570	199	340	141	RIGHT	Y483.EDF	Y48	3
48	3907985	3908201	755	971	216	RIGHT	Y483.EDF	Y48	3
48	3910751	3910861	3521	3631	110	RIGHT	Y483.EDF	Y48	3
48	3912094	3912094	4864	4864	0	RIGHT	Y483.EDF	Y48	3
48	3912136	3912144	4906	4914	8	RIGHT	Y483.EDF	Y48	3
48	3912210	3914425	4980	7195	2215	RIGHT	Y483.EDF	Y48	3
49	3915890	3916145	94	349	255	RIGHT	Y483.EDF	Y48	3
49	3916185	3918403	389	2607	2218	RIGHT	Y483.EDF	Y48	3
49	3918461	3919756	2665	3960	1295	RIGHT	Y483.EDF	Y48	3
49	3919782	3919783	3986	3987	1	RIGHT	Y483.EDF	Y48	3
49	3919805	3922700	4009	6904	2895	RIGHT	Y483.EDF	Y48	3
50	3924637	3924946	495	804	309	RIGHT	Y483.EDF	Y48	3
50	3928334	3928334	4192	4192	0	RIGHT	Y483.EDF	Y48	3
50	3928673	3928713	4531	4571	40	RIGHT	Y483.EDF	Y48	3
50	3928832	3929426	4690	5284	594	RIGHT	Y483.EDF	Y48	3
51	3932513	3932879	887	1253	366	RIGHT	Y483.EDF	Y48	3
51	3936341	3936508	4715	4882	167	RIGHT	Y483.EDF	Y48	3
52	3938153	3938419	121	387	266	RIGHT	Y483.EDF	Y48	3
52	3938509	3938924	477	892	415	RIGHT	Y483.EDF	Y48	3
53	3944862	3945259	459	856	397	RIGHT	Y483.EDF	Y48	3
53	3948458	3948712	4055	4309	254	RIGHT	Y483.EDF	Y48	3
54	3951388	3951637	151	400	249	RIGHT	Y483.EDF	Y48	3
54	3953960	3954226	2723	2989	266	RIGHT	Y483.EDF	Y48	3
54	3954590	3954768	3353	3531	178	RIGHT	Y483.EDF	Y48	3
54	3956576	3956794	5339	5557	218	RIGHT	Y483.EDF	Y48	3
54	3957727	3957952	6490	6715	225	RIGHT	Y483.EDF	Y48	3
55	3960020	3960319	57	356	299	RIGHT	Y483.EDF	Y48	3
55	3961480	3961749	1517	1786	269	RIGHT	Y483.EDF	Y48	3
56	3968620	3968772	237	389	152	RIGHT	Y483.EDF	Y48	3
56	3969201	3969416	818	1033	215	RIGHT	Y483.EDF	Y48	3
56	3970584	3970764	2201	2381	180	RIGHT	Y483.EDF	Y48	3
56	3972258	3972424	3875	4041	166	RIGHT	Y483.EDF	Y48	3
56	3973823	3974061	5440	5678	238	RIGHT	Y483.EDF	Y48	3
57	3976764	3977041	90	367	277	RIGHT	Y483.EDF	Y48	3
57	3979950	3980109	3276	3435	159	RIGHT	Y483.EDF	Y48	3
59	3994049	3994413	324	688	364	RIGHT	Y483.EDF	Y48	3
60	4003231	4003522	861	1152	291	RIGHT	Y483.EDF	Y48	3
60	4004942	4008623	2572	6253	3681	RIGHT	Y483.EDF	Y48	3
61	4009991	4015587	58	5654	5596	RIGHT	Y483.EDF	Y48	3
62	4017395	4017668	57	330	273	RIGHT	Y483.EDF	Y48	3
62	4017961	4018109	623	771	148	RIGHT	Y483.EDF	Y48	3
62	4021496	4021527	4158	4189	31	RIGHT	Y483.EDF	Y48	3
62	4023147	4023182	5809	5844	35	RIGHT	Y483.EDF	Y48	3
62	4023878	4023887	6540	6549	9	RIGHT	Y483.EDF	Y48	3
63	4026412	4026762	499	849	350	RIGHT	Y483.EDF	Y48	3
64	4034414	4034454	58	98	40	RIGHT	Y483.EDF	Y48	3
64	4034811	4035312	455	956	501	RIGHT	Y483.EDF	Y48	3
64	4035990	4035990	1634	1634	0	RIGHT	Y483.EDF	Y48	3
64	4036039	4036039	1683	1683	0	RIGHT	Y483.EDF	Y48	3
64	4037533	4037756	3177	3400	223	RIGHT	Y483.EDF	Y48	3
64	4037815	4037987	3459	3631	172	RIGHT	Y483.EDF	Y48	3
64	4038013	4038160	3657	3804	147	RIGHT	Y483.EDF	Y48	3
64	4038182	4038257	3826	3901	75	RIGHT	Y483.EDF	Y48	3
64	4038886	4038886	4530	4530	0	RIGHT	Y483.EDF	Y48	3
64	4038939	4038939	4583	4583	0	RIGHT	Y483.EDF	Y48	3
64	4039016	4039016	4660	4660	0	RIGHT	Y483.EDF	Y48	3
64	4039048	4039048	4692	4692	0	RIGHT	Y483.EDF	Y48	3
64	4039078	4039078	4722	4722	0	RIGHT	Y483.EDF	Y48	3
64	4039122	4039173	4766	4817	51	RIGHT	Y483.EDF	Y48	3
64	4039208	4039239	4852	4883	31	RIGHT	Y483.EDF	Y48	3
64	4039718	4039800	5362	5444	82	RIGHT	Y483.EDF	Y48	3
64	4039835	4039950	5479	5594	115	RIGHT	Y483.EDF	Y48	3
64	4039971	4040307	5615	5951	336	RIGHT	Y483.EDF	Y48	3
65	4041902	4041931	57	86	29	RIGHT	Y483.EDF	Y48	3
65	4042046	4042276	201	431	230	RIGHT	Y483.EDF	Y48	3
65	4042396	4042396	551	551	0	RIGHT	Y483.EDF	Y48	3
65	4042428	4042517	583	672	89	RIGHT	Y483.EDF	Y48	3
65	4042562	4042669	717	824	107	RIGHT	Y483.EDF	Y48	3
65	4042692	4043111	847	1266	419	RIGHT	Y483.EDF	Y48	3
65	4043152	4043152	1307	1307	0	RIGHT	Y483.EDF	Y48	3
65	4043205	4043217	1360	1372	12	RIGHT	Y483.EDF	Y48	3
65	4043443	4043444	1598	1599	1	RIGHT	Y483.EDF	Y48	3
65	4043553	4043553	1708	1708	0	RIGHT	Y483.EDF	Y48	3
65	4044395	4044636	2550	2791	241	RIGHT	Y483.EDF	Y48	3
65	4045049	4048788	3204	6943	3739	RIGHT	Y483.EDF	Y48	3
66	4050496	4050730	58	292	234	RIGHT	Y483.EDF	Y48	3
66	4050764	4051016	326	578	252	RIGHT	Y483.EDF	Y48	3
66	4051043	4051618	605	1180	575	RIGHT	Y483.EDF	Y48	3
67	4059281	4059397	58	174	116	RIGHT	Y483.EDF	Y48	3
67	4059748	4060142	525	919	394	RIGHT	Y483.EDF	Y48	3
68	4066920	4068062	463	1605	1142	RIGHT	Y483.EDF	Y48	3
69	4073831	4074081	458	708	250	RIGHT	Y483.EDF	Y48	3
69	4078472	4078730	5099	5357	258	RIGHT	Y483.EDF	Y48	3
69	4079537	4079746	6164	6373	209	RIGHT	Y483.EDF	Y48	3
70	4081524	4082023	58	557	499	RIGHT	Y483.EDF	Y48	3
70	4082333	4082682	867	1216	349	RIGHT	Y483.EDF	Y48	3
70	4082713	4082831	1247	1365	118	RIGHT	Y483.EDF	Y48	3
70	4083219	4083219	1753	1753	0	RIGHT	Y483.EDF	Y48	3
70	4083244	4083245	1778	1779	1	RIGHT	Y483.EDF	Y48	3
70	4083271	4083304	1805	1838	33	RIGHT	Y483.EDF	Y48	3
70	4083325	4083339	1859	1873	14	RIGHT	Y483.EDF	Y48	3
70	4085540	4088552	4074	7086	3012	RIGHT	Y483.EDF	Y48	3
71	4090212	4090251	59	98	39	RIGHT	Y483.EDF	Y48	3
71	4090363	4090379	210	226	16	RIGHT	Y483.EDF	Y48	3
71	4090604	4090926	451	773	322	RIGHT	Y483.EDF	Y48	3
71	4091552	4091673	1399	1520	121	RIGHT	Y483.EDF	Y48	3
71	4091700	4091760	1547	1607	60	RIGHT	Y483.EDF	Y48	3
71	4091783	4091809	1630	1656	26	RIGHT	Y483.EDF	Y48	3
71	4091834	4091892	1681	1739	58	RIGHT	Y483.EDF	Y48	3
71	4091975	4091975	1822	1822	0	RIGHT	Y483.EDF	Y48	3
71	4092212	4092222	2059	2069	10	RIGHT	Y483.EDF	Y48	3
71	4092284	4092315	2131	2162	31	RIGHT	Y483.EDF	Y48	3
72	4097552	4097725	364	537	173	RIGHT	Y483.EDF	Y48	3
72	4097747	4098051	559	863	304	RIGHT	Y483.EDF	Y48	3
72	4098074	4098227	886	1039	153	RIGHT	Y483.EDF	Y48	3
72	4098815	4098817	1627	1629	2	RIGHT	Y483.EDF	Y48	3
72	4100464	4100532	3276	3344	68	RIGHT	Y483.EDF	Y48	3
72	4100560	4100728	3372	3540	168	RIGHT	Y483.EDF	Y48	3
72	4100975	4101196	3787	4008	221	RIGHT	Y483.EDF	Y48	3
72	4101227	4101227	4039	4039	0	RIGHT	Y483.EDF	Y48	3
72	4101643	4101656	4455	4468	13	RIGHT	Y483.EDF	Y48	3
72	4101762	4101955	4574	4767	193	RIGHT	Y483.EDF	Y48	3
72	4102024	4102245	4836	5057	221	RIGHT	Y483.EDF	Y48	3
72	4102608	4102645	5420	5457	37	RIGHT	Y483.EDF	Y48	3
72	4102816	4103881	5628	6693	1065	RIGHT	Y483.EDF	Y48	3
73	4105625	4105802	114	291	177	RIGHT	Y483.EDF	Y48	3
74	4113910	4114145	1647	1882	235	RIGHT	Y483.EDF	Y48	3
75	4120664	4120948	659	943	284	RIGHT	Y483.EDF	Y48	3
75	4122226	4122576	2221	2571	350	RIGHT	Y483.EDF	Y48	3
75	4123236	4124413	3231	4408	1177	RIGHT	Y483.EDF	Y48	3
75	4126092	4126145	6087	6140	53	RIGHT	Y483.EDF	Y48	3
76	4127712	4127802	58	148	90	RIGHT	Y483.EDF	Y48	3
77	4135110	4135239	58	187	129	RIGHT	Y483.EDF	Y48	3
77	4135761	4136003	709	951	242	RIGHT	Y483.EDF	Y48	3
77	4136824	4142446	1772	7394	5622	RIGHT	Y483.EDF	Y48	3
78	4144122	4145351	57	1286	1229	RIGHT	Y483.EDF	Y48	3
78	4145588	4145976	1523	1911	388	RIGHT	Y483.EDF	Y48	3
78	4146156	4146305	2091	2240	149	RIGHT	Y483.EDF	Y48	3
78	4148975	4149198	4910	5133	223	RIGHT	Y483.EDF	Y48	3
78	4149221	4149232	5156	5167	11	RIGHT	Y483.EDF	Y48	3
79	4152040	4152241	149	350	201	RIGHT	Y483.EDF	Y48	3
80	4160868	4160903	76	111	35	RIGHT	Y483.EDF	Y48	3
80	4161040	4167320	248	6528	6280	RIGHT	Y483.EDF	Y48	3
81	4168868	4173814	58	5004	4946	RIGHT	Y483.EDF	Y48	3
82	4176469	4176675	773	979	206	RIGHT	Y483.EDF	Y48	3
83	4182525	4182613	57	145	88	RIGHT	Y483.EDF	Y48	3
83	4184116	4184308	1648	1840	192	RIGHT	Y483.EDF	Y48	3
84	4189661	4189680	57	76	19	RIGHT	Y483.EDF	Y48	3
84	4190051	4190280	447	676	229	RIGHT	Y483.EDF	Y48	3
84	4190985	4191251	1381	1647	266	RIGHT	Y483.EDF	Y48	3
84	4193378	4194558	3774	4954	1180	RIGHT	Y483.EDF	Y48	3
85	4196277	4196651	57	431	374	RIGHT	Y483.EDF	Y48	3
85	4197007	4197306	787	1086	299	RIGHT	Y483.EDF	Y48	3
85	4198559	4202222	2339	6002	3663	RIGHT	Y483.EDF	Y48	3
86	4204004	4210477	57	6530	6473	RIGHT	Y483.EDF	Y48	3
87	4212116	4219292	57	7233	7176	RIGHT	Y483.EDF	Y48	3
88	4220939	4226517	58	5636	5578	RIGHT	Y483.EDF	Y48	3
89	4228024	4234872	57	6905	6848	RIGHT	Y483.EDF	Y48	3
90	4236659	4243147	57	6545	6488	RIGHT	Y483.EDF	Y48	3
91	4245156	4250522	57	5423	5366	RIGHT	Y483.EDF	Y48	3
92	4252479	4253626	57	1204	1147	RIGHT	Y483.EDF	Y48	3
92	4254320	4254320	1898	1898	0	RIGHT	Y483.EDF	Y48	3
92	4254399	4257556	1977	5134	3157	RIGHT	Y483.EDF	Y48	3
93	4259186	4265941	58	6813	6755	RIGHT	Y483.EDF	Y48	3
94	4267508	4273266	57	5815	5758	RIGHT	Y483.EDF	Y48	3
95	4275102	4281441	57	6396	6339	RIGHT	Y483.EDF	Y48	3
96	4283448	4285195	57	1804	1747	RIGHT	Y483.EDF	Y48	3
96	4285228	4285418	1837	2027	190	RIGHT	Y483.EDF	Y48	3
97	4291100	4293041	58	1999	1941	RIGHT	Y483.EDF	Y48	3
98	4298545	4305445	57	6957	6900	RIGHT	Y483.EDF	Y48	3
99	4307414	4312710	58	5354	5296	RIGHT	Y483.EDF	Y48	3
100	4314598	4319484	57	4943	4886	RIGHT	Y483.EDF	Y48	3
101	4321263	4321884	58	679	621	RIGHT	Y483.EDF	Y48	3
101	4322792	4323053	1587	1848	261	RIGHT	Y483.EDF	Y48	3
101	4323147	4323159	1942	1954	12	RIGHT	Y483.EDF	Y48	3
101	4323271	4328120	2066	6915	4849	RIGHT	Y483.EDF	Y48	3
102	4330600	4337286	58	6744	6686	RIGHT	Y483.EDF	Y48	3
103	4339179	4344130	58	5009	4951	RIGHT	Y483.EDF	Y48	3
104	4345866	4352564	57	6755	6698	RIGHT	Y483.EDF	Y48	3
105	4354223	4359519	57	5353	5296	RIGHT	Y483.EDF	Y48	3
106	4361147	4361646	58	557	499	RIGHT	Y483.EDF	Y48	3
106	4361762	4362578	673	1489	816	RIGHT	Y483.EDF	Y48	3
106	4363279	4368554	2190	7465	5275	RIGHT	Y483.EDF	Y48	3
107	4370770	4377190	57	6477	6420	RIGHT	Y483.EDF	Y48	3
108	4378997	4384414	57	5474	5417	RIGHT	Y483.EDF	Y48	3
109	4386863	4392669	58	5864	5806	RIGHT	Y483.EDF	Y48	3
110	4394968	4400854	57	5943	5886	RIGHT	Y483.EDF	Y48	3
111	4402313	4408330	58	6075	6017	RIGHT	Y483.EDF	Y48	3
112	4409955	4415893	58	5996	5938	RIGHT	Y483.EDF	Y48	3
113	4418499	4425830	57	7388	7331	RIGHT	Y483.EDF	Y48	3
114	4427470	4432564	58	5152	5094	RIGHT	Y483.EDF	Y48	3
115	4434392	4441230	57	6895	6838	RIGHT	Y483.EDF	Y48	3
116	4443176	4449514	58	6396	6338	RIGHT	Y483.EDF	Y48	3
117	4451521	4456388	57	4924	4867	RIGHT	Y483.EDF	Y48	3
118	4457947	4464523	57	6633	6576	RIGHT	Y483.EDF	Y48	3
119	4467374	4474050	58	6734	6676	RIGHT	Y483.EDF	Y48	3
120	4475949	4480884	57	4992	4935	RIGHT	Y483.EDF	Y48	3
